service_date,from_stop_id,to_stop_id,route_id,direction_id,start_time_sec,end_time_sec,travel_time_sec
2022-10-20,70048,70056,Blue,1,64565,64981,416
2022-03-24,70055,70043,Blue,0,67110,67780,670
2022-01-06,70046,70050,Blue,1,77454,77621,167
2022-06-12,70046,70048,Blue,1,85011,85087,76
2022-07-07,70042,70048,Blue,1,38036,38393,357
2022-11-28,70053,70041,Blue,0,66336,66990,654
2022-11-25,70053,70047,Blue,0,53372,53668,296
2022-10-21,70052,70058,Blue,1,35605,35843,238
2022-10-12,70051,70047,Blue,0,41054,41355,301
2022-07-25,70042,70058,Blue,1,54154,55065,911
2022-02-27,70040,70042,Blue,1,74834,74867,33
2022-06-24,70045,70838,Blue,0,72664,73030,366
2022-08-14,70058,70060,Blue,1,73712,73786,74
2022-08-10,70051,70047,Blue,0,46743,46954,211
2022-01-14,70055,70049,Blue,0,34336,34763,427
2022-12-18,70059,70045,Blue,0,68429,69180,751
2022-01-12,70053,70051,Blue,0,57763,57819,56
2022-09-26,70057,70051,Blue,0,34294,34584,290
2022-10-22,70051,70045,Blue,0,68535,68889,354
2022-10-28,70041,70838,Blue,0,60282,60400,118
2022-08-24,70044,70046,Blue,1,64243,64346,103
2022-10-20,70055,70039,Blue,0,51153,52038,885
2022-10-16,70045,70041,Blue,0,83719,83888,169
2022-01-03,70046,70050,Blue,1,56876,57062,186
2022-01-11,70048,70054,Blue,1,79612,79974,362
2022-08-25,70059,70049,Blue,0,28461,28966,505
2022-09-06,70044,70048,Blue,1,74147,74377,230
2022-08-03,70044,70048,Blue,1,78124,78362,238
2022-03-10,70039,70838,Blue,0,62463,62536,73
2022-11-03,70044,70048,Blue,1,24317,24556,239
2022-06-18,70051,70043,Blue,0,86960,87435,475
2022-07-29,70044,70050,Blue,1,35109,35457,348
2022-12-04,70051,70838,Blue,0,72015,72799,784
2022-12-20,70038,70044,Blue,1,34907,35078,171
2022-03-20,70055,70039,Blue,0,73500,74408,908
2022-11-25,70039,70838,Blue,0,64990,65024,34
2022-11-27,70053,70039,Blue,0,22480,23204,724
2022-02-08,70055,70039,Blue,0,63085,63941,856
2022-08-29,70048,70060,Blue,1,86358,87008,650
2022-08-21,70047,70045,Blue,0,49107,49218,111
2022-02-26,70039,70838,Blue,0,43774,43809,35
2022-06-22,70052,70060,Blue,1,43630,43995,365
2022-06-25,70040,70052,Blue,1,61750,62292,542
2022-09-21,70057,70043,Blue,0,35558,36441,883
2022-07-21,70043,70039,Blue,0,68051,68149,98
2022-08-03,70051,70838,Blue,0,35401,36221,820
2022-04-27,70055,70047,Blue,0,65852,66232,380
2022-03-31,70045,70041,Blue,0,30545,30717,172
2022-08-15,70038,70050,Blue,1,43656,44272,616
2022-08-18,70059,70838,Blue,0,68276,69361,1085
2022-05-20,70059,70039,Blue,0,54795,55918,1123
2022-12-16,70046,70048,Blue,1,70413,70492,79
2022-08-18,70045,70039,Blue,0,77434,77678,244
2022-08-09,70041,70039,Blue,0,34523,34556,33
2022-03-06,70055,70039,Blue,0,52393,53230,837
2022-11-08,70048,70050,Blue,1,27368,27424,56
2022-01-15,70042,70044,Blue,1,53558,53587,29
2022-09-25,70042,70050,Blue,1,35636,36087,451
2022-09-29,70038,70058,Blue,1,42604,43674,1070
2022-08-07,70051,70045,Blue,0,43152,43495,343
2022-01-27,70048,70056,Blue,1,37822,38314,492
2022-03-25,70046,70054,Blue,1,23992,24428,436
2022-10-21,70059,70057,Blue,0,63502,63537,35
2022-09-27,70042,70046,Blue,1,56706,56896,190
2022-03-31,70050,70056,Blue,1,58379,58680,301
2022-07-14,70053,70039,Blue,0,30405,31287,882
2022-06-11,70057,70047,Blue,0,66032,66491,459
2022-10-19,70055,70053,Blue,0,40766,40812,46
2022-04-18,70040,70054,Blue,1,31208,31939,731
2022-10-17,70042,70046,Blue,1,44128,44301,173
2022-01-17,70050,70054,Blue,1,54096,54318,222
2022-06-17,70057,70039,Blue,0,42792,43925,1133
2022-08-25,70049,70043,Blue,0,37301,37707,406
2022-06-14,70038,70040,Blue,1,36730,36751,21
2022-11-26,70046,70050,Blue,1,68914,69095,181
2022-07-03,70042,70052,Blue,1,81824,82444,620
2022-11-09,70051,70047,Blue,0,51433,51639,206
2022-03-27,70051,70041,Blue,0,25120,25709,589
2022-09-18,70055,70049,Blue,0,86594,86867,273
2022-11-03,70055,70047,Blue,0,23969,24353,384
2022-11-25,70040,70048,Blue,1,66466,66854,388
2022-12-17,70042,70052,Blue,1,61156,61737,581
2022-03-03,70057,70047,Blue,0,57284,57795,511
2022-05-15,70059,70057,Blue,0,25812,25847,35
2022-09-17,70049,70047,Blue,0,67001,67086,85
2022-09-27,70048,70052,Blue,1,82627,82840,213
2022-10-05,70045,70041,Blue,0,42907,43086,179
2022-04-08,70050,70054,Blue,1,61963,62181,218
2022-04-16,70053,70049,Blue,0,40834,41055,221
2022-10-07,70049,70041,Blue,0,28984,29444,460
2022-09-07,70056,70058,Blue,1,79749,79820,71
2022-02-23,70052,70054,Blue,1,29308,29372,64
2022-01-22,70044,70056,Blue,1,67939,68645,706
2022-12-21,70039,70838,Blue,0,54786,54819,33
2022-09-25,70054,70056,Blue,1,24572,24618,46
2022-04-07,70038,70040,Blue,1,29952,29968,16
2022-01-19,70059,70838,Blue,0,57193,58218,1025
2022-03-26,70040,70050,Blue,1,42136,42638,502
2022-12-30,70049,70047,Blue,0,20245,20300,55
2022-12-25,70049,70039,Blue,0,30554,31071,517
2022-04-16,70059,70055,Blue,0,77231,77371,140
2022-06-23,70044,70046,Blue,1,89336,89463,127
2022-07-08,70048,70054,Blue,1,33731,34057,326
2022-01-17,70051,70045,Blue,0,64713,65071,358
2022-01-31,70055,70838,Blue,0,21061,22251,1190
2022-01-21,70054,70060,Blue,1,74321,74570,249
2022-10-22,70055,70051,Blue,0,56421,56559,138
2022-03-11,70042,70048,Blue,1,80488,80805,317
2022-01-09,70057,70053,Blue,0,67411,67580,169
2022-09-07,70047,70041,Blue,0,32834,33165,331
2022-01-02,70059,70045,Blue,0,85518,86273,755
2022-02-17,70042,70048,Blue,1,78836,79169,333
2022-05-20,70055,70045,Blue,0,60065,60609,544
2022-07-11,70052,70056,Blue,1,56901,57055,154
2022-01-03,70057,70051,Blue,0,24044,24330,286
2022-09-25,70040,70060,Blue,1,88266,89267,1001
2022-11-28,70053,70838,Blue,0,29879,30844,965
2022-07-13,70051,70838,Blue,0,61258,62038,780
2022-12-02,70048,70060,Blue,1,85476,86123,647
2022-03-01,70057,70045,Blue,0,24328,24917,589
2022-07-12,70051,70039,Blue,0,33600,34343,743
2022-11-15,70042,70044,Blue,1,22070,22102,32
2022-02-03,70043,70041,Blue,0,81522,81555,33
2022-05-06,70052,70060,Blue,1,63886,64238,352
2022-01-27,70049,70838,Blue,0,48680,49296,616
2022-09-05,70051,70838,Blue,0,83382,84109,727
2022-02-02,70046,70054,Blue,1,23415,23851,436
2022-02-04,70053,70049,Blue,0,55305,55507,202
2022-07-15,70053,70049,Blue,0,57092,57277,185
2022-02-24,70053,70049,Blue,0,32632,32846,214
2022-12-09,70059,70053,Blue,0,22585,22841,256
2022-02-23,70057,70043,Blue,0,65966,66839,873
2022-10-04,70056,70060,Blue,1,79423,79599,176
2022-03-02,70038,70060,Blue,1,30853,32041,1188
2022-08-09,70057,70055,Blue,0,35974,36043,69
2022-07-05,70042,70060,Blue,1,33780,34825,1045
2022-01-14,70045,70838,Blue,0,78512,78835,323
2022-12-19,70043,70039,Blue,0,60573,60678,105
2022-01-09,70044,70056,Blue,1,35708,36376,668
2022-11-22,70059,70053,Blue,0,25833,26093,260
2022-10-19,70042,70046,Blue,1,62356,62558,202
2022-07-02,70046,70048,Blue,1,71691,71777,86
2022-05-28,70047,70039,Blue,0,67083,67491,408
2022-05-18,70042,70056,Blue,1,74290,75171,881
2022-09-23,70045,70838,Blue,0,31952,32347,395
2022-10-04,70044,70050,Blue,1,56947,57309,362
2022-10-22,70053,70049,Blue,0,27369,27578,209
2022-08-01,70054,70060,Blue,1,66715,66973,258
2022-06-10,70039,70838,Blue,0,34182,34215,33
2022-03-09,70046,70050,Blue,1,61730,61903,173
2022-07-02,70051,70043,Blue,0,36659,37157,498
2022-03-11,70038,70052,Blue,1,88390,89228,838
2022-04-18,70059,70051,Blue,0,34165,34493,328
2022-03-29,70054,70060,Blue,1,34092,34354,262
2022-12-26,70059,70039,Blue,0,31642,32639,997
2022-02-21,70038,70058,Blue,1,55608,56696,1088
2022-01-28,70041,70039,Blue,0,81137,81172,35
2022-10-30,70044,70056,Blue,1,61544,62208,664
2022-08-02,70049,70045,Blue,0,64046,64252,206
2022-10-14,70047,70838,Blue,0,34490,34967,477
2022-12-07,70038,70056,Blue,1,67393,68204,811
2022-12-22,70049,70039,Blue,0,32689,33157,468
2022-08-22,70059,70039,Blue,0,42135,43265,1130
2022-01-11,70046,70056,Blue,1,63889,64397,508
2022-03-24,70042,70046,Blue,1,43226,43398,172
2022-05-04,70059,70053,Blue,0,36323,36565,242
2022-01-10,70038,70040,Blue,1,37706,37723,17
2022-07-18,70059,70041,Blue,0,55093,56030,937
2022-12-26,70051,70041,Blue,0,77412,77960,548
2022-03-04,70040,70056,Blue,1,89231,90092,861
2022-07-16,70047,70041,Blue,0,60108,60439,331
2022-10-17,70044,70048,Blue,1,55193,55425,232
2022-07-23,70049,70039,Blue,0,25944,26481,537
2022-04-26,70052,70054,Blue,1,83267,83311,44
2022-01-29,70043,70838,Blue,0,49604,49842,238
2022-11-28,70042,70050,Blue,1,32957,33384,427
2022-09-07,70055,70051,Blue,0,47580,47807,227
2022-02-01,70042,70044,Blue,1,51524,51556,32
2022-02-23,70057,70043,Blue,0,59894,60645,751
2022-06-27,70046,70050,Blue,1,44522,44739,217
2022-06-29,70050,70054,Blue,1,29160,29361,201
2022-09-09,70043,70838,Blue,0,58091,58310,219
2022-06-12,70047,70041,Blue,0,59325,59700,375
2022-10-24,70038,70052,Blue,1,68177,68887,710
2022-11-25,70053,70047,Blue,0,37709,37993,284
2022-02-14,70040,70054,Blue,1,86117,86868,751
2022-06-19,70055,70039,Blue,0,21820,22753,933
2022-04-13,70051,70049,Blue,0,80388,80489,101
2022-09-06,70051,70043,Blue,0,24678,25194,516
2022-03-21,70050,70054,Blue,1,83154,83490,336
2022-12-29,70059,70055,Blue,0,45493,45640,147
2022-11-01,70048,70052,Blue,1,39336,39556,220
2022-11-30,70048,70050,Blue,1,35363,35421,58
2022-01-11,70051,70045,Blue,0,87270,87649,379
2022-08-04,70044,70046,Blue,1,56912,57045,133
2022-08-06,70053,70041,Blue,0,48423,49142,719
2022-06-10,70038,70060,Blue,1,56014,57554,1540
2022-06-25,70042,70056,Blue,1,21154,21944,790
2022-02-02,70040,70056,Blue,1,69978,70954,976
2022-07-30,70057,70041,Blue,0,70365,71248,883
2022-10-21,70053,70041,Blue,0,23280,24011,731
2022-11-01,70044,70060,Blue,1,36610,37546,936
2022-08-27,70055,70838,Blue,0,52098,53283,1185
2022-02-25,70050,70060,Blue,1,73563,74086,523
2022-06-22,70038,70060,Blue,1,57175,58413,1238
2022-04-01,70051,70049,Blue,0,24958,25064,106
2022-06-18,70050,70060,Blue,1,69949,70485,536
2022-07-11,70053,70051,Blue,0,27049,27114,65
2022-05-10,70057,70055,Blue,0,20134,20203,69
2022-03-31,70055,70047,Blue,0,87193,87547,354
2022-11-22,70042,70046,Blue,1,65575,65748,173
2022-10-05,70055,70051,Blue,0,71442,71577,135
2022-06-16,70046,70058,Blue,1,75971,76603,632
2022-03-17,70055,70041,Blue,0,32840,33576,736
2022-04-18,70042,70056,Blue,1,62415,63183,768
2022-09-11,70040,70054,Blue,1,55957,56704,747
2022-08-22,70038,70048,Blue,1,28685,29147,462
2022-02-14,70051,70049,Blue,0,31221,31328,107
2022-01-06,70038,70054,Blue,1,82647,83467,820
2022-11-08,70052,70054,Blue,1,84256,84302,46
2022-11-11,70039,70838,Blue,0,79500,79532,32
2022-03-28,70050,70058,Blue,1,57507,57929,422
2022-09-23,70050,70056,Blue,1,70639,70914,275
2022-08-21,70059,70041,Blue,0,25395,26322,927
2022-07-25,70048,70060,Blue,1,37812,38462,650
2022-10-16,70052,70058,Blue,1,66333,66574,241
2022-04-21,70057,70051,Blue,0,66592,66845,253
2022-04-18,70052,70060,Blue,1,53284,53703,419
2022-07-29,70044,70046,Blue,1,26288,26395,107
2022-09-27,70042,70058,Blue,1,58433,59269,836
2022-08-02,70050,70052,Blue,1,25770,25878,108
2022-12-10,70040,70044,Blue,1,78694,78830,136
2022-10-22,70038,70052,Blue,1,28580,29289,709
2022-01-13,70042,70056,Blue,1,43140,43924,784
2022-01-10,70057,70051,Blue,0,26737,27057,320
2022-10-21,70043,70041,Blue,0,52035,52068,33
2022-01-11,70051,70039,Blue,0,66555,67146,591
2022-12-02,70038,70052,Blue,1,52044,52732,688
2022-01-28,70054,70056,Blue,1,68151,68198,47
2022-07-07,70055,70051,Blue,0,54380,54526,146
2022-04-16,70040,70054,Blue,1,23087,23832,745
2022-12-20,70044,70058,Blue,1,34589,35395,806
2022-10-13,70039,70838,Blue,0,27558,27592,34
2022-04-07,70042,70046,Blue,1,47108,47296,188
2022-09-02,70046,70048,Blue,1,32258,32338,80
2022-10-15,70042,70060,Blue,1,48698,49635,937
2022-02-01,70048,70050,Blue,1,44697,44771,74
2022-06-27,70051,70045,Blue,0,19959,20319,360
2022-11-12,70038,70044,Blue,1,71767,71948,181
2022-02-15,70049,70043,Blue,0,53108,53429,321
2022-07-04,70047,70045,Blue,0,58994,59094,100
2022-03-05,70041,70838,Blue,0,69648,69774,126
2022-12-14,70057,70053,Blue,0,27690,27848,158
2022-08-21,70040,70050,Blue,1,50538,51030,492
2022-07-24,70038,70054,Blue,1,42306,43085,779
2022-01-14,70059,70057,Blue,0,22036,22076,40
2022-02-04,70046,70060,Blue,1,35755,37152,1397
2022-01-21,70046,70056,Blue,1,67713,68203,490
2022-02-06,70047,70838,Blue,0,33058,33630,572
2022-10-27,70053,70041,Blue,0,63375,64072,697
2022-09-06,70055,70049,Blue,0,54255,54533,278
2022-08-14,70053,70039,Blue,0,58969,59776,807
2022-01-11,70052,70054,Blue,1,21518,21578,60
2022-03-24,70039,70838,Blue,0,24875,24911,36
2022-03-09,70049,70838,Blue,0,59531,60197,666
2022-10-31,70042,70060,Blue,1,80498,81597,1099
2022-02-08,70038,70040,Blue,1,58037,58069,32
2022-11-21,70055,70045,Blue,0,43241,43849,608
2022-05-01,70058,70060,Blue,1,31461,31538,77
2022-12-02,70055,70051,Blue,0,81364,81500,136
2022-02-03,70044,70048,Blue,1,66989,67223,234
2022-12-26,70059,70051,Blue,0,59782,60108,326
2022-11-21,70059,70049,Blue,0,25873,26336,463
2022-08-21,70047,70043,Blue,0,60907,61178,271
2022-01-21,70038,70058,Blue,1,64077,65050,973
2022-07-01,70051,70043,Blue,0,63863,64388,525
2022-04-27,70057,70051,Blue,0,51035,51284,249
2022-02-19,70040,70052,Blue,1,47032,47702,670
2022-01-14,70044,70054,Blue,1,68787,69370,583
2022-12-24,70049,70043,Blue,0,73451,73765,314
2022-01-19,70047,70045,Blue,0,70615,70714,99
2022-09-13,70044,70054,Blue,1,58095,58648,553
2022-03-07,70043,70041,Blue,0,53422,53451,29
2022-07-12,70059,70043,Blue,0,26360,27371,1011
2022-09-06,70040,70052,Blue,1,47607,48264,657
2022-04-12,70056,70058,Blue,1,59860,59933,73
2022-10-03,70047,70045,Blue,0,22636,22732,96
2022-12-19,70057,70049,Blue,0,56560,56991,431
2022-09-05,70059,70051,Blue,0,77065,77385,320
2022-12-29,70044,70060,Blue,1,59184,60112,928
2022-05-19,70048,70058,Blue,1,80474,81011,537
2022-04-20,70054,70056,Blue,1,37653,37700,47
2022-09-26,70053,70047,Blue,0,48714,49046,332
2022-04-16,70054,70056,Blue,1,46731,46778,47
2022-11-04,70040,70056,Blue,1,67058,68359,1301
2022-07-19,70047,70838,Blue,0,71882,72376,494
2022-12-19,70047,70043,Blue,0,39005,39420,415
2022-10-10,70051,70041,Blue,0,25127,25704,577
2022-11-02,70038,70044,Blue,1,67879,68076,197
2022-02-07,70059,70055,Blue,0,21332,21497,165
2022-03-18,70043,70039,Blue,0,36144,36257,113
2022-12-21,70044,70060,Blue,1,50978,51992,1014
2022-10-29,70040,70050,Blue,1,50232,50701,469
2022-03-24,70044,70060,Blue,1,40940,41918,978
2022-03-01,70055,70049,Blue,0,69673,69950,277
2022-11-26,70055,70053,Blue,0,60734,60779,45
2022-02-23,70059,70055,Blue,0,73213,73363,150
2022-11-05,70038,70060,Blue,1,35682,36759,1077
2022-09-06,70057,70055,Blue,0,32040,32110,70
2022-12-06,70052,70060,Blue,1,33543,33925,382
2022-06-19,70051,70838,Blue,0,72070,72823,753
2022-12-22,70055,70045,Blue,0,79413,79949,536
2022-12-02,70050,70054,Blue,1,55337,55554,217
2022-10-10,70042,70054,Blue,1,32491,33204,713
2022-01-31,70047,70045,Blue,0,67483,67591,108
2022-01-23,70048,70060,Blue,1,55972,56586,614
2022-04-07,70038,70046,Blue,1,67335,67727,392
2022-11-24,70048,70052,Blue,1,26597,26792,195
2022-08-24,70059,70838,Blue,0,53653,54920,1267
2022-06-15,70043,70041,Blue,0,61143,61170,27
2022-04-04,70047,70045,Blue,0,32986,33083,97
2022-06-29,70055,70039,Blue,0,72851,73660,809
2022-11-23,70059,70047,Blue,0,65177,66702,1525
2022-11-30,70059,70043,Blue,0,63409,64229,820
2022-11-11,70046,70050,Blue,1,24438,24625,187
2022-11-16,70054,70060,Blue,1,80248,80519,271
2022-01-20,70049,70045,Blue,0,29023,29212,189
2022-12-20,70055,70053,Blue,0,86376,86423,47
2022-11-15,70057,70047,Blue,0,27574,28077,503
2022-01-09,70044,70052,Blue,1,23219,23806,587
2022-10-02,70048,70054,Blue,1,45482,45777,295
2022-08-21,70059,70045,Blue,0,25395,26088,693
2022-08-08,70046,70052,Blue,1,71424,71764,340
2022-04-25,70057,70051,Blue,0,65969,66226,257
2022-09-28,70059,70057,Blue,0,60853,60887,34
2022-01-26,70047,70043,Blue,0,24600,24881,281
2022-03-08,70050,70058,Blue,1,53138,53538,400
2022-08-08,70053,70039,Blue,0,60085,60849,764
2022-12-31,70055,70039,Blue,0,71375,72131,756
2022-07-07,70052,70056,Blue,1,50953,51090,137
2022-04-11,70059,70055,Blue,0,42114,42292,178
2022-11-29,70059,70053,Blue,0,29630,29884,254
2022-09-14,70043,70041,Blue,0,34440,34471,31
2022-11-14,70051,70047,Blue,0,40511,40731,220
2022-02-05,70044,70050,Blue,1,84832,85282,450
2022-06-30,70056,70058,Blue,1,49742,49816,74
2022-12-22,70042,70048,Blue,1,72047,72363,316
2022-01-27,70047,70041,Blue,0,49319,49649,330
2022-09-25,70040,70042,Blue,1,62509,62540,31
2022-12-02,70048,70050,Blue,1,91187,91244,57
2022-03-19,70051,70043,Blue,0,58227,58725,498
2022-02-23,70038,70042,Blue,1,42967,43053,86
2022-12-29,70053,70838,Blue,0,23605,24456,851
2022-09-23,70059,70039,Blue,0,60624,61798,1174
2022-06-20,70048,70056,Blue,1,63351,63745,394
2022-04-18,70044,70058,Blue,1,23305,24111,806
2022-04-26,70057,70051,Blue,0,59790,60053,263
2022-01-11,70045,70043,Blue,0,32512,32604,92
2022-04-01,70046,70052,Blue,1,35137,35473,336
2022-09-21,70042,70048,Blue,1,34569,34848,279
2022-01-21,70038,70056,Blue,1,36732,37587,855
2022-09-17,70046,70060,Blue,1,49502,50276,774
2022-04-14,70044,70054,Blue,1,23840,24421,581
2022-02-15,70044,70046,Blue,1,59821,59936,115
2022-11-18,70044,70054,Blue,1,26702,27313,611
2022-01-17,70051,70041,Blue,0,47447,48048,601
2022-09-10,70042,70048,Blue,1,31413,31720,307
2022-06-25,70045,70043,Blue,0,50655,50745,90
2022-01-16,70050,70056,Blue,1,45625,45907,282
2022-11-21,70042,70058,Blue,1,24086,24916,830
2022-06-29,70046,70050,Blue,1,86056,86233,177
2022-03-27,70057,70053,Blue,0,81637,81791,154
2022-09-14,70046,70056,Blue,1,65766,66272,506
2022-05-20,70038,70056,Blue,1,29951,30929,978
2022-08-02,70048,70058,Blue,1,24804,25301,497
2022-03-27,70040,70046,Blue,1,59235,59523,288
2022-08-18,70050,70060,Blue,1,74069,74687,618
2022-01-07,70053,70039,Blue,0,76327,77034,707
2022-07-07,70040,70048,Blue,1,77330,77762,432
2022-04-29,70053,70051,Blue,0,55421,55481,60
2022-08-17,70057,70041,Blue,0,43776,44803,1027
2022-12-25,70052,70060,Blue,1,87181,87581,400
2022-12-23,70038,70058,Blue,1,23719,24832,1113
2022-03-05,70042,70046,Blue,1,77431,77606,175
2022-12-24,70047,70045,Blue,0,50912,51001,89
2022-02-08,70059,70051,Blue,0,25219,25603,384
2022-02-12,70050,70060,Blue,1,73503,74033,530
2022-10-14,70049,70045,Blue,0,80976,81176,200
2022-11-29,70055,70049,Blue,0,63076,63386,310
2022-06-28,70055,70838,Blue,0,36207,37246,1039
2022-06-15,70059,70041,Blue,0,31754,32722,968
2022-10-03,70038,70060,Blue,1,87001,88167,1166
2022-04-01,70059,70045,Blue,0,76632,77285,653
2022-04-05,70042,70044,Blue,1,30981,31010,29
2022-12-05,70056,70060,Blue,1,42984,43154,170
2022-09-06,70057,70055,Blue,0,40320,40402,82
2022-04-04,70049,70045,Blue,0,51273,51495,222
2022-04-01,70051,70838,Blue,0,24156,25030,874
2022-10-06,70051,70039,Blue,0,31351,32029,678
2022-03-02,70047,70043,Blue,0,85799,86042,243
2022-02-23,70049,70047,Blue,0,53879,53936,57
2022-01-16,70047,70039,Blue,0,58768,59193,425
2022-04-20,70057,70051,Blue,0,27053,27303,250
2022-04-08,70059,70039,Blue,0,79461,80500,1039
2022-02-02,70057,70051,Blue,0,79523,79755,232
2022-01-17,70055,70039,Blue,0,63431,64267,836
2022-08-30,70047,70043,Blue,0,42918,43195,277
2022-07-02,70053,70039,Blue,0,37078,37862,784
2022-07-29,70057,70039,Blue,0,60784,61720,936
2022-04-22,70048,70050,Blue,1,87682,87739,57
2022-05-23,70040,70046,Blue,1,59483,59830,347
2022-03-06,70045,70039,Blue,0,65972,66218,246
2022-12-22,70056,70060,Blue,1,67082,67259,177
2022-07-17,70048,70058,Blue,1,56385,56885,500
2022-08-30,70042,70044,Blue,1,85124,85152,28
2022-01-05,70053,70039,Blue,0,66583,67312,729
2022-06-30,70045,70039,Blue,0,75408,75684,276
2022-09-14,70040,70044,Blue,1,89167,89277,110
2022-12-19,70053,70043,Blue,0,75947,76523,576
2022-07-19,70040,70046,Blue,1,45609,45858,249
2022-07-22,70059,70049,Blue,0,69882,70413,531
2022-11-22,70057,70041,Blue,0,31372,32240,868
2022-07-28,70049,70047,Blue,0,65488,65542,54
2022-01-21,70038,70044,Blue,1,58336,58524,188
2022-09-26,70040,70052,Blue,1,23854,24485,631
2022-01-04,70047,70838,Blue,0,65338,65820,482
2022-11-30,70057,70039,Blue,0,30093,31097,1004
2022-03-28,70045,70041,Blue,0,69203,69366,163
2022-08-02,70041,70838,Blue,0,85132,85240,108
2022-10-01,70044,70058,Blue,1,71495,72280,785
2022-12-20,70055,70838,Blue,0,86376,87249,873
2022-02-03,70042,70058,Blue,1,32565,33479,914
2022-12-01,70059,70043,Blue,0,58215,59194,979
2022-04-01,70038,70046,Blue,1,27250,27586,336
2022-03-11,70038,70042,Blue,1,67032,67130,98
2022-02-22,70057,70041,Blue,0,42143,42983,840
2022-05-19,70055,70045,Blue,0,88310,88936,626
2022-11-04,70051,70043,Blue,0,37984,38481,497
2022-08-24,70050,70054,Blue,1,52371,52585,214
2022-08-16,70038,70048,Blue,1,39979,40495,516
2022-03-09,70046,70050,Blue,1,81244,81467,223
2022-08-19,70042,70056,Blue,1,67867,68716,849
2022-09-20,70047,70039,Blue,0,41225,41644,419
2022-11-25,70053,70051,Blue,0,24118,24173,55
2022-06-27,70042,70056,Blue,1,77362,78172,810
2022-11-29,70049,70047,Blue,0,75851,75904,53
2022-02-05,70038,70056,Blue,1,80051,80928,877
2022-03-17,70044,70048,Blue,1,59166,59442,276
2022-01-28,70051,70049,Blue,0,60275,60382,107
2022-04-07,70040,70042,Blue,1,28517,28549,32
2022-02-15,70046,70054,Blue,1,65074,65476,402
2022-11-08,70049,70043,Blue,0,53023,53362,339
2022-04-14,70038,70054,Blue,1,24390,25222,832
2022-12-21,70041,70039,Blue,0,25180,25212,32
2022-12-22,70040,70046,Blue,1,44379,44836,457
2022-12-08,70055,70043,Blue,0,75078,75730,652
2022-03-18,70053,70838,Blue,0,84311,85189,878
2022-12-09,70059,70045,Blue,0,70216,70923,707
2022-02-17,70055,70049,Blue,0,54989,55286,297
2022-02-27,70042,70048,Blue,1,74392,74705,313
2022-09-14,70044,70046,Blue,1,58847,58959,112
2022-05-19,70053,70051,Blue,0,74008,74064,56
2022-07-06,70059,70043,Blue,0,81227,82223,996
2022-01-06,70038,70056,Blue,1,23659,24540,881
2022-12-14,70039,70838,Blue,0,60486,60517,31
2022-04-03,70055,70051,Blue,0,54018,54154,136
2022-12-02,70051,70838,Blue,0,24975,25741,766
2022-03-20,70048,70060,Blue,1,56412,56989,577
2022-07-23,70038,70046,Blue,1,61025,61336,311
2022-03-11,70047,70838,Blue,0,85759,86212,453
2022-04-24,70047,70039,Blue,0,34597,35042,445
2022-10-03,70040,70052,Blue,1,81437,82229,792
2022-04-07,70038,70046,Blue,1,25196,25534,338
2022-03-29,70041,70039,Blue,0,59380,59415,35
2022-04-10,70049,70043,Blue,0,65650,65972,322
2022-07-07,70056,70060,Blue,1,68512,68683,171
2022-01-03,70049,70045,Blue,0,82880,83066,186
2022-06-21,70046,70052,Blue,1,61938,62284,346
2022-08-28,70054,70056,Blue,1,24580,24627,47
2022-12-24,70051,70049,Blue,0,83511,83613,102
2022-04-06,70040,70050,Blue,1,72544,73073,529
2022-02-25,70057,70041,Blue,0,37713,38724,1011
2022-08-03,70057,70051,Blue,0,77219,77471,252
2022-01-25,70045,70039,Blue,0,31125,31464,339
2022-12-26,70055,70041,Blue,0,71294,72033,739
2022-12-20,70050,70054,Blue,1,41040,41289,249
2022-03-15,70045,70838,Blue,0,52588,53017,429
2022-05-24,70047,70041,Blue,0,76169,76661,492
2022-08-09,70052,70056,Blue,1,79649,79788,139
2022-03-07,70052,70056,Blue,1,78793,78932,139
2022-10-28,70041,70039,Blue,0,63910,63939,29
2022-02-03,70052,70058,Blue,1,57788,58077,289
2022-04-04,70044,70058,Blue,1,81193,82050,857
2022-09-10,70046,70048,Blue,1,70557,70649,92
2022-03-16,70049,70838,Blue,0,30192,30806,614
2022-08-19,70059,70039,Blue,0,50534,52054,1520
2022-07-07,70058,70060,Blue,1,61891,61968,77
2022-01-11,70048,70058,Blue,1,60061,60575,514
2022-10-03,70043,70838,Blue,0,28584,28790,206
2022-03-12,70046,70056,Blue,1,61927,62499,572
2022-12-23,70048,70058,Blue,1,24221,24832,611
2022-12-27,70047,70041,Blue,0,37767,38096,329
2022-06-12,70053,70039,Blue,0,53042,53851,809
2022-01-31,70057,70049,Blue,0,29938,30898,960
2022-10-16,70042,70058,Blue,1,65745,66574,829
2022-11-18,70050,70054,Blue,1,57168,57388,220
2022-09-22,70055,70838,Blue,0,83605,84482,877
2022-11-14,70059,70039,Blue,0,28344,29430,1086
2022-09-03,70055,70053,Blue,0,66747,66792,45
2022-06-28,70046,70054,Blue,1,77278,77718,440
2022-08-04,70051,70049,Blue,0,55468,55573,105
2022-01-21,70048,70054,Blue,1,63591,63883,292
2022-12-28,70038,70044,Blue,1,48862,49063,201
2022-08-15,70059,70041,Blue,0,24275,25323,1048
2022-11-14,70043,70039,Blue,0,48778,48909,131
2022-04-12,70053,70049,Blue,0,60461,60683,222
2022-12-11,70046,70048,Blue,1,74633,74714,81
2022-08-01,70043,70039,Blue,0,36301,36417,116
2022-03-18,70049,70039,Blue,0,46007,46541,534
2022-08-19,70043,70838,Blue,0,74737,74930,193
2022-08-17,70055,70053,Blue,0,57373,57419,46
2022-01-20,70043,70041,Blue,0,53070,53101,31
2022-09-07,70054,70058,Blue,1,81590,81746,156
2022-07-05,70046,70056,Blue,1,32994,33650,656
2022-01-06,70055,70053,Blue,0,88318,88380,62
2022-05-24,70038,70052,Blue,1,20474,21380,906
2022-07-21,70040,70044,Blue,1,58290,58418,128
2022-03-16,70038,70046,Blue,1,64335,64725,390
2022-12-31,70051,70045,Blue,0,59085,59442,357
2022-02-20,70040,70056,Blue,1,49456,50279,823
2022-08-22,70044,70056,Blue,1,59635,60381,746
2022-08-17,70054,70060,Blue,1,69792,70051,259
2022-03-22,70053,70049,Blue,0,79751,79988,237
2022-12-23,70052,70060,Blue,1,55697,56108,411
2022-10-22,70043,70039,Blue,0,69561,69665,104
2022-11-17,70048,70058,Blue,1,58777,59302,525
2022-12-07,70053,70838,Blue,0,38212,39077,865
2022-07-27,70040,70058,Blue,1,33259,34350,1091
2022-12-08,70049,70045,Blue,0,50436,50629,193
2022-02-15,70040,70050,Blue,1,33307,33792,485
2022-11-21,70040,70048,Blue,1,43627,44033,406
2022-08-28,70038,70046,Blue,1,69380,69724,344
2022-12-18,70053,70838,Blue,0,37125,37950,825
2022-06-25,70057,70053,Blue,0,44435,44590,155
2022-10-21,70046,70052,Blue,1,46488,46840,352
2022-09-19,70040,70058,Blue,1,55579,56632,1053
2022-04-23,70042,70048,Blue,1,79455,79786,331
2022-08-05,70040,70058,Blue,1,32452,33410,958
2022-10-30,70053,70039,Blue,0,23344,24091,747
2022-06-30,70045,70838,Blue,0,52384,52747,363
2022-12-14,70048,70060,Blue,1,74717,75394,677
2022-12-21,70048,70060,Blue,1,52744,53415,671
2022-08-08,70049,70039,Blue,0,86863,87367,504
2022-12-18,70053,70043,Blue,0,86677,87240,563
2022-12-07,70043,70838,Blue,0,77791,77977,186
2022-06-30,70040,70050,Blue,1,70100,70649,549
2022-04-19,70049,70039,Blue,0,32344,32901,557
2022-10-10,70044,70046,Blue,1,55334,55436,102
2022-02-19,70056,70060,Blue,1,22537,22702,165
2022-02-07,70038,70056,Blue,1,32074,33010,936
2022-07-01,70040,70054,Blue,1,57085,57878,793
2022-08-31,70040,70054,Blue,1,29230,29917,687
2022-05-19,70038,70042,Blue,1,28032,28127,95
2022-03-09,70038,70054,Blue,1,71413,72205,792
2022-02-11,70042,70056,Blue,1,71573,72318,745
2022-01-06,70046,70060,Blue,1,49314,50087,773
2022-07-16,70052,70056,Blue,1,57965,58115,150
2022-02-22,70057,70053,Blue,0,28836,28987,151
2022-09-06,70056,70060,Blue,1,60554,60732,178
2022-04-06,70049,70043,Blue,0,81092,81453,361
2022-02-14,70057,70051,Blue,0,86363,86603,240
2022-07-08,70044,70058,Blue,1,55108,55930,822
2022-03-17,70038,70042,Blue,1,86036,86197,161
2022-06-20,70038,70048,Blue,1,43663,44178,515
2022-05-25,70038,70040,Blue,1,79217,79235,18
2022-06-15,70040,70042,Blue,1,30323,30357,34
2022-03-18,70052,70056,Blue,1,60586,60742,156
2022-12-28,70057,70047,Blue,0,57251,57715,464
2022-12-04,70055,70045,Blue,0,38628,39173,545
2022-04-09,70058,70060,Blue,1,84030,84095,65
2022-02-09,70045,70041,Blue,0,34038,34224,186
2022-01-25,70051,70047,Blue,0,52942,53135,193
2022-08-12,70053,70838,Blue,0,37987,38900,913
2022-12-20,70038,70044,Blue,1,54739,54903,164
2022-08-20,70059,70039,Blue,0,33040,34093,1053
2022-03-30,70046,70052,Blue,1,57527,57850,323
2022-12-19,70040,70056,Blue,1,21038,21802,764
2022-06-21,70059,70039,Blue,0,60944,62005,1061
2022-09-13,70046,70060,Blue,1,61532,62350,818
2022-12-07,70052,70056,Blue,1,25217,25359,142
2022-10-05,70057,70045,Blue,0,52606,53268,662
2022-12-26,70052,70054,Blue,1,50615,50694,79
2022-05-26,70043,70838,Blue,0,35515,35718,203
2022-10-31,70055,70047,Blue,0,36079,36465,386
2022-12-30,70057,70838,Blue,0,85580,86528,948
2022-12-21,70055,70047,Blue,0,26882,27245,363
2022-07-11,70059,70047,Blue,0,76456,77004,548
2022-03-17,70049,70043,Blue,0,24738,25076,338
2022-03-07,70051,70049,Blue,0,69435,69539,104
2022-09-22,70049,70041,Blue,0,77415,77825,410
2022-06-02,70049,70045,Blue,0,36169,36378,209
2022-09-15,70048,70058,Blue,1,51333,51872,539
2022-08-11,70055,70051,Blue,0,71950,72078,128
2022-06-22,70044,70046,Blue,1,87450,87553,103
2022-01-23,70044,70060,Blue,1,54475,55357,882
2022-07-24,70042,70060,Blue,1,63597,64635,1038
2022-01-18,70054,70058,Blue,1,40328,40485,157
2022-11-08,70051,70049,Blue,0,42661,42781,120
2022-02-12,70046,70054,Blue,1,66244,66691,447
2022-06-18,70057,70838,Blue,0,59043,60171,1128
2022-03-18,70058,70060,Blue,1,68075,68149,74
2022-03-27,70056,70058,Blue,1,78411,78481,70
2022-02-10,70057,70053,Blue,0,20316,20498,182
2022-08-10,70040,70058,Blue,1,22781,23683,902
2022-01-26,70040,70046,Blue,1,72666,72946,280
2022-11-08,70038,70052,Blue,1,75192,75902,710
2022-08-23,70056,70060,Blue,1,52936,53152,216
2022-03-25,70051,70039,Blue,0,79802,80406,604
2022-10-29,70049,70045,Blue,0,31900,32087,187
2022-11-10,70040,70046,Blue,1,51103,51387,284
2022-09-27,70038,70048,Blue,1,32150,32630,480
2022-11-11,70053,70041,Blue,0,28120,28802,682
2022-03-27,70051,70045,Blue,0,79276,79624,348
2022-09-30,70044,70056,Blue,1,58346,59229,883
2022-03-07,70040,70052,Blue,1,19980,20659,679
2022-10-10,70040,70060,Blue,1,19924,20972,1048
2022-02-23,70053,70047,Blue,0,23075,23403,328
2022-04-28,70059,70051,Blue,0,54615,54947,332
2022-10-04,70049,70039,Blue,0,49917,50445,528
2022-04-04,70038,70048,Blue,1,76984,77485,501
2022-01-12,70052,70060,Blue,1,71630,71981,351
2022-08-27,70040,70056,Blue,1,61613,62470,857
2022-09-10,70048,70052,Blue,1,65916,66143,227
2022-12-06,70059,70049,Blue,0,28404,28890,486
2022-09-19,70042,70054,Blue,1,59588,60240,652
2022-12-14,70042,70054,Blue,1,42736,43428,692
2022-04-19,70040,70056,Blue,1,54871,55747,876
2022-11-14,70057,70047,Blue,0,34356,34848,492
2022-11-15,70056,70058,Blue,1,58754,58826,72
2022-07-07,70048,70050,Blue,1,48244,48304,60
2022-06-12,70046,70050,Blue,1,64919,65105,186
2022-01-16,70051,70838,Blue,0,28903,29655,752
2022-12-09,70055,70838,Blue,0,75553,76404,851
2022-03-10,70046,70048,Blue,1,71810,71911,101
2022-02-14,70057,70041,Blue,0,72689,73512,823
2022-12-07,70048,70058,Blue,1,69974,70472,498
2022-04-16,70059,70049,Blue,0,22816,23307,491
2022-04-12,70057,70838,Blue,0,26145,27285,1140
2022-06-10,70042,70046,Blue,1,67505,67693,188
2022-05-20,70043,70041,Blue,0,33392,33423,31
2022-07-17,70050,70058,Blue,1,25936,26347,411
2022-05-14,70059,70055,Blue,0,52814,52970,156
2022-02-07,70059,70049,Blue,0,34208,34719,511
2022-05-20,70044,70048,Blue,1,65134,65415,281
2022-08-06,70051,70045,Blue,0,53893,54238,345
2022-02-21,70059,70051,Blue,0,74593,74930,337
2022-03-06,70048,70054,Blue,1,66691,67004,313
2022-09-20,70057,70049,Blue,0,72872,73260,388
2022-08-30,70044,70048,Blue,1,55700,55937,237
2022-07-16,70046,70052,Blue,1,40251,40579,328
2022-12-03,70046,70054,Blue,1,30529,30948,419
2022-12-28,70049,70043,Blue,0,61564,61878,314
2022-11-02,70058,70060,Blue,1,26232,26328,96
2022-12-09,70039,70838,Blue,0,69179,69216,37
2022-02-07,70057,70043,Blue,0,36515,37466,951
2022-09-22,70050,70058,Blue,1,76045,76448,403
2022-03-04,70040,70054,Blue,1,35426,36224,798
2022-12-01,70054,70060,Blue,1,29392,29657,265
2022-04-13,70051,70043,Blue,0,19216,19789,573
2022-06-12,70059,70051,Blue,0,77605,77934,329
2022-03-01,70043,70039,Blue,0,74380,74485,105
2022-09-08,70044,70060,Blue,1,26689,27628,939
2022-04-17,70047,70045,Blue,0,42890,42993,103
2022-06-22,70049,70041,Blue,0,26440,26923,483
2022-07-31,70046,70052,Blue,1,68751,69124,373
2022-11-03,70049,70047,Blue,0,44666,44725,59
2022-05-18,70054,70058,Blue,1,59285,59444,159
2022-10-19,70042,70056,Blue,1,66032,66849,817
2022-10-17,70038,70048,Blue,1,45458,45907,449
2022-06-30,70042,70054,Blue,1,54556,55260,704
2022-06-19,70046,70048,Blue,1,60619,60714,95
2022-08-26,70038,70046,Blue,1,54570,54920,350
2022-02-09,70053,70043,Blue,0,75174,75787,613
2022-06-13,70045,70838,Blue,0,67941,68295,354
2022-06-19,70049,70041,Blue,0,33724,34240,516
2022-07-14,70046,70054,Blue,1,79522,80127,605
2022-02-24,70043,70039,Blue,0,57292,57402,110
2022-07-30,70051,70045,Blue,0,67929,68264,335
2022-08-06,70042,70058,Blue,1,89262,90147,885
2022-06-13,70059,70045,Blue,0,23653,24382,729
2022-02-11,70059,70057,Blue,0,64153,64190,37
2022-12-08,70057,70047,Blue,0,46525,47005,480
2022-02-24,70040,70056,Blue,1,27028,27869,841
2022-10-01,70055,70053,Blue,0,48348,48395,47
2022-04-17,70050,70056,Blue,1,39002,39310,308
2022-01-23,70057,70053,Blue,0,27029,27177,148
2022-03-15,70040,70042,Blue,1,45852,45890,38
2022-02-11,70043,70039,Blue,0,47503,47605,102
2022-04-03,70055,70045,Blue,0,81104,81615,511
2022-09-14,70057,70838,Blue,0,30644,31730,1086
2022-10-26,70040,70052,Blue,1,31661,32302,641
2022-02-09,70044,70056,Blue,1,54518,55160,642
2022-12-01,70046,70058,Blue,1,51266,51927,661
2022-03-11,70040,70050,Blue,1,21143,21682,539
2022-12-29,70055,70039,Blue,0,66739,67501,762
2022-05-11,70057,70049,Blue,0,75187,75596,409
2022-01-26,70057,70043,Blue,0,73289,74200,911
2022-01-16,70046,70058,Blue,1,53028,53672,644
2022-08-03,70050,70056,Blue,1,22146,22462,316
2022-07-16,70038,70060,Blue,1,77297,78467,1170
2022-12-14,70057,70838,Blue,0,82229,83229,1000
2022-08-24,70045,70043,Blue,0,82433,82565,132
2022-03-07,70054,70060,Blue,1,55467,55763,296
2022-01-05,70057,70049,Blue,0,26454,26893,439
2022-04-08,70048,70050,Blue,1,61549,61608,59
2022-04-05,70050,70056,Blue,1,81599,81919,320
2022-12-01,70042,70048,Blue,1,65982,66277,295
2022-12-06,70038,70040,Blue,1,49866,49885,19
2022-06-02,70041,70838,Blue,0,63115,63236,121
2022-01-20,70049,70047,Blue,0,46030,46092,62
2022-03-03,70041,70838,Blue,0,40479,40610,131
2022-01-11,70043,70039,Blue,0,55803,55930,127
2022-02-04,70046,70052,Blue,1,33876,34190,314
2022-04-13,70041,70039,Blue,0,53616,53649,33
2022-09-17,70042,70058,Blue,1,51391,52219,828
2022-08-02,70042,70058,Blue,1,36386,37218,832
2022-10-02,70040,70042,Blue,1,81330,81362,32
2022-04-25,70050,70058,Blue,1,74060,74497,437
2022-07-31,70051,70041,Blue,0,28144,28707,563
2022-08-05,70044,70058,Blue,1,39745,40573,828
2022-12-03,70059,70055,Blue,0,29322,29471,149
2022-08-08,70053,70051,Blue,0,75689,75753,64
2022-01-28,70038,70058,Blue,1,22147,23059,912
2022-06-07,70040,70050,Blue,1,23424,24053,629
2022-09-27,70040,70044,Blue,1,25266,25372,106
2022-01-09,70059,70039,Blue,0,44652,45588,936
2022-12-01,70057,70043,Blue,0,79994,80745,751
2022-03-26,70055,70041,Blue,0,42935,43718,783
2022-01-06,70047,70039,Blue,0,32358,32736,378
2022-09-14,70044,70052,Blue,1,26853,27412,559
2022-02-14,70057,70838,Blue,0,24335,25456,1121
2022-04-04,70059,70043,Blue,0,56615,57451,836
2022-10-12,70049,70043,Blue,0,25131,25491,360
2022-06-15,70044,70054,Blue,1,64871,65477,606
2022-10-16,70055,70051,Blue,0,77323,77450,127
2022-04-04,70047,70041,Blue,0,69039,69336,297
2022-06-09,70048,70050,Blue,1,44128,44187,59
2022-07-01,70046,70058,Blue,1,61424,62106,682
2022-08-05,70057,70051,Blue,0,55716,55981,265
2022-05-03,70059,70055,Blue,0,34516,34655,139
2022-02-01,70040,70060,Blue,1,76394,77440,1046
2022-02-03,70038,70040,Blue,1,73506,73520,14
2022-11-16,70057,70053,Blue,0,78986,79132,146
2022-07-25,70042,70058,Blue,1,82873,83795,922
2022-01-10,70050,70058,Blue,1,46319,46777,458
2022-09-16,70059,70045,Blue,0,21574,22341,767
2022-08-13,70051,70045,Blue,0,26878,27222,344
2022-03-09,70041,70838,Blue,0,70938,71051,113
2022-09-03,70040,70058,Blue,1,64286,65380,1094
2022-07-10,70052,70058,Blue,1,75005,75266,261
2022-06-21,70057,70053,Blue,0,59099,59264,165
2022-05-08,70053,70051,Blue,0,48900,48968,68
2022-02-11,70043,70838,Blue,0,67101,67362,261
2022-11-07,70048,70058,Blue,1,55432,55964,532
2022-10-19,70051,70041,Blue,0,57385,57984,599
2022-12-25,70042,70050,Blue,1,75990,76403,413
2022-03-17,70043,70039,Blue,0,25493,25610,117
2022-09-11,70054,70056,Blue,1,26579,26627,48
2022-07-20,70042,70054,Blue,1,67171,67864,693
2022-05-30,70040,70046,Blue,1,44776,45101,325
2022-12-12,70051,70039,Blue,0,23878,24629,751
2022-12-18,70038,70060,Blue,1,45617,46672,1055
2022-01-13,70057,70051,Blue,0,30344,30634,290
2022-07-10,70040,70050,Blue,1,30849,31367,518
2022-03-25,70046,70060,Blue,1,64432,65218,786
2022-12-17,70046,70058,Blue,1,36143,36841,698
2022-01-30,70044,70054,Blue,1,74495,75372,877
2022-06-23,70053,70039,Blue,0,34678,35534,856
2022-07-27,70044,70048,Blue,1,40430,40677,247
2022-08-12,70053,70045,Blue,0,77195,77636,441
2022-01-09,70038,70054,Blue,1,37030,37842,812
2022-09-26,70038,70048,Blue,1,39453,39920,467
2022-03-02,70051,70043,Blue,0,51923,52414,491
2022-03-12,70046,70056,Blue,1,73755,74267,512
2022-09-28,70057,70053,Blue,0,25460,25671,211
2022-09-29,70038,70046,Blue,1,71234,71563,329
2022-11-08,70053,70045,Blue,0,65318,65754,436
2022-02-17,70052,70058,Blue,1,66625,66878,253
2022-09-15,70041,70039,Blue,0,40828,40859,31
2022-10-30,70042,70050,Blue,1,37836,38234,398
2022-03-18,70040,70056,Blue,1,84329,85137,808
2022-09-19,70057,70049,Blue,0,67682,68064,382
2022-08-17,70052,70060,Blue,1,61512,61882,370
2022-06-11,70039,70838,Blue,0,23313,23352,39
2022-10-16,70044,70046,Blue,1,69589,69695,106
2022-09-07,70039,70838,Blue,0,50222,50254,32
2022-08-07,70048,70056,Blue,1,68261,68657,396
2022-08-27,70048,70054,Blue,1,68018,68308,290
2022-03-13,70055,70047,Blue,0,52407,52786,379
2022-02-16,70045,70838,Blue,0,56216,56611,395
2022-01-05,70055,70047,Blue,0,23274,23689,415
2022-11-16,70044,70046,Blue,1,25824,25929,105
2022-05-17,70049,70047,Blue,0,71887,71968,81
2022-02-06,70043,70041,Blue,0,57472,57501,29
2022-03-28,70057,70055,Blue,0,28537,28608,71
2022-11-03,70052,70060,Blue,1,88957,89305,348
2022-01-23,70052,70054,Blue,1,46878,46921,43
2022-06-09,70057,70045,Blue,0,72695,73310,615
2022-08-22,70045,70041,Blue,0,41354,41568,214
2022-05-18,70043,70041,Blue,0,66225,66253,28
2022-11-25,70047,70039,Blue,0,82968,83347,379
2022-01-16,70048,70050,Blue,1,24338,24396,58
2022-06-13,70046,70048,Blue,1,66265,66367,102
2022-04-11,70042,70048,Blue,1,30110,30511,401
2022-12-22,70038,70042,Blue,1,72721,72827,106
2022-07-30,70040,70042,Blue,1,34578,34613,35
2022-02-27,70055,70043,Blue,0,85729,86383,654
2022-12-03,70048,70052,Blue,1,38773,38973,200
2022-09-02,70039,70838,Blue,0,29605,29639,34
2022-06-21,70043,70838,Blue,0,69413,69785,372
2022-02-08,70053,70045,Blue,0,64223,64662,439
2022-05-18,70038,70056,Blue,1,59260,60336,1076
2022-06-06,70045,70041,Blue,0,73005,73205,200
2022-07-10,70055,70051,Blue,0,68329,68467,138
2022-01-25,70058,70060,Blue,1,91708,91771,63
2022-11-26,70050,70056,Blue,1,53423,53701,278
2022-02-07,70057,70041,Blue,0,47193,48078,885
2022-11-08,70048,70050,Blue,1,31276,31338,62
2022-01-05,70051,70049,Blue,0,33040,33144,104
2022-12-02,70057,70045,Blue,0,84314,84931,617
2022-08-28,70051,70043,Blue,0,47821,48336,515
2022-06-09,70054,70058,Blue,1,76847,77003,156
2022-09-18,70038,70054,Blue,1,83712,84592,880
2022-02-02,70049,70039,Blue,0,76513,77034,521
2022-12-09,70057,70053,Blue,0,32031,32187,156
2022-03-31,70055,70051,Blue,0,76234,76392,158
2022-03-09,70046,70050,Blue,1,29676,29848,172
2022-09-17,70051,70047,Blue,0,27476,27669,193
2022-07-17,70042,70058,Blue,1,60893,61761,868
2022-03-12,70053,70049,Blue,0,81821,82020,199
2022-08-17,70044,70046,Blue,1,27636,27741,105
2022-07-17,70038,70054,Blue,1,23768,24568,800
2022-09-07,70056,70060,Blue,1,32178,32352,174
2022-03-14,70059,70051,Blue,0,49220,49531,311
2022-02-07,70040,70060,Blue,1,64434,65647,1213
2022-09-26,70053,70047,Blue,0,49172,49480,308
2022-08-19,70038,70040,Blue,1,51505,51522,17
2022-04-13,70052,70054,Blue,1,46083,46133,50
2022-06-12,70038,70052,Blue,1,67215,67916,701
2022-03-20,70038,70044,Blue,1,62346,62512,166
2022-03-01,70057,70055,Blue,0,21903,21975,72
2022-05-31,70046,70048,Blue,1,67945,68027,82
2022-08-24,70053,70039,Blue,0,53547,54372,825
2022-09-29,70050,70054,Blue,1,56589,56793,204
2022-04-21,70051,70047,Blue,0,70857,71044,187
2022-04-12,70051,70039,Blue,0,47696,48381,685
2022-03-02,70051,70041,Blue,0,41345,41944,599
2022-06-03,70042,70044,Blue,1,44054,44082,28
2022-12-16,70042,70048,Blue,1,73291,73602,311
2022-12-04,70043,70041,Blue,0,63895,63924,29
2022-11-08,70044,70056,Blue,1,33453,34168,715
2022-09-02,70053,70047,Blue,0,29143,29437,294
2022-07-09,70055,70051,Blue,0,28986,29136,150
2022-11-26,70049,70043,Blue,0,31425,31774,349
2022-10-21,70055,70047,Blue,0,67751,68108,357
2022-08-29,70038,70054,Blue,1,26232,27030,798
2022-09-21,70048,70056,Blue,1,86257,86659,402
2022-06-15,70051,70838,Blue,0,44260,45044,784
2022-11-15,70038,70054,Blue,1,37765,38520,755
2022-11-23,70047,70045,Blue,0,70845,70937,92
2022-12-05,70046,70054,Blue,1,72995,73428,433
2022-12-17,70059,70045,Blue,0,65424,66168,744
2022-01-29,70046,70052,Blue,1,75934,76429,495
2022-12-10,70047,70043,Blue,0,66531,66766,235
2022-09-30,70040,70042,Blue,1,77563,77596,33
2022-05-17,70057,70051,Blue,0,23076,23330,254
2022-08-03,70048,70058,Blue,1,51422,51936,514
2022-02-13,70045,70039,Blue,0,48626,48857,231
2022-12-17,70044,70056,Blue,1,66073,66724,651
2022-09-19,70050,70052,Blue,1,54811,54925,114
2022-12-03,70055,70053,Blue,0,77961,78008,47
2022-06-12,70045,70838,Blue,0,65928,66282,354
2022-01-12,70040,70050,Blue,1,75845,76302,457
2022-05-09,70057,70051,Blue,0,46600,46861,261
2022-08-09,70048,70056,Blue,1,33493,33880,387
2022-02-27,70053,70838,Blue,0,54112,55097,985
2022-02-23,70040,70060,Blue,1,42070,43143,1073
2022-01-16,70038,70042,Blue,1,88213,88300,87
2022-10-23,70048,70058,Blue,1,83022,83507,485
2022-12-25,70057,70047,Blue,0,87384,87850,466
2022-08-05,70053,70051,Blue,0,31279,31348,69
2022-09-10,70042,70056,Blue,1,66556,67364,808
2022-09-27,70045,70041,Blue,0,32281,32486,205
2022-03-13,70042,70056,Blue,1,43776,44533,757
2022-08-09,70046,70056,Blue,1,43497,44044,547
2022-10-14,70057,70043,Blue,0,66093,66881,788
2022-06-06,70042,70052,Blue,1,37658,38515,857
2022-09-05,70044,70050,Blue,1,59880,60206,326
2022-04-22,70040,70046,Blue,1,45853,46112,259
2022-04-20,70059,70043,Blue,0,81193,82057,864
2022-04-15,70053,70049,Blue,0,66135,66327,192
2022-02-26,70051,70039,Blue,0,40504,41169,665
2022-06-19,70057,70039,Blue,0,65552,66491,939
2022-09-29,70049,70039,Blue,0,29847,30438,591
2022-05-18,70059,70045,Blue,0,29957,30872,915
2022-07-23,70048,70058,Blue,1,72979,73501,522
2022-03-19,70042,70054,Blue,1,21145,21826,681
2022-04-28,70053,70051,Blue,0,61108,61168,60
2022-03-24,70055,70049,Blue,0,49932,50211,279
2022-08-02,70038,70050,Blue,1,76749,77290,541
2022-06-09,70038,70040,Blue,1,56057,56073,16
2022-10-17,70050,70054,Blue,1,25368,25631,263
2022-11-15,70042,70058,Blue,1,30388,31189,801
2022-09-13,70042,70048,Blue,1,23756,24054,298
2022-01-23,70044,70052,Blue,1,78797,79305,508
2022-12-22,70052,70058,Blue,1,86616,86893,277
2022-10-30,70056,70058,Blue,1,59009,59078,69
2022-08-08,70043,70041,Blue,0,75370,75397,27
2022-05-20,70044,70060,Blue,1,46143,47062,919
2022-01-31,70053,70047,Blue,0,27038,27396,358
2022-02-01,70050,70052,Blue,1,22297,22482,185
2022-08-28,70048,70050,Blue,1,36755,36813,58
2022-03-07,70048,70054,Blue,1,39225,39576,351
2022-02-28,70046,70058,Blue,1,56343,56973,630
2022-12-06,70042,70052,Blue,1,57195,57757,562
2022-10-04,70059,70045,Blue,0,23835,24571,736
2022-07-26,70048,70060,Blue,1,87208,87846,638
2022-05-11,70056,70058,Blue,1,46503,46572,69
2022-06-25,70053,70043,Blue,0,21761,22331,570
2022-08-29,70044,70046,Blue,1,25960,26067,107
2022-10-14,70053,70838,Blue,0,87582,88419,837
2022-02-04,70059,70049,Blue,0,68736,69394,658
2022-06-28,70052,70054,Blue,1,47579,47646,67
2022-02-23,70049,70043,Blue,0,30793,31263,470
2022-03-22,70057,70039,Blue,0,66266,67247,981
2022-08-10,70047,70838,Blue,0,21010,21525,515
2022-07-02,70042,70060,Blue,1,83916,85004,1088
2022-03-18,70040,70054,Blue,1,32738,33454,716
2022-06-30,70045,70039,Blue,0,55472,55751,279
2022-10-14,70048,70060,Blue,1,59594,60173,579
2022-01-02,70057,70053,Blue,0,72816,72968,152
2022-06-14,70042,70052,Blue,1,21282,21870,588
2022-10-10,70055,70049,Blue,0,52152,52422,270
2022-07-16,70053,70041,Blue,0,53343,54055,712
2022-07-11,70057,70039,Blue,0,57820,58822,1002
2022-07-15,70056,70058,Blue,1,52877,52948,71
2022-04-01,70052,70054,Blue,1,28703,28764,61
2022-03-01,70039,70838,Blue,0,46000,46030,30
2022-02-15,70049,70041,Blue,0,52058,52480,422
2022-02-12,70048,70050,Blue,1,32301,32358,57
2022-08-18,70042,70052,Blue,1,80456,81011,555
2022-02-18,70044,70050,Blue,1,71714,72071,357
2022-12-02,70038,70060,Blue,1,36732,37864,1132
2022-11-09,70057,70053,Blue,0,38432,38583,151
2022-06-12,70044,70046,Blue,1,32551,32661,110
2022-03-27,70042,70052,Blue,1,38482,38989,507
2022-01-05,70044,70046,Blue,1,60372,60475,103
2022-02-15,70055,70053,Blue,0,31288,31347,59
2022-04-08,70052,70060,Blue,1,54178,54572,394
2022-05-19,70051,70041,Blue,0,21710,22474,764
2022-03-13,70045,70041,Blue,0,62683,62850,167
2022-05-18,70055,70047,Blue,0,63093,63511,418
2022-12-27,70055,70053,Blue,0,56636,56685,49
2022-07-23,70055,70838,Blue,0,50493,51435,942
2022-08-05,70053,70047,Blue,0,30008,30333,325
2022-10-10,70052,70054,Blue,1,79655,79714,59
2022-04-07,70051,70045,Blue,0,55139,55501,362
2022-03-18,70059,70041,Blue,0,48186,49090,904
2022-01-14,70046,70050,Blue,1,37688,37849,161
2022-01-31,70038,70044,Blue,1,78592,78764,172
2022-05-21,70040,70060,Blue,1,30798,31886,1088
2022-11-14,70055,70053,Blue,0,32335,32385,50
2022-04-04,70056,70060,Blue,1,34521,34741,220
2022-04-17,70057,70055,Blue,0,64181,64250,69
2022-08-26,70040,70054,Blue,1,89169,89888,719
2022-07-22,70057,70838,Blue,0,42697,43734,1037
2022-09-28,70053,70838,Blue,0,36631,37449,818
2022-04-03,70039,70838,Blue,0,86550,86585,35
2022-03-15,70057,70051,Blue,0,26443,26703,260
2022-05-04,70052,70056,Blue,1,71881,72023,142
2022-05-19,70047,70039,Blue,0,73868,74400,532
2022-07-28,70049,70041,Blue,0,83351,83838,487
2022-02-16,70059,70051,Blue,0,50248,50564,316
2022-02-04,70044,70052,Blue,1,30361,30884,523
2022-12-19,70057,70838,Blue,0,23428,24656,1228
2022-07-14,70059,70049,Blue,0,23837,24325,488
2022-07-13,70044,70054,Blue,1,54269,54971,702
2022-10-20,70059,70053,Blue,0,68115,68344,229
2022-03-08,70047,70043,Blue,0,57529,57815,286
2022-07-23,70040,70042,Blue,1,36740,36778,38
2022-03-26,70057,70041,Blue,0,47126,47973,847
2022-11-01,70043,70041,Blue,0,43080,43111,31
2022-01-08,70044,70048,Blue,1,70903,71138,235
2022-07-31,70042,70054,Blue,1,64126,64788,662
2022-06-12,70057,70051,Blue,0,46354,46594,240
2022-10-19,70038,70046,Blue,1,60197,60553,356
2022-02-24,70059,70838,Blue,0,86334,87346,1012
2022-11-02,70059,70055,Blue,0,27196,27343,147
2022-07-13,70038,70058,Blue,1,52463,53486,1023
2022-04-18,70038,70060,Blue,1,75805,77187,1382
2022-11-02,70044,70050,Blue,1,66261,66600,339
2022-12-20,70049,70838,Blue,0,51131,51721,590
2022-06-18,70055,70047,Blue,0,42408,42773,365
2022-03-03,70059,70057,Blue,0,30256,30290,34
2022-02-15,70042,70060,Blue,1,58513,59572,1059
2022-05-19,70038,70044,Blue,1,62325,62569,244
2022-07-19,70047,70838,Blue,0,57262,57774,512
2022-10-16,70039,70838,Blue,0,44484,44517,33
2022-03-07,70048,70056,Blue,1,55544,55927,383
2022-01-21,70044,70058,Blue,1,23178,23994,816
2022-03-16,70050,70054,Blue,1,30856,31061,205
2022-05-06,70054,70058,Blue,1,47181,47329,148
2022-12-21,70040,70056,Blue,1,62836,63733,897
2022-11-18,70038,70042,Blue,1,81023,81125,102
2022-11-13,70052,70054,Blue,1,61124,61172,48
2022-09-03,70054,70060,Blue,1,71540,71801,261
2022-03-12,70050,70060,Blue,1,55111,55727,616
2022-04-23,70049,70047,Blue,0,27593,27649,56
2022-12-08,70047,70838,Blue,0,56865,57382,517
2022-11-21,70059,70838,Blue,0,23717,24815,1098
2022-04-18,70043,70039,Blue,0,86166,86287,121
2022-10-19,70041,70838,Blue,0,77892,78016,124
2022-11-03,70057,70838,Blue,0,71861,72847,986
2022-06-11,70051,70041,Blue,0,80950,81611,661
2022-04-23,70054,70058,Blue,1,85428,85590,162
2022-09-02,70041,70039,Blue,0,21407,21439,32
2022-10-31,70047,70838,Blue,0,66183,66685,502
2022-05-28,70049,70838,Blue,0,82598,83206,608
2022-03-04,70050,70060,Blue,1,63145,63781,636
2022-07-28,70050,70052,Blue,1,41119,41271,152
2022-08-27,70046,70050,Blue,1,28913,29083,170
2022-02-04,70039,70838,Blue,0,32921,32956,35
2022-01-19,70046,70056,Blue,1,28551,29147,596
2022-03-01,70040,70052,Blue,1,49801,50411,610
2022-10-19,70050,70054,Blue,1,87908,88097,189
2022-12-30,70039,70838,Blue,0,60531,60569,38
2022-08-29,70051,70049,Blue,0,35752,35855,103
2022-07-20,70044,70048,Blue,1,58954,59229,275
2022-09-22,70054,70056,Blue,1,63299,63346,47
2022-04-02,70046,70056,Blue,1,24702,25230,528
2022-06-25,70045,70039,Blue,0,75119,75398,279
2022-04-18,70048,70058,Blue,1,63859,64360,501
2022-06-17,70038,70040,Blue,1,66139,66153,14
2022-10-02,70053,70043,Blue,0,60725,61378,653
2022-02-01,70046,70052,Blue,1,46805,47187,382
2022-03-19,70042,70046,Blue,1,58966,59144,178
2022-08-21,70057,70039,Blue,0,77132,78123,991
2022-01-05,70057,70047,Blue,0,56384,56908,524
2022-11-10,70045,70043,Blue,0,83162,83256,94
2022-12-29,70050,70060,Blue,1,37266,37791,525
2022-02-20,70057,70049,Blue,0,36275,36677,402
2022-05-25,70038,70052,Blue,1,42075,42894,819
2022-10-02,70042,70054,Blue,1,47918,48557,639
2022-10-07,70052,70054,Blue,1,78654,78715,61
2022-12-20,70055,70051,Blue,0,25611,25761,150
2022-07-22,70059,70039,Blue,0,61147,62373,1226
2022-06-15,70042,70058,Blue,1,55846,56760,914
2022-09-21,70040,70046,Blue,1,24214,24446,232
2022-01-21,70057,70047,Blue,0,71615,72141,526
2022-03-22,70045,70041,Blue,0,53936,54100,164
2022-08-28,70041,70838,Blue,0,50518,50645,127
2022-12-06,70042,70044,Blue,1,86742,86769,27
2022-12-05,70049,70047,Blue,0,58945,59015,70
2022-07-05,70050,70060,Blue,1,32149,32714,565
2022-08-13,70053,70838,Blue,0,64091,64952,861
2022-07-26,70049,70041,Blue,0,82835,83254,419
2022-10-19,70051,70041,Blue,0,79100,79670,570
2022-12-08,70049,70043,Blue,0,27998,28363,365
2022-06-11,70057,70051,Blue,0,39039,39296,257
2022-10-02,70042,70044,Blue,1,51188,51221,33
2022-07-08,70059,70053,Blue,0,28875,29113,238
2022-09-19,70042,70048,Blue,1,52172,52501,329
2022-12-06,70057,70045,Blue,0,63200,63843,643
2022-06-17,70046,70056,Blue,1,84284,84809,525
2022-12-25,70042,70046,Blue,1,36396,36568,172
2022-09-19,70057,70838,Blue,0,68376,69408,1032
2022-02-16,70040,70050,Blue,1,32418,32867,449
2022-03-28,70045,70041,Blue,0,58865,59056,191
2022-09-03,70038,70044,Blue,1,30748,30924,176
2022-04-19,70053,70838,Blue,0,31710,32531,821
2022-06-18,70040,70060,Blue,1,76168,77236,1068
2022-11-30,70040,70048,Blue,1,30310,30682,372
2022-03-14,70047,70041,Blue,0,20894,21230,336
2022-06-22,70038,70054,Blue,1,47141,47935,794
2022-09-04,70046,70048,Blue,1,27243,27319,76
2022-08-11,70038,70054,Blue,1,75186,75972,786
2022-07-05,70047,70838,Blue,0,76517,77049,532
2022-03-20,70059,70049,Blue,0,46463,46994,531
2022-01-13,70049,70039,Blue,0,79978,80518,540
2022-09-15,70038,70060,Blue,1,47122,48287,1165
2022-11-27,70038,70046,Blue,1,80358,80693,335
2022-02-28,70038,70054,Blue,1,21551,22323,772
2022-11-15,70038,70048,Blue,1,38828,39282,454
2022-11-24,70051,70838,Blue,0,62418,63149,731
2022-06-29,70040,70058,Blue,1,76327,77289,962
2022-08-02,70042,70060,Blue,1,27852,28924,1072
2022-11-18,70048,70058,Blue,1,53883,54363,480
2022-09-20,70057,70051,Blue,0,26443,26704,261
2022-08-26,70040,70042,Blue,1,82707,82739,32
2022-09-09,70040,70058,Blue,1,61417,62293,876
2022-09-08,70057,70045,Blue,0,31057,31741,684
2022-08-11,70055,70043,Blue,0,62169,62855,686
2022-09-29,70038,70058,Blue,1,55995,56982,987
2022-07-21,70055,70051,Blue,0,87228,87399,171
2022-03-27,70059,70043,Blue,0,36854,37707,853
2022-04-13,70059,70043,Blue,0,76635,77440,805
2022-08-16,70038,70040,Blue,1,53503,53518,15
2022-08-25,70053,70045,Blue,0,60874,61304,430
2022-09-01,70040,70044,Blue,1,82756,82870,114
2022-04-24,70055,70041,Blue,0,59426,60349,923
2022-12-31,70049,70045,Blue,0,72743,72940,197
2022-03-10,70049,70039,Blue,0,87964,88416,452
2022-04-29,70055,70051,Blue,0,47904,48039,135
2022-12-10,70040,70048,Blue,1,56174,56739,565
2022-07-22,70038,70054,Blue,1,68580,69449,869
2022-03-20,70046,70056,Blue,1,85000,85515,515
2022-01-17,70048,70054,Blue,1,23749,24097,348
2022-01-24,70058,70060,Blue,1,62461,62526,65
2022-09-23,70050,70056,Blue,1,60475,60779,304
2022-02-10,70045,70043,Blue,0,29302,29450,148
2022-02-16,70052,70058,Blue,1,68572,68823,251
2022-09-09,70049,70047,Blue,0,53609,53665,56
2022-03-02,70057,70049,Blue,0,46707,47087,380
2022-07-13,70038,70044,Blue,1,52463,52654,191
2022-07-27,70048,70054,Blue,1,28182,28495,313
2022-04-05,70053,70051,Blue,0,32342,32401,59
2022-02-10,70038,70048,Blue,1,20727,21194,467
2022-07-12,70057,70043,Blue,0,39255,40084,829
2022-03-11,70048,70058,Blue,1,50855,51351,496
2022-02-09,70051,70838,Blue,0,71340,72049,709
2022-06-16,70042,70048,Blue,1,54705,55062,357
2022-05-31,70048,70052,Blue,1,37911,38269,358
2022-05-08,70056,70058,Blue,1,74033,74106,73
2022-10-13,70053,70045,Blue,0,68516,68955,439
2022-11-08,70059,70057,Blue,0,35885,35926,41
2022-03-02,70038,70040,Blue,1,54323,54343,20
2022-02-24,70051,70049,Blue,0,45302,45438,136
2022-10-28,70042,70046,Blue,1,83497,83683,186
2022-09-23,70045,70041,Blue,0,61680,61848,168
2022-03-05,70046,70054,Blue,1,39182,39587,405
2022-12-01,70057,70041,Blue,0,25115,26010,895
2022-08-23,70042,70058,Blue,1,26297,27221,924
2022-03-25,70054,70060,Blue,1,54983,55244,261
2022-11-10,70052,70060,Blue,1,75575,75953,378
2022-10-26,70057,70049,Blue,0,21733,22193,460
2022-04-10,70053,70039,Blue,0,48705,49452,747
2022-12-21,70051,70043,Blue,0,87211,88069,858
2022-07-18,70049,70043,Blue,0,62662,63031,369
2022-07-16,70048,70054,Blue,1,74462,74804,342
2022-12-15,70044,70056,Blue,1,79799,80430,631
2022-11-10,70050,70052,Blue,1,84531,84645,114
2022-01-04,70038,70056,Blue,1,61929,62809,880
2022-04-18,70057,70043,Blue,0,24935,25813,878
2022-07-04,70041,70039,Blue,0,59692,59727,35
2022-12-15,70059,70051,Blue,0,24818,25164,346
2022-10-29,70046,70054,Blue,1,55949,56377,428
2022-01-26,70040,70052,Blue,1,73567,74200,633
2022-06-17,70040,70058,Blue,1,23407,24368,961
2022-07-06,70059,70049,Blue,0,46818,47305,487
2022-06-15,70057,70043,Blue,0,32168,32998,830
2022-12-19,70059,70049,Blue,0,50998,51467,469
2022-01-02,70055,70049,Blue,0,36408,36730,322
2022-03-19,70058,70060,Blue,1,33368,33429,61
2022-03-26,70055,70047,Blue,0,60801,61184,383
2022-01-24,70047,70039,Blue,0,27307,27768,461
2022-04-14,70044,70056,Blue,1,36160,36909,749
2022-06-27,70048,70058,Blue,1,61134,61686,552
2022-12-21,70041,70838,Blue,0,63534,63658,124
2022-09-21,70047,70041,Blue,0,51016,51337,321
2022-08-19,70042,70060,Blue,1,29636,30675,1039
2022-12-22,70053,70838,Blue,0,24996,25960,964
2022-09-05,70051,70041,Blue,0,55826,56396,570
2022-04-14,70038,70054,Blue,1,82659,83526,867
2022-12-02,70046,70048,Blue,1,50132,50205,73
2022-01-25,70053,70838,Blue,0,59854,60613,759
2022-09-30,70038,70052,Blue,1,40885,41668,783
2022-06-25,70044,70046,Blue,1,88454,88623,169
2022-12-30,70059,70057,Blue,0,72697,72731,34
2022-12-20,70044,70060,Blue,1,63724,64746,1022
2022-12-16,70045,70041,Blue,0,32244,32458,214
2022-12-01,70038,70042,Blue,1,89991,90070,79
2022-02-28,70051,70043,Blue,0,72451,72924,473
2022-11-18,70044,70050,Blue,1,41416,41798,382
2022-08-31,70045,70039,Blue,0,40931,41198,267
2022-02-11,70038,70056,Blue,1,68951,69901,950
2022-11-09,70053,70041,Blue,0,81446,82124,678
2022-07-22,70043,70039,Blue,0,25283,25396,113
2022-01-07,70057,70047,Blue,0,35308,35820,512
2022-01-15,70057,70055,Blue,0,49299,49367,68
2022-11-17,70057,70043,Blue,0,22665,23582,917
2022-02-28,70058,70060,Blue,1,53094,53177,83
2022-08-20,70059,70039,Blue,0,25458,26561,1103
2022-01-19,70056,70060,Blue,1,87097,87282,185
2022-12-06,70056,70058,Blue,1,72020,72089,69
2022-02-04,70047,70039,Blue,0,77405,77910,505
2022-07-17,70044,70058,Blue,1,40584,41342,758
2022-02-28,70044,70056,Blue,1,20708,21412,704
2022-06-17,70059,70047,Blue,0,37634,38321,687
2022-11-29,70059,70045,Blue,0,29177,29899,722
2022-12-03,70059,70045,Blue,0,33013,33758,745
2022-12-08,70051,70838,Blue,0,61703,62427,724
2022-04-20,70055,70041,Blue,0,49394,50173,779
2022-11-21,70045,70041,Blue,0,30852,31055,203
2022-07-20,70047,70041,Blue,0,22768,23144,376
2022-07-01,70038,70058,Blue,1,45814,47012,1198
2022-04-08,70053,70045,Blue,0,39581,40203,622
2022-05-20,70038,70056,Blue,1,53262,54226,964
2022-04-21,70055,70838,Blue,0,24749,25720,971
2022-08-31,70055,70838,Blue,0,79795,80672,877
2022-02-16,70059,70047,Blue,0,22779,23438,659
2022-07-24,70055,70838,Blue,0,41668,42662,994
2022-09-02,70059,70053,Blue,0,24480,24717,237
2022-09-01,70050,70058,Blue,1,55803,56191,388
2022-04-15,70040,70044,Blue,1,51274,51377,103
2022-06-16,70053,70045,Blue,0,54015,54474,459
2022-03-24,70038,70056,Blue,1,47527,48420,893
2022-10-06,70059,70053,Blue,0,33497,33731,234
2022-03-28,70059,70049,Blue,0,40934,41430,496
2022-12-03,70053,70838,Blue,0,42652,43535,883
2022-08-14,70038,70060,Blue,1,79696,80901,1205
2022-03-31,70044,70048,Blue,1,86275,86498,223
2022-08-04,70059,70057,Blue,0,84327,84362,35
2022-12-27,70038,70048,Blue,1,79548,80061,513
2022-02-01,70057,70047,Blue,0,23341,24003,662
2022-09-11,70038,70060,Blue,1,54255,55354,1099
2022-10-22,70046,70060,Blue,1,35967,36707,740
2022-03-07,70046,70052,Blue,1,33278,33594,316
2022-01-18,70057,70049,Blue,0,32397,32806,409
2022-08-03,70055,70039,Blue,0,26549,27499,950
2022-09-06,70049,70838,Blue,0,59779,60346,567
2022-04-21,70042,70058,Blue,1,41489,42465,976
2022-07-23,70056,70058,Blue,1,23298,23373,75
2022-07-25,70044,70054,Blue,1,63206,63812,606
2022-01-03,70055,70053,Blue,0,61112,61175,63
2022-09-24,70049,70838,Blue,0,39433,40022,589
2022-08-15,70053,70041,Blue,0,29605,30338,733
2022-02-25,70050,70052,Blue,1,54604,54712,108
2022-06-23,70045,70039,Blue,0,59342,59613,271
2022-11-11,70042,70054,Blue,1,58190,58868,678
2022-10-18,70051,70041,Blue,0,66233,66805,572
2022-12-24,70053,70039,Blue,0,39762,40538,776
2022-10-02,70042,70054,Blue,1,24718,25375,657
2022-04-09,70047,70045,Blue,0,52533,52625,92
2022-09-19,70046,70060,Blue,1,20443,21205,762
2022-09-04,70057,70049,Blue,0,51212,51596,384
2022-11-30,70059,70041,Blue,0,80721,81637,916
2022-07-08,70040,70060,Blue,1,37648,38811,1163
2022-02-05,70057,70838,Blue,0,60635,61682,1047
2022-11-17,70051,70041,Blue,0,40499,41115,616
2022-08-13,70055,70049,Blue,0,75324,75587,263
2022-02-03,70050,70052,Blue,1,36220,36471,251
2022-10-03,70040,70046,Blue,1,55537,55822,285
2022-05-18,70038,70042,Blue,1,62594,62690,96
2022-08-04,70057,70838,Blue,0,56736,57762,1026
2022-01-03,70047,70045,Blue,0,55389,55483,94
2022-08-27,70053,70045,Blue,0,63051,63469,418
2022-01-26,70055,70049,Blue,0,33658,34057,399
2022-12-27,70045,70043,Blue,0,58058,58153,95
2022-06-27,70055,70039,Blue,0,58037,58840,803
2022-02-28,70038,70048,Blue,1,28468,29061,593
2022-02-12,70053,70045,Blue,0,80953,81369,416
2022-10-18,70049,70043,Blue,0,34910,35302,392
2022-12-23,70049,70041,Blue,0,64801,65228,427
2022-08-08,70044,70046,Blue,1,44405,44518,113
2022-09-13,70038,70052,Blue,1,76782,77467,685
2022-01-20,70049,70838,Blue,0,22238,22889,651
2022-02-15,70044,70050,Blue,1,53645,54231,586
2022-10-17,70043,70838,Blue,0,19427,19655,228
2022-03-15,70054,70060,Blue,1,53642,53907,265
2022-03-05,70059,70049,Blue,0,77802,78288,486
2022-04-23,70051,70838,Blue,0,66849,67553,704
2022-04-06,70044,70050,Blue,1,24155,24535,380
2022-02-25,70050,70056,Blue,1,42721,43038,317
2022-08-21,70051,70039,Blue,0,45603,46308,705
2022-02-03,70051,70047,Blue,0,43863,44068,205
2022-11-21,70045,70838,Blue,0,70520,70827,307
2022-09-21,70055,70051,Blue,0,28241,28383,142
2022-06-09,70048,70058,Blue,1,49251,49795,544
2022-11-21,70052,70054,Blue,1,30982,31037,55
2022-11-18,70050,70054,Blue,1,56707,58300,1593
2022-07-29,70057,70838,Blue,0,56064,57116,1052
2022-12-10,70044,70054,Blue,1,27291,27878,587
2022-11-25,70047,70045,Blue,0,22381,22476,95
2022-10-05,70055,70047,Blue,0,28674,29057,383
2022-04-17,70051,70838,Blue,0,74174,74938,764
2022-04-27,70055,70053,Blue,0,56597,56643,46
2022-10-11,70040,70048,Blue,1,57100,57487,387
2022-12-19,70048,70050,Blue,1,55731,55788,57
2022-09-24,70038,70044,Blue,1,21677,21841,164
2022-09-01,70040,70054,Blue,1,68957,69748,791
2022-03-08,70040,70042,Blue,1,20419,20454,35
2022-10-21,70046,70060,Blue,1,22158,22847,689
2022-02-07,70055,70045,Blue,0,45685,46269,584
2022-05-19,70040,70060,Blue,1,69258,70403,1145
2022-07-30,70050,70060,Blue,1,63827,64382,555
2022-12-15,70049,70041,Blue,0,31853,32285,432
2022-09-13,70042,70058,Blue,1,58815,59710,895
2022-06-15,70059,70049,Blue,0,61701,62343,642
2022-02-17,70052,70056,Blue,1,32853,33002,149
2022-12-17,70049,70039,Blue,0,68069,68550,481
2022-08-24,70045,70838,Blue,0,45561,45910,349
2022-03-29,70046,70050,Blue,1,42789,42992,203
2022-06-21,70045,70041,Blue,0,22388,22559,171
2022-05-12,70058,70060,Blue,1,81895,81956,61
2022-11-03,70040,70044,Blue,1,37837,37960,123
2022-02-04,70047,70838,Blue,0,31567,32306,739
2022-09-11,70052,70058,Blue,1,51782,52025,243
2022-08-07,70050,70054,Blue,1,59785,60010,225
2022-02-12,70055,70051,Blue,0,56976,57127,151
2022-07-28,70038,70060,Blue,1,76265,77375,1110
2022-06-11,70057,70039,Blue,0,86641,87550,909
2022-04-12,70059,70045,Blue,0,19925,20599,674
2022-03-11,70053,70838,Blue,0,31965,32856,891
2022-05-19,70052,70060,Blue,1,22673,23243,570
2022-11-03,70055,70838,Blue,0,82791,83769,978
2022-09-17,70040,70054,Blue,1,34580,35297,717
2022-04-16,70045,70041,Blue,0,21667,21844,177
2022-08-26,70055,70049,Blue,0,75134,75405,271
2022-03-02,70048,70052,Blue,1,91312,91583,271
2022-01-10,70059,70057,Blue,0,20956,20993,37
2022-01-14,70051,70041,Blue,0,54533,55070,537
2022-03-11,70039,70838,Blue,0,41707,41740,33
2022-07-02,70040,70054,Blue,1,47373,48181,808
2022-11-30,70055,70049,Blue,0,68958,69661,703
2022-11-01,70053,70045,Blue,0,22619,23109,490
2022-11-23,70040,70058,Blue,1,33248,34306,1058
2022-09-19,70057,70045,Blue,0,22315,22951,636
2022-06-21,70051,70041,Blue,0,48338,48948,610
2022-10-03,70044,70056,Blue,1,26279,26955,676
2022-07-15,70041,70039,Blue,0,65420,65464,44
2022-08-25,70055,70049,Blue,0,79601,79890,289
2022-11-12,70040,70054,Blue,1,48065,48831,766
2022-06-26,70038,70042,Blue,1,27668,27796,128
2022-03-12,70059,70838,Blue,0,32477,33628,1151
2022-12-29,70040,70058,Blue,1,24060,25053,993
2022-11-24,70057,70049,Blue,0,23178,23628,450
2022-02-15,70056,70058,Blue,1,59330,59401,71
2022-02-21,70047,70045,Blue,0,25587,25697,110
2022-09-18,70048,70050,Blue,1,72009,72067,58
2022-05-25,70048,70052,Blue,1,25315,25614,299
2022-05-28,70042,70050,Blue,1,50208,50657,449
2022-02-15,70038,70054,Blue,1,33880,34741,861
2022-07-10,70049,70838,Blue,0,56007,56702,695
2022-05-06,70053,70047,Blue,0,50376,50666,290
2022-12-27,70052,70054,Blue,1,24896,24948,52
2022-01-11,70057,70047,Blue,0,63882,64360,478
2022-08-14,70055,70039,Blue,0,38365,39189,824
2022-08-08,70038,70054,Blue,1,19970,20954,984
2022-04-12,70047,70045,Blue,0,81221,81350,129
2022-11-29,70040,70058,Blue,1,34083,35026,943
2022-12-01,70059,70041,Blue,0,69308,70187,879
2022-01-21,70055,70041,Blue,0,30147,30989,842
2022-11-22,70049,70039,Blue,0,29270,29828,558
2022-04-17,70058,70060,Blue,1,44079,44140,61
2022-11-20,70046,70060,Blue,1,47062,47803,741
2022-11-19,70057,70047,Blue,0,69269,69742,473
2022-11-26,70040,70058,Blue,1,55101,56099,998
2022-02-15,70053,70047,Blue,0,66489,66808,319
2022-05-21,70051,70838,Blue,0,35535,36361,826
2022-12-20,70053,70045,Blue,0,32787,33448,661
2022-07-04,70038,70054,Blue,1,84612,85664,1052
2022-12-07,70054,70060,Blue,1,22116,22373,257
2022-12-20,70051,70047,Blue,0,51800,51991,191
2022-07-03,70052,70056,Blue,1,34014,34184,170
2022-04-06,70038,70052,Blue,1,66131,66999,868
2022-01-13,70052,70056,Blue,1,35727,35871,144
2022-10-18,70044,70046,Blue,1,30367,30474,107
2022-10-01,70055,70041,Blue,0,72079,72829,750
2022-01-19,70042,70056,Blue,1,29786,30508,722
2022-12-22,70040,70056,Blue,1,19884,21004,1120
2022-01-28,70045,70043,Blue,0,30217,30370,153
2022-05-19,70057,70045,Blue,0,87563,88252,689
2022-04-13,70044,70046,Blue,1,66371,66481,110
2022-08-17,70057,70041,Blue,0,20529,21467,938
2022-10-25,70046,70058,Blue,1,42468,43098,630
2022-02-04,70052,70056,Blue,1,59479,59649,170
2022-04-10,70053,70838,Blue,0,48705,49546,841
2022-12-26,70040,70048,Blue,1,66748,67126,378
2022-07-28,70050,70058,Blue,1,45720,46154,434
2022-07-29,70049,70039,Blue,0,20436,20943,507
2022-03-23,70047,70039,Blue,0,25766,26172,406
2022-01-29,70041,70838,Blue,0,87872,88035,163
2022-12-08,70055,70053,Blue,0,61038,61084,46
2022-09-03,70055,70051,Blue,0,80839,80985,146
2022-12-15,70038,70052,Blue,1,87502,88248,746
2022-11-26,70057,70045,Blue,0,83252,83878,626
2022-04-13,70047,70838,Blue,0,79521,79989,468
2022-06-16,70049,70838,Blue,0,62571,63187,616
2022-02-22,70042,70058,Blue,1,34325,35164,839
2022-10-13,70057,70049,Blue,0,22215,22680,465
2022-04-14,70046,70048,Blue,1,63181,63251,70
2022-02-02,70052,70054,Blue,1,58885,58932,47
2022-11-21,70040,70052,Blue,1,90673,91356,683
2022-02-13,70053,70047,Blue,0,25691,25997,306
2022-06-04,70047,70043,Blue,0,55634,55953,319
2022-07-28,70050,70052,Blue,1,55428,55605,177
2022-08-17,70040,70054,Blue,1,59739,60542,803
2022-02-15,70053,70045,Blue,0,60182,60617,435
2022-09-06,70048,70052,Blue,1,58598,58807,209
2022-03-19,70044,70050,Blue,1,32548,32879,331
2022-03-15,70047,70838,Blue,0,20130,20901,771
2022-10-03,70040,70042,Blue,1,69044,69078,34
2022-06-27,70049,70047,Blue,0,34897,34958,61
2022-02-10,70040,70060,Blue,1,60668,61701,1033
2022-02-14,70055,70043,Blue,0,67338,68042,704
2022-06-27,70042,70052,Blue,1,34454,35076,622
2022-05-19,70049,70039,Blue,0,28133,28756,623
2022-10-25,70042,70048,Blue,1,48842,49142,300
2022-06-22,70055,70047,Blue,0,61895,62314,419
2022-01-20,70059,70043,Blue,0,56298,57237,939
2022-03-30,70042,70058,Blue,1,55500,56390,890
2022-06-04,70038,70046,Blue,1,27890,28245,355
2022-07-22,70050,70054,Blue,1,35257,35495,238
2022-12-30,70052,70060,Blue,1,65313,65652,339
2022-06-12,70057,70838,Blue,0,60948,61991,1043
2022-04-12,70057,70047,Blue,0,22486,22999,513
2022-06-09,70047,70039,Blue,0,53223,53686,463
2022-02-21,70045,70838,Blue,0,26229,26602,373
2022-09-16,70051,70049,Blue,0,36314,36414,100
2022-08-19,70051,70041,Blue,0,35304,35942,638
2022-04-07,70049,70043,Blue,0,31659,32019,360
2022-04-23,70040,70048,Blue,1,24366,24740,374
2022-10-10,70056,70058,Blue,1,79340,79419,79
2022-02-10,70057,70043,Blue,0,42764,43627,863
2022-08-13,70053,70039,Blue,0,43600,44359,759
2022-10-05,70045,70838,Blue,0,64726,65040,314
2022-08-24,70053,70838,Blue,0,28057,28932,875
2022-03-29,70044,70054,Blue,1,43160,43714,554
2022-07-09,70048,70056,Blue,1,27974,28334,360
2022-03-07,70046,70058,Blue,1,51995,52601,606
2022-06-04,70040,70048,Blue,1,77714,78156,442
2022-11-14,70051,70047,Blue,0,37709,37908,199
2022-06-22,70040,70052,Blue,1,63440,64272,832
2022-05-14,70049,70047,Blue,0,86815,86890,75
2022-06-22,70038,70046,Blue,1,49844,50205,361
2022-02-27,70038,70054,Blue,1,72068,72858,790
2022-01-21,70057,70043,Blue,0,56968,57782,814
2022-11-05,70047,70041,Blue,0,35393,35707,314
2022-02-19,70059,70055,Blue,0,21497,21647,150
2022-01-22,70040,70060,Blue,1,38437,39595,1158
2022-02-07,70040,70044,Blue,1,41442,41557,115
2022-11-02,70040,70044,Blue,1,76362,76481,119
2022-10-17,70042,70060,Blue,1,60313,61310,997
2022-04-03,70055,70838,Blue,0,47537,48554,1017
2022-02-19,70056,70058,Blue,1,66258,66329,71
2022-01-07,70052,70058,Blue,1,85796,86080,284
2022-03-14,70038,70056,Blue,1,68587,69461,874
2022-11-20,70051,70043,Blue,0,37069,37517,448
2022-12-04,70059,70055,Blue,0,58668,58817,149
2022-07-19,70038,70046,Blue,1,44649,44969,320
2022-08-25,70044,70048,Blue,1,26681,26929,248
2022-08-31,70040,70046,Blue,1,39628,39899,271
2022-10-25,70041,70039,Blue,0,70781,70816,35
2022-03-26,70042,70052,Blue,1,27620,28173,553
2022-03-11,70040,70044,Blue,1,30151,30257,106
2022-01-17,70057,70045,Blue,0,30419,31120,701
2022-11-25,70042,70050,Blue,1,59289,59684,395
2022-06-21,70044,70054,Blue,1,61765,62384,619
2022-12-20,70040,70046,Blue,1,59309,59624,315
2022-03-18,70050,70060,Blue,1,45296,45799,503
2022-08-12,70057,70049,Blue,0,21635,22056,421
2022-01-11,70047,70045,Blue,0,74960,75060,100
2022-12-19,70059,70043,Blue,0,37066,38420,1354
2022-10-31,70056,70060,Blue,1,73745,73937,192
2022-04-23,70043,70039,Blue,0,19362,19492,130
2022-02-15,70043,70039,Blue,0,61112,61228,116
2022-04-04,70044,70054,Blue,1,20972,21664,692
2022-07-17,70043,70838,Blue,0,39123,39312,189
2022-09-22,70049,70043,Blue,0,18957,19329,372
2022-01-04,70051,70049,Blue,0,27071,27188,117
2022-08-11,70040,70048,Blue,1,21143,21562,419
2022-07-14,70044,70048,Blue,1,68172,68643,471
2022-10-15,70056,70060,Blue,1,32236,32405,169
2022-02-22,70046,70060,Blue,1,69827,70726,899
2022-11-30,70051,70838,Blue,0,79577,80348,771
2022-03-11,70046,70048,Blue,1,66546,66620,74
2022-08-13,70047,70039,Blue,0,68764,69228,464
2022-04-15,70057,70053,Blue,0,27918,28074,156
2022-06-30,70040,70042,Blue,1,61962,62002,40
2022-08-13,70040,70052,Blue,1,28626,29229,603
2022-12-04,70055,70053,Blue,0,87501,87547,46
2022-10-03,70044,70052,Blue,1,61677,62216,539
2022-11-17,70046,70060,Blue,1,63138,63872,734
2022-08-13,70044,70060,Blue,1,37429,38367,938
2022-02-26,70038,70060,Blue,1,46388,47532,1144
2022-02-11,70057,70055,Blue,0,24935,25004,69
2022-03-28,70038,70044,Blue,1,76353,76527,174
2022-01-31,70054,70058,Blue,1,59636,59931,295
2022-12-04,70044,70050,Blue,1,74988,75338,350
2022-09-30,70053,70039,Blue,0,31490,32252,762
2022-09-01,70059,70051,Blue,0,79417,79719,302
2022-08-01,70055,70041,Blue,0,22916,23677,761
2022-06-16,70055,70043,Blue,0,28351,29159,808
2022-09-26,70051,70838,Blue,0,26781,27676,895
2022-11-05,70055,70049,Blue,0,81675,81952,277
2022-08-30,70057,70049,Blue,0,58233,58630,397
2022-09-10,70055,70053,Blue,0,43992,44043,51
2022-02-17,70057,70053,Blue,0,65371,65544,173
2022-08-11,70046,70058,Blue,1,23329,23980,651
2022-03-01,70051,70039,Blue,0,19586,20319,733
2022-09-27,70051,70041,Blue,0,41989,42646,657
2022-08-17,70059,70053,Blue,0,31995,32213,218
2022-03-29,70046,70048,Blue,1,71799,71896,97
2022-08-22,70055,70051,Blue,0,20174,20320,146
2022-04-21,70045,70041,Blue,0,25026,25198,172
2022-10-12,70042,70060,Blue,1,34649,35607,958
2022-07-05,70040,70046,Blue,1,54086,54370,284
2022-02-06,70044,70048,Blue,1,39236,39472,236
2022-03-02,70053,70041,Blue,0,86011,86603,592
2022-01-06,70042,70050,Blue,1,82796,83228,432
2022-11-30,70044,70058,Blue,1,24983,25765,782
2022-09-24,70042,70058,Blue,1,67616,68473,857
2022-06-02,70047,70838,Blue,0,43929,44410,481
2022-02-21,70047,70043,Blue,0,79728,79998,270
2022-12-03,70046,70054,Blue,1,28375,28780,405
2022-09-04,70042,70058,Blue,1,73335,74221,886
2022-11-14,70038,70050,Blue,1,45603,46163,560
2022-01-04,70051,70045,Blue,0,49043,49364,321
2022-12-24,70059,70039,Blue,0,48356,49446,1090
2022-01-13,70045,70838,Blue,0,62805,63194,389
2022-02-20,70040,70052,Blue,1,63011,63696,685
2022-09-05,70057,70047,Blue,0,30156,30727,571
2022-08-05,70042,70044,Blue,1,41094,41126,32
2022-04-05,70040,70050,Blue,1,43152,43630,478
2022-11-14,70042,70060,Blue,1,43189,44222,1033
2022-01-09,70055,70053,Blue,0,55641,55707,66
2022-02-12,70046,70054,Blue,1,62077,62502,425
2022-02-23,70040,70058,Blue,1,79914,80889,975
2022-04-06,70051,70047,Blue,0,21706,21905,199
2022-12-25,70052,70060,Blue,1,31486,31817,331
2022-02-26,70049,70838,Blue,0,72958,73508,550
2022-12-29,70053,70039,Blue,0,24673,25427,754
2022-07-06,70052,70054,Blue,1,22956,23036,80
2022-10-27,70059,70057,Blue,0,70694,70729,35
2022-09-08,70041,70039,Blue,0,59498,59538,40
2022-11-05,70048,70054,Blue,1,35576,35885,309
2022-10-20,70042,70050,Blue,1,38976,39364,388
2022-10-21,70049,70041,Blue,0,61389,61814,425
2022-03-17,70052,70060,Blue,1,78785,79136,351
2022-11-14,70057,70041,Blue,0,28042,28950,908
2022-09-10,70047,70039,Blue,0,24743,25161,418
2022-01-12,70050,70054,Blue,1,57519,57730,211
2022-02-16,70045,70043,Blue,0,80235,80370,135
2022-01-20,70058,70060,Blue,1,27984,28111,127
2022-09-24,70045,70043,Blue,0,28394,28493,99
2022-02-26,70057,70041,Blue,0,43366,44259,893
2022-03-18,70042,70060,Blue,1,39183,40196,1013
2022-07-09,70059,70049,Blue,0,79098,79556,458
2022-06-13,70040,70060,Blue,1,62906,64046,1140
2022-12-10,70053,70045,Blue,0,33818,34228,410
2022-05-14,70055,70047,Blue,0,61757,62173,416
2022-03-14,70039,70838,Blue,0,49780,49814,34
2022-02-17,70044,70060,Blue,1,67334,68290,956
2022-10-29,70038,70046,Blue,1,81368,81743,375
2022-12-07,70052,70058,Blue,1,78063,78308,245
2022-01-08,70059,70053,Blue,0,49751,50011,260
2022-01-19,70042,70048,Blue,1,52291,52628,337
2022-04-03,70057,70053,Blue,0,41562,41717,155
2022-02-22,70049,70041,Blue,0,52060,52513,453
2022-07-10,70049,70838,Blue,0,24405,24974,569
2022-08-02,70042,70056,Blue,1,43427,44215,788
2022-02-08,70040,70048,Blue,1,52417,52835,418
2022-03-12,70038,70058,Blue,1,57197,58251,1054
2022-09-27,70046,70050,Blue,1,62322,62520,198
2022-03-18,70059,70047,Blue,0,70562,71083,521
2022-12-11,70040,70058,Blue,1,28509,29370,861
2022-10-14,70040,70054,Blue,1,42559,43321,762
2022-05-21,70055,70047,Blue,0,41334,41712,378
2022-04-06,70051,70047,Blue,0,55321,55509,188
2022-12-14,70048,70052,Blue,1,60164,60376,212
2022-08-05,70057,70053,Blue,0,38546,38694,148
2022-02-15,70042,70058,Blue,1,35215,36161,946
2022-01-18,70054,70056,Blue,1,88498,88544,46
2022-11-01,70044,70060,Blue,1,70285,71194,909
2022-10-24,70048,70056,Blue,1,37388,37796,408
2022-09-09,70058,70060,Blue,1,71388,71449,61
2022-04-12,70057,70045,Blue,0,45575,46309,734
2022-04-01,70053,70051,Blue,0,47417,47474,57
2022-07-16,70048,70056,Blue,1,55037,55436,399
2022-07-30,70047,70043,Blue,0,63398,63643,245
2022-08-21,70057,70047,Blue,0,26262,26731,469
2022-12-16,70048,70058,Blue,1,68235,68741,506
2022-04-18,70052,70056,Blue,1,42859,43004,145
2022-03-04,70051,70043,Blue,0,60299,60825,526
2022-02-19,70058,70060,Blue,1,28650,28733,83
2022-06-10,70054,70058,Blue,1,36083,36266,183
2022-04-12,70042,70044,Blue,1,75935,75966,31
2022-12-21,70038,70048,Blue,1,23929,24402,473
2022-06-27,70059,70041,Blue,0,26775,27772,997
2022-02-08,70038,70054,Blue,1,37350,38223,873
2022-11-04,70056,70058,Blue,1,36854,36930,76
2022-08-23,70053,70041,Blue,0,20211,20952,741
2022-04-09,70055,70045,Blue,0,50480,50998,518
2022-10-13,70038,70044,Blue,1,57440,57641,201
2022-12-29,70047,70043,Blue,0,54971,55211,240
2022-10-03,70055,70838,Blue,0,57911,58876,965
2022-07-07,70059,70039,Blue,0,34408,35498,1090
2022-02-04,70043,70039,Blue,0,31423,31561,138
2022-12-22,70054,70060,Blue,1,58248,58540,292
2022-03-23,70051,70043,Blue,0,25523,26005,482
2022-08-22,70038,70048,Blue,1,70142,70688,546
2022-01-17,70041,70039,Blue,0,41067,41100,33
2022-06-30,70042,70056,Blue,1,78886,79766,880
2022-07-14,70044,70048,Blue,1,28078,28362,284
2022-10-17,70054,70056,Blue,1,36537,36583,46
2022-09-10,70057,70047,Blue,0,45510,46031,521
2022-07-25,70050,70058,Blue,1,62515,62960,445
2022-01-25,70040,70044,Blue,1,53151,53245,94
2022-02-07,70045,70039,Blue,0,25344,25649,305
2022-10-29,70044,70052,Blue,1,65130,65620,490
2022-12-03,70046,70060,Blue,1,65679,66462,783
2022-03-31,70055,70043,Blue,0,42267,42929,662
2022-02-07,70038,70050,Blue,1,58652,59223,571
2022-04-20,70053,70041,Blue,0,27806,28485,679
2022-03-03,70059,70043,Blue,0,32656,33532,876
2022-10-02,70053,70049,Blue,0,44390,44601,211
2022-08-20,70051,70049,Blue,0,73346,73450,104
2022-06-30,70047,70045,Blue,0,77258,77377,119
2022-12-20,70059,70051,Blue,0,25419,25761,342
2022-01-18,70042,70058,Blue,1,70057,70949,892
2022-10-14,70047,70041,Blue,0,37575,37927,352
2022-01-13,70048,70056,Blue,1,57678,58145,467
2022-05-28,70043,70838,Blue,0,55967,56188,221
2022-09-02,70055,70041,Blue,0,59476,60226,750
2022-06-17,70059,70045,Blue,0,64095,64787,692
2022-06-24,70059,70047,Blue,0,51984,52530,546
2022-04-02,70038,70040,Blue,1,40994,41009,15
2022-12-14,70040,70056,Blue,1,50822,51584,762
2022-02-19,70057,70043,Blue,0,59550,60391,841
2022-01-06,70045,70838,Blue,0,72305,72633,328
2022-04-23,70055,70053,Blue,0,41880,41926,46
2022-05-19,70042,70056,Blue,1,21715,22625,910
2022-03-08,70055,70043,Blue,0,31933,32651,718
2022-03-15,70046,70048,Blue,1,67994,68074,80
2022-03-29,70053,70039,Blue,0,73482,74200,718
2022-04-22,70059,70053,Blue,0,56894,57123,229
2022-08-21,70044,70052,Blue,1,40631,41156,525
2022-11-19,70049,70047,Blue,0,70790,70850,60
2022-03-14,70044,70046,Blue,1,35295,35406,111
2022-02-24,70056,70058,Blue,1,64664,64737,73
2022-01-20,70040,70048,Blue,1,45432,45829,397
2022-08-28,70044,70046,Blue,1,47441,47544,103
2022-01-31,70050,70058,Blue,1,54012,54600,588
2022-08-21,70057,70053,Blue,0,69024,69175,151
2022-02-06,70055,70045,Blue,0,66983,67506,523
2022-11-25,70053,70043,Blue,0,20703,21294,591
2022-03-17,70059,70047,Blue,0,71534,72096,562
2022-08-20,70059,70045,Blue,0,44916,45602,686
2022-03-12,70053,70049,Blue,0,30591,30798,207
2022-07-31,70053,70039,Blue,0,74623,75389,766
2022-03-09,70048,70058,Blue,1,75765,76268,503
2022-09-25,70044,70046,Blue,1,56653,56761,108
2022-03-23,70052,70058,Blue,1,55327,55643,316
2022-08-14,70042,70056,Blue,1,83873,84713,840
2022-03-08,70038,70052,Blue,1,27553,28320,767
2022-03-21,70052,70058,Blue,1,31732,31983,251
2022-03-20,70044,70046,Blue,1,54508,54619,111
2022-09-12,70041,70838,Blue,0,19527,19676,149
2022-12-06,70040,70050,Blue,1,40932,41416,484
2022-08-08,70038,70042,Blue,1,50235,50355,120
2022-05-18,70055,70051,Blue,0,59768,59908,140
2022-03-02,70049,70045,Blue,0,78882,79086,204
2022-12-09,70059,70053,Blue,0,71235,71469,234
2022-06-07,70042,70044,Blue,1,81771,81799,28
2022-03-15,70046,70052,Blue,1,31492,31838,346
2022-05-19,70048,70060,Blue,1,50301,50950,649
2022-01-13,70059,70049,Blue,0,35815,36350,535
2022-05-03,70052,70058,Blue,1,66819,67062,243
2022-11-12,70053,70051,Blue,0,84322,84381,59
2022-05-04,70059,70047,Blue,0,50959,51552,593
2022-04-08,70047,70039,Blue,0,23211,23633,422
2022-06-19,70050,70056,Blue,1,66442,66751,309
2022-08-01,70044,70056,Blue,1,21531,22322,791
2022-08-21,70051,70039,Blue,0,37892,38543,651
2022-12-01,70055,70043,Blue,0,60242,60937,695
2022-01-10,70059,70057,Blue,0,59599,59634,35
2022-08-02,70045,70043,Blue,0,63986,64081,95
2022-03-27,70057,70047,Blue,0,50678,51141,463
2022-10-12,70038,70048,Blue,1,24270,24738,468
2022-11-25,70040,70060,Blue,1,43683,44900,1217
2022-11-16,70048,70054,Blue,1,71613,71965,352
2022-08-20,70040,70058,Blue,1,79986,81070,1084
2022-08-02,70059,70049,Blue,0,63411,64010,599
2022-04-14,70057,70053,Blue,0,54288,54444,156
2022-02-16,70044,70052,Blue,1,53103,53701,598
2022-01-19,70055,70047,Blue,0,62775,63152,377
2022-11-17,70038,70056,Blue,1,60228,61161,933
2022-06-19,70050,70054,Blue,1,84450,84676,226
2022-02-12,70053,70043,Blue,0,70581,71160,579
2022-12-29,70056,70060,Blue,1,23769,23946,177
2022-09-19,70050,70054,Blue,1,29804,30025,221
2022-02-09,70054,70056,Blue,1,38891,38942,51
2022-03-29,70048,70056,Blue,1,69135,69524,389
2022-11-02,70051,70838,Blue,0,58071,58759,688
2022-11-23,70050,70054,Blue,1,46696,46907,211
2022-03-22,70057,70047,Blue,0,64663,65145,482
2022-03-08,70059,70043,Blue,0,65594,66468,874
2022-12-19,70046,70048,Blue,1,21017,21093,76
2022-08-11,70044,70054,Blue,1,75408,75972,564
2022-01-27,70043,70041,Blue,0,59902,59933,31
2022-08-11,70040,70044,Blue,1,28258,28365,107
2022-07-28,70059,70043,Blue,0,26783,27739,956
2022-07-16,70053,70047,Blue,0,63518,63798,280
2022-02-26,70048,70052,Blue,1,45821,46014,193
2022-12-26,70038,70056,Blue,1,60195,61128,933
2022-11-26,70055,70045,Blue,0,37519,37999,480
2022-03-07,70042,70060,Blue,1,85019,85986,967
2022-09-08,70049,70838,Blue,0,20087,20805,718
2022-11-26,70046,70058,Blue,1,63518,64138,620
2022-03-07,70046,70056,Blue,1,63181,63717,536
2022-08-01,70044,70050,Blue,1,65592,65916,324
2022-08-27,70041,70039,Blue,0,37799,37830,31
2022-06-18,70041,70838,Blue,0,84131,84246,115
2022-10-31,70053,70049,Blue,0,86024,86214,190
2022-01-07,70055,70043,Blue,0,42867,43509,642
2022-04-14,70042,70044,Blue,1,59986,60012,26
2022-06-29,70055,70047,Blue,0,82236,82612,376
2022-07-22,70049,70041,Blue,0,85635,86070,435
2022-01-29,70038,70056,Blue,1,58569,60673,2104
2022-10-25,70049,70045,Blue,0,55819,56001,182
2022-10-03,70048,70058,Blue,1,64888,65423,535
2022-01-13,70048,70052,Blue,1,33591,33831,240
2022-06-13,70053,70039,Blue,0,51501,52324,823
2022-06-12,70053,70039,Blue,0,39763,40605,842
2022-02-16,70051,70838,Blue,0,19920,20764,844
2022-02-03,70057,70047,Blue,0,88188,88722,534
2022-06-17,70040,70054,Blue,1,68694,69468,774
2022-08-18,70051,70045,Blue,0,64490,64861,371
2022-11-22,70047,70043,Blue,0,51550,51786,236
2022-10-31,70038,70048,Blue,1,41612,42090,478
2022-08-19,70050,70060,Blue,1,59953,60506,553
2022-12-06,70038,70052,Blue,1,83472,84160,688
2022-12-25,70040,70046,Blue,1,66720,66959,239
2022-04-21,70055,70045,Blue,0,66096,66669,573
2022-01-14,70055,70041,Blue,0,59482,60266,784
2022-04-01,70051,70049,Blue,0,84974,85079,105
2022-01-20,70038,70058,Blue,1,66180,67299,1119
2022-08-25,70057,70045,Blue,0,70291,70960,669
2022-09-06,70059,70053,Blue,0,44254,44496,242
2022-07-13,70054,70056,Blue,1,64197,64245,48
2022-12-29,70039,70838,Blue,0,71107,71138,31
2022-02-02,70057,70049,Blue,0,82407,82786,379
2022-08-26,70042,70044,Blue,1,66076,66104,28
2022-02-25,70038,70044,Blue,1,72454,72629,175
2022-04-20,70055,70838,Blue,0,36552,37548,996
2022-07-14,70055,70039,Blue,0,36131,37162,1031
2022-08-06,70049,70047,Blue,0,19019,19083,64
2022-04-20,70055,70838,Blue,0,29251,30238,987
2022-09-21,70054,70058,Blue,1,28280,28436,156
2022-01-27,70044,70056,Blue,1,60140,60839,699
2022-09-02,70057,70045,Blue,0,74511,75150,639
2022-12-07,70059,70039,Blue,0,44138,45119,981
2022-11-19,70038,70060,Blue,1,69385,70579,1194
2022-08-12,70059,70045,Blue,0,44714,45435,721
2022-10-11,70039,70838,Blue,0,40338,40368,30
2022-12-03,70057,70043,Blue,0,39579,40489,910
2022-01-08,70039,70838,Blue,0,28692,28728,36
2022-11-10,70055,70049,Blue,0,23096,23407,311
2022-09-21,70042,70046,Blue,1,53059,53229,170
2022-06-19,70051,70039,Blue,0,77966,78651,685
2022-01-13,70042,70058,Blue,1,75937,76793,856
2022-01-07,70047,70838,Blue,0,19924,20473,549
2022-07-12,70044,70050,Blue,1,67562,67901,339
2022-10-28,70053,70051,Blue,0,25367,25430,63
2022-09-09,70057,70049,Blue,0,72326,72698,372
2022-07-11,70042,70060,Blue,1,81034,81985,951
2022-12-23,70048,70056,Blue,1,53954,54658,704
2022-03-17,70044,70056,Blue,1,33759,34544,785
2022-01-23,70053,70049,Blue,0,34265,34459,194
2022-08-13,70044,70054,Blue,1,69873,70509,636
2022-05-20,70038,70044,Blue,1,53262,53435,173
2022-03-17,70055,70043,Blue,0,28663,29492,829
2022-07-10,70052,70056,Blue,1,69568,69711,143
2022-08-22,70050,70056,Blue,1,50509,50838,329
2022-09-02,70046,70060,Blue,1,26849,27690,841
2022-06-29,70048,70056,Blue,1,20632,21122,490
2022-10-17,70042,70056,Blue,1,65138,65902,764
2022-11-18,70055,70049,Blue,0,49686,49964,278
2022-10-11,70051,70045,Blue,0,78504,78813,309
2022-02-25,70042,70058,Blue,1,49375,50309,934
2022-02-01,70040,70058,Blue,1,62914,63894,980
2022-08-03,70056,70058,Blue,1,66888,66960,72
2022-12-30,70057,70047,Blue,0,20491,20981,490
2022-07-26,70038,70042,Blue,1,43361,43464,103
2022-04-09,70038,70050,Blue,1,69678,70248,570
2022-05-29,70044,70046,Blue,1,73399,73519,120
2022-03-10,70038,70042,Blue,1,32395,32501,106
2022-01-26,70039,70838,Blue,0,67586,67771,185
2022-09-23,70049,70045,Blue,0,57950,58166,216
2022-01-19,70057,70043,Blue,0,38570,39475,905
2022-02-17,70038,70042,Blue,1,26366,26491,125
2022-11-07,70052,70056,Blue,1,28148,28322,174
2022-10-28,70046,70050,Blue,1,40219,40415,196
2022-06-19,70044,70058,Blue,1,75073,75887,814
2022-07-30,70057,70049,Blue,0,57936,58329,393
2022-01-26,70042,70046,Blue,1,43254,43440,186
2022-11-20,70055,70047,Blue,0,63204,63615,411
2022-11-04,70050,70058,Blue,1,42977,43404,427
2022-02-07,70053,70045,Blue,0,82030,82475,445
2022-12-27,70049,70045,Blue,0,24087,24280,193
2022-07-23,70044,70060,Blue,1,70626,71574,948
2022-09-14,70057,70053,Blue,0,24783,24955,172
2022-02-14,70059,70053,Blue,0,55396,55653,257
2022-04-10,70047,70039,Blue,0,42800,43248,448
2022-11-25,70059,70053,Blue,0,63434,63658,224
2022-12-06,70055,70049,Blue,0,31058,31355,297
2022-02-20,70045,70838,Blue,0,75073,75403,330
2022-04-20,70059,70041,Blue,0,74893,75869,976
2022-08-14,70044,70046,Blue,1,74985,75090,105
2022-08-07,70045,70039,Blue,0,66091,66342,251
2022-01-17,70053,70049,Blue,0,48429,48624,195
2022-02-06,70047,70045,Blue,0,53918,54011,93
2022-10-16,70038,70054,Blue,1,78548,79427,879
2022-03-24,70038,70046,Blue,1,82633,82972,339
2022-09-10,70040,70060,Blue,1,28677,29672,995
2022-03-12,70054,70060,Blue,1,62903,63162,259
2022-07-06,70053,70049,Blue,0,48626,48818,192
2022-12-14,70056,70058,Blue,1,79329,79401,72
2022-10-23,70054,70060,Blue,1,70828,71095,267
2022-11-29,70057,70055,Blue,0,70768,70836,68
2022-10-01,70038,70040,Blue,1,58847,58861,14
2022-04-08,70055,70053,Blue,0,19694,19739,45
2022-09-28,70053,70047,Blue,0,40851,41158,307
2022-01-21,70059,70043,Blue,0,35882,36783,901
2022-04-15,70053,70047,Blue,0,44676,45024,348
2022-07-13,70044,70056,Blue,1,66982,67753,771
2022-09-13,70053,70041,Blue,0,38740,39467,727
2022-04-18,70047,70043,Blue,0,76762,77036,274
2022-10-13,70038,70060,Blue,1,60406,61640,1234
2022-01-23,70053,70045,Blue,0,68686,69102,416
2022-07-18,70038,70042,Blue,1,67481,67607,126
2022-09-24,70043,70838,Blue,0,63717,63907,190
2022-08-06,70054,70056,Blue,1,30559,30606,47
2022-12-12,70059,70043,Blue,0,60323,61199,876
2022-03-22,70047,70045,Blue,0,23719,23861,142
2022-09-08,70042,70048,Blue,1,67791,68107,316
2022-07-30,70046,70050,Blue,1,28382,28549,167
2022-03-09,70042,70054,Blue,1,43639,44333,694
2022-10-23,70042,70058,Blue,1,70066,70987,921
2022-11-09,70040,70044,Blue,1,40966,41079,113
2022-04-08,70059,70041,Blue,0,74901,75862,961
2022-11-18,70050,70056,Blue,1,62826,63129,303
2022-11-07,70055,70045,Blue,0,73514,73986,472
2022-12-30,70059,70049,Blue,0,60749,61259,510
2022-11-01,70056,70060,Blue,1,62896,63080,184
2022-01-15,70053,70043,Blue,0,41577,42104,527
2022-09-08,70038,70044,Blue,1,29832,29996,164
2022-09-03,70055,70047,Blue,0,23671,24056,385
2022-10-24,70047,70043,Blue,0,31609,31890,281
2022-07-20,70050,70056,Blue,1,68861,69171,310
2022-08-21,70041,70838,Blue,0,73219,73342,123
2022-12-29,70047,70043,Blue,0,19391,19650,259
2022-10-20,70041,70039,Blue,0,51356,51389,33
2022-03-16,70051,70838,Blue,0,28258,28964,706
2022-08-24,70055,70047,Blue,0,28232,28629,397
2022-12-25,70048,70052,Blue,1,82836,83044,208
2022-04-18,70042,70044,Blue,1,32226,32257,31
2022-04-08,70044,70046,Blue,1,67248,67355,107
2022-07-07,70057,70053,Blue,0,35140,35307,167
2022-09-21,70059,70055,Blue,0,57213,57358,145
2022-02-03,70045,70838,Blue,0,21769,22171,402
2022-06-15,70049,70838,Blue,0,61024,61691,667
2022-07-22,70040,70054,Blue,1,84454,85339,885
2022-09-07,70047,70838,Blue,0,25396,25911,515
2022-12-19,70038,70040,Blue,1,26980,26998,18
2022-01-11,70047,70039,Blue,0,62044,62456,412
2022-10-17,70042,70050,Blue,1,43752,44169,417
2022-12-17,70055,70047,Blue,0,35352,35755,403
2022-01-19,70053,70838,Blue,0,63478,64265,787
2022-07-20,70042,70044,Blue,1,53722,53755,33
2022-03-30,70057,70043,Blue,0,58161,58925,764
2022-12-26,70038,70046,Blue,1,59655,59995,340
2022-04-10,70044,70046,Blue,1,37920,38026,106
2022-12-23,70038,70040,Blue,1,56564,56580,16
2022-02-24,70049,70039,Blue,0,38756,39244,488
2022-12-05,70053,70039,Blue,0,32381,33094,713
2022-07-29,70046,70052,Blue,1,49809,50175,366
2022-11-25,70041,70039,Blue,0,66531,66563,32
2022-10-07,70053,70047,Blue,0,53540,53829,289
2022-02-01,70043,70838,Blue,0,37658,37885,227
2022-01-04,70055,70047,Blue,0,87678,88060,382
2022-12-25,70043,70838,Blue,0,29351,29526,175
2022-02-25,70040,70056,Blue,1,86197,87064,867
2022-06-14,70046,70054,Blue,1,55791,56259,468
2022-06-16,70040,70060,Blue,1,28241,29512,1271
2022-11-06,70056,70058,Blue,1,64447,64530,83
2022-05-28,70047,70039,Blue,0,27415,27952,537
2022-01-24,70040,70042,Blue,1,20841,20877,36
2022-08-09,70051,70041,Blue,0,55759,56356,597
2022-04-02,70055,70045,Blue,0,79274,79777,503
2022-01-11,70047,70041,Blue,0,64404,64732,328
2022-01-24,70049,70041,Blue,0,74849,75350,501
2022-08-24,70059,70053,Blue,0,52107,52333,226
2022-01-18,70044,70050,Blue,1,68904,69241,337
2022-06-24,70038,70044,Blue,1,27757,27919,162
2022-02-11,70057,70039,Blue,0,82943,83855,912
2022-04-18,70044,70048,Blue,1,76047,76544,497
2022-03-14,70038,70060,Blue,1,30848,31974,1126
2022-02-11,70042,70052,Blue,1,86710,87297,587
2022-12-30,70042,70060,Blue,1,19962,21087,1125
2022-04-07,70053,70045,Blue,0,25729,26203,474
2022-12-14,70057,70041,Blue,0,45825,46674,849
2022-10-03,70058,70060,Blue,1,40560,40633,73
2022-04-07,70041,70039,Blue,0,55778,55811,33
2022-11-13,70043,70041,Blue,0,57940,57967,27
2022-02-24,70038,70040,Blue,1,70597,70617,20
2022-02-26,70038,70056,Blue,1,41557,42580,1023
2022-02-24,70054,70058,Blue,1,85137,85298,161
2022-02-24,70040,70058,Blue,1,53957,55153,1196
2022-09-22,70054,70060,Blue,1,42478,42742,264
2022-03-24,70051,70047,Blue,0,32469,32675,206
2022-02-26,70043,70838,Blue,0,71196,71377,181
2022-09-26,70052,70058,Blue,1,32585,32848,263
2022-01-04,70053,70838,Blue,0,55340,56213,873
2022-03-15,70054,70058,Blue,1,71836,71991,155
2022-02-14,70040,70042,Blue,1,62316,62350,34
2022-03-12,70040,70056,Blue,1,21092,21920,828
2022-03-11,70059,70045,Blue,0,56892,57621,729
2022-04-18,70049,70838,Blue,0,82827,83448,621
2022-01-27,70048,70054,Blue,1,24502,24835,333
2022-07-01,70055,70838,Blue,0,55519,56695,1176
2022-06-29,70043,70838,Blue,0,41509,41714,205
2022-03-18,70038,70050,Blue,1,76337,77078,741
2022-02-17,70055,70043,Blue,0,66443,67226,783
2022-12-27,70045,70041,Blue,0,44915,45082,167
2022-03-08,70055,70039,Blue,0,61268,62085,817
2022-06-29,70038,70052,Blue,1,57657,58464,807
2022-08-24,70043,70838,Blue,0,28698,28932,234
2022-05-19,70057,70043,Blue,0,71094,71982,888
2022-03-30,70049,70043,Blue,0,27752,28083,331
2022-05-05,70050,70052,Blue,1,26063,26172,109
2022-01-05,70044,70046,Blue,1,22056,22166,110
2022-04-12,70055,70045,Blue,0,27180,27745,565
2022-06-08,70043,70041,Blue,0,46743,46771,28
2022-02-18,70055,70053,Blue,0,20785,20834,49
2022-08-05,70046,70056,Blue,1,20167,20659,492
2022-03-15,70059,70047,Blue,0,19868,20407,539
2022-09-15,70048,70052,Blue,1,48802,49030,228
2022-07-10,70053,70838,Blue,0,84047,84923,876
2022-02-17,70047,70838,Blue,0,62345,62854,509
2022-11-05,70059,70055,Blue,0,29250,29400,150
2022-04-07,70045,70043,Blue,0,20029,20140,111
2022-05-21,70042,70054,Blue,1,34130,34848,718
2022-10-13,70038,70054,Blue,1,40870,41630,760
2022-02-20,70038,70048,Blue,1,52091,52538,447
2022-02-18,70045,70041,Blue,0,34020,34222,202
2022-01-04,70038,70042,Blue,1,77407,77500,93
2022-04-09,70042,70060,Blue,1,53041,54054,1013
2022-03-08,70055,70838,Blue,0,50411,51334,923
2022-01-13,70055,70051,Blue,0,54999,55170,171
2022-05-21,70042,70056,Blue,1,86579,87519,940
2022-08-02,70038,70052,Blue,1,65238,66016,778
2022-08-26,70059,70053,Blue,0,77078,77307,229
2022-02-27,70059,70043,Blue,0,48982,49830,848
2022-12-26,70050,70054,Blue,1,38266,38489,223
2022-09-08,70051,70041,Blue,0,39549,40152,603
2022-04-06,70045,70838,Blue,0,88881,89407,526
2022-02-21,70038,70056,Blue,1,28045,28956,911
2022-02-09,70047,70043,Blue,0,29378,29658,280
2022-09-08,70047,70045,Blue,0,37581,37690,109
2022-02-18,70040,70056,Blue,1,27635,28544,909
2022-12-19,70038,70040,Blue,1,38651,38669,18
2022-11-09,70053,70049,Blue,0,61156,61380,224
2022-02-14,70040,70042,Blue,1,87225,87258,33
2022-12-27,70054,70060,Blue,1,53935,54420,485
2022-12-26,70050,70056,Blue,1,86989,87282,293
2022-11-03,70040,70060,Blue,1,68054,69222,1168
2022-12-30,70044,70048,Blue,1,57328,57561,233
2022-05-07,70049,70047,Blue,0,86297,86355,58
2022-02-07,70038,70042,Blue,1,66225,66320,95
2022-11-14,70057,70045,Blue,0,66627,67259,632
2022-04-23,70049,70039,Blue,0,34060,34601,541
2022-10-20,70059,70041,Blue,0,78118,78985,867
2022-08-06,70051,70039,Blue,0,49039,49690,651
2022-11-10,70053,70041,Blue,0,78458,79074,616
2022-06-10,70050,70058,Blue,1,46206,46632,426
2022-11-05,70047,70045,Blue,0,42797,42887,90
2022-09-10,70038,70058,Blue,1,37746,38752,1006
2022-02-24,70039,70838,Blue,0,75386,75420,34
2022-11-03,70044,70052,Blue,1,44820,45431,611
2022-01-13,70042,70060,Blue,1,30754,31797,1043
2022-08-06,70045,70838,Blue,0,69932,70253,321
2022-01-21,70039,70838,Blue,0,79968,80014,46
2022-05-18,70043,70041,Blue,0,70430,70461,31
2022-07-12,70053,70039,Blue,0,77728,78427,699
2022-07-07,70048,70052,Blue,1,40286,40564,278
2022-05-04,70052,70058,Blue,1,81482,81737,255
2022-05-23,70045,70838,Blue,0,73073,73487,414
2022-04-22,70050,70058,Blue,1,36759,37227,468
2022-04-13,70047,70838,Blue,0,52728,53232,504
2022-06-24,70038,70044,Blue,1,20033,20244,211
2022-01-17,70059,70039,Blue,0,29238,30323,1085
2022-10-09,70059,70043,Blue,0,28516,29396,880
2022-09-28,70044,70060,Blue,1,57828,58860,1032
2022-02-24,70038,70042,Blue,1,52888,52989,101
2022-01-19,70053,70051,Blue,0,38527,38602,75
2022-02-03,70040,70060,Blue,1,52204,53234,1030
2022-03-04,70040,70046,Blue,1,62600,62840,240
2022-07-15,70047,70838,Blue,0,65845,66361,516
2022-07-09,70050,70056,Blue,1,85270,85575,305
2022-05-20,70051,70047,Blue,0,65973,66177,204
2022-10-26,70051,70049,Blue,0,25937,26044,107
2022-06-13,70040,70052,Blue,1,81568,82282,714
2022-09-28,70038,70042,Blue,1,51915,52023,108
2022-07-11,70048,70050,Blue,1,51239,51295,56
2022-06-27,70059,70838,Blue,0,21769,23040,1271
2022-06-18,70056,70060,Blue,1,87411,87588,177
2022-10-23,70038,70044,Blue,1,65060,65250,190
2022-07-30,70051,70049,Blue,0,27998,28103,105
2022-04-02,70046,70056,Blue,1,57610,58135,525
2022-11-25,70057,70045,Blue,0,47996,48655,659
2022-10-11,70059,70049,Blue,0,60313,60797,484
2022-04-05,70057,70043,Blue,0,32729,33531,802
2022-09-15,70059,70049,Blue,0,53775,54208,433
2022-06-21,70040,70058,Blue,1,59310,60377,1067
2022-03-30,70044,70060,Blue,1,49961,50817,856
2022-03-25,70059,70041,Blue,0,53113,54011,898
2022-04-07,70051,70045,Blue,0,25532,25874,342
2022-12-09,70039,70838,Blue,0,76372,76404,32
2022-10-29,70055,70049,Blue,0,39714,39983,269
2022-01-06,70057,70043,Blue,0,88218,89078,860
2022-10-04,70046,70056,Blue,1,21762,22294,532
2022-03-15,70049,70039,Blue,0,71033,71563,530
2022-01-06,70046,70050,Blue,1,30618,30803,185
2022-06-26,70041,70039,Blue,0,74281,74314,33
2022-02-21,70059,70051,Blue,0,68115,68461,346
2022-05-17,70049,70047,Blue,0,59463,59516,53
2022-09-05,70051,70043,Blue,0,35908,36401,493
2022-08-26,70039,70838,Blue,0,59751,59787,36
2022-08-30,70055,70047,Blue,0,88280,88647,367
2022-04-22,70049,70047,Blue,0,64284,64341,57
2022-11-06,70045,70041,Blue,0,72480,72651,171
2022-08-24,70044,70050,Blue,1,58530,58901,371
2022-06-30,70055,70051,Blue,0,23612,23763,151
2022-12-08,70046,70054,Blue,1,27727,28205,478
2022-01-21,70043,70039,Blue,0,84466,84587,121
2022-11-17,70042,70058,Blue,1,49905,50740,835
2022-11-02,70049,70045,Blue,0,57172,57374,202
2022-06-18,70054,70060,Blue,1,31632,31898,266
2022-12-08,70041,70838,Blue,0,82543,82657,114
2022-11-02,70042,70044,Blue,1,59301,59329,28
2022-04-23,70059,70057,Blue,0,22812,22847,35
2022-08-21,70057,70043,Blue,0,49052,49848,796
2022-03-23,70040,70042,Blue,1,60211,60246,35
2022-02-24,70049,70838,Blue,0,59464,60165,701
2022-07-29,70057,70053,Blue,0,52047,52198,151
2022-07-08,70038,70058,Blue,1,40680,41711,1031
2022-01-03,70057,70047,Blue,0,19591,20072,481
2022-11-30,70059,70045,Blue,0,63409,64097,688
2022-12-16,70043,70838,Blue,0,34058,34254,196
2022-01-14,70057,70039,Blue,0,60266,61165,899
2022-04-20,70038,70054,Blue,1,49311,50210,899
2022-07-03,70050,70058,Blue,1,50043,50489,446
2022-06-23,70047,70045,Blue,0,34158,34253,95
2022-11-01,70055,70043,Blue,0,34105,34781,676
2022-03-22,70040,70052,Blue,1,28819,29586,767
2022-02-02,70046,70060,Blue,1,89482,90188,706
2022-04-01,70039,70838,Blue,0,72274,72311,37
2022-11-06,70042,70048,Blue,1,47917,48220,303
2022-02-22,70042,70044,Blue,1,65415,65444,29
2022-08-10,70048,70050,Blue,1,27411,27470,59
2022-07-12,70059,70057,Blue,0,65532,65567,35
2022-02-05,70053,70039,Blue,0,45175,45983,808
2022-07-19,70055,70045,Blue,0,75079,75587,508
2022-02-01,70038,70052,Blue,1,77594,78352,758
2022-12-20,70050,70052,Blue,1,50702,51081,379
2022-01-01,70055,70047,Blue,0,75201,75569,368
2022-07-08,70055,70053,Blue,0,35462,35509,47
2022-02-27,70038,70054,Blue,1,51548,52394,846
2022-12-05,70046,70060,Blue,1,26825,27573,748
2022-09-20,70059,70838,Blue,0,31783,32923,1140
2022-03-15,70055,70053,Blue,0,64272,64349,77
2022-05-25,70049,70041,Blue,0,25482,25955,473
2022-02-10,70042,70058,Blue,1,55080,55933,853
2022-08-08,70048,70054,Blue,1,86167,86473,306
2022-08-23,70040,70052,Blue,1,55113,55995,882
2022-02-15,70042,70056,Blue,1,53563,54584,1021
2022-02-07,70051,70838,Blue,0,61489,62364,875
2022-09-05,70043,70039,Blue,0,80622,80723,101
2022-04-01,70059,70838,Blue,0,20236,21319,1083
2022-01-16,70043,70838,Blue,0,78474,78659,185
2022-09-09,70048,70050,Blue,1,73438,73495,57
2022-03-16,70040,70050,Blue,1,44731,45270,539
2022-10-30,70042,70044,Blue,1,40503,40538,35
2022-04-04,70055,70051,Blue,0,47308,47450,142
2022-09-05,70059,70041,Blue,0,81552,82449,897
2022-07-02,70055,70043,Blue,0,59660,60350,690
2022-07-08,70046,70050,Blue,1,25489,25691,202
2022-09-19,70053,70039,Blue,0,62897,63725,828
2022-08-21,70040,70042,Blue,1,56497,56533,36
2022-04-02,70048,70056,Blue,1,26724,27220,496
2022-12-24,70040,70056,Blue,1,61629,62487,858
2022-07-28,70051,70045,Blue,0,79764,80116,352
2022-09-24,70059,70045,Blue,0,75797,76486,689
2022-09-06,70059,70838,Blue,0,47305,48407,1102
2022-05-19,70053,70838,Blue,0,57745,58857,1112
2022-12-26,70046,70056,Blue,1,85928,86474,546
2022-08-08,70044,70052,Blue,1,57470,57976,506
2022-11-22,70038,70048,Blue,1,72093,72530,437
2022-02-02,70046,70056,Blue,1,62094,62587,493
2022-11-11,70053,70047,Blue,0,30822,31112,290
2022-11-20,70047,70041,Blue,0,43906,44219,313
2022-09-27,70038,70042,Blue,1,82035,82161,126
2022-01-12,70038,70044,Blue,1,62231,62441,210
2022-04-22,70040,70058,Blue,1,59897,60839,942
2022-07-25,70057,70838,Blue,0,30213,31316,1103
2022-05-09,70056,70060,Blue,1,53404,53588,184
2022-09-28,70055,70043,Blue,0,45929,46592,663
2022-11-14,70053,70051,Blue,0,71008,71063,55
2022-08-20,70053,70045,Blue,0,78709,79149,440
2022-08-07,70059,70047,Blue,0,23847,24371,524
2022-02-17,70040,70056,Blue,1,44766,45669,903
2022-08-15,70055,70043,Blue,0,29926,30654,728
2022-03-07,70040,70046,Blue,1,46439,46678,239
2022-03-07,70053,70043,Blue,0,25737,26328,591
2022-06-16,70040,70046,Blue,1,22840,23223,383
2022-10-28,70042,70060,Blue,1,64434,65431,997
2022-04-14,70046,70060,Blue,1,53435,54535,1100
2022-05-19,70046,70058,Blue,1,67598,68282,684
2022-04-08,70049,70043,Blue,0,68946,69258,312
2022-02-12,70049,70039,Blue,0,43247,43772,525
2022-03-25,70053,70838,Blue,0,81471,82306,835
2022-01-11,70044,70054,Blue,1,30510,31147,637
2022-08-27,70044,70060,Blue,1,28256,29117,861
2022-03-08,70040,70060,Blue,1,60815,61912,1097
2022-04-12,70055,70043,Blue,0,80239,80836,597
2022-09-03,70046,70048,Blue,1,89501,89580,79
2022-12-12,70057,70047,Blue,0,82352,82810,458
2022-07-11,70046,70060,Blue,1,81279,81985,706
2022-12-22,70042,70058,Blue,1,43539,44459,920
2022-01-16,70051,70045,Blue,0,41221,41552,331
2022-09-02,70057,70041,Blue,0,51051,51952,901
2022-08-11,70048,70060,Blue,1,67209,67834,625
2022-08-07,70059,70041,Blue,0,49530,50461,931
2022-04-02,70050,70054,Blue,1,32373,32569,196
2022-03-30,70038,70054,Blue,1,69428,70325,897
2022-04-18,70053,70047,Blue,0,35207,35521,314
2022-08-24,70040,70060,Blue,1,72930,74040,1110
2022-04-07,70059,70055,Blue,0,56340,56485,145
2022-03-18,70052,70054,Blue,1,79338,79392,54
2022-12-01,70043,70041,Blue,0,59247,59287,40
2022-01-11,70046,70048,Blue,1,67176,67266,90
2022-11-18,70051,70047,Blue,0,82293,82517,224
2022-12-12,70042,70056,Blue,1,23016,23835,819
2022-02-25,70045,70039,Blue,0,56199,56493,294
2022-06-14,70057,70045,Blue,0,85244,85881,637
2022-03-07,70050,70052,Blue,1,77418,77529,111
2022-09-26,70050,70052,Blue,1,42208,42328,120
2022-12-02,70038,70054,Blue,1,64807,65603,796
2022-08-29,70053,70049,Blue,0,63708,63910,202
2022-09-25,70053,70051,Blue,0,69743,69797,54
2022-04-12,70059,70057,Blue,0,54813,54832,19
2022-07-04,70057,70051,Blue,0,29854,30090,236
2022-08-11,70053,70047,Blue,0,41639,41937,298
2022-02-07,70057,70039,Blue,0,49848,50908,1060
2022-08-26,70052,70056,Blue,1,46479,46622,143
2022-10-05,70057,70039,Blue,0,50483,51418,935
2022-05-09,70051,70047,Blue,0,72497,72890,393
2022-10-09,70053,70045,Blue,0,76236,76656,420
2022-12-28,70058,70060,Blue,1,27561,27637,76
2022-09-28,70052,70054,Blue,1,61938,61986,48
2022-07-27,70051,70039,Blue,0,49262,49932,670
2022-01-04,70059,70057,Blue,0,55399,55460,61
2022-11-20,70044,70058,Blue,1,34892,35724,832
2022-05-23,70049,70039,Blue,0,78099,78772,673
2022-07-18,70042,70052,Blue,1,23695,24242,547
2022-10-16,70050,70058,Blue,1,74840,75331,491
2022-10-12,70040,70054,Blue,1,70615,71337,722
2022-07-24,70053,70041,Blue,0,35145,35841,696
2022-08-03,70046,70056,Blue,1,75174,75700,526
2022-01-06,70059,70055,Blue,0,81206,81350,144
2022-06-13,70040,70052,Blue,1,31216,31911,695
2022-10-11,70057,70045,Blue,0,23502,24144,642
2022-09-23,70038,70046,Blue,1,54733,55134,401
2022-04-23,70049,70039,Blue,0,82869,83347,478
2022-04-01,70038,70048,Blue,1,63143,63669,526
2022-11-06,70049,70047,Blue,0,50035,50089,54
2022-04-14,70041,70838,Blue,0,60871,60999,128
2022-02-11,70053,70041,Blue,0,86035,86666,631
2022-07-17,70057,70838,Blue,0,45281,46271,990
2022-06-19,70053,70047,Blue,0,64343,64624,281
2022-06-12,70057,70043,Blue,0,51836,52736,900
2022-01-19,70043,70041,Blue,0,60866,60896,30
2022-08-31,70040,70046,Blue,1,46210,46531,321
2022-07-30,70049,70838,Blue,0,39448,40050,602
2022-08-07,70051,70838,Blue,0,24186,24880,694
2022-04-18,70053,70047,Blue,0,64959,65255,296
2022-11-03,70044,70050,Blue,1,40774,41173,399
2022-10-02,70050,70060,Blue,1,41570,42078,508
2022-11-13,70044,70058,Blue,1,36457,37197,740
2022-11-24,70043,70838,Blue,0,22385,22580,195
2022-07-29,70050,70056,Blue,1,76910,77195,285
2022-11-01,70058,70060,Blue,1,61947,62015,68
2022-09-30,70051,70041,Blue,0,52348,52897,549
2022-12-29,70054,70056,Blue,1,51979,52047,68
2022-10-29,70049,70039,Blue,0,68062,68582,520
2022-12-14,70059,70045,Blue,0,25936,26735,799
2022-10-27,70049,70039,Blue,0,29680,30289,609
2022-04-13,70055,70043,Blue,0,22212,22913,701
2022-09-29,70059,70051,Blue,0,26432,26799,367
2022-04-19,70044,70058,Blue,1,29568,30352,784
2022-03-15,70050,70058,Blue,1,66111,66527,416
2022-10-02,70057,70045,Blue,0,53922,54666,744
2022-10-07,70057,70053,Blue,0,47961,48114,153
2022-01-11,70055,70039,Blue,0,44083,45055,972
2022-03-03,70047,70039,Blue,0,64117,64546,429
2022-11-03,70055,70041,Blue,0,38353,39092,739
2022-11-06,70053,70043,Blue,0,37130,37738,608
2022-11-28,70038,70058,Blue,1,33612,34569,957
2022-06-13,70059,70838,Blue,0,83475,84589,1114
2022-04-18,70059,70057,Blue,0,74893,74929,36
2022-08-28,70049,70041,Blue,0,71607,72008,401
2022-12-12,70044,70060,Blue,1,22471,23508,1037
2022-11-10,70038,70042,Blue,1,77294,77387,93
2022-02-24,70051,70041,Blue,0,55209,55756,547
2022-02-05,70055,70838,Blue,0,67750,68657,907
2022-08-01,70042,70046,Blue,1,65509,65693,184
2022-09-15,70047,70041,Blue,0,50027,50357,330
2022-06-11,70049,70041,Blue,0,49749,50213,464
2022-08-24,70042,70044,Blue,1,69544,69576,32
2022-10-27,70050,70058,Blue,1,53279,53686,407
2022-03-12,70053,70047,Blue,0,36075,36372,297
2022-09-14,70059,70041,Blue,0,51974,52880,906
2022-06-29,70055,70049,Blue,0,84365,84660,295
2022-12-20,70057,70045,Blue,0,67249,67859,610
2022-07-13,70043,70039,Blue,0,26469,26579,110
2022-08-06,70057,70041,Blue,0,37948,38785,837
2022-09-20,70055,70049,Blue,0,37642,37967,325
2022-09-11,70040,70060,Blue,1,31680,32721,1041
2022-03-04,70042,70058,Blue,1,31604,32545,941
2022-11-07,70046,70048,Blue,1,79304,79385,81
2022-04-07,70041,70039,Blue,0,74271,74307,36
2022-08-03,70054,70058,Blue,1,30311,30462,151
2022-02-03,70053,70051,Blue,0,49514,49573,59
2022-11-30,70050,70052,Blue,1,29544,29661,117
2022-11-08,70059,70039,Blue,0,63551,64606,1055
2022-02-02,70052,70054,Blue,1,71305,71360,55
2022-07-25,70043,70838,Blue,0,27380,27612,232
2022-05-28,70042,70050,Blue,1,76611,77225,614
2022-11-28,70047,70039,Blue,0,64840,65236,396
2022-06-15,70038,70056,Blue,1,59540,60485,945
2022-11-09,70046,70056,Blue,1,32657,33196,539
2022-03-17,70040,70046,Blue,1,57497,57771,274
2022-11-17,70042,70060,Blue,1,64671,65618,947
2022-12-04,70051,70049,Blue,0,74149,74249,100
2022-11-02,70053,70049,Blue,0,32511,32719,208
2022-02-27,70038,70042,Blue,1,73694,73796,102
2022-07-21,70042,70052,Blue,1,51562,52138,576
2022-08-22,70040,70060,Blue,1,78263,79366,1103
2022-09-21,70051,70041,Blue,0,54125,54670,545
2022-01-31,70044,70048,Blue,1,35926,36303,377
2022-01-28,70049,70041,Blue,0,63127,63527,400
2022-10-03,70038,70060,Blue,1,74298,75397,1099
2022-01-04,70038,70058,Blue,1,59532,60591,1059
2022-12-15,70041,70838,Blue,0,55699,55812,113
2022-12-17,70040,70044,Blue,1,61069,61182,113
2022-01-16,70038,70060,Blue,1,49386,50502,1116
2022-01-02,70052,70054,Blue,1,36220,36268,48
2022-10-03,70049,70043,Blue,0,74937,75275,338
2022-10-17,70049,70041,Blue,0,64705,65116,411
2022-09-05,70045,70043,Blue,0,37702,37816,114
2022-10-04,70057,70039,Blue,0,70771,71678,907
2022-03-29,70044,70054,Blue,1,43755,44384,629
2022-02-07,70042,70058,Blue,1,47906,48834,928
2022-03-09,70054,70056,Blue,1,61517,61567,50
2022-07-10,70048,70054,Blue,1,76381,76729,348
2022-12-06,70043,70838,Blue,0,62189,62401,212
2022-09-23,70050,70054,Blue,1,27083,27298,215
2022-12-27,70043,70838,Blue,0,49052,49264,212
2022-04-12,70038,70054,Blue,1,74184,75012,828
2022-03-25,70051,70045,Blue,0,52674,53074,400
2022-03-08,70051,70045,Blue,0,26770,27136,366
2022-01-23,70044,70050,Blue,1,49593,49908,315
2022-09-22,70051,70041,Blue,0,73164,73806,642
2022-03-23,70038,70056,Blue,1,21848,22730,882
2022-01-18,70047,70041,Blue,0,67491,67821,330
2022-10-26,70042,70054,Blue,1,33229,33934,705
2022-08-18,70044,70046,Blue,1,43795,43913,118
2022-10-11,70056,70058,Blue,1,87392,87466,74
2022-02-16,70046,70060,Blue,1,58446,59209,763
2022-03-22,70052,70060,Blue,1,54967,55355,388
2022-03-26,70044,70052,Blue,1,67112,67622,510
2022-04-11,70038,70058,Blue,1,26057,27042,985
2022-03-08,70044,70048,Blue,1,77087,77317,230
2022-05-22,70038,70042,Blue,1,79717,79860,143
2022-10-18,70059,70045,Blue,0,70225,70902,677
2022-01-11,70039,70838,Blue,0,61900,61935,35
2022-09-14,70059,70047,Blue,0,63972,64542,570
2022-03-26,70038,70048,Blue,1,54503,54994,491
2022-07-25,70053,70049,Blue,0,25800,26014,214
2022-10-26,70045,70838,Blue,0,79022,79370,348
2022-10-25,70042,70052,Blue,1,70186,70742,556
2022-07-06,70050,70056,Blue,1,23918,24253,335
2022-12-08,70059,70049,Blue,0,44272,44726,454
2022-02-10,70038,70050,Blue,1,57271,57823,552
2022-09-19,70044,70052,Blue,1,53880,54356,476
2022-06-17,70053,70043,Blue,0,67447,68029,582
2022-04-16,70053,70838,Blue,0,55963,56853,890
2022-04-12,70057,70051,Blue,0,43930,44207,277
2022-07-03,70053,70047,Blue,0,36473,36768,295
2022-01-19,70059,70053,Blue,0,59602,59844,242
2022-03-15,70051,70838,Blue,0,59168,60020,852
2022-02-15,70051,70041,Blue,0,84988,85599,611
2022-12-10,70051,70049,Blue,0,37768,37869,101
2022-07-28,70052,70056,Blue,1,55072,55229,157
2022-10-10,70049,70039,Blue,0,43132,43634,502
2022-08-15,70048,70054,Blue,1,73728,74068,340
2022-02-22,70044,70052,Blue,1,54217,54679,462
2022-10-05,70053,70049,Blue,0,68950,69158,208
2022-11-16,70050,70058,Blue,1,47760,48178,418
2022-09-13,70042,70056,Blue,1,79536,80240,704
2022-01-08,70048,70050,Blue,1,84276,84335,59
2022-09-03,70047,70043,Blue,0,82178,82452,274
2022-06-19,70057,70041,Blue,0,47431,48305,874
2022-08-24,70043,70039,Blue,0,46328,46447,119
2022-09-26,70046,70048,Blue,1,35716,35800,84
2022-10-06,70050,70058,Blue,1,63090,63549,459
2022-12-22,70051,70838,Blue,0,56167,56926,759
2022-10-28,70044,70052,Blue,1,80951,81436,485
2022-01-06,70045,70838,Blue,0,23586,23964,378
2022-08-02,70042,70052,Blue,1,30108,30727,619
2022-02-23,70057,70838,Blue,0,61033,62203,1170
2022-11-15,70040,70052,Blue,1,64000,64670,670
2022-08-24,70057,70039,Blue,0,62642,63625,983
2022-09-30,70051,70045,Blue,0,38445,38843,398
2022-04-22,70048,70054,Blue,1,24449,24768,319
2022-03-05,70057,70055,Blue,0,56852,56921,69
2022-03-18,70040,70046,Blue,1,62077,62399,322
2022-06-14,70042,70058,Blue,1,23214,24122,908
2022-10-29,70051,70045,Blue,0,71179,71525,346
2022-11-09,70053,70045,Blue,0,79498,79888,390
2022-10-03,70049,70039,Blue,0,26095,26674,579
2022-07-17,70038,70048,Blue,1,60726,61214,488
2022-06-27,70047,70043,Blue,0,55222,55479,257
2022-12-05,70057,70041,Blue,0,47376,48233,857
2022-03-21,70049,70838,Blue,0,30496,31131,635
2022-02-14,70044,70060,Blue,1,20064,21030,966
2022-12-23,70045,70039,Blue,0,30644,30878,234
2022-10-11,70038,70044,Blue,1,62297,62510,213
2022-04-22,70059,70055,Blue,0,25191,25355,164
2022-02-11,70038,70048,Blue,1,83714,84203,489
2022-10-28,70052,70056,Blue,1,24387,24535,148
2022-09-13,70049,70047,Blue,0,44678,44739,61
2022-11-04,70042,70060,Blue,1,31321,33283,1962
2022-09-24,70047,70045,Blue,0,71939,72042,103
2022-03-12,70057,70045,Blue,0,63342,64020,678
2022-10-07,70052,70060,Blue,1,31870,32239,369
2022-08-18,70046,70060,Blue,1,72802,73612,810
2022-10-28,70055,70838,Blue,0,31603,32535,932
2022-08-23,70042,70054,Blue,1,47056,47841,785
2022-06-25,70040,70052,Blue,1,85842,86716,874
2022-11-18,70042,70060,Blue,1,25358,26274,916
2022-04-05,70052,70058,Blue,1,57289,57564,275
2022-07-03,70053,70045,Blue,0,74631,75050,419
2022-10-13,70059,70045,Blue,0,36371,37138,767
2022-06-24,70050,70060,Blue,1,40232,41000,768
2022-07-22,70038,70056,Blue,1,25213,26018,805
2022-11-11,70044,70058,Blue,1,29723,30507,784
2022-12-21,70050,70056,Blue,1,37261,37629,368
2022-12-15,70046,70058,Blue,1,21859,22576,717
2022-04-01,70042,70052,Blue,1,68501,69055,554
2022-01-20,70045,70041,Blue,0,72866,73088,222
2022-09-15,70051,70045,Blue,0,79865,80190,325
2022-03-24,70052,70054,Blue,1,55120,55178,58
2022-11-16,70059,70045,Blue,0,35946,36686,740
2022-07-12,70042,70048,Blue,1,52724,53064,340
2022-04-15,70057,70055,Blue,0,61181,61251,70
2022-07-29,70043,70039,Blue,0,54071,54180,109
2022-08-30,70059,70043,Blue,0,21598,22494,896
2022-06-25,70040,70048,Blue,1,52695,53172,477
2022-12-29,70044,70050,Blue,1,62012,62331,319
2022-04-05,70040,70046,Blue,1,30020,30289,269
2022-11-22,70055,70041,Blue,0,31914,32751,837
2022-12-01,70040,70056,Blue,1,81965,82779,814
2022-12-25,70040,70060,Blue,1,23834,25440,1606
2022-03-27,70052,70058,Blue,1,42315,42547,232
2022-04-04,70046,70052,Blue,1,84789,85170,381
2022-10-07,70048,70056,Blue,1,29742,30144,402
2022-07-06,70038,70050,Blue,1,68953,69560,607
2022-06-04,70047,70039,Blue,0,56235,56715,480
2022-06-09,70048,70052,Blue,1,39093,39353,260
2022-09-24,70055,70049,Blue,0,59666,59941,275
2022-02-23,70053,70043,Blue,0,24578,25138,560
2022-11-23,70040,70044,Blue,1,25285,25398,113
2022-02-23,70044,70046,Blue,1,28715,28828,113
2022-01-04,70050,70056,Blue,1,48681,49005,324
2022-04-11,70057,70051,Blue,0,22115,22360,245
2022-06-27,70038,70056,Blue,1,33851,34893,1042
2022-08-19,70054,70056,Blue,1,79978,80026,48
2022-05-08,70057,70053,Blue,0,23509,23658,149
2022-08-31,70040,70048,Blue,1,77909,78298,389
2022-10-15,70054,70060,Blue,1,32154,32405,251
2022-07-03,70048,70058,Blue,1,62936,63459,523
2022-10-19,70055,70838,Blue,0,80093,80937,844
2022-04-04,70053,70041,Blue,0,60452,61077,625
2022-01-12,70046,70060,Blue,1,69329,70070,741
2022-03-30,70053,70051,Blue,0,21959,22019,60
2022-07-23,70057,70047,Blue,0,87664,88156,492
2022-06-10,70046,70048,Blue,1,32735,32824,89
2022-11-25,70042,70060,Blue,1,32073,33054,981
2022-02-20,70048,70052,Blue,1,25805,25998,193
2022-02-10,70059,70051,Blue,0,50714,51052,338
2022-01-06,70043,70838,Blue,0,35283,35495,212
2022-06-17,70042,70048,Blue,1,64787,65131,344
2022-03-06,70054,70060,Blue,1,61577,61822,245
2022-12-23,70051,70049,Blue,0,49750,49860,110
2022-01-13,70044,70054,Blue,1,71654,72303,649
2022-08-30,70042,70054,Blue,1,55288,55908,620
2022-02-03,70048,70050,Blue,1,61426,61484,58
2022-12-12,70053,70039,Blue,0,73182,73906,724
2022-08-15,70038,70044,Blue,1,38434,38630,196
2022-05-21,70054,70060,Blue,1,51717,51980,263
2022-01-18,70059,70049,Blue,0,80059,80579,520
2022-01-11,70038,70048,Blue,1,36195,36658,463
2022-11-07,70040,70044,Blue,1,59543,59672,129
2022-03-30,70049,70045,Blue,0,64292,64514,222
2022-07-04,70057,70055,Blue,0,47666,47734,68
2022-02-26,70042,70048,Blue,1,29799,30152,353
2022-04-24,70048,70052,Blue,1,84229,84563,334
2022-11-18,70049,70043,Blue,0,35356,35706,350
2022-09-11,70057,70055,Blue,0,70122,70190,68
2022-10-25,70040,70046,Blue,1,65889,66145,256
2022-03-10,70043,70039,Blue,0,63786,63888,102
2022-12-26,70055,70047,Blue,0,72377,72809,432
2022-02-05,70041,70838,Blue,0,38287,38417,130
2022-03-17,70059,70041,Blue,0,29958,30941,983
2022-03-08,70055,70838,Blue,0,38308,39287,979
2022-07-02,70039,70838,Blue,0,26563,26597,34
2022-09-03,70050,70052,Blue,1,30188,30294,106
2022-04-01,70038,70042,Blue,1,67638,67754,116
2022-10-05,70040,70052,Blue,1,49277,50024,747
2022-03-10,70058,70060,Blue,1,29635,29699,64
2022-07-26,70040,70046,Blue,1,70339,70619,280
2022-08-08,70051,70039,Blue,0,39404,40064,660
2022-02-06,70057,70043,Blue,0,58234,59054,820
2022-08-13,70055,70047,Blue,0,72083,72447,364
2022-12-31,70038,70042,Blue,1,65946,66061,115
2022-09-29,70053,70039,Blue,0,72046,72813,767
2022-07-09,70044,70056,Blue,1,59640,60367,727
2022-12-13,70059,70057,Blue,0,78892,78926,34
2022-11-15,70057,70838,Blue,0,43349,44398,1049
2022-02-18,70044,70048,Blue,1,67835,68071,236
2022-02-16,70059,70049,Blue,0,43833,44368,535
2022-05-15,70055,70049,Blue,0,85426,85748,322
2022-03-29,70043,70838,Blue,0,80431,80657,226
2022-01-01,70048,70050,Blue,1,27327,27386,59
2022-04-21,70049,70045,Blue,0,66686,66887,201
2022-06-04,70040,70046,Blue,1,76531,76846,315
2022-04-24,70041,70039,Blue,0,61961,61995,34
2022-09-02,70042,70048,Blue,1,58819,59151,332
2022-07-25,70043,70041,Blue,0,48729,48757,28
2022-03-01,70050,70058,Blue,1,29896,30280,384
2022-06-15,70041,70838,Blue,0,55294,55412,118
2022-10-15,70055,70047,Blue,0,70466,70840,374
2022-08-22,70046,70052,Blue,1,67098,67424,326
2022-12-02,70044,70060,Blue,1,59863,60764,901
2022-08-29,70055,70045,Blue,0,56851,57361,510
2022-11-08,70051,70043,Blue,0,69409,69882,473
2022-03-27,70050,70052,Blue,1,39643,39759,116
2022-11-03,70057,70039,Blue,0,65608,66551,943
2022-08-27,70057,70053,Blue,0,61232,61387,155
2022-10-06,70046,70056,Blue,1,88648,89251,603
2022-12-25,70051,70041,Blue,0,35153,35704,551
2022-01-31,70038,70046,Blue,1,85395,85731,336
2022-09-02,70040,70044,Blue,1,71396,71504,108
2022-07-22,70057,70053,Blue,0,54635,54818,183
2022-09-01,70038,70058,Blue,1,23324,24306,982
2022-01-29,70050,70052,Blue,1,43950,44084,134
2022-04-22,70056,70058,Blue,1,44591,44666,75
2022-12-15,70043,70838,Blue,0,60872,61068,196
2022-04-21,70038,70042,Blue,1,28217,28322,105
2022-03-25,70040,70058,Blue,1,73568,74513,945
2022-08-31,70051,70039,Blue,0,71597,72224,627
2022-04-17,70040,70056,Blue,1,89175,90083,908
2022-06-29,70038,70052,Blue,1,66976,67876,900
2022-03-08,70057,70055,Blue,0,26162,26231,69
2022-02-11,70040,70054,Blue,1,85458,86145,687
2022-06-05,70043,70838,Blue,0,59353,59582,229
2022-01-02,70059,70045,Blue,0,73329,74042,713
2022-12-28,70045,70043,Blue,0,21808,21897,89
2022-03-14,70044,70060,Blue,1,70746,71601,855
2022-08-31,70043,70838,Blue,0,80726,80933,207
2022-01-11,70051,70049,Blue,0,53963,54066,103
2022-06-19,70053,70041,Blue,0,59280,60026,746
2022-08-05,70051,70047,Blue,0,73437,73655,218
2022-02-17,70042,70046,Blue,1,31310,31484,174
2022-08-29,70040,70050,Blue,1,31296,31810,514
2022-08-07,70040,70056,Blue,1,59727,60830,1103
2022-07-01,70059,70838,Blue,0,76508,77680,1172
2022-01-12,70053,70838,Blue,0,56852,57691,839
2022-08-10,70049,70043,Blue,0,52093,52480,387
2022-04-17,70058,70060,Blue,1,38099,38184,85
2022-08-17,70055,70043,Blue,0,70866,71488,622
2022-06-27,70057,70055,Blue,0,45928,46000,72
2022-02-01,70051,70838,Blue,0,49665,50469,804
2022-02-07,70053,70039,Blue,0,64706,65449,743
2022-07-08,70054,70058,Blue,1,51663,51823,160
2022-01-04,70051,70039,Blue,0,56094,56685,591
2022-12-31,70044,70048,Blue,1,75941,76156,215
2022-01-18,70057,70053,Blue,0,38220,38389,169
2022-10-19,70053,70043,Blue,0,64963,65523,560
2022-05-19,70040,70048,Blue,1,63532,63967,435
2022-08-10,70039,70838,Blue,0,40656,40688,32
2022-08-11,70040,70052,Blue,1,63520,64409,889
2022-01-09,70040,70054,Blue,1,79857,80657,800
2022-11-05,70048,70052,Blue,1,47444,47661,217
2022-08-06,70041,70039,Blue,0,87479,87514,35
2022-10-28,70057,70047,Blue,0,26576,27092,516
2022-04-05,70047,70041,Blue,0,60232,60618,386
2022-03-11,70053,70838,Blue,0,78042,78856,814
2022-01-14,70038,70058,Blue,1,83715,84772,1057
2022-01-07,70045,70838,Blue,0,66588,66910,322
2022-09-03,70047,70838,Blue,0,59524,60064,540
2022-06-12,70055,70049,Blue,0,31807,32077,270
2022-04-09,70040,70042,Blue,1,50798,50834,36
2022-08-02,70054,70058,Blue,1,42411,42562,151
2022-08-21,70038,70046,Blue,1,40993,41329,336
2022-01-17,70048,70050,Blue,1,54995,55052,57
2022-10-19,70056,70060,Blue,1,76810,77011,201
2022-06-13,70042,70060,Blue,1,83326,84394,1068
2022-11-19,70046,70058,Blue,1,21529,22177,648
2022-09-10,70038,70044,Blue,1,50178,50359,181
2022-11-03,70040,70060,Blue,1,45161,46223,1062
2022-08-16,70052,70058,Blue,1,83408,83677,269
2022-07-27,70040,70052,Blue,1,26536,27238,702
2022-01-17,70049,70043,Blue,0,81169,81513,344
2022-11-12,70054,70058,Blue,1,71181,71346,165
2022-05-20,70038,70060,Blue,1,75792,76993,1201
2022-04-18,70054,70058,Blue,1,37297,37452,155
2022-11-08,70038,70056,Blue,1,83428,84386,958
2022-04-03,70051,70043,Blue,0,70378,70860,482
2022-03-18,70038,70060,Blue,1,38506,39752,1246
2022-03-19,70038,70046,Blue,1,90165,91485,1320
2022-12-21,70042,70060,Blue,1,66889,67843,954
2022-06-09,70053,70051,Blue,0,66167,66231,64
2022-04-22,70059,70041,Blue,0,56296,57265,969
2022-12-30,70040,70048,Blue,1,61184,61544,360
2022-12-22,70055,70053,Blue,0,67871,67920,49
2022-08-02,70053,70043,Blue,0,51767,52360,593
2022-07-02,70044,70052,Blue,1,59623,60179,556
2022-12-27,70040,70060,Blue,1,87794,88796,1002
2022-10-19,70039,70838,Blue,0,53679,53745,66
2022-03-23,70038,70042,Blue,1,50299,50413,114
2022-09-28,70048,70058,Blue,1,83855,84377,522
2022-10-08,70044,70046,Blue,1,26563,26676,113
2022-06-08,70038,70048,Blue,1,48687,49218,531
2022-03-17,70038,70048,Blue,1,72432,72899,467
2022-06-24,70049,70043,Blue,0,74247,74636,389
2022-03-17,70049,70041,Blue,0,24498,24946,448
2022-07-06,70038,70050,Blue,1,36868,37455,587
2022-07-17,70047,70043,Blue,0,67426,67694,268
2022-04-13,70057,70043,Blue,0,32139,33011,872
2022-04-12,70055,70045,Blue,0,20773,21273,500
2022-03-07,70048,70050,Blue,1,33394,33448,54
2022-03-21,70038,70052,Blue,1,78552,79356,804
2022-12-04,70044,70060,Blue,1,45712,46675,963
2022-08-21,70051,70049,Blue,0,67808,67911,103
2022-09-08,70042,70052,Blue,1,45947,46529,582
2022-04-22,70054,70060,Blue,1,47769,48037,268
2022-01-25,70048,70058,Blue,1,25112,25639,527
2022-03-26,70047,70039,Blue,0,82904,83271,367
2022-07-02,70038,70060,Blue,1,47283,48479,1196
2022-03-06,70053,70041,Blue,0,65995,66650,655
2022-08-24,70053,70043,Blue,0,84261,84818,557
2022-11-10,70051,70049,Blue,0,54550,54651,101
2022-06-14,70051,70838,Blue,0,68213,68936,723
2022-03-12,70054,70060,Blue,1,35437,35719,282
2022-02-02,70057,70043,Blue,0,22193,23152,959
2022-01-09,70048,70050,Blue,1,24281,24343,62
2022-04-23,70057,70039,Blue,0,20919,21863,944
2022-02-14,70038,70048,Blue,1,51353,51851,498
2022-01-11,70052,70056,Blue,1,62160,62305,145
2022-02-22,70046,70056,Blue,1,79579,80136,557
2022-08-12,70051,70049,Blue,0,30948,31049,101
2022-11-01,70051,70041,Blue,0,21262,21910,648
2022-11-27,70046,70060,Blue,1,27252,27945,693
2022-03-28,70044,70056,Blue,1,21255,21946,691
2022-10-20,70053,70049,Blue,0,39333,39565,232
2022-09-03,70055,70043,Blue,0,27261,27917,656
2022-09-10,70057,70039,Blue,0,35255,36137,882
2022-03-27,70040,70048,Blue,1,70508,70859,351
2022-02-04,70057,70043,Blue,0,54020,54807,787
2022-04-23,70059,70043,Blue,0,36272,37122,850
2022-10-04,70053,70043,Blue,0,24980,25671,691
2022-03-24,70055,70049,Blue,0,56477,56758,281
2022-01-02,70038,70040,Blue,1,67811,67825,14
2022-08-10,70052,70054,Blue,1,68277,68338,61
2022-09-08,70059,70039,Blue,0,24254,25308,1054
2022-03-11,70057,70049,Blue,0,31567,31960,393
2022-01-26,70038,70050,Blue,1,32067,32632,565
2022-07-18,70038,70052,Blue,1,24537,25291,754
2022-07-18,70040,70054,Blue,1,25263,25948,685
2022-03-09,70055,70049,Blue,0,76211,76537,326
2022-10-02,70046,70058,Blue,1,29603,30278,675
2022-08-05,70055,70041,Blue,0,66731,67654,923
2022-09-06,70038,70048,Blue,1,34927,35361,434
2022-03-05,70049,70045,Blue,0,49183,49394,211
2022-12-12,70059,70051,Blue,0,45736,46057,321
2022-03-09,70057,70045,Blue,0,27637,28338,701
2022-04-07,70042,70050,Blue,1,19995,20462,467
2022-01-20,70038,70050,Blue,1,27576,28153,577
2022-06-04,70040,70044,Blue,1,56137,56248,111
2022-03-14,70053,70043,Blue,0,32961,33535,574
2022-01-17,70049,70838,Blue,0,32972,33555,583
2022-04-22,70051,70043,Blue,0,44692,45175,483
2022-04-22,70059,70043,Blue,0,50716,51554,838
2022-01-25,70052,70058,Blue,1,44326,44582,256
2022-08-30,70050,70058,Blue,1,65975,66366,391
2022-02-07,70047,70043,Blue,0,50449,50742,293
2022-10-15,70045,70041,Blue,0,71048,71275,227
2022-11-23,70038,70060,Blue,1,81908,83075,1167
2022-08-25,70051,70041,Blue,0,27638,28307,669
2022-12-13,70040,70058,Blue,1,86587,87485,898
2022-01-23,70059,70045,Blue,0,53296,53978,682
2022-09-27,70055,70043,Blue,0,82482,83118,636
2022-05-21,70053,70047,Blue,0,48933,49207,274
2022-01-06,70057,70049,Blue,0,29757,30231,474
2022-04-10,70052,70054,Blue,1,25376,25428,52
2022-02-27,70057,70047,Blue,0,56066,56541,475
2022-06-09,70059,70045,Blue,0,19162,19940,778
2022-07-06,70044,70060,Blue,1,67097,68051,954
2022-11-17,70045,70041,Blue,0,62400,62570,170
2022-01-26,70046,70050,Blue,1,39264,39465,201
2022-06-22,70040,70054,Blue,1,31635,32510,875
2022-03-29,70052,70060,Blue,1,53312,53711,399
2022-05-25,70040,70046,Blue,1,33027,33294,267
2022-04-05,70053,70045,Blue,0,33861,34368,507
2022-02-08,70051,70039,Blue,0,51556,52367,811
2022-01-07,70038,70044,Blue,1,59230,59391,161
2022-09-02,70055,70043,Blue,0,29918,30651,733
2022-08-18,70051,70045,Blue,0,66642,66987,345
2022-05-19,70055,70045,Blue,0,66681,67312,631
2022-05-23,70050,70052,Blue,1,77577,77779,202
2022-08-14,70059,70057,Blue,0,63019,63053,34
2022-11-22,70043,70838,Blue,0,21211,21406,195
2022-01-15,70051,70047,Blue,0,64836,65054,218
2022-05-20,70040,70044,Blue,1,55208,55326,118
2022-10-15,70057,70051,Blue,0,37948,38186,238
2022-03-16,70047,70039,Blue,0,86945,87379,434
2022-05-06,70059,70049,Blue,0,58936,59396,460
2022-03-01,70055,70047,Blue,0,38332,38759,427
2022-09-15,70045,70043,Blue,0,37856,37947,91
2022-04-14,70049,70047,Blue,0,24510,24573,63
2022-02-27,70051,70049,Blue,0,52598,52701,103
2022-06-19,70040,70046,Blue,1,51629,51883,254
2022-04-22,70057,70039,Blue,0,33709,34754,1045
2022-07-18,70059,70045,Blue,0,21574,22322,748
2022-07-16,70040,70056,Blue,1,26347,27237,890
2022-10-18,70056,70060,Blue,1,38393,38600,207
2022-07-19,70055,70047,Blue,0,60493,60903,410
2022-11-27,70047,70043,Blue,0,62027,62261,234
2022-09-23,70053,70045,Blue,0,66814,67249,435
2022-10-10,70055,70049,Blue,0,66453,66749,296
2022-08-03,70054,70060,Blue,1,51274,51540,266
2022-02-02,70059,70039,Blue,0,28750,29771,1021
2022-04-17,70051,70047,Blue,0,29645,29832,187
2022-09-22,70054,70056,Blue,1,72938,72985,47
2022-04-24,70057,70041,Blue,0,61475,62370,895
2022-10-28,70047,70045,Blue,0,24480,24590,110
2022-08-13,70050,70058,Blue,1,72425,72891,466
2022-11-23,70048,70050,Blue,1,36775,36835,60
2022-08-06,70049,70039,Blue,0,59465,60011,546
2022-03-16,70050,70054,Blue,1,21238,21509,271
2022-11-03,70055,70838,Blue,0,55403,56393,990
2022-04-05,70048,70056,Blue,1,33755,34177,422
2022-07-24,70038,70054,Blue,1,58574,59423,849
2022-10-24,70043,70041,Blue,0,29063,29092,29
2022-06-12,70049,70045,Blue,0,63025,63221,196
2022-12-07,70038,70052,Blue,1,23532,24228,696
2022-10-19,70044,70048,Blue,1,79257,79483,226
2022-12-23,70050,70056,Blue,1,72674,73025,351
2022-10-04,70052,70054,Blue,1,43594,43660,66
2022-09-02,70042,70054,Blue,1,30823,31509,686
2022-01-13,70057,70051,Blue,0,29133,29422,289
2022-02-08,70040,70060,Blue,1,73577,74608,1031
2022-11-14,70044,70054,Blue,1,59880,60471,591
2022-11-26,70042,70054,Blue,1,21258,21958,700
2022-10-24,70048,70050,Blue,1,78382,78438,56
2022-12-20,70057,70045,Blue,0,53860,54491,631
2022-09-24,70048,70052,Blue,1,86133,86347,214
2022-07-30,70046,70050,Blue,1,56552,56741,189
2022-06-13,70044,70056,Blue,1,56165,57101,936
2022-01-22,70041,70039,Blue,0,51883,51917,34
2022-02-19,70040,70058,Blue,1,29182,30152,970
2022-08-13,70048,70052,Blue,1,72329,72538,209
2022-03-09,70048,70054,Blue,1,25072,25362,290
2022-03-21,70042,70056,Blue,1,55923,56686,763
2022-04-09,70050,70054,Blue,1,35091,35290,199
2022-04-22,70051,70041,Blue,0,84347,84877,530
2022-02-18,70038,70050,Blue,1,24725,25366,641
2022-08-15,70043,70838,Blue,0,57852,58052,200
2022-10-26,70059,70051,Blue,0,49486,49850,364
2022-12-27,70041,70838,Blue,0,32403,32525,122
2022-04-01,70053,70039,Blue,0,46388,47149,761
2022-07-12,70051,70049,Blue,0,35310,35417,107
2022-04-18,70051,70047,Blue,0,31210,31398,188
2022-08-25,70053,70838,Blue,0,63708,64561,853
2022-10-31,70043,70838,Blue,0,55534,55733,199
2022-07-11,70044,70048,Blue,1,32259,32537,278
2022-06-20,70044,70046,Blue,1,62298,62429,131
2022-06-09,70040,70050,Blue,1,55122,55686,564
2022-12-06,70039,70838,Blue,0,57719,57753,34
2022-01-24,70059,70051,Blue,0,87055,87397,342
2022-01-26,70044,70056,Blue,1,81245,82016,771
2022-08-31,70053,70041,Blue,0,77753,78423,670
2022-06-26,70055,70039,Blue,0,42332,43230,898
2022-10-22,70059,70043,Blue,0,24135,25017,882
2022-09-04,70050,70052,Blue,1,53232,53345,113
2022-09-27,70045,70039,Blue,0,81983,82235,252
2022-08-06,70048,70056,Blue,1,57722,58115,393
2022-08-18,70043,70041,Blue,0,89006,89034,28
2022-04-28,70052,70056,Blue,1,86325,86465,140
2022-08-31,70049,70041,Blue,0,86047,86451,404
2022-11-25,70046,70048,Blue,1,28509,28594,85
2022-10-03,70042,70046,Blue,1,40143,40320,177
2022-07-25,70050,70058,Blue,1,44923,45371,448
2022-12-21,70054,70056,Blue,1,27695,27749,54
2022-01-19,70038,70040,Blue,1,49760,49773,13
2022-12-10,70055,70049,Blue,0,53187,53468,281
2022-01-23,70055,70838,Blue,0,45614,46545,931
2022-03-11,70044,70054,Blue,1,26263,26823,560
2022-01-27,70047,70041,Blue,0,31522,31888,366
2022-03-05,70039,70838,Blue,0,53024,53058,34
2022-09-26,70047,70041,Blue,0,32106,32438,332
2022-02-05,70049,70838,Blue,0,56805,57412,607
2022-01-12,70059,70049,Blue,0,59294,59782,488
2022-02-07,70046,70060,Blue,1,23196,24086,890
2022-04-29,70051,70047,Blue,0,48076,48295,219
2022-10-02,70046,70060,Blue,1,51932,52686,754
2022-03-05,70042,70044,Blue,1,21845,21874,29
2022-08-07,70038,70040,Blue,1,74769,74785,16
2022-09-27,70040,70046,Blue,1,39036,39278,242
2022-10-19,70055,70045,Blue,0,57201,57732,531
2022-11-23,70059,70039,Blue,0,66564,67534,970
2022-01-08,70050,70058,Blue,1,86156,86560,404
2022-11-07,70058,70060,Blue,1,29379,29461,82
2022-06-13,70040,70048,Blue,1,37951,38391,440
2022-09-11,70042,70046,Blue,1,56036,56215,179
2022-07-01,70051,70043,Blue,0,40552,41079,527
2022-07-28,70046,70050,Blue,1,57522,57711,189
2022-12-15,70046,70056,Blue,1,57466,58009,543
2022-06-14,70048,70054,Blue,1,36991,37329,338
2022-09-19,70038,70052,Blue,1,23135,23831,696
2022-11-26,70054,70056,Blue,1,32037,32083,46
2022-10-22,70054,70056,Blue,1,72722,72769,47
2022-10-08,70040,70058,Blue,1,40514,41448,934
2022-04-21,70052,70058,Blue,1,27954,28213,259
2022-10-23,70055,70039,Blue,0,34165,34999,834
2022-07-01,70052,70058,Blue,1,48717,48978,261
2022-10-06,70059,70055,Blue,0,76936,77079,143
2022-01-27,70040,70054,Blue,1,82903,83622,719
2022-02-04,70042,70056,Blue,1,50430,51285,855
2022-01-10,70044,70048,Blue,1,57492,57746,254
2022-09-20,70046,70058,Blue,1,67802,68439,637
2022-01-24,70059,70053,Blue,0,78905,79139,234
2022-04-10,70049,70041,Blue,0,37358,37783,425
2022-03-05,70059,70051,Blue,0,28153,28470,317
2022-06-14,70053,70049,Blue,0,19914,20114,200
2022-10-22,70046,70060,Blue,1,50593,51340,747
2022-01-19,70053,70041,Blue,0,21639,22510,871
2022-06-11,70059,70053,Blue,0,42743,43006,263
2022-09-01,70049,70047,Blue,0,68053,68107,54
2022-03-15,70052,70060,Blue,1,27966,28322,356
2022-01-23,70055,70047,Blue,0,65344,65714,370
2022-11-15,70057,70055,Blue,0,58332,58401,69
2022-08-31,70048,70050,Blue,1,51053,51108,55
2022-12-08,70047,70045,Blue,0,24879,24976,97
2022-10-23,70059,70039,Blue,0,78921,80101,1180
2022-10-10,70045,70039,Blue,0,30541,30819,278
2022-08-06,70054,70056,Blue,1,37499,37545,46
2022-09-07,70038,70052,Blue,1,45797,46570,773
2022-07-19,70048,70056,Blue,1,77291,77672,381
2022-06-10,70046,70060,Blue,1,63546,64516,970
2022-11-01,70059,70051,Blue,0,39021,39358,337
2022-01-31,70059,70047,Blue,0,56896,57500,604
2022-08-13,70057,70838,Blue,0,34184,35193,1009
2022-11-17,70049,70045,Blue,0,28060,28260,200
2022-03-10,70046,70058,Blue,1,75563,76192,629
2022-06-10,70041,70838,Blue,0,34099,34215,116
2022-10-07,70042,70046,Blue,1,21319,21492,173
2022-07-16,70059,70049,Blue,0,25992,26445,453
2022-12-23,70053,70047,Blue,0,81002,81345,343
2022-05-18,70040,70046,Blue,1,53753,54052,299
2022-11-29,70053,70039,Blue,0,29925,30787,862
2022-03-29,70042,70046,Blue,1,57869,58038,169
2022-12-27,70048,70058,Blue,1,37168,37647,479
2022-09-14,70045,70043,Blue,0,38211,38309,98
2022-10-11,70042,70054,Blue,1,44948,45608,660
2022-08-25,70040,70050,Blue,1,73705,74199,494
2022-09-17,70038,70044,Blue,1,42617,42797,180
2022-12-09,70038,70050,Blue,1,61580,62210,630
2022-12-30,70045,70838,Blue,0,39913,40254,341
2022-05-07,70054,70060,Blue,1,72758,73016,258
2022-03-12,70046,70052,Blue,1,34912,35291,379
2022-07-28,70057,70039,Blue,0,23074,23954,880
2022-07-23,70055,70039,Blue,0,58050,58949,899
2022-11-02,70053,70049,Blue,0,42981,43219,238
2022-01-19,70044,70050,Blue,1,82955,83381,426
2022-10-12,70049,70047,Blue,0,32754,32810,56
2022-06-12,70048,70052,Blue,1,33571,33766,195
2022-08-24,70050,70052,Blue,1,39500,39630,130
2022-02-14,70042,70060,Blue,1,50440,51396,956
2022-06-13,70056,70060,Blue,1,26652,26896,244
2022-04-18,70046,70052,Blue,1,61270,61631,361
2022-04-22,70059,70051,Blue,0,19541,19863,322
2022-09-14,70058,70060,Blue,1,40893,41009,116
2022-06-23,70039,70838,Blue,0,61936,62042,106
2022-09-26,70051,70047,Blue,0,27187,27456,269
2022-04-18,70046,70050,Blue,1,45745,45937,192
2022-04-17,70038,70052,Blue,1,33906,34575,669
2022-03-21,70046,70054,Blue,1,79660,80224,564
2022-03-04,70045,70043,Blue,0,88243,88335,92
2022-08-22,70042,70060,Blue,1,64263,65276,1013
2022-09-10,70052,70058,Blue,1,70961,71223,262
2022-03-05,70044,70046,Blue,1,46084,46184,100
2022-09-09,70046,70050,Blue,1,40915,41114,199
2022-06-14,70038,70054,Blue,1,42164,43081,917
2022-03-07,70059,70043,Blue,0,59482,60332,850
2022-12-20,70051,70043,Blue,0,43998,44468,470
2022-11-25,70051,70041,Blue,0,41767,42360,593
2022-07-09,70042,70056,Blue,1,34195,34956,761
2022-09-15,70059,70047,Blue,0,87470,88044,574
2022-09-19,70045,70041,Blue,0,43460,43650,190
2022-03-10,70055,70049,Blue,0,22660,22986,326
2022-01-31,70048,70052,Blue,1,53565,53848,283
2022-02-27,70046,70058,Blue,1,34285,34908,623
2022-01-29,70050,70056,Blue,1,69569,70469,900
2022-09-12,70047,70838,Blue,0,55966,56478,512
2022-03-01,70042,70046,Blue,1,60160,60339,179
2022-09-18,70054,70060,Blue,1,35466,35707,241
2022-09-16,70044,70050,Blue,1,65814,66514,700
2022-10-18,70050,70060,Blue,1,41567,42152,585
2022-02-28,70042,70052,Blue,1,31535,32163,628
2022-06-03,70042,70050,Blue,1,61935,62406,471
2022-09-17,70038,70056,Blue,1,59346,60241,895
2022-08-02,70049,70838,Blue,0,60941,61714,773
2022-09-29,70039,70838,Blue,0,27699,27737,38
2022-11-28,70049,70043,Blue,0,21407,21777,370
2022-12-16,70055,70045,Blue,0,42339,42940,601
2022-04-15,70057,70043,Blue,0,85224,86005,781
2022-02-28,70044,70046,Blue,1,55246,55349,103
2022-06-21,70044,70046,Blue,1,84383,84509,126
2022-04-06,70040,70048,Blue,1,20447,20862,415
2022-09-04,70059,70049,Blue,0,55997,56461,464
2022-08-08,70054,70058,Blue,1,29049,29202,153
2022-06-18,70043,70039,Blue,0,57682,57785,103
2022-08-14,70053,70039,Blue,0,24101,24887,786
2022-01-09,70052,70056,Blue,1,54504,54632,128
2022-10-06,70050,70054,Blue,1,25251,25488,237
2022-04-05,70055,70053,Blue,0,36553,36598,45
2022-07-11,70040,70042,Blue,1,23805,23843,38
2022-09-27,70052,70058,Blue,1,37303,37562,259
2022-03-03,70040,70060,Blue,1,51979,53138,1159
2022-06-14,70038,70060,Blue,1,42499,43781,1282
2022-08-10,70055,70043,Blue,0,85381,86062,681
2022-02-05,70059,70045,Blue,0,25222,25947,725
2022-03-12,70053,70049,Blue,0,56524,56724,200
2022-05-27,70040,70052,Blue,1,43363,44223,860
2022-01-10,70054,70058,Blue,1,77234,77385,151
2022-10-15,70059,70047,Blue,0,46512,47048,536
2022-12-10,70041,70039,Blue,0,45888,45923,35
2022-07-11,70052,70054,Blue,1,57840,57909,69
2022-02-20,70040,70060,Blue,1,39741,40743,1002
2022-01-07,70059,70055,Blue,0,67154,67302,148
2022-04-24,70047,70045,Blue,0,28411,28530,119
2022-10-25,70047,70043,Blue,0,28294,28547,253
2022-01-06,70046,70052,Blue,1,67434,67780,346
2022-02-06,70051,70045,Blue,0,35129,35457,328
2022-02-24,70040,70052,Blue,1,34234,34971,737
2022-03-08,70046,70060,Blue,1,62881,63741,860
2022-06-08,70045,70043,Blue,0,25329,25445,116
2022-02-17,70051,70045,Blue,0,57602,58029,427
2022-11-05,70053,70045,Blue,0,63546,63989,443
2022-04-03,70042,70046,Blue,1,26252,26423,171
2022-08-01,70049,70039,Blue,0,55859,56392,533
2022-08-01,70050,70060,Blue,1,43011,43556,545
2022-09-16,70055,70049,Blue,0,21780,22083,303
2022-03-03,70038,70044,Blue,1,61935,62125,190
2022-10-17,70059,70055,Blue,0,36387,36532,145
2022-05-29,70048,70050,Blue,1,50734,50791,57
2022-03-29,70059,70039,Blue,0,33587,34766,1179
2022-09-27,70057,70053,Blue,0,82796,82953,157
2022-03-19,70044,70058,Blue,1,60632,61389,757
2022-03-24,70044,70046,Blue,1,71785,71888,103
2022-11-17,70040,70044,Blue,1,47719,47829,110
2022-03-25,70038,70058,Blue,1,65855,66986,1131
2022-12-28,70040,70056,Blue,1,32226,33015,789
2022-12-08,70038,70058,Blue,1,34036,35191,1155
2022-06-25,70044,70048,Blue,1,41432,41711,279
2022-03-09,70038,70046,Blue,1,57734,58090,356
2022-03-25,70040,70050,Blue,1,23709,24183,474
2022-08-20,70038,70058,Blue,1,31268,32446,1178
2022-04-04,70057,70053,Blue,0,33674,33830,156
2022-01-16,70038,70042,Blue,1,55403,55513,110
2022-09-21,70046,70060,Blue,1,20325,21159,834
2022-02-16,70059,70049,Blue,0,23925,24376,451
2022-01-13,70055,70049,Blue,0,25638,25966,328
2022-07-27,70042,70054,Blue,1,55000,55763,763
2022-02-24,70053,70049,Blue,0,75772,75963,191
2022-04-11,70053,70043,Blue,0,51457,52042,585
2022-02-02,70057,70039,Blue,0,58774,59826,1052
2022-01-25,70040,70060,Blue,1,72702,73776,1074
2022-09-07,70042,70056,Blue,1,57886,58702,816
2022-06-27,70057,70045,Blue,0,52138,52793,655
2022-05-18,70040,70052,Blue,1,64794,65789,995
2022-03-08,70055,70039,Blue,0,53776,54624,848
2022-01-07,70047,70039,Blue,0,24286,24870,584
2022-09-08,70041,70838,Blue,0,29486,29613,127
2022-12-09,70056,70060,Blue,1,78783,78983,200
2022-09-25,70038,70048,Blue,1,43003,43452,449
2022-07-05,70053,70041,Blue,0,59054,59740,686
2022-12-19,70054,70060,Blue,1,23761,24046,285
2022-10-15,70048,70052,Blue,1,22861,23215,354
2022-08-07,70050,70060,Blue,1,45492,45984,492
2022-03-13,70051,70043,Blue,0,50932,51444,512
2022-02-06,70054,70060,Blue,1,67635,67903,268
2022-01-26,70057,70041,Blue,0,23137,24180,1043
2022-04-06,70049,70043,Blue,0,71470,71852,382
2022-01-12,70039,70838,Blue,0,71463,71497,34
2022-12-31,70053,70051,Blue,0,90039,90090,51
2022-07-17,70050,70058,Blue,1,56472,56885,413
2022-03-01,70059,70838,Blue,0,25172,26386,1214
2022-04-16,70059,70045,Blue,0,34097,34830,733
2022-06-22,70057,70838,Blue,0,62616,63808,1192
2022-06-25,70057,70055,Blue,0,70668,70738,70
2022-10-25,70041,70039,Blue,0,57163,57191,28
2022-08-11,70053,70043,Blue,0,76708,77266,558
2022-11-19,70046,70050,Blue,1,24000,24173,173
2022-10-13,70057,70041,Blue,0,35231,36128,897
2022-01-18,70044,70056,Blue,1,61568,62353,785
2022-04-09,70052,70060,Blue,1,42406,42789,383
2022-02-12,70040,70060,Blue,1,86499,87611,1112
2022-12-02,70048,70050,Blue,1,74656,74715,59
2022-07-15,70048,70056,Blue,1,26581,27019,438
2022-12-21,70057,70053,Blue,0,52912,53065,153
2022-01-28,70052,70060,Blue,1,64743,65248,505
2022-09-06,70038,70046,Blue,1,46095,46462,367
2022-08-06,70044,70050,Blue,1,24524,24870,346
2022-03-27,70042,70058,Blue,1,47385,48271,886
2022-09-25,70053,70051,Blue,0,46000,46057,57
2022-06-17,70046,70056,Blue,1,52161,52722,561
2022-12-28,70048,70058,Blue,1,39101,39780,679
2022-02-18,70050,70052,Blue,1,64253,64371,118
2022-06-16,70038,70042,Blue,1,48676,48769,93
2022-12-04,70055,70053,Blue,0,34179,34226,47
2022-08-04,70059,70045,Blue,0,20426,21140,714
2022-11-10,70055,70051,Blue,0,26080,26224,144
2022-02-27,70040,70054,Blue,1,73227,74010,783
2022-09-16,70053,70039,Blue,0,47086,47833,747
2022-05-20,70040,70056,Blue,1,33606,34600,994
2022-03-30,70040,70056,Blue,1,25540,26414,874
2022-06-13,70044,70046,Blue,1,28375,28510,135
2022-03-27,70042,70060,Blue,1,67895,68870,975
2022-11-08,70052,70054,Blue,1,60204,60251,47
2022-01-16,70047,70039,Blue,0,71256,71675,419
2022-09-14,70044,70046,Blue,1,53909,54012,103
2022-09-25,70053,70043,Blue,0,63604,64216,612
2022-08-22,70051,70047,Blue,0,52502,52700,198
2022-01-31,70048,70060,Blue,1,79080,79719,639
2022-04-03,70040,70054,Blue,1,53792,54581,789
2022-04-05,70051,70049,Blue,0,49084,49193,109
2022-09-26,70051,70838,Blue,0,41456,42259,803
2022-08-10,70051,70045,Blue,0,23379,23721,342
2022-01-24,70053,70041,Blue,0,63199,63886,687
2022-01-04,70057,70045,Blue,0,62380,63020,640
2022-06-25,70057,70043,Blue,0,40728,41533,805
2022-01-01,70050,70056,Blue,1,87966,88279,313
2022-09-03,70050,70052,Blue,1,29167,29290,123
2022-11-08,70055,70045,Blue,0,73998,74502,504
2022-01-26,70038,70046,Blue,1,70261,70768,507
2022-09-27,70052,70058,Blue,1,41278,41535,257
2022-10-15,70055,70045,Blue,0,67225,67756,531
2022-09-06,70039,70838,Blue,0,39687,39723,36
2022-12-29,70051,70047,Blue,0,55084,55286,202
2022-05-19,70059,70053,Blue,0,60247,60461,214
2022-08-15,70046,70048,Blue,1,26529,26618,89
2022-07-23,70045,70043,Blue,0,33365,33454,89
2022-03-31,70055,70043,Blue,0,59786,60433,647
2022-09-16,70053,70838,Blue,0,77750,78616,866
2022-11-12,70044,70052,Blue,1,59101,59620,519
2022-11-19,70056,70060,Blue,1,64304,64491,187
2022-06-17,70046,70050,Blue,1,52396,52599,203
2022-01-12,70050,70052,Blue,1,51460,51577,117
2022-02-19,70059,70047,Blue,0,46510,47158,648
2022-07-16,70057,70055,Blue,0,64439,64509,70
2022-02-07,70057,70055,Blue,0,78978,79046,68
2022-03-04,70050,70052,Blue,1,28535,28662,127
2022-01-19,70057,70838,Blue,0,71610,72775,1165
2022-12-15,70050,70052,Blue,1,84140,84265,125
2022-09-26,70041,70838,Blue,0,32847,32973,126
2022-02-09,70052,70054,Blue,1,58174,58219,45
2022-01-23,70059,70053,Blue,0,31633,31868,235
2022-10-01,70055,70053,Blue,0,44002,44047,45
2022-03-01,70049,70047,Blue,0,62394,62448,54
2022-03-01,70054,70060,Blue,1,61312,62082,770
2022-07-20,70040,70046,Blue,1,40337,40624,287
2022-08-20,70052,70054,Blue,1,79375,79457,82
2022-02-13,70045,70043,Blue,0,56234,56355,121
2022-04-04,70040,70050,Blue,1,44160,44675,515
2022-06-26,70044,70052,Blue,1,63663,64252,589
2022-08-12,70053,70045,Blue,0,20714,21138,424
2022-12-20,70046,70048,Blue,1,64183,64257,74
2022-01-24,70054,70056,Blue,1,29089,29136,47
2022-12-08,70055,70045,Blue,0,43463,44070,607
2022-03-06,70040,70052,Blue,1,33978,34589,611
2022-04-14,70049,70043,Blue,0,29097,29508,411
2022-12-17,70049,70039,Blue,0,64319,64806,487
2022-09-22,70045,70041,Blue,0,28698,28881,183
2022-03-05,70052,70054,Blue,1,60193,60248,55
2022-04-17,70038,70058,Blue,1,58033,59124,1091
2022-02-24,70050,70054,Blue,1,69553,69784,231
2022-01-19,70056,70058,Blue,1,77304,77374,70
2022-11-28,70049,70838,Blue,0,83658,84259,601
2022-08-12,70044,70052,Blue,1,36951,37448,497
2022-08-09,70038,70044,Blue,1,39510,39700,190
2022-10-04,70049,70041,Blue,0,37661,38174,513
2022-02-12,70055,70047,Blue,0,83388,83823,435
2022-11-07,70044,70056,Blue,1,76948,77586,638
2022-01-23,70038,70054,Blue,1,41031,41878,847
2022-04-15,70059,70055,Blue,0,88117,88253,136
2022-08-01,70046,70058,Blue,1,22691,23409,718
2022-04-14,70051,70047,Blue,0,45901,46133,232
2022-04-11,70040,70056,Blue,1,19909,20846,937
2022-03-10,70049,70041,Blue,0,79932,80399,467
2022-07-09,70045,70039,Blue,0,19211,19489,278
2022-04-04,70059,70045,Blue,0,28449,29198,749
2022-09-12,70057,70838,Blue,0,38633,39634,1001
2022-02-04,70040,70052,Blue,1,83823,84493,670
2022-10-11,70059,70049,Blue,0,58213,58675,462
2022-04-11,70045,70838,Blue,0,34666,35067,401
2022-04-13,70050,70060,Blue,1,86771,87304,533
2022-10-22,70041,70838,Blue,0,50201,50338,137
2022-01-19,70046,70052,Blue,1,64416,64772,356
2022-10-16,70050,70060,Blue,1,40232,40695,463
2022-09-06,70057,70051,Blue,0,80718,81058,340
2022-01-04,70057,70043,Blue,0,78990,79862,872
2022-09-06,70053,70041,Blue,0,83872,84488,616
2022-06-15,70059,70045,Blue,0,32953,33667,714
2022-09-22,70055,70049,Blue,0,66743,67031,288
2022-04-15,70053,70051,Blue,0,35034,35097,63
2022-11-03,70046,70060,Blue,1,24002,24770,768
2022-01-12,70038,70052,Blue,1,37521,38221,700
2022-02-24,70053,70051,Blue,0,24858,24917,59
2022-09-14,70038,70050,Blue,1,22236,22756,520
2022-11-10,70049,70039,Blue,0,31816,32378,562
2022-01-24,70054,70058,Blue,1,30266,30428,162
2022-08-09,70038,70042,Blue,1,35773,35859,86
2022-09-05,70042,70050,Blue,1,34838,35243,405
2022-06-20,70047,70043,Blue,0,84447,84751,304
2022-02-28,70051,70045,Blue,0,19927,20305,378
2022-06-05,70040,70048,Blue,1,77188,77651,463
2022-08-27,70041,70838,Blue,0,68045,68161,116
2022-10-31,70042,70058,Blue,1,43684,44592,908
2022-12-26,70051,70039,Blue,0,56911,57550,639
2022-07-13,70056,70058,Blue,1,70400,70469,69
2022-11-16,70046,70058,Blue,1,67758,68452,694
2022-06-10,70038,70042,Blue,1,84926,85039,113
2022-02-20,70040,70058,Blue,1,50005,51008,1003
2022-09-18,70040,70042,Blue,1,76465,76498,33
2022-01-02,70053,70049,Blue,0,52055,52283,228
2022-12-29,70056,70060,Blue,1,61945,62149,204
2022-02-12,70038,70058,Blue,1,21668,22573,905
2022-11-06,70059,70039,Blue,0,78915,79962,1047
2022-02-03,70057,70045,Blue,0,32738,33405,667
2022-06-16,70051,70049,Blue,0,48583,48685,102
2022-11-16,70050,70060,Blue,1,22036,22665,629
2022-04-14,70055,70053,Blue,0,32291,32352,61
2022-04-22,70042,70060,Blue,1,30663,31816,1153
2022-03-28,70055,70041,Blue,0,65773,66483,710
2022-09-18,70038,70056,Blue,1,52086,53036,950
2022-11-08,70040,70044,Blue,1,45310,45424,114
2022-04-17,70038,70060,Blue,1,25321,26467,1146
2022-11-01,70046,70052,Blue,1,45097,45437,340
2022-12-09,70055,70049,Blue,0,50587,50856,269
2022-10-05,70042,70056,Blue,1,22365,23107,742
2022-04-19,70046,70056,Blue,1,29400,29961,561
2022-08-10,70057,70053,Blue,0,79957,80105,148
2022-10-11,70052,70058,Blue,1,47451,47715,264
2022-07-20,70042,70060,Blue,1,22050,23001,951
2022-06-30,70055,70039,Blue,0,21038,21977,939
2022-01-31,70038,70050,Blue,1,56935,57574,639
2022-08-15,70042,70048,Blue,1,21719,22014,295
2022-02-03,70046,70054,Blue,1,28561,29004,443
2022-09-24,70053,70049,Blue,0,47848,48066,218
2022-10-16,70040,70048,Blue,1,37752,38139,387
2022-10-14,70045,70838,Blue,0,44930,45286,356
2022-12-14,70059,70049,Blue,0,64457,64937,480
2022-12-10,70048,70060,Blue,1,85183,85801,618
2022-08-18,70057,70041,Blue,0,51089,52023,934
2022-02-03,70055,70041,Blue,0,72252,73011,759
2022-10-16,70051,70047,Blue,0,67708,67896,188
2022-11-19,70059,70041,Blue,0,30858,31801,943
2022-10-05,70051,70043,Blue,0,50754,51251,497
2022-11-29,70046,70050,Blue,1,66776,66954,178
2022-01-07,70046,70060,Blue,1,49756,50526,770
2022-11-30,70049,70047,Blue,0,81606,81660,54
2022-08-08,70044,70046,Blue,1,64026,64131,105
2022-03-26,70044,70052,Blue,1,38496,38980,484
2022-12-19,70059,70053,Blue,0,67275,67504,229
2022-04-17,70052,70054,Blue,1,51790,51845,55
2022-02-27,70055,70049,Blue,0,42356,42636,280
2022-02-06,70053,70047,Blue,0,55807,56081,274
2022-07-25,70055,70039,Blue,0,57804,58654,850
2022-02-09,70045,70039,Blue,0,63981,64275,294
2022-02-25,70047,70039,Blue,0,61124,61544,420
2022-06-15,70040,70044,Blue,1,56338,56454,116
2022-12-12,70059,70049,Blue,0,69137,69594,457
2022-08-06,70052,70060,Blue,1,33639,34010,371
2022-10-13,70038,70058,Blue,1,88208,89254,1046
2022-11-21,70051,70047,Blue,0,66883,67073,190
2022-02-07,70059,70053,Blue,0,34689,34949,260
2022-07-15,70050,70052,Blue,1,58057,58166,109
2022-11-10,70059,70047,Blue,0,40070,40659,589
2022-01-13,70051,70041,Blue,0,59089,59676,587
2022-10-12,70054,70058,Blue,1,27647,27805,158
2022-03-26,70042,70044,Blue,1,71928,71957,29
2022-06-30,70047,70039,Blue,0,87271,87674,403
2022-02-21,70043,70041,Blue,0,47568,47597,29
2022-02-25,70059,70045,Blue,0,32913,33762,849
2022-03-01,70048,70050,Blue,1,29217,29271,54
2022-12-13,70057,70045,Blue,0,78962,79552,590
2022-06-24,70045,70043,Blue,0,77319,77420,101
2022-08-18,70043,70041,Blue,0,28698,28730,32
2022-11-29,70040,70048,Blue,1,78920,79324,404
2022-04-11,70040,70048,Blue,1,64410,64837,427
2022-06-15,70059,70043,Blue,0,21679,22614,935
2022-12-06,70050,70054,Blue,1,49844,50049,205
2022-11-26,70049,70041,Blue,0,21353,21799,446
2022-07-29,70047,70045,Blue,0,64968,65081,113
2022-05-11,70053,70051,Blue,0,87883,87935,52
2022-09-07,70040,70056,Blue,1,74820,75626,806
2022-06-15,70056,70058,Blue,1,68333,68536,203
2022-10-29,70048,70056,Blue,1,40987,41390,403
2022-11-06,70046,70050,Blue,1,72974,73153,179
2022-12-19,70042,70052,Blue,1,32416,33025,609
2022-11-06,70040,70052,Blue,1,48373,48977,604
2022-09-15,70042,70044,Blue,1,74102,74148,46
2022-01-24,70049,70047,Blue,0,35184,35242,58
2022-05-19,70041,70039,Blue,0,56099,56135,36
2022-03-18,70051,70047,Blue,0,45863,46072,209
2022-12-30,70043,70039,Blue,0,75272,75388,116
2022-12-10,70057,70053,Blue,0,29876,30029,153
2022-03-11,70053,70045,Blue,0,26973,27449,476
2022-10-04,70045,70041,Blue,0,23005,23201,196
2022-01-07,70059,70053,Blue,0,38115,38369,254
2022-02-21,70040,70060,Blue,1,44322,45395,1073
2022-03-17,70057,70039,Blue,0,25536,26518,982
2022-10-24,70044,70058,Blue,1,73820,74571,751
2022-01-25,70059,70055,Blue,0,63495,63650,155
2022-11-27,70051,70049,Blue,0,69889,69994,105
2022-11-04,70057,70045,Blue,0,34460,35082,622
2022-12-20,70050,70060,Blue,1,35750,36543,793
2022-08-19,70056,70058,Blue,1,40916,40992,76
2022-01-23,70059,70039,Blue,0,35576,36583,1007
2022-04-17,70038,70052,Blue,1,53711,54450,739
2022-03-18,70048,70060,Blue,1,46311,46905,594
2022-12-12,70057,70049,Blue,0,68461,68854,393
2022-11-23,70055,70838,Blue,0,77683,78595,912
2022-03-23,70053,70045,Blue,0,45211,45614,403
2022-04-22,70044,70052,Blue,1,85216,85735,519
2022-08-12,70053,70039,Blue,0,41024,41865,841
2022-12-16,70048,70054,Blue,1,47127,47431,304
2022-03-25,70050,70054,Blue,1,35748,36126,378
2022-09-15,70042,70048,Blue,1,64657,65017,360
2022-03-21,70044,70058,Blue,1,76528,77289,761
2022-10-10,70055,70047,Blue,0,83637,83996,359
2022-01-22,70042,70058,Blue,1,43294,44233,939
2022-03-15,70040,70050,Blue,1,47018,47584,566
2022-09-07,70047,70838,Blue,0,35005,35523,518
2022-02-01,70050,70058,Blue,1,68826,69694,868
2022-05-10,70050,70060,Blue,1,30153,30643,490
2022-11-16,70046,70060,Blue,1,52402,53301,899
2022-11-24,70049,70039,Blue,0,53260,53746,486
2022-07-11,70053,70039,Blue,0,39954,40824,870
2022-04-08,70056,70060,Blue,1,55905,56233,328
2022-01-02,70051,70043,Blue,0,68248,68730,482
2022-08-21,70038,70046,Blue,1,88204,88504,300
2022-12-22,70042,70044,Blue,1,27298,27333,35
2022-05-17,70057,70047,Blue,0,23496,23978,482
2022-12-26,70053,70049,Blue,0,84922,85106,184
2022-02-13,70052,70054,Blue,1,47618,47671,53
2022-02-14,70041,70039,Blue,0,32232,32263,31
2022-02-03,70049,70039,Blue,0,54693,55203,510
2022-07-19,70051,70039,Blue,0,50300,51032,732
2022-04-06,70052,70058,Blue,1,59335,59568,233
2022-06-20,70048,70056,Blue,1,81036,81536,500
2022-01-22,70038,70058,Blue,1,19812,20839,1027
2022-09-17,70058,70060,Blue,1,52267,52328,61
2022-08-31,70046,70060,Blue,1,61139,61881,742
2022-12-30,70053,70039,Blue,0,41265,42017,752
2022-04-11,70051,70838,Blue,0,44919,45660,741
2022-02-01,70041,70838,Blue,0,68168,68290,122
2022-11-22,70041,70039,Blue,0,40157,40189,32
2022-01-12,70040,70052,Blue,1,55237,56039,802
2022-08-22,70048,70054,Blue,1,35828,36137,309
2022-05-19,70050,70052,Blue,1,44956,45083,127
2022-02-03,70040,70058,Blue,1,38205,39258,1053
2022-09-20,70052,70060,Blue,1,31617,32023,406
2022-02-14,70040,70044,Blue,1,69018,69146,128
2022-08-01,70059,70049,Blue,0,48377,48892,515
2022-09-26,70048,70050,Blue,1,42108,42171,63
2022-03-05,70055,70047,Blue,0,68295,68693,398
2022-11-27,70049,70043,Blue,0,37923,38284,361
2022-04-15,70038,70056,Blue,1,24284,25140,856
2022-12-02,70048,70060,Blue,1,48173,48748,575
2022-11-27,70055,70047,Blue,0,56748,57129,381
2022-08-11,70038,70054,Blue,1,54944,55880,936
2022-09-26,70040,70060,Blue,1,60770,61889,1119
2022-10-03,70042,70052,Blue,1,47320,47873,553
2022-08-10,70055,70049,Blue,0,38663,38964,301
2022-09-19,70059,70838,Blue,0,60332,61439,1107
2022-12-01,70038,70044,Blue,1,57483,57720,237
2022-11-17,70059,70053,Blue,0,68192,68413,221
2022-01-12,70055,70049,Blue,0,41299,41644,345
2022-10-12,70042,70056,Blue,1,24008,24754,746
2022-04-22,70057,70045,Blue,0,62670,63313,643
2022-10-08,70044,70052,Blue,1,84939,85486,547
2022-04-14,70055,70838,Blue,0,33469,34559,1090
2022-02-06,70057,70047,Blue,0,54449,54913,464
2022-11-06,70046,70052,Blue,1,67601,67926,325
2022-09-26,70042,70058,Blue,1,31325,32334,1009
2022-01-17,70042,70060,Blue,1,26498,27578,1080
2022-10-09,70053,70051,Blue,0,70362,70410,48
2022-03-16,70040,70042,Blue,1,84913,84943,30
2022-11-14,70052,70058,Blue,1,38453,38687,234
2022-04-12,70056,70058,Blue,1,34857,34935,78
2022-01-27,70057,70047,Blue,0,85230,85733,503
2022-03-18,70057,70051,Blue,0,56374,56619,245
2022-08-08,70050,70052,Blue,1,77314,77421,107
2022-11-21,70051,70838,Blue,0,24091,24815,724
2022-10-08,70051,70043,Blue,0,27466,28010,544
2022-09-16,70042,70046,Blue,1,68178,68374,196
2022-09-06,70057,70039,Blue,0,53619,54574,955
2022-02-04,70044,70046,Blue,1,87355,87457,102
2022-12-08,70055,70049,Blue,0,20594,20865,271
2022-04-06,70045,70041,Blue,0,56381,56551,170
2022-04-15,70047,70039,Blue,0,55173,55618,445
2022-11-29,70046,70048,Blue,1,76780,76857,77
2022-10-13,70040,70060,Blue,1,51851,52888,1037
2022-06-19,70046,70058,Blue,1,32043,32679,636
2022-07-14,70049,70041,Blue,0,79729,80141,412
2022-04-11,70053,70049,Blue,0,20197,20393,196
2022-08-22,70055,70053,Blue,0,53324,53370,46
2022-09-11,70059,70838,Blue,0,58694,59836,1142
2022-04-05,70050,70060,Blue,1,53666,54158,492
2022-08-21,70057,70049,Blue,0,52296,52693,397
2022-12-13,70057,70051,Blue,0,58385,58624,239
2022-11-22,70047,70043,Blue,0,61572,61815,243
2022-12-19,70053,70049,Blue,0,19070,19305,235
2022-03-13,70048,70058,Blue,1,60781,61283,502
2022-11-02,70038,70048,Blue,1,53386,53899,513
2022-09-04,70057,70043,Blue,0,23132,23872,740
2022-12-20,70048,70054,Blue,1,69659,69997,338
2022-02-17,70051,70047,Blue,0,20639,20868,229
2022-11-22,70047,70039,Blue,0,73390,73783,393
2022-06-22,70055,70039,Blue,0,56640,57511,871
2022-06-01,70050,70052,Blue,1,71053,71247,194
2022-06-20,70038,70040,Blue,1,66800,66814,14
2022-06-22,70044,70056,Blue,1,22330,23133,803
2022-06-16,70047,70838,Blue,0,84609,85108,499
2022-12-28,70038,70058,Blue,1,20040,21052,1012
2022-06-17,70048,70058,Blue,1,47677,48492,815
2022-12-07,70047,70039,Blue,0,65256,65638,382
2022-10-19,70044,70060,Blue,1,88425,89358,933
2022-04-16,70038,70056,Blue,1,69628,70502,874
2022-01-02,70057,70049,Blue,0,68492,68885,393
2022-03-20,70038,70060,Blue,1,52794,53855,1061
2022-11-17,70051,70045,Blue,0,60704,61054,350
2022-02-20,70051,70043,Blue,0,69319,69840,521
2022-08-29,70050,70052,Blue,1,42571,42681,110
2022-03-20,70057,70047,Blue,0,26263,26731,468
2022-02-23,70042,70058,Blue,1,50492,51369,877
2022-08-11,70044,70054,Blue,1,52401,52999,598
2022-11-04,70055,70047,Blue,0,22540,22953,413
2022-12-14,70052,70054,Blue,1,68508,68568,60
2022-04-01,70047,70838,Blue,0,24407,25030,623
2022-10-27,70059,70043,Blue,0,43175,44115,940
2022-02-15,70057,70043,Blue,0,65676,66519,843
2022-09-13,70053,70041,Blue,0,46039,46769,730
2022-03-30,70038,70052,Blue,1,68227,69008,781
2022-07-31,70044,70052,Blue,1,52851,53348,497
2022-03-12,70057,70053,Blue,0,35880,36034,154
2022-12-02,70050,70058,Blue,1,35860,36243,383
2022-08-08,70049,70047,Blue,0,56070,56127,57
2022-01-26,70044,70050,Blue,1,58887,59240,353
2022-09-18,70048,70056,Blue,1,73761,74153,392
2022-05-02,70059,70053,Blue,0,74415,74637,222
2022-07-09,70038,70042,Blue,1,73936,74026,90
2022-12-09,70055,70041,Blue,0,49059,49856,797
2022-03-17,70046,70048,Blue,1,69551,69644,93
2022-05-01,70057,70055,Blue,0,61680,61750,70
2022-01-06,70044,70056,Blue,1,48754,49423,669
2022-08-12,70040,70052,Blue,1,39190,39842,652
2022-10-24,70038,70056,Blue,1,76559,77495,936
2022-10-02,70053,70047,Blue,0,75171,75450,279
2022-11-08,70044,70050,Blue,1,39147,39578,431
2022-10-09,70042,70046,Blue,1,46279,46443,164
2022-10-15,70055,70047,Blue,0,51556,51934,378
2022-03-29,70050,70052,Blue,1,31161,31274,113
2022-06-12,70055,70041,Blue,0,27964,28721,757
2022-06-30,70049,70039,Blue,0,55529,56051,522
2022-03-05,70038,70044,Blue,1,26292,26464,172
2022-06-13,70044,70052,Blue,1,44337,44931,594
2022-11-25,70050,70058,Blue,1,66433,66847,414
2022-07-05,70040,70042,Blue,1,20097,20132,35
2022-02-03,70044,70050,Blue,1,20215,20585,370
2022-06-04,70047,70039,Blue,0,33024,33536,512
2022-09-03,70038,70046,Blue,1,71279,71646,367
2022-02-15,70057,70051,Blue,0,26391,26690,299
2022-01-08,70044,70060,Blue,1,42847,43775,928
2022-11-27,70038,70054,Blue,1,55339,56220,881
2022-03-02,70044,70052,Blue,1,26289,26805,516
2022-03-22,70059,70049,Blue,0,20260,20750,490
2022-03-02,70056,70060,Blue,1,34146,34424,278
2022-08-15,70057,70049,Blue,0,67158,67532,374
2022-05-14,70053,70047,Blue,0,55502,55802,300
2022-02-26,70056,70060,Blue,1,84709,84883,174
2022-11-07,70043,70041,Blue,0,64741,64771,30
2022-08-15,70056,70060,Blue,1,30906,31094,188
2022-03-04,70040,70050,Blue,1,87795,88288,493
2022-03-05,70038,70042,Blue,1,25629,25734,105
2022-02-10,70055,70838,Blue,0,26574,27594,1020
2022-02-24,70040,70060,Blue,1,52099,53349,1250
2022-06-10,70044,70058,Blue,1,61021,61954,933
2022-08-14,70044,70050,Blue,1,58814,59160,346
2022-09-09,70043,70039,Blue,0,39445,39549,104
2022-02-25,70044,70046,Blue,1,89374,89475,101
2022-12-06,70042,70054,Blue,1,72229,72886,657
2022-02-08,70053,70047,Blue,0,24263,24572,309
2022-11-20,70059,70043,Blue,0,68966,69867,901
2022-11-28,70057,70047,Blue,0,80556,81037,481
2022-09-19,70051,70047,Blue,0,76814,77006,192
2022-07-25,70047,70838,Blue,0,26165,26717,552
2022-09-21,70059,70043,Blue,0,57726,58590,864
2022-10-25,70040,70044,Blue,1,77394,77520,126
2022-10-06,70053,70838,Blue,0,54913,55721,808
2022-02-22,70046,70054,Blue,1,32497,32957,460
2022-01-18,70057,70838,Blue,0,22133,23315,1182
2022-08-01,70042,70050,Blue,1,30015,30456,441
2022-10-22,70048,70052,Blue,1,72837,73032,195
2022-12-22,70050,70054,Blue,1,38176,38513,337
2022-01-04,70059,70039,Blue,0,53896,54886,990
2022-10-17,70057,70051,Blue,0,23942,24202,260
2022-09-22,70043,70041,Blue,0,61283,61312,29
2022-01-11,70057,70043,Blue,0,72089,72810,721
2022-07-20,70038,70044,Blue,1,62220,62443,223
2022-02-19,70040,70046,Blue,1,47542,47799,257
2022-04-24,70057,70838,Blue,0,63096,64159,1063
2022-12-12,70055,70053,Blue,0,22763,22810,47
2022-06-25,70038,70040,Blue,1,89113,89128,15
2022-02-09,70042,70048,Blue,1,44325,44649,324
2022-10-07,70049,70838,Blue,0,39011,39724,713
2022-09-04,70052,70060,Blue,1,36005,36387,382
2022-12-05,70040,70060,Blue,1,58718,59854,1136
2022-12-02,70050,70056,Blue,1,52389,52677,288
2022-09-03,70057,70039,Blue,0,59008,59956,948
2022-04-21,70038,70056,Blue,1,61332,62282,950
2022-12-27,70051,70039,Blue,0,29919,30579,660
2022-01-05,70046,70058,Blue,1,35460,36167,707
2022-11-30,70059,70051,Blue,0,24669,25024,355
2022-01-14,70040,70050,Blue,1,29408,29858,450
2022-02-05,70038,70058,Blue,1,33453,34474,1021
2022-12-08,70059,70047,Blue,0,19942,20515,573
2022-05-21,70047,70045,Blue,0,65178,65348,170
2022-03-21,70051,70045,Blue,0,59958,60293,335
2022-12-27,70049,70043,Blue,0,19304,19698,394
2022-06-30,70053,70041,Blue,0,71954,72618,664
2022-03-08,70059,70051,Blue,0,55092,55438,346
2022-02-17,70040,70052,Blue,1,29398,30015,617
2022-08-21,70054,70060,Blue,1,58356,58633,277
2022-06-28,70048,70060,Blue,1,61005,61680,675
2022-05-19,70053,70047,Blue,0,25753,26091,338
2022-01-27,70057,70039,Blue,0,63569,64557,988
2022-06-23,70045,70838,Blue,0,81484,81863,379
2022-12-12,70042,70058,Blue,1,30124,30994,870
2022-10-02,70038,70044,Blue,1,65604,65773,169
2022-02-15,70039,70838,Blue,0,61915,61952,37
2022-11-22,70042,70060,Blue,1,40652,41724,1072
2022-09-20,70051,70049,Blue,0,42529,42656,127
2022-01-24,70043,70041,Blue,0,70336,70365,29
2022-03-02,70047,70041,Blue,0,53167,53468,301
2022-03-24,70051,70041,Blue,0,59660,60399,739
2022-10-13,70051,70041,Blue,0,31966,32538,572
2022-11-22,70057,70041,Blue,0,57803,58633,830
2022-09-04,70053,70051,Blue,0,45449,45502,53
2022-05-10,70054,70060,Blue,1,61651,61928,277
2022-07-22,70048,70058,Blue,1,42611,43128,517
2022-05-18,70038,70044,Blue,1,58112,58303,191
2022-11-26,70055,70045,Blue,0,57497,57985,488
2022-12-16,70048,70050,Blue,1,32113,32168,55
2022-11-02,70053,70043,Blue,0,68931,69518,587
2022-10-09,70051,70045,Blue,0,59054,59399,345
2022-04-07,70040,70056,Blue,1,33911,34724,813
2022-04-04,70054,70056,Blue,1,33452,33499,47
2022-02-28,70038,70060,Blue,1,48069,49141,1072
2022-05-19,70038,70050,Blue,1,51234,51871,637
2022-07-01,70051,70043,Blue,0,27134,27689,555
2022-08-31,70049,70838,Blue,0,59239,59856,617
2022-02-23,70057,70047,Blue,0,63877,64412,535
2022-08-19,70038,70046,Blue,1,62921,63316,395
2022-08-01,70051,70049,Blue,0,38843,38953,110
2022-03-20,70044,70052,Blue,1,28668,29209,541
2022-12-31,70043,70838,Blue,0,77914,78222,308
2022-04-20,70055,70047,Blue,0,46312,46782,470
2022-08-12,70045,70838,Blue,0,84172,84545,373
2022-04-28,70056,70058,Blue,1,81018,81104,86
2022-09-07,70043,70838,Blue,0,31273,31501,228
2022-11-17,70052,70054,Blue,1,69729,69784,55
2022-11-17,70056,70060,Blue,1,30623,30817,194
2022-03-31,70042,70058,Blue,1,24680,25515,835
2022-01-13,70040,70046,Blue,1,19877,20180,303
2022-01-24,70055,70053,Blue,0,55872,55932,60
2022-02-01,70049,70041,Blue,0,46084,46554,470
2022-08-24,70052,70056,Blue,1,42857,43006,149
2022-11-20,70038,70058,Blue,1,70986,71991,1005
2022-12-18,70052,70056,Blue,1,29198,29336,138
2022-01-14,70048,70052,Blue,1,73529,73747,218
2022-06-09,70048,70056,Blue,1,46939,47365,426
2022-04-03,70042,70044,Blue,1,62540,62567,27
2022-07-11,70045,70041,Blue,0,50184,50430,246
2022-07-26,70039,70838,Blue,0,83381,83416,35
2022-11-19,70056,70058,Blue,1,44625,44694,69
2022-06-28,70044,70054,Blue,1,22431,23255,824
2022-08-25,70057,70049,Blue,0,71319,71717,398
2022-10-25,70040,70060,Blue,1,25304,26368,1064
2022-03-03,70042,70050,Blue,1,76501,76948,447
2022-07-04,70038,70042,Blue,1,50298,50398,100
2022-07-02,70043,70838,Blue,0,32800,32991,191
2022-11-23,70057,70051,Blue,0,66099,66354,255
2022-01-09,70057,70838,Blue,0,57187,58296,1109
2022-06-26,70049,70838,Blue,0,70558,71173,615
2022-03-01,70051,70049,Blue,0,30116,30222,106
2022-06-12,70051,70043,Blue,0,49893,50427,534
2022-06-09,70038,70048,Blue,1,66831,67351,520
2022-04-18,70052,70054,Blue,1,34979,35032,53
2022-10-09,70038,70058,Blue,1,58034,59014,980
2022-11-08,70042,70046,Blue,1,27034,27204,170
2022-08-19,70045,70039,Blue,0,22931,23199,268
2022-10-09,70038,70050,Blue,1,53712,54233,521
2022-02-19,70040,70046,Blue,1,32957,33203,246
2022-05-09,70055,70051,Blue,0,20424,20578,154
2022-06-10,70046,70060,Blue,1,20201,20972,771
2022-07-09,70053,70838,Blue,0,42999,43819,820
2022-12-09,70055,70838,Blue,0,26976,27947,971
2022-10-05,70051,70838,Blue,0,29285,30148,863
2022-08-25,70059,70838,Blue,0,38472,39592,1120
2022-06-15,70057,70049,Blue,0,86383,86776,393
2022-09-13,70059,70838,Blue,0,63600,64681,1081
2022-06-14,70057,70039,Blue,0,30056,31131,1075
2022-02-18,70055,70051,Blue,0,23867,24013,146
2022-04-20,70040,70048,Blue,1,21899,22272,373
2022-11-24,70059,70055,Blue,0,51141,51286,145
2022-01-14,70038,70050,Blue,1,23961,24583,622
2022-04-12,70040,70052,Blue,1,23140,23799,659
2022-04-11,70038,70052,Blue,1,56529,57182,653
2022-01-11,70047,70838,Blue,0,63797,64346,549
2022-01-14,70041,70039,Blue,0,61519,61551,32
2022-02-24,70046,70058,Blue,1,52512,53224,712
2022-03-18,70059,70838,Blue,0,60196,61301,1105
2022-12-16,70048,70052,Blue,1,24804,25074,270
2022-09-12,70048,70060,Blue,1,34094,34764,670
2022-06-10,70053,70049,Blue,0,22314,22517,203
2022-06-29,70049,70039,Blue,0,34064,34644,580
2022-11-15,70057,70039,Blue,0,58881,59804,923
2022-06-30,70054,70056,Blue,1,24786,24832,46
2022-03-12,70049,70045,Blue,0,50255,50457,202
2022-07-15,70044,70048,Blue,1,49969,50209,240
2022-07-16,70042,70058,Blue,1,56906,57797,891
2022-03-14,70038,70050,Blue,1,53710,54260,550
2022-08-25,70059,70047,Blue,0,63978,64523,545
2022-03-25,70042,70052,Blue,1,53176,53861,685
2022-03-07,70053,70039,Blue,0,58848,59559,711
2022-10-23,70045,70838,Blue,0,58916,59254,338
2022-01-01,70044,70046,Blue,1,70648,70750,102
2022-02-06,70042,70056,Blue,1,40557,41412,855
2022-03-26,70053,70039,Blue,0,68935,69889,954
2022-03-09,70044,70056,Blue,1,58904,59608,704
2022-10-01,70048,70052,Blue,1,31216,31421,205
2022-06-16,70040,70050,Blue,1,30051,30662,611
2022-02-25,70054,70060,Blue,1,54844,55276,432
2022-05-09,70054,70060,Blue,1,48966,49230,264
2022-07-12,70055,70053,Blue,0,42809,42855,46
2022-01-31,70038,70046,Blue,1,61330,61648,318
2022-04-14,70059,70838,Blue,0,56900,58070,1170
2022-02-01,70040,70048,Blue,1,81488,81854,366
2022-04-13,70051,70838,Blue,0,79282,79989,707
2022-01-05,70038,70040,Blue,1,27563,27580,17
2022-12-31,70042,70060,Blue,1,67862,68867,1005
2022-01-17,70052,70060,Blue,1,46737,47097,360
2022-12-29,70041,70039,Blue,0,51675,51708,33
2022-08-26,70044,70056,Blue,1,64820,65504,684
2022-10-13,70046,70048,Blue,1,31924,32013,89
2022-06-27,70044,70052,Blue,1,25111,25679,568
2022-03-02,70055,70053,Blue,0,27147,27208,61
2022-10-04,70054,70060,Blue,1,52318,52576,258
2022-03-12,70040,70052,Blue,1,61047,61706,659
2022-01-24,70052,70056,Blue,1,36578,36753,175
2022-08-22,70042,70052,Blue,1,28056,28638,582
2022-07-11,70057,70053,Blue,0,83357,83509,152
2022-10-17,70046,70058,Blue,1,67303,67946,643
2022-01-19,70055,70838,Blue,0,33342,34370,1028
2022-09-29,70038,70046,Blue,1,27510,27829,319
2022-02-02,70053,70043,Blue,0,34172,34845,673
2022-06-30,70040,70052,Blue,1,65370,66178,808
2022-03-04,70050,70060,Blue,1,44089,44675,586
2022-01-28,70038,70060,Blue,1,29647,30774,1127
2022-07-30,70055,70045,Blue,0,38058,38558,500
2022-03-02,70051,70043,Blue,0,25849,26378,529
2022-06-16,70044,70056,Blue,1,69722,70473,751
2022-12-21,70057,70049,Blue,0,56367,56731,364
2022-05-20,70040,70060,Blue,1,27305,28431,1126
2022-08-23,70044,70050,Blue,1,30955,31295,340
2022-04-15,70042,70052,Blue,1,56396,56992,596
2022-11-19,70040,70046,Blue,1,43756,44021,265
2022-02-15,70043,70838,Blue,0,59702,59892,190
2022-10-19,70047,70045,Blue,0,82648,82741,93
2022-12-14,70038,70040,Blue,1,27852,27871,19
2022-12-20,70050,70056,Blue,1,32469,32772,303
2022-12-31,70038,70060,Blue,1,57312,58438,1126
2022-04-09,70044,70056,Blue,1,34709,35377,668
2022-08-20,70057,70838,Blue,0,59014,60106,1092
2022-03-22,70040,70054,Blue,1,80402,81189,787
2022-08-27,70057,70053,Blue,0,26069,26231,162
2022-10-10,70038,70050,Blue,1,48678,49254,576
2022-10-10,70044,70050,Blue,1,55334,55639,305
2022-11-10,70040,70052,Blue,1,41557,42503,946
2022-09-26,70046,70058,Blue,1,34053,34888,835
2022-12-20,70059,70039,Blue,0,25654,26644,990
2022-07-15,70048,70054,Blue,1,76163,76484,321
2022-10-22,70038,70060,Blue,1,64740,65908,1168
2022-07-19,70055,70045,Blue,0,24899,25464,565
2022-06-28,70050,70060,Blue,1,21757,22352,595
2022-07-16,70054,70060,Blue,1,69998,70265,267
2022-07-04,70043,70039,Blue,0,64135,64245,110
2022-11-14,70059,70057,Blue,0,20416,20453,37
2022-01-26,70052,70056,Blue,1,64205,64343,138
2022-07-18,70057,70041,Blue,0,84476,85900,1424
2022-07-14,70048,70056,Blue,1,29330,29741,411
2022-10-26,70044,70050,Blue,1,44859,45214,355
2022-04-14,70055,70041,Blue,0,51822,52587,765
2022-07-29,70042,70050,Blue,1,22406,22797,391
2022-03-10,70057,70045,Blue,0,67233,67844,611
2022-10-07,70044,70050,Blue,1,54811,55140,329
2022-04-05,70058,70060,Blue,1,59655,59812,157
2022-03-05,70042,70046,Blue,1,54646,54821,175
2022-02-01,70055,70045,Blue,0,86491,87057,566
2022-01-28,70042,70052,Blue,1,32792,33428,636
2022-11-21,70043,70041,Blue,0,39964,39992,28
2022-06-10,70055,70047,Blue,0,23026,23473,447
2022-03-19,70050,70052,Blue,1,41604,41712,108
2022-12-11,70043,70041,Blue,0,43028,43061,33
2022-03-01,70053,70838,Blue,0,53448,54293,845
2022-04-01,70050,70054,Blue,1,24035,24246,211
2022-07-14,70044,70058,Blue,1,45126,46045,919
2022-10-27,70053,70045,Blue,0,45077,45551,474
2022-03-30,70055,70041,Blue,0,28647,29445,798
2022-10-04,70046,70052,Blue,1,73591,73946,355
2022-12-21,70059,70039,Blue,0,34943,35917,974
2022-12-15,70048,70058,Blue,1,61856,62418,562
2022-07-29,70042,70056,Blue,1,48211,49055,844
2022-03-03,70047,70043,Blue,0,22373,22665,292
2022-09-12,70059,70047,Blue,0,23837,24456,619
2022-10-17,70054,70058,Blue,1,77792,77945,153
2022-12-30,70044,70052,Blue,1,69563,70043,480
2022-10-10,70046,70050,Blue,1,40199,40372,173
2022-01-05,70059,70039,Blue,0,27255,28219,964
2022-04-18,70056,70060,Blue,1,47262,47481,219
2022-04-06,70055,70045,Blue,0,27163,27710,547
2022-09-30,70040,70046,Blue,1,46192,46485,293
2022-11-16,70042,70058,Blue,1,40560,41488,928
2022-04-02,70059,70838,Blue,0,75794,76836,1042
2022-11-21,70042,70048,Blue,1,78532,78843,311
2022-06-13,70059,70039,Blue,0,53113,54176,1063
2022-01-19,70059,70049,Blue,0,56594,57021,427
2022-01-27,70059,70039,Blue,0,57203,58138,935
2022-08-21,70059,70055,Blue,0,43457,43602,145
2022-06-16,70040,70060,Blue,1,29519,30688,1169
2022-07-27,70055,70043,Blue,0,63103,63768,665
2022-06-23,70051,70045,Blue,0,38543,38923,380
2022-06-14,70047,70838,Blue,0,68110,68579,469
2022-07-09,70055,70039,Blue,0,52633,53461,828
2022-03-21,70055,70049,Blue,0,28646,28937,291
2022-03-20,70048,70058,Blue,1,85125,85623,498
2022-08-21,70049,70041,Blue,0,72161,72608,447
2022-08-02,70042,70060,Blue,1,36919,38186,1267
2022-01-12,70046,70048,Blue,1,25297,25378,81
2022-03-29,70053,70045,Blue,0,41220,41704,484
2022-02-20,70057,70055,Blue,0,66882,66951,69
2022-06-26,70057,70053,Blue,0,75600,75757,157
2022-02-07,70049,70043,Blue,0,75458,75858,400
2022-01-20,70047,70041,Blue,0,46818,47200,382
2022-06-14,70054,70060,Blue,1,89459,90451,992
2022-02-04,70044,70054,Blue,1,33073,33685,612
2022-07-04,70056,70058,Blue,1,81437,81512,75
2022-02-20,70057,70049,Blue,0,55526,55911,385
2022-06-12,70044,70048,Blue,1,83253,83529,276
2022-11-15,70053,70047,Blue,0,29032,29344,312
2022-01-12,70038,70042,Blue,1,55674,55769,95
2022-03-22,70046,70048,Blue,1,70458,70556,98
2022-07-23,70053,70039,Blue,0,38146,38894,748
2022-08-28,70053,70047,Blue,0,48845,49121,276
2022-06-17,70040,70052,Blue,1,88401,89103,702
2022-03-17,70044,70056,Blue,1,60042,60689,647
2022-07-02,70053,70049,Blue,0,37617,37803,186
2022-10-12,70043,70041,Blue,0,78993,79021,28
2022-08-20,70050,70056,Blue,1,78584,78892,308
2022-11-01,70046,70056,Blue,1,64242,64783,541
2022-08-31,70040,70060,Blue,1,30742,31699,957
2022-10-07,70041,70838,Blue,0,30779,30911,132
2022-09-08,70055,70053,Blue,0,64612,64663,51
2022-02-28,70051,70049,Blue,0,62092,62196,104
2022-04-30,70054,70060,Blue,1,32689,32955,266
2022-07-25,70051,70047,Blue,0,22224,22446,222
2022-04-03,70059,70039,Blue,0,56536,57524,988
2022-05-19,70040,70054,Blue,1,54079,54975,896
2022-05-15,70056,70060,Blue,1,63148,63338,190
2022-09-15,70050,70054,Blue,1,21994,22246,252
2022-09-18,70039,70838,Blue,0,83303,83336,33
2022-08-31,70042,70048,Blue,1,41097,41371,274
2022-10-19,70059,70045,Blue,0,45777,46490,713
2022-07-01,70045,70041,Blue,0,32988,33157,169
2022-12-06,70049,70041,Blue,0,31394,31890,496
2022-09-25,70053,70047,Blue,0,72472,72757,285
2022-02-04,70055,70043,Blue,0,58490,59286,796
2022-11-27,70055,70053,Blue,0,59418,59465,47
2022-04-08,70051,70045,Blue,0,65649,65977,328
2022-06-18,70053,70045,Blue,0,26925,27366,441
2022-12-12,70058,70060,Blue,1,52510,52571,61
2022-09-29,70040,70060,Blue,1,65410,66606,1196
2022-01-31,70055,70049,Blue,0,45458,45752,294
2022-02-12,70038,70042,Blue,1,44767,44875,108
2022-07-10,70048,70056,Blue,1,51726,52175,449
2022-01-07,70044,70050,Blue,1,33035,33372,337
2022-07-17,70057,70049,Blue,0,38258,38671,413
2022-06-01,70044,70050,Blue,1,30282,30686,404
2022-02-06,70038,70048,Blue,1,52088,52575,487
2022-09-08,70044,70050,Blue,1,82168,82521,353
2022-03-07,70057,70053,Blue,0,23165,23388,223
2022-02-25,70057,70838,Blue,0,56969,57927,958
2022-01-10,70040,70046,Blue,1,82039,82334,295
2022-02-01,70050,70056,Blue,1,55169,55553,384
2022-12-14,70050,70054,Blue,1,86366,86578,212
2022-06-07,70046,70052,Blue,1,84498,84957,459
2022-06-23,70048,70050,Blue,1,32766,32823,57
2022-07-05,70044,70060,Blue,1,31765,32714,949
2022-08-06,70059,70039,Blue,0,27084,28089,1005
2022-01-11,70057,70045,Blue,0,82410,83082,672
2022-07-17,70038,70060,Blue,1,71067,72182,1115
2022-03-10,70055,70039,Blue,0,66074,66904,830
2022-12-05,70059,70053,Blue,0,19518,19801,283
2022-09-09,70052,70054,Blue,1,72864,72926,62
2022-01-28,70044,70060,Blue,1,29543,30516,973
2022-06-11,70059,70838,Blue,0,72978,74198,1220
2022-07-22,70057,70049,Blue,0,50567,50952,385
2022-12-06,70059,70045,Blue,0,52524,53207,683
2022-02-16,70047,70041,Blue,0,56941,57335,394
2022-12-11,70044,70046,Blue,1,34123,34224,101
2022-08-02,70052,70060,Blue,1,64196,64681,485
2022-09-20,70044,70046,Blue,1,44771,44874,103
2022-08-10,70040,70052,Blue,1,22275,22895,620
2022-09-09,70056,70058,Blue,1,45793,45869,76
2022-03-24,70046,70058,Blue,1,47885,48538,653
2022-04-13,70049,70047,Blue,0,61025,61080,55
2022-08-04,70049,70041,Blue,0,47826,48309,483
2022-02-03,70040,70048,Blue,1,63330,63758,428
2022-04-23,70043,70041,Blue,0,51286,51326,40
2022-12-10,70040,70056,Blue,1,55092,55913,821
2022-12-24,70040,70048,Blue,1,52934,53350,416
2022-10-29,70051,70043,Blue,0,40952,41464,512
2022-03-10,70059,70043,Blue,0,28760,29726,966
2022-05-18,70047,70039,Blue,0,79544,80086,542
2022-12-06,70051,70045,Blue,0,67488,67840,352
2022-04-04,70040,70056,Blue,1,43848,44716,868
2022-11-09,70038,70042,Blue,1,29000,29101,101
2022-11-02,70059,70039,Blue,0,80652,81632,980
2022-05-20,70059,70057,Blue,0,63496,63530,34
2022-08-03,70051,70045,Blue,0,78953,79278,325
2022-02-03,70038,70058,Blue,1,52756,53819,1063
2022-02-10,70049,70039,Blue,0,80620,81189,569
2022-03-11,70055,70047,Blue,0,67374,67731,357
2022-07-22,70051,70838,Blue,0,24195,24903,708
2022-07-05,70049,70039,Blue,0,53676,54244,568
2022-06-14,70045,70041,Blue,0,81402,81603,201
2022-02-20,70048,70060,Blue,1,48302,48873,571
2022-11-30,70042,70054,Blue,1,53284,54079,795
2022-02-02,70047,70045,Blue,0,19912,20079,167
2022-12-26,70052,70054,Blue,1,88069,88126,57
2022-08-17,70048,70060,Blue,1,53988,54620,632
2022-12-28,70055,70043,Blue,0,46931,47587,656
2022-06-30,70057,70039,Blue,0,68215,69329,1114
2022-03-24,70049,70047,Blue,0,21079,21133,54
2022-10-07,70040,70056,Blue,1,44121,44921,800
2022-12-01,70053,70838,Blue,0,47211,48051,840
2022-02-09,70038,70048,Blue,1,70604,71086,482
2022-07-04,70043,70039,Blue,0,52832,52934,102
2022-06-30,70050,70058,Blue,1,22575,22996,421
2022-01-07,70040,70058,Blue,1,32883,33861,978
2022-07-14,70051,70039,Blue,0,60196,60861,665
2022-08-17,70047,70045,Blue,0,75960,76069,109
2022-11-24,70038,70044,Blue,1,54781,54945,164
2022-09-10,70055,70047,Blue,0,88403,88763,360
2022-04-08,70057,70049,Blue,0,74979,75369,390
2022-01-23,70042,70044,Blue,1,31687,31716,29
2022-03-26,70042,70058,Blue,1,43965,45022,1057
2022-08-16,70050,70052,Blue,1,73285,73402,117
2022-01-04,70043,70039,Blue,0,29807,29936,129
2022-07-19,70059,70049,Blue,0,63975,64462,487
2022-07-18,70053,70039,Blue,0,53783,54513,730
2022-07-25,70041,70039,Blue,0,58028,58062,34
2022-02-06,70045,70041,Blue,0,34919,35103,184
2022-01-18,70040,70048,Blue,1,31818,32388,570
2022-12-02,70059,70047,Blue,0,49393,49940,547
2022-11-30,70052,70060,Blue,1,51012,51376,364
2022-09-10,70038,70052,Blue,1,37746,38467,721
2022-03-24,70057,70055,Blue,0,58789,58858,69
2022-04-13,70058,70060,Blue,1,36283,36358,75
2022-12-01,70040,70056,Blue,1,22390,23195,805
2022-06-03,70038,70044,Blue,1,56476,56698,222
2022-09-29,70056,70058,Blue,1,90135,90211,76
2022-02-24,70053,70039,Blue,0,49511,50586,1075
2022-10-16,70049,70039,Blue,0,65149,65648,499
2022-06-20,70042,70056,Blue,1,44277,45100,823
2022-07-06,70052,70054,Blue,1,34414,34532,118
2022-02-03,70053,70043,Blue,0,50086,50788,702
2022-06-03,70042,70048,Blue,1,61935,62279,344
2022-06-29,70052,70060,Blue,1,78127,78489,362
2022-01-31,70042,70048,Blue,1,55082,55407,325
2022-08-17,70042,70050,Blue,1,44799,45306,507
2022-04-11,70038,70052,Blue,1,59529,60312,783
2022-08-01,70043,70039,Blue,0,71572,71677,105
2022-02-18,70052,70054,Blue,1,25854,25914,60
2022-10-17,70053,70041,Blue,0,66817,67488,671
2022-08-06,70044,70060,Blue,1,39049,39875,826
2022-10-09,70050,70054,Blue,1,40260,40466,206
2022-06-15,70050,70058,Blue,1,54036,54598,562
2022-01-01,70051,70838,Blue,0,48807,49491,684
2022-04-12,70050,70058,Blue,1,84466,84885,419
2022-02-03,70053,70049,Blue,0,37283,37518,235
2022-09-21,70055,70838,Blue,0,32444,33525,1081
2022-11-11,70038,70060,Blue,1,83004,84259,1255
2022-07-07,70043,70041,Blue,0,60969,60997,28
2022-11-15,70038,70044,Blue,1,64559,64804,245
2022-09-15,70051,70045,Blue,0,40918,41281,363
2022-01-26,70044,70052,Blue,1,33294,33846,552
2022-03-11,70040,70052,Blue,1,68649,69305,656
2022-12-19,70057,70047,Blue,0,23428,23997,569
2022-02-22,70044,70054,Blue,1,20902,21621,719
2022-08-20,70044,70056,Blue,1,77500,78210,710
2022-01-19,70059,70045,Blue,0,31872,32649,777
2022-11-02,70056,70060,Blue,1,28352,28542,190
2022-01-04,70055,70043,Blue,0,55263,55867,604
2022-03-17,70052,70056,Blue,1,24161,24302,141
2022-03-28,70038,70048,Blue,1,55935,56362,427
2022-07-27,70040,70050,Blue,1,63419,63975,556
2022-10-11,70040,70060,Blue,1,51856,52901,1045
2022-03-07,70057,70041,Blue,0,75572,76388,816
2022-06-29,70044,70060,Blue,1,52633,53551,918
2022-07-01,70046,70050,Blue,1,21461,21672,211
2022-12-19,70057,70051,Blue,0,70009,70261,252
2022-12-19,70048,70056,Blue,1,20914,21311,397
2022-11-08,70048,70054,Blue,1,31609,31902,293
2022-03-17,70042,70060,Blue,1,61194,62330,1136
2022-11-10,70048,70054,Blue,1,41056,41383,327
2022-10-26,70051,70049,Blue,0,34284,34397,113
2022-02-18,70041,70838,Blue,0,62067,62193,126
2022-01-03,70044,70046,Blue,1,26877,26982,105
2022-10-12,70046,70058,Blue,1,86877,87487,610
2022-03-09,70051,70039,Blue,0,44265,44914,649
2022-12-07,70053,70047,Blue,0,84486,84793,307
2022-04-08,70042,70048,Blue,1,67186,67490,304
2022-07-26,70059,70043,Blue,0,32237,33152,915
2022-11-09,70053,70049,Blue,0,64338,64538,200
2022-03-16,70046,70052,Blue,1,46751,47075,324
2022-02-15,70040,70060,Blue,1,55727,56869,1142
2022-10-31,70048,70052,Blue,1,32021,32229,208
2022-11-29,70051,70043,Blue,0,37372,37893,521
2022-10-14,70038,70046,Blue,1,58613,59050,437
2022-08-29,70057,70045,Blue,0,28062,28701,639
2022-08-28,70048,70056,Blue,1,32794,33209,415
2022-01-23,70049,70043,Blue,0,39371,39784,413
2022-09-13,70059,70055,Blue,0,35913,36068,155
2022-06-13,70038,70042,Blue,1,80296,80400,104
2022-08-12,70055,70051,Blue,0,36116,36265,149
2022-10-06,70050,70054,Blue,1,48853,49083,230
2022-07-26,70040,70050,Blue,1,54874,55457,583
2022-02-03,70053,70051,Blue,0,37841,37900,59
2022-01-12,70050,70054,Blue,1,44757,44964,207
2022-09-22,70040,70060,Blue,1,62470,63589,1119
2022-02-18,70055,70045,Blue,0,28037,28550,513
2022-10-16,70054,70060,Blue,1,84613,84896,283
2022-06-28,70059,70053,Blue,0,59353,59576,223
2022-12-16,70045,70838,Blue,0,41403,41753,350
2022-01-19,70054,70058,Blue,1,33912,34180,268
2022-12-30,70038,70044,Blue,1,67712,67900,188
2022-02-19,70052,70054,Blue,1,88113,88166,53
2022-07-21,70055,70049,Blue,0,35549,35848,299
2022-03-20,70051,70041,Blue,0,51141,51733,592
2022-07-26,70041,70039,Blue,0,75879,75914,35
2022-12-25,70038,70058,Blue,1,78014,78988,974
2022-09-02,70051,70047,Blue,0,58586,58782,196
2022-10-20,70040,70042,Blue,1,23405,23445,40
2022-08-21,70040,70050,Blue,1,54451,54966,515
2022-01-24,70044,70052,Blue,1,20603,21140,537
2022-03-17,70050,70056,Blue,1,66828,67157,329
2022-06-30,70051,70838,Blue,0,80798,81586,788
2022-02-20,70055,70041,Blue,0,22449,23240,791
2022-09-29,70040,70054,Blue,1,84219,85001,782
2022-06-10,70057,70043,Blue,0,68039,68834,795
2022-03-13,70051,70049,Blue,0,49879,49983,104
2022-02-12,70041,70838,Blue,0,20469,20598,129
2022-08-02,70050,70052,Blue,1,65596,65710,114
2022-01-06,70046,70052,Blue,1,57804,58127,323
2022-02-11,70044,70050,Blue,1,44356,44742,386
2022-12-24,70048,70050,Blue,1,60375,60434,59
2022-04-14,70047,70838,Blue,0,68140,68648,508
2022-11-07,70053,70039,Blue,0,26380,27181,801
2022-12-28,70057,70051,Blue,0,80079,80330,251
2022-02-22,70046,70060,Blue,1,26423,27189,766
2022-06-15,70042,70054,Blue,1,27394,28089,695
2022-07-17,70054,70056,Blue,1,37847,37893,46
2022-01-02,70038,70042,Blue,1,53448,53583,135
2022-11-01,70057,70041,Blue,0,20023,20985,962
2022-04-15,70051,70041,Blue,0,31280,31965,685
2022-12-29,70051,70838,Blue,0,53807,54500,693
2022-10-16,70053,70041,Blue,0,73541,74218,677
2022-03-13,70044,70054,Blue,1,52293,52875,582
2022-04-08,70045,70041,Blue,0,62445,62617,172
2022-10-07,70049,70039,Blue,0,63035,63553,518
2022-10-22,70054,70060,Blue,1,64578,64851,273
2022-01-05,70042,70054,Blue,1,90473,91188,715
2022-01-28,70046,70058,Blue,1,55424,56064,640
2022-09-13,70059,70838,Blue,0,65134,66199,1065
2022-12-28,70059,70049,Blue,0,44260,44748,488
2022-03-14,70038,70042,Blue,1,83117,83215,98
2022-01-06,70040,70054,Blue,1,25515,26261,746
2022-11-29,70040,70050,Blue,1,24599,25095,496
2022-06-17,70038,70058,Blue,1,30555,31630,1075
2022-11-08,70053,70051,Blue,0,37679,37740,61
2022-03-15,70055,70053,Blue,0,20047,20093,46
2022-04-14,70046,70058,Blue,1,40512,41170,658
2022-06-27,70048,70056,Blue,1,85489,85899,410
2022-06-29,70048,70050,Blue,1,51081,51136,55
2022-06-29,70046,70060,Blue,1,78703,79489,786
2022-08-21,70038,70052,Blue,1,65058,65791,733
2022-10-16,70042,70054,Blue,1,23155,24088,933
2022-03-16,70045,70043,Blue,0,82498,82590,92
2022-10-15,70055,70049,Blue,0,47235,47510,275
2022-08-12,70059,70055,Blue,0,40329,40484,155
2022-10-24,70040,70046,Blue,1,34987,35240,253
2022-03-29,70041,70039,Blue,0,40918,40951,33
2022-02-20,70053,70039,Blue,0,83278,84063,785
2022-03-30,70047,70045,Blue,0,57753,57842,89
2022-04-24,70044,70058,Blue,1,62577,63483,906
2022-10-14,70057,70838,Blue,0,26858,27970,1112
2022-12-06,70053,70051,Blue,0,35566,35620,54
2022-06-27,70050,70054,Blue,1,89035,89249,214
2022-12-12,70047,70039,Blue,0,35624,36072,448
2022-08-30,70055,70049,Blue,0,81249,81529,280
2022-12-16,70038,70058,Blue,1,28742,29769,1027
2022-09-26,70038,70054,Blue,1,53714,54541,827
2022-11-20,70046,70050,Blue,1,80184,80367,183
2022-03-24,70038,70042,Blue,1,31194,31303,109
2022-10-11,70048,70056,Blue,1,78818,79206,388
2022-04-22,70055,70053,Blue,0,32755,32810,55
2022-03-08,70038,70052,Blue,1,57733,58380,647
2022-03-12,70052,70054,Blue,1,83783,83846,63
2022-08-01,70046,70058,Blue,1,50632,51362,730
2022-03-13,70042,70060,Blue,1,51682,52619,937
2022-03-14,70045,70041,Blue,0,33704,33873,169
2022-11-11,70044,70058,Blue,1,71345,72179,834
2022-09-23,70056,70060,Blue,1,61186,61426,240
2022-04-12,70042,70052,Blue,1,54372,55036,664
2022-03-13,70053,70045,Blue,0,73072,73509,437
2022-01-14,70046,70056,Blue,1,72327,72814,487
2022-11-30,70038,70060,Blue,1,65142,66344,1202
2022-09-10,70051,70047,Blue,0,50704,50894,190
2022-07-10,70050,70056,Blue,1,27445,27740,295
2022-10-19,70057,70055,Blue,0,27932,28000,68
2022-04-11,70038,70050,Blue,1,43596,44162,566
2022-03-24,70040,70046,Blue,1,50851,51117,266
2022-02-04,70043,70039,Blue,0,43721,43848,127
2022-11-19,70051,70047,Blue,0,62696,62889,193
2022-10-09,70044,70050,Blue,1,81929,82287,358
2022-10-18,70049,70045,Blue,0,81110,81301,191
2022-03-09,70038,70048,Blue,1,53358,53853,495
2022-05-12,70056,70058,Blue,1,65177,65249,72
2022-01-18,70055,70041,Blue,0,55881,56654,773
2022-09-29,70049,70045,Blue,0,22290,22507,217
2022-06-29,70053,70049,Blue,0,35672,35945,273
2022-07-16,70049,70045,Blue,0,47561,47757,196
2022-02-16,70057,70051,Blue,0,49289,49550,261
2022-10-09,70039,70838,Blue,0,46824,46859,35
2022-11-18,70057,70055,Blue,0,37413,37481,68
2022-07-05,70047,70043,Blue,0,77072,77330,258
2022-04-19,70038,70042,Blue,1,49753,49855,102
2022-11-01,70059,70838,Blue,0,53535,54645,1110
2022-08-23,70047,70838,Blue,0,84485,84934,449
2022-03-18,70053,70041,Blue,0,61053,61663,610
2022-08-02,70055,70041,Blue,0,67180,67918,738
2022-10-31,70044,70054,Blue,1,50019,50592,573
2022-10-26,70059,70043,Blue,0,30163,31078,915
2022-04-02,70041,70838,Blue,0,41545,41659,114
2022-11-28,70044,70054,Blue,1,26684,27259,575
2022-06-10,70045,70039,Blue,0,53595,53900,305
2022-01-06,70053,70039,Blue,0,75815,76702,887
2022-02-01,70042,70058,Blue,1,82107,82989,882
2022-03-12,70043,70039,Blue,0,75604,75711,107
2022-07-06,70052,70060,Blue,1,88891,89209,318
2022-11-22,70042,70046,Blue,1,57745,57922,177
2022-01-04,70046,70054,Blue,1,91089,91511,422
2022-01-26,70057,70055,Blue,0,55372,55452,80
2022-12-24,70046,70050,Blue,1,49885,50060,175
2022-02-14,70059,70049,Blue,0,22038,22620,582
2022-07-13,70049,70043,Blue,0,40440,41034,594
2022-02-22,70057,70047,Blue,0,22999,23536,537
2022-07-06,70047,70043,Blue,0,20218,20507,289
2022-08-16,70053,70838,Blue,0,21744,22631,887
2022-03-25,70042,70046,Blue,1,67170,67359,189
2022-02-14,70051,70045,Blue,0,70876,71198,322
2022-07-21,70049,70047,Blue,0,26886,26941,55
2022-01-16,70040,70060,Blue,1,27883,28896,1013
2022-04-24,70045,70041,Blue,0,67484,67641,157
2022-10-06,70053,70047,Blue,0,70982,71260,278
2022-03-15,70038,70050,Blue,1,57134,57681,547
2022-12-27,70047,70045,Blue,0,69569,69675,106
2022-04-02,70038,70060,Blue,1,29110,30342,1232
2022-07-04,70055,70049,Blue,0,76756,77053,297
2022-01-13,70047,70043,Blue,0,59691,59927,236
2022-03-30,70057,70049,Blue,0,56070,56453,383
2022-12-14,70055,70043,Blue,0,59005,59685,680
2022-12-29,70048,70052,Blue,1,77510,77705,195
2022-09-15,70056,70058,Blue,1,43161,43246,85
2022-09-20,70052,70054,Blue,1,32111,32165,54
2022-10-30,70057,70041,Blue,0,32492,33347,855
2022-02-11,70045,70041,Blue,0,21038,21229,191
2022-11-30,70049,70047,Blue,0,66965,67024,59
2022-06-30,70051,70039,Blue,0,75008,75684,676
2022-05-17,70050,70052,Blue,1,32313,32437,124
2022-03-30,70055,70049,Blue,0,46812,47114,302
2022-08-18,70049,70045,Blue,0,55257,55496,239
2022-01-04,70047,70838,Blue,0,34178,34715,537
2022-08-24,70053,70043,Blue,0,50487,51123,636
2022-08-15,70038,70058,Blue,1,25930,26967,1037
2022-07-29,70059,70039,Blue,0,48386,49394,1008
2022-04-28,70054,70060,Blue,1,47752,47994,242
2022-05-12,70055,70049,Blue,0,69587,69950,363
2022-02-21,70038,70060,Blue,1,64754,65892,1138
2022-01-06,70038,70054,Blue,1,64927,65738,811
2022-11-09,70038,70040,Blue,1,31449,31464,15
2022-09-09,70047,70041,Blue,0,20539,20854,315
2022-08-31,70047,70045,Blue,0,23662,23766,104
2022-03-14,70044,70048,Blue,1,45998,46239,241
2022-09-05,70049,70041,Blue,0,59763,60192,429
2022-07-16,70050,70060,Blue,1,36802,37327,525
2022-03-14,70040,70048,Blue,1,27040,27468,428
2022-07-18,70052,70054,Blue,1,81455,81527,72
2022-07-26,70046,70060,Blue,1,31986,32785,799
2022-08-13,70051,70047,Blue,0,65249,65450,201
2022-06-29,70052,70058,Blue,1,41054,41369,315
2022-03-15,70049,70043,Blue,0,81096,81488,392
2022-01-04,70041,70039,Blue,0,87924,87961,37
2022-02-14,70049,70838,Blue,0,85149,85731,582
2022-06-22,70046,70056,Blue,1,77822,78368,546
2022-01-07,70040,70056,Blue,1,50847,51702,855
2022-08-16,70044,70052,Blue,1,25969,26479,510
2022-04-05,70049,70838,Blue,0,57110,57717,607
2022-02-22,70048,70060,Blue,1,76396,77009,613
2022-04-16,70055,70039,Blue,0,38054,38963,909
2022-04-10,70056,70058,Blue,1,69154,69227,73
2022-09-11,70042,70052,Blue,1,84754,85280,526
2022-10-22,70059,70053,Blue,0,50846,51067,221
2022-04-04,70038,70054,Blue,1,67656,68571,915
2022-09-11,70050,70056,Blue,1,86144,86448,304
2022-04-06,70057,70039,Blue,0,30631,31644,1013
2022-12-11,70044,70046,Blue,1,81913,82023,110
2022-04-01,70059,70043,Blue,0,22756,23987,1231
2022-03-10,70040,70060,Blue,1,50856,51953,1097
2022-07-23,70044,70058,Blue,1,33635,34417,782
2022-06-10,70046,70048,Blue,1,70325,70433,108
2022-10-30,70051,70039,Blue,0,43835,44502,667
2022-06-05,70047,70838,Blue,0,67183,67750,567
2022-09-08,70049,70045,Blue,0,31975,32193,218
2022-04-10,70051,70041,Blue,0,43827,44404,577
2022-04-13,70046,70052,Blue,1,65637,65975,338
2022-11-21,70054,70060,Blue,1,55345,55614,269
2022-08-11,70038,70056,Blue,1,56506,57432,926
2022-09-28,70038,70044,Blue,1,35777,35941,164
2022-02-06,70049,70041,Blue,0,73210,73614,404
2022-12-23,70040,70048,Blue,1,36390,36782,392
2022-11-19,70057,70838,Blue,0,59540,60546,1006
2022-03-03,70057,70041,Blue,0,55476,56361,885
2022-12-09,70047,70045,Blue,0,45398,45493,95
2022-10-12,70040,70044,Blue,1,74356,74480,124
2022-06-23,70042,70048,Blue,1,79241,79661,420
2022-02-27,70050,70054,Blue,1,41615,41814,199
2022-08-03,70059,70039,Blue,0,50416,51414,998
2022-10-07,70040,70058,Blue,1,78447,79419,972
2022-01-03,70053,70047,Blue,0,40121,40434,313
2022-12-28,70038,70050,Blue,1,21849,22411,562
2022-01-31,70051,70043,Blue,0,26465,27246,781
2022-11-29,70059,70045,Blue,0,76461,77166,705
2022-02-19,70040,70052,Blue,1,40052,40709,657
2022-11-06,70051,70039,Blue,0,35173,35824,651
2022-12-29,70055,70041,Blue,0,21054,21972,918
2022-01-24,70046,70060,Blue,1,62017,62829,812
2022-10-14,70040,70044,Blue,1,80709,80818,109
2022-03-07,70042,70050,Blue,1,56671,57049,378
2022-11-18,70059,70041,Blue,0,64081,65127,1046
2022-04-06,70057,70049,Blue,0,60770,61128,358
2022-01-12,70055,70053,Blue,0,34521,34587,66
2022-06-27,70038,70060,Blue,1,45249,46451,1202
2022-02-28,70047,70039,Blue,0,41609,42051,442
2022-09-16,70049,70047,Blue,0,59317,59376,59
2022-11-18,70057,70055,Blue,0,28442,28514,72
2022-09-23,70055,70043,Blue,0,29904,30708,804
2022-09-11,70041,70838,Blue,0,87323,87439,116
2022-03-14,70051,70838,Blue,0,22387,23230,843
2022-04-02,70054,70056,Blue,1,55364,55411,47
2022-06-14,70054,70058,Blue,1,80494,80645,151
2022-06-28,70051,70043,Blue,0,48728,49214,486
2022-04-04,70046,70054,Blue,1,22488,22924,436
2022-04-07,70049,70045,Blue,0,34085,34285,200
2022-10-18,70059,70043,Blue,0,27612,28529,917
2022-01-14,70053,70043,Blue,0,53880,54484,604
2022-02-27,70044,70058,Blue,1,25629,26362,733
2022-08-03,70053,70047,Blue,0,66713,67024,311
2022-11-26,70038,70060,Blue,1,42072,43120,1048
2022-03-02,70054,70056,Blue,1,49505,49552,47
2022-06-13,70049,70039,Blue,0,23622,24230,608
2022-02-15,70048,70052,Blue,1,76352,76561,209
2022-09-23,70045,70838,Blue,0,63769,64103,334
2022-12-12,70051,70047,Blue,0,87227,87428,201
2022-08-29,70043,70039,Blue,0,46627,46740,113
2022-07-06,70049,70838,Blue,0,31464,32085,621
2022-07-28,70056,70060,Blue,1,38459,38659,200
2022-02-17,70054,70056,Blue,1,24561,24610,49
2022-12-01,70048,70050,Blue,1,58084,58141,57
2022-08-15,70038,70040,Blue,1,43110,43125,15
2022-02-23,70048,70052,Blue,1,28084,28318,234
2022-09-01,70053,70049,Blue,0,25781,25981,200
2022-01-27,70048,70056,Blue,1,52669,53295,626
2022-10-09,70046,70050,Blue,1,71963,72146,183
2022-08-18,70041,70838,Blue,0,69245,69361,116
2022-07-05,70046,70058,Blue,1,77438,78069,631
2022-02-05,70040,70060,Blue,1,32943,33985,1042
2022-12-22,70042,70048,Blue,1,49440,49743,303
2022-06-17,70051,70043,Blue,0,58770,59283,513
2022-06-15,70051,70047,Blue,0,60894,61084,190
2022-09-26,70051,70043,Blue,0,56033,56514,481
2022-09-11,70042,70056,Blue,1,57075,57805,730
2022-04-02,70047,70039,Blue,0,40087,40491,404
2022-03-12,70042,70050,Blue,1,65447,65869,422
2022-12-12,70057,70043,Blue,0,68461,69242,781
2022-10-30,70057,70043,Blue,0,78988,79762,774
2022-04-04,70053,70047,Blue,0,54166,54477,311
2022-06-24,70040,70046,Blue,1,35238,35561,323
2022-09-10,70044,70050,Blue,1,46619,46955,336
2022-07-19,70043,70838,Blue,0,65667,65881,214
2022-01-26,70057,70051,Blue,0,74416,74665,249
2022-06-28,70047,70041,Blue,0,87112,87407,295
2022-04-19,70057,70043,Blue,0,47735,48502,767
2022-02-12,70052,70056,Blue,1,84539,84672,133
2022-09-10,70040,70050,Blue,1,30236,30681,445
2022-04-07,70045,70039,Blue,0,68642,68866,224
2022-06-14,70042,70048,Blue,1,50444,50781,337
2022-08-12,70050,70060,Blue,1,52437,52964,527
2022-07-06,70038,70052,Blue,1,32839,33586,747
2022-08-22,70048,70050,Blue,1,43117,43179,62
2022-02-27,70051,70043,Blue,0,27336,27790,454
2022-12-01,70048,70056,Blue,1,46071,46452,381
2022-05-18,70055,70838,Blue,0,64882,66547,1665
2022-10-13,70052,70060,Blue,1,87227,87573,346
2022-02-09,70040,70060,Blue,1,24064,25174,1110
2022-09-14,70046,70050,Blue,1,60027,60201,174
2022-08-17,70049,70039,Blue,0,74282,74779,497
2022-10-19,70038,70040,Blue,1,39599,39616,17
2022-07-23,70055,70045,Blue,0,77705,78246,541
2022-02-04,70046,70054,Blue,1,52687,53221,534
2022-05-30,70050,70052,Blue,1,58643,58835,192
2022-12-21,70039,70838,Blue,0,31999,32052,53
2022-09-07,70042,70054,Blue,1,26660,27336,676
2022-10-05,70054,70058,Blue,1,78647,78797,150
2022-03-29,70042,70056,Blue,1,38838,39874,1036
2022-08-24,70050,70052,Blue,1,52969,53086,117
2022-04-20,70040,70054,Blue,1,47768,48619,851
2022-08-09,70040,70060,Blue,1,69636,70797,1161
2022-11-14,70059,70053,Blue,0,67577,67798,221
2022-11-01,70051,70041,Blue,0,39833,40350,517
2022-09-30,70040,70044,Blue,1,39029,39145,116
2022-04-05,70040,70060,Blue,1,24915,26016,1101
2022-12-31,70052,70058,Blue,1,79049,79305,256
2022-05-14,70050,70054,Blue,1,51375,51599,224
2022-10-17,70042,70046,Blue,1,54537,54713,176
2022-03-24,70057,70041,Blue,0,76117,77030,913
2022-02-09,70051,70043,Blue,0,67195,67893,698
2022-06-20,70059,70047,Blue,0,53394,53965,571
2022-08-08,70040,70054,Blue,1,50885,51680,795
2022-11-04,70055,70051,Blue,0,20860,21046,186
2022-09-12,70050,70060,Blue,1,62910,63418,508
2022-01-13,70055,70047,Blue,0,30451,30870,419
2022-09-11,70049,70041,Blue,0,61350,61768,418
2022-02-17,70042,70050,Blue,1,62685,63097,412
2022-10-14,70052,70058,Blue,1,78008,78254,246
2022-06-15,70040,70044,Blue,1,78655,78768,113
2022-08-26,70041,70039,Blue,0,58962,58996,34
2022-11-08,70051,70043,Blue,0,45662,46170,508
2022-11-18,70045,70043,Blue,0,60108,60215,107
2022-03-19,70045,70043,Blue,0,39735,39830,95
2022-12-14,70059,70041,Blue,0,21787,23421,1634
2022-02-12,70045,70043,Blue,0,21650,21762,112
2022-09-26,70052,70056,Blue,1,27229,27394,165
2022-08-02,70042,70060,Blue,1,75918,76910,992
2022-08-23,70047,70039,Blue,0,44369,44846,477
2022-02-11,70046,70048,Blue,1,35453,35533,80
2022-02-03,70038,70042,Blue,1,89166,89249,83
2022-12-29,70054,70058,Blue,1,46294,46470,176
2022-03-02,70053,70041,Blue,0,65597,66264,667
2022-12-10,70058,70060,Blue,1,52271,52336,65
2022-01-16,70057,70043,Blue,0,45441,46315,874
2022-03-17,70040,70056,Blue,1,20520,21365,845
2022-04-23,70051,70039,Blue,0,24522,25182,660
2022-11-19,70038,70040,Blue,1,71776,71792,16
2022-02-23,70042,70048,Blue,1,38696,39035,339
2022-12-11,70046,70054,Blue,1,53573,53980,407
2022-08-14,70045,70041,Blue,0,57831,58010,179
2022-11-13,70048,70050,Blue,1,47173,47228,55
2022-01-19,70048,70050,Blue,1,45128,45183,55
2022-01-28,70038,70054,Blue,1,62228,63117,889
2022-11-14,70038,70046,Blue,1,22905,23227,322
2022-04-24,70048,70060,Blue,1,61215,61840,625
2022-09-10,70044,70048,Blue,1,56904,57130,226
2022-01-11,70051,70041,Blue,0,57854,58407,553
2022-07-24,70038,70052,Blue,1,75852,76621,769
2022-12-13,70039,70838,Blue,0,79171,79200,29
2022-04-06,70038,70052,Blue,1,26657,27424,767
2022-07-18,70042,70060,Blue,1,54382,55604,1222
2022-04-01,70047,70045,Blue,0,79550,79657,107
2022-09-03,70038,70054,Blue,1,55034,55885,851
2022-09-25,70049,70047,Blue,0,36082,36155,73
2022-10-30,70053,70051,Blue,0,56273,56334,61
2022-02-22,70047,70045,Blue,0,80757,80880,123
2022-12-28,70046,70058,Blue,1,25422,26058,636
2022-08-31,70051,70041,Blue,0,57030,57627,597
2022-11-05,70042,70058,Blue,1,24673,25572,899
2022-08-18,70053,70045,Blue,0,52254,52703,449
2022-01-15,70044,70058,Blue,1,67883,68754,871
2022-11-13,70038,70044,Blue,1,73701,73869,168
2022-09-02,70044,70058,Blue,1,30081,30846,765
2022-03-17,70040,70058,Blue,1,47016,48077,1061
2022-12-13,70038,70048,Blue,1,28992,29444,452
2022-04-06,70049,70043,Blue,0,55456,55784,328
2022-07-26,70053,70838,Blue,0,33334,34209,875
2022-07-12,70048,70058,Blue,1,78017,78569,552
2022-11-22,70049,70047,Blue,0,21309,21368,59
2022-07-12,70057,70051,Blue,0,26861,27134,273
2022-02-18,70044,70052,Blue,1,21382,21932,550
2022-11-22,70048,70050,Blue,1,30369,30429,60
2022-01-22,70046,70052,Blue,1,49492,49858,366
2022-05-23,70045,70838,Blue,0,57595,57964,369
2022-09-16,70053,70047,Blue,0,40972,41425,453
2022-10-09,70059,70051,Blue,0,82216,82541,325
2022-04-27,70054,70056,Blue,1,76947,76995,48
2022-02-25,70052,70058,Blue,1,86222,86496,274
2022-02-09,70059,70051,Blue,0,28749,29093,344
2022-08-29,70046,70060,Blue,1,53731,54474,743
2022-10-14,70057,70049,Blue,0,24330,24710,380
2022-09-06,70053,70049,Blue,0,35614,35825,211
2022-12-04,70059,70043,Blue,0,66270,67200,930
2022-02-09,70051,70041,Blue,0,76999,77597,598
2022-07-31,70038,70058,Blue,1,64507,65600,1093
2022-03-27,70039,70838,Blue,0,24182,24226,44
2022-04-15,70052,70056,Blue,1,63607,63741,134
2022-06-10,70054,70060,Blue,1,39914,40266,352
2022-10-23,70045,70838,Blue,0,61592,61919,327
2022-07-06,70049,70043,Blue,0,24731,25100,369
2022-02-28,70043,70838,Blue,0,56900,57102,202
2022-09-08,70051,70049,Blue,0,58581,58680,99
2022-12-13,70059,70041,Blue,0,21751,22755,1004
2022-03-28,70038,70050,Blue,1,41232,41790,558
2022-11-22,70059,70047,Blue,0,67096,67622,526
2022-11-17,70052,70056,Blue,1,31463,31594,131
2022-08-23,70046,70058,Blue,1,53834,54554,720
2022-03-27,70053,70041,Blue,0,67611,68309,698
2022-02-26,70048,70052,Blue,1,57175,57386,211
2022-12-17,70042,70050,Blue,1,27076,27451,375
2022-04-17,70044,70056,Blue,1,86635,87538,903
2022-08-04,70051,70047,Blue,0,58096,58286,190
2022-12-11,70049,70039,Blue,0,59857,60384,527
2022-07-31,70047,70039,Blue,0,30653,31049,396
2022-08-26,70059,70045,Blue,0,23008,23768,760
2022-03-06,70054,70060,Blue,1,64261,64512,251
2022-08-22,70050,70054,Blue,1,68238,68468,230
2022-07-12,70048,70052,Blue,1,32467,32677,210
2022-12-22,70049,70039,Blue,0,62620,63126,506
2022-09-10,70057,70055,Blue,0,38496,38563,67
2022-03-17,70038,70050,Blue,1,64633,65228,595
2022-06-19,70040,70052,Blue,1,28595,29311,716
2022-03-24,70059,70045,Blue,0,29356,30067,711
2022-02-09,70058,70060,Blue,1,66287,66441,154
2022-08-11,70051,70049,Blue,0,78679,78782,103
2022-03-31,70038,70040,Blue,1,75819,75833,14
2022-06-30,70055,70053,Blue,0,71313,71359,46
2022-06-09,70059,70051,Blue,0,22035,22384,349
2022-10-26,70040,70054,Blue,1,23337,24163,826
2022-08-25,70059,70043,Blue,0,22996,24091,1095
2022-07-28,70040,70042,Blue,1,60752,60786,34
2022-10-16,70040,70044,Blue,1,52150,52266,116
2022-04-10,70053,70045,Blue,0,35021,35461,440
2022-03-31,70044,70046,Blue,1,61302,61411,109
2022-04-04,70048,70056,Blue,1,84946,85360,414
2022-05-31,70046,70050,Blue,1,30934,31124,190
2022-03-07,70057,70838,Blue,0,30641,31754,1113
2022-03-18,70043,70041,Blue,0,40266,40297,31
2022-11-22,70052,70056,Blue,1,48446,48581,135
2022-08-25,70044,70048,Blue,1,77557,77802,245
2022-11-22,70042,70050,Blue,1,80780,81205,425
2022-07-05,70053,70045,Blue,0,72520,72964,444
2022-07-14,70055,70838,Blue,0,52757,53731,974
2022-01-28,70054,70060,Blue,1,30250,30516,266
2022-11-05,70051,70838,Blue,0,53382,54146,764
2022-12-05,70053,70039,Blue,0,30754,31515,761
2022-09-03,70042,70054,Blue,1,42204,42817,613
2022-02-17,70044,70058,Blue,1,27872,28702,830
2022-09-26,70047,70838,Blue,0,27889,28416,527
2022-09-03,70038,70040,Blue,1,45850,45864,14
2022-08-22,70053,70045,Blue,0,66444,67398,954
2022-03-21,70059,70049,Blue,0,20592,21064,472
2022-12-25,70049,70838,Blue,0,53296,53890,594
2022-07-20,70059,70057,Blue,0,27226,27260,34
2022-01-05,70045,70838,Blue,0,28348,28681,333
2022-06-23,70053,70045,Blue,0,32139,32650,511
2022-03-04,70051,70838,Blue,0,84390,85098,708
2022-04-09,70053,70043,Blue,0,78048,78658,610
2022-06-16,70041,70838,Blue,0,67223,67393,170
2022-11-12,70040,70046,Blue,1,56177,56472,295
2022-10-24,70050,70060,Blue,1,60945,61474,529
2022-09-14,70047,70039,Blue,0,46369,46802,433
2022-11-06,70040,70052,Blue,1,41063,41712,649
2022-09-26,70050,70060,Blue,1,52007,52516,509
2022-12-14,70046,70048,Blue,1,24739,24819,80
2022-04-15,70049,70041,Blue,0,51318,51785,467
2022-10-24,70045,70838,Blue,0,63158,63479,321
2022-03-13,70046,70048,Blue,1,84125,84217,92
2022-06-26,70052,70058,Blue,1,30812,31089,277
2022-03-01,70042,70050,Blue,1,46523,46921,398
2022-01-08,70052,70058,Blue,1,78465,78719,254
2022-06-30,70040,70054,Blue,1,56776,57628,852
2022-06-29,70055,70039,Blue,0,19717,20663,946
2022-04-14,70053,70041,Blue,0,64048,64698,650
2022-01-01,70043,70039,Blue,0,39723,39825,102
2022-12-06,70059,70057,Blue,0,47834,47874,40
2022-01-20,70055,70045,Blue,0,34883,35505,622
2022-03-23,70042,70056,Blue,1,77655,78513,858
2022-11-01,70059,70045,Blue,0,60904,61584,680
2022-12-19,70044,70048,Blue,1,20633,20869,236
2022-08-27,70050,70052,Blue,1,86467,86576,109
2022-04-21,70049,70047,Blue,0,26328,26389,61
2022-10-29,70049,70043,Blue,0,56731,57068,337
2022-07-08,70051,70049,Blue,0,29694,29803,109
2022-10-26,70056,70060,Blue,1,64093,64305,212
2022-09-02,70040,70052,Blue,1,71010,71654,644
2022-04-11,70047,70838,Blue,0,63034,63595,561
2022-07-17,70046,70050,Blue,1,45417,45607,190
2022-04-08,70053,70838,Blue,0,69342,70160,818
2022-07-10,70052,70056,Blue,1,88157,88319,162
2022-03-26,70049,70039,Blue,0,36760,37327,567
2022-02-05,70050,70052,Blue,1,28567,28672,105
2022-11-26,70038,70046,Blue,1,63675,64003,328
2022-10-19,70046,70054,Blue,1,33276,33740,464
2022-02-06,70042,70058,Blue,1,59940,60827,887
2022-07-02,70056,70058,Blue,1,43023,43093,70
2022-12-07,70044,70050,Blue,1,73394,73735,341
2022-04-17,70055,70039,Blue,0,67510,68325,815
2022-12-28,70050,70058,Blue,1,55650,56053,403
2022-04-01,70057,70045,Blue,0,63276,63891,615
2022-05-21,70057,70043,Blue,0,36873,37814,941
2022-03-09,70055,70043,Blue,0,87691,88312,621
2022-06-13,70057,70047,Blue,0,24339,24821,482
2022-06-28,70049,70039,Blue,0,32392,32989,597
2022-07-10,70038,70052,Blue,1,67206,67921,715
2022-11-18,70055,70041,Blue,0,26074,26867,793
2022-10-23,70054,70056,Blue,1,52968,53015,47
2022-04-12,70053,70045,Blue,0,34477,35016,539
2022-09-08,70046,70058,Blue,1,31232,31901,669
2022-01-05,70055,70045,Blue,0,54994,55533,539
2022-09-17,70047,70043,Blue,0,56980,57212,232
2022-07-06,70054,70060,Blue,1,59458,59749,291
2022-03-10,70045,70838,Blue,0,52881,53415,534
2022-06-22,70057,70047,Blue,0,69605,70059,454
2022-05-17,70055,70051,Blue,0,26977,27128,151
2022-11-09,70053,70051,Blue,0,58472,58526,54
2022-06-26,70048,70052,Blue,1,54009,54229,220
2022-10-16,70053,70039,Blue,0,82485,83208,723
2022-10-18,70059,70838,Blue,0,52294,53420,1126
2022-04-19,70057,70045,Blue,0,40507,41370,863
2022-04-20,70040,70042,Blue,1,37408,37442,34
2022-10-15,70044,70054,Blue,1,58472,59066,594
2022-04-20,70054,70058,Blue,1,65533,65898,365
2022-01-06,70038,70052,Blue,1,24550,25266,716
2022-02-05,70052,70054,Blue,1,55849,55900,51
2022-12-30,70055,70047,Blue,0,66600,66966,366
2022-02-15,70047,70041,Blue,0,62926,63342,416
2022-09-12,70057,70051,Blue,0,33573,33820,247
2022-07-16,70048,70052,Blue,1,40383,40579,196
2022-09-13,70053,70043,Blue,0,32121,32822,701
2022-12-23,70045,70041,Blue,0,55270,55432,162
2022-01-19,70042,70060,Blue,1,80483,81404,921
2022-06-09,70038,70054,Blue,1,87135,88023,888
2022-11-12,70043,70838,Blue,0,82408,82595,187
2022-12-06,70050,70058,Blue,1,84050,84471,421
2022-02-25,70039,70838,Blue,0,23160,23320,160
2022-11-22,70055,70053,Blue,0,28551,28596,45
2022-05-18,70053,70045,Blue,0,20151,21059,908
2022-02-09,70040,70056,Blue,1,51680,52529,849
2022-09-30,70057,70838,Blue,0,51073,52368,1295
2022-02-08,70059,70838,Blue,0,69978,71112,1134
2022-10-08,70041,70039,Blue,0,21906,21950,44
2022-08-13,70040,70042,Blue,1,64277,64310,33
2022-08-03,70048,70060,Blue,1,47444,48120,676
2022-08-29,70039,70838,Blue,0,23307,23342,35
2022-06-16,70048,70052,Blue,1,63727,63942,215
2022-12-29,70050,70060,Blue,1,85287,85805,518
2022-10-27,70059,70043,Blue,0,24258,25096,838
2022-04-05,70043,70838,Blue,0,29435,29634,199
2022-10-07,70042,70048,Blue,1,45683,45979,296
2022-08-15,70051,70045,Blue,0,18812,19193,381
2022-04-06,70040,70054,Blue,1,20737,21515,778
2022-10-31,70046,70054,Blue,1,22258,22749,491
2022-04-21,70055,70039,Blue,0,33457,34423,966
2022-12-06,70050,70058,Blue,1,35214,35646,432
2022-10-05,70040,70052,Blue,1,35343,35942,599
2022-05-18,70052,70060,Blue,1,51242,51641,399
2022-11-16,70049,70838,Blue,0,55605,56212,607
2022-07-14,70049,70045,Blue,0,50549,50754,205
2022-03-30,70049,70838,Blue,0,86261,86891,630
2022-07-16,70046,70056,Blue,1,64624,65142,518
2022-03-08,70042,70048,Blue,1,87315,87631,316
2022-02-17,70040,70044,Blue,1,57071,57207,136
2022-03-05,70052,70056,Blue,1,66555,66696,141
2022-10-06,70056,70058,Blue,1,27460,27532,72
2022-03-16,70050,70060,Blue,1,54611,55128,517
2022-07-22,70055,70045,Blue,0,68368,68901,533
2022-09-01,70059,70055,Blue,0,23877,24021,144
2022-09-30,70044,70056,Blue,1,39775,40456,681
2022-01-13,70053,70041,Blue,0,46941,47604,663
2022-04-21,70053,70049,Blue,0,62260,62456,196
2022-09-02,70055,70043,Blue,0,27796,28451,655
2022-06-14,70047,70838,Blue,0,27853,28424,571
2022-09-24,70054,70060,Blue,1,49934,50179,245
2022-07-14,70044,70050,Blue,1,25150,25526,376
2022-10-10,70046,70050,Blue,1,26843,27019,176
2022-12-14,70059,70045,Blue,0,57254,58110,856
2022-02-11,70042,70056,Blue,1,58797,59565,768
2022-03-07,70050,70060,Blue,1,63195,63796,601
2022-11-06,70049,70043,Blue,0,60795,61117,322
2022-02-23,70051,70041,Blue,0,29451,30041,590
2022-03-13,70058,70060,Blue,1,74229,74296,67
2022-03-29,70043,70039,Blue,0,59720,59847,127
2022-09-01,70050,70056,Blue,1,61831,62144,313
2022-10-22,70055,70041,Blue,0,27280,28074,794
2022-03-23,70044,70048,Blue,1,45467,45718,251
2022-12-27,70049,70838,Blue,0,62894,63577,683
2022-01-13,70038,70040,Blue,1,49754,49768,14
2022-04-15,70046,70048,Blue,1,26079,26151,72
2022-01-26,70057,70045,Blue,0,55829,56534,705
2022-03-19,70047,70041,Blue,0,29813,30154,341
2022-05-10,70059,70051,Blue,0,69859,70175,316
2022-06-23,70041,70838,Blue,0,26555,26683,128
2022-09-02,70041,70838,Blue,0,38606,38730,124
2022-03-07,70055,70043,Blue,0,21871,22546,675
2022-03-11,70055,70053,Blue,0,32291,32337,46
2022-08-10,70038,70046,Blue,1,46156,46495,339
2022-02-14,70040,70054,Blue,1,75945,76707,762
2022-06-15,70042,70052,Blue,1,68087,68730,643
2022-04-01,70057,70049,Blue,0,50786,51176,390
2022-12-20,70057,70045,Blue,0,20874,21634,760
2022-03-29,70041,70838,Blue,0,79997,80118,121
2022-04-17,70055,70047,Blue,0,35717,36075,358
2022-09-08,70046,70052,Blue,1,75099,75445,346
2022-08-02,70057,70049,Blue,0,23066,23460,394
2022-01-19,70048,70060,Blue,1,20339,20976,637
2022-11-25,70052,70056,Blue,1,56270,56417,147
2022-01-19,70042,70052,Blue,1,64483,65089,606
2022-11-14,70044,70054,Blue,1,24571,25231,660
2022-08-08,70048,70060,Blue,1,72130,72738,608
2022-09-03,70050,70058,Blue,1,30716,31094,378
2022-11-06,70040,70048,Blue,1,54316,54709,393
2022-12-08,70040,70056,Blue,1,48301,49111,810
2022-07-14,70051,70045,Blue,0,59315,59660,345
2022-09-04,70046,70054,Blue,1,70828,71263,435
2022-02-04,70058,70060,Blue,1,65673,65741,68
2022-04-19,70041,70039,Blue,0,71010,71043,33
2022-09-23,70044,70056,Blue,1,89336,90018,682
2022-03-15,70049,70045,Blue,0,29278,29485,207
2022-05-03,70054,70060,Blue,1,77013,77288,275
2022-09-27,70047,70043,Blue,0,84836,85079,243
2022-10-17,70046,70052,Blue,1,70902,71232,330
2022-10-13,70038,70046,Blue,1,42516,42872,356
2022-09-17,70051,70041,Blue,0,43635,44358,723
2022-04-13,70046,70052,Blue,1,33025,33389,364
2022-07-08,70047,70838,Blue,0,39963,40468,505
2022-08-04,70053,70041,Blue,0,25794,26480,686
2022-04-08,70059,70051,Blue,0,60804,61108,304
2022-06-23,70044,70056,Blue,1,79325,80140,815
2022-06-10,70055,70045,Blue,0,28062,28604,542
2022-01-09,70045,70838,Blue,0,77854,78169,315
2022-07-03,70055,70045,Blue,0,44843,45365,522
2022-06-25,70040,70054,Blue,1,80667,81640,973
2022-07-18,70053,70838,Blue,0,83800,84624,824
2022-05-20,70039,70838,Blue,0,40729,40759,30
2022-11-08,70045,70041,Blue,0,34176,34353,177
2022-10-12,70051,70045,Blue,0,57005,57358,353
2022-02-14,70051,70047,Blue,0,59986,60180,194
2022-07-31,70059,70045,Blue,0,63561,64266,705
2022-11-09,70050,70052,Blue,1,27031,27148,117
2022-01-22,70049,70043,Blue,0,27020,27317,297
2022-11-30,70051,70047,Blue,0,36200,36393,193
2022-11-17,70042,70058,Blue,1,67859,68715,856
2022-12-28,70046,70056,Blue,1,21524,22034,510
2022-03-25,70056,70058,Blue,1,62612,62694,82
2022-08-27,70055,70053,Blue,0,46156,46201,45
2022-02-10,70046,70054,Blue,1,35464,36076,612
2022-08-01,70044,70046,Blue,1,67151,67249,98
2022-01-23,70059,70055,Blue,0,65717,65855,138
2022-02-15,70041,70838,Blue,0,74746,74862,116
2022-05-19,70047,70838,Blue,0,61685,62298,613
2022-02-05,70055,70039,Blue,0,74239,75072,833
2022-10-01,70045,70043,Blue,0,51587,51677,90
2022-07-08,70055,70045,Blue,0,58637,59167,530
2022-04-02,70051,70043,Blue,0,74941,75392,451
2022-06-10,70054,70060,Blue,1,57459,58133,674
2022-02-12,70055,70051,Blue,0,80078,80265,187
2022-09-12,70044,70050,Blue,1,27700,28055,355
2022-02-03,70053,70043,Blue,0,36157,36709,552
2022-03-04,70046,70060,Blue,1,64487,65251,764
2022-10-10,70042,70048,Blue,1,57797,58120,323
2022-01-18,70040,70042,Blue,1,62583,62619,36
2022-06-18,70057,70039,Blue,0,27178,28158,980
2022-06-12,70057,70053,Blue,0,63091,63245,154
2022-03-08,70041,70039,Blue,0,66874,66908,34
2022-06-19,70040,70044,Blue,1,51629,51734,105
2022-12-24,70053,70838,Blue,0,62437,63259,822
2022-02-15,70042,70044,Blue,1,60902,60939,37
2022-04-18,70057,70838,Blue,0,39341,40537,1196
2022-03-23,70042,70054,Blue,1,36396,37134,738
2022-04-03,70048,70056,Blue,1,83635,84062,427
2022-08-03,70055,70043,Blue,0,68658,69324,666
2022-10-05,70048,70058,Blue,1,46769,47268,499
2022-11-07,70059,70838,Blue,0,50097,51196,1099
2022-12-25,70045,70838,Blue,0,48635,48973,338
2022-12-19,70055,70039,Blue,0,51798,52637,839
2022-03-30,70059,70047,Blue,0,84615,85164,549
2022-04-24,70045,70838,Blue,0,60183,60509,326
2022-01-02,70038,70040,Blue,1,25329,25346,17
2022-01-05,70057,70051,Blue,0,71626,71904,278
2022-01-11,70059,70043,Blue,0,31459,32402,943
2022-06-25,70049,70043,Blue,0,74308,74659,351
2022-07-29,70059,70055,Blue,0,61349,61538,189
2022-10-01,70056,70060,Blue,1,27220,27392,172
2022-01-20,70049,70838,Blue,0,41197,41830,633
2022-01-24,70042,70060,Blue,1,34015,35052,1037
2022-08-18,70048,70054,Blue,1,63467,63933,466
2022-06-19,70038,70052,Blue,1,28516,29311,795
2022-06-16,70051,70043,Blue,0,20960,21478,518
2022-09-20,70048,70060,Blue,1,40450,41126,676
2022-12-17,70059,70045,Blue,0,25447,26155,708
2022-06-10,70055,70041,Blue,0,61413,62247,834
2022-10-28,70059,70049,Blue,0,87678,88144,466
2022-07-09,70051,70838,Blue,0,22588,23469,881
2022-10-03,70059,70043,Blue,0,47922,48772,850
2022-02-17,70057,70039,Blue,0,71603,72601,998
2022-12-31,70038,70052,Blue,1,27492,28158,666
2022-09-23,70046,70054,Blue,1,20319,20773,454
2022-01-12,70057,70039,Blue,0,22283,23286,1003
2022-06-02,70042,70050,Blue,1,81195,81618,423
2022-08-15,70045,70039,Blue,0,66724,66990,266
2022-05-28,70039,70838,Blue,0,63476,63509,33
2022-07-24,70057,70053,Blue,0,78275,78432,157
2022-01-18,70057,70838,Blue,0,22843,24957,2114
2022-09-22,70041,70838,Blue,0,44728,44844,116
2022-10-12,70042,70054,Blue,1,70696,71337,641
2022-07-07,70042,70044,Blue,1,51020,51053,33
2022-07-15,70043,70041,Blue,0,23974,24003,29
2022-12-29,70059,70039,Blue,0,62851,63923,1072
2022-02-18,70053,70049,Blue,0,79212,79424,212
2022-07-26,70038,70044,Blue,1,68981,69151,170
2022-06-11,70049,70039,Blue,0,42713,43277,564
2022-11-18,70038,70050,Blue,1,76276,76872,596
2022-01-29,70044,70056,Blue,1,40276,42107,1831
2022-10-20,70045,70041,Blue,0,31188,31352,164
2022-06-07,70041,70838,Blue,0,69760,69877,117
2022-06-18,70042,70060,Blue,1,55194,56261,1067
2022-04-06,70055,70838,Blue,0,55774,56717,943
2022-03-13,70056,70060,Blue,1,43961,44137,176
2022-12-19,70059,70838,Blue,0,45496,46885,1389
2022-10-03,70049,70041,Blue,0,59254,59661,407
2022-11-03,70040,70060,Blue,1,25278,26308,1030
2022-06-12,70051,70047,Blue,0,72578,72776,198
2022-04-23,70044,70048,Blue,1,52065,52327,262
2022-02-08,70046,70060,Blue,1,35839,36807,968
2022-10-05,70045,70039,Blue,0,71998,72240,242
2022-01-24,70038,70058,Blue,1,31758,32926,1168
2022-12-12,70051,70049,Blue,0,27660,27762,102
2022-10-26,70053,70043,Blue,0,74943,75986,1043
2022-06-15,70048,70060,Blue,1,87128,87770,642
2022-05-29,70047,70039,Blue,0,38324,38796,472
2022-01-05,70057,70049,Blue,0,67605,68045,440
2022-02-23,70049,70041,Blue,0,23343,23877,534
2022-07-16,70055,70041,Blue,0,30501,31250,749
2022-05-23,70039,70838,Blue,0,75717,75752,35
2022-03-24,70051,70041,Blue,0,35589,36168,579
2022-04-11,70044,70046,Blue,1,57480,57582,102
2022-08-18,70046,70058,Blue,1,78211,78881,670
2022-11-12,70047,70043,Blue,0,31455,31696,241
2022-11-03,70038,70052,Blue,1,59637,60562,925
2022-11-27,70051,70041,Blue,0,52558,53105,547
2022-05-02,70050,70058,Blue,1,41112,41595,483
2022-11-03,70043,70041,Blue,0,23599,23628,29
2022-06-05,70049,70041,Blue,0,72425,72964,539
2022-05-01,70059,70051,Blue,0,87733,88122,389
2022-06-24,70040,70056,Blue,1,20119,21093,974
2022-07-07,70053,70041,Blue,0,25801,26521,720
2022-04-15,70046,70048,Blue,1,49651,49755,104
2022-02-22,70049,70043,Blue,0,24487,24869,382
2022-05-30,70041,70838,Blue,0,46594,46730,136
2022-04-30,70056,70058,Blue,1,48972,49044,72
2022-03-10,70053,70051,Blue,0,32045,32104,59
2022-10-16,70059,70051,Blue,0,47895,48214,319
2022-04-01,70059,70043,Blue,0,38662,39513,851
2022-10-20,70051,70045,Blue,0,18829,19221,392
2022-03-01,70038,70046,Blue,1,85490,85811,321
2022-12-19,70040,70050,Blue,1,22515,22997,482
2022-01-27,70051,70047,Blue,0,53558,53761,203
2022-10-19,70055,70838,Blue,0,59333,60226,893
2022-03-21,70044,70052,Blue,1,23338,23927,589
2022-08-12,70055,70838,Blue,0,79376,80252,876
2022-08-15,70038,70050,Blue,1,56477,57063,586
2022-10-25,70050,70054,Blue,1,58667,58875,208
2022-12-01,70042,70054,Blue,1,25351,26016,665
2022-10-06,70051,70043,Blue,0,74788,75272,484
2022-12-29,70059,70039,Blue,0,76401,77412,1011
2022-08-11,70057,70049,Blue,0,87503,87865,362
2022-07-09,70042,70056,Blue,1,30873,31640,767
2022-12-18,70043,70041,Blue,0,76939,76969,30
2022-07-21,70051,70049,Blue,0,54441,54545,104
2022-10-19,70043,70039,Blue,0,34105,34222,117
2022-07-22,70053,70047,Blue,0,24650,24934,284
2022-09-10,70055,70043,Blue,0,35358,35989,631
2022-10-19,70049,70838,Blue,0,25153,25786,633
2022-04-22,70049,70041,Blue,0,61026,61518,492
2022-07-30,70038,70042,Blue,1,21676,21764,88
2022-03-04,70045,70039,Blue,0,66053,66295,242
2022-10-02,70043,70039,Blue,0,74712,74891,179
2022-11-06,70055,70049,Blue,0,57287,57559,272
2022-04-20,70052,70058,Blue,1,28301,28553,252
2022-02-10,70048,70060,Blue,1,77949,78595,646
2022-05-19,70044,70050,Blue,1,33772,34246,474
2022-05-27,70049,70039,Blue,0,50550,51120,570
2022-11-23,70059,70041,Blue,0,78731,79620,889
2022-08-20,70057,70049,Blue,0,37601,38032,431
2022-02-03,70059,70039,Blue,0,85755,86749,994
2022-09-10,70040,70042,Blue,1,82232,82267,35
2022-09-24,70043,70041,Blue,0,79981,80010,29
2022-12-19,70047,70041,Blue,0,61197,61613,416
2022-06-28,70042,70056,Blue,1,46946,47726,780
2022-05-06,70055,70047,Blue,0,23605,24040,435
2022-07-03,70047,70043,Blue,0,44047,44314,267
2022-11-03,70051,70047,Blue,0,22534,22752,218
2022-07-09,70053,70045,Blue,0,37125,37557,432
2022-02-13,70041,70039,Blue,0,51628,51661,33
2022-10-12,70055,70045,Blue,0,71957,72480,523
2022-02-04,70048,70060,Blue,1,62343,62975,632
2022-12-20,70057,70047,Blue,0,64323,64809,486
2022-05-20,70052,70060,Blue,1,83736,84145,409
2022-04-11,70042,70046,Blue,1,67792,67959,167
2022-10-05,70057,70053,Blue,0,24582,24742,160
2022-03-16,70043,70039,Blue,0,71527,71630,103
2022-12-10,70038,70054,Blue,1,54487,55352,865
2022-09-22,70059,70838,Blue,0,53081,54300,1219
2022-02-21,70043,70838,Blue,0,21886,22094,208
2022-05-18,70040,70058,Blue,1,52030,53406,1376
2022-03-20,70040,70060,Blue,1,47040,48438,1398
2022-03-12,70040,70048,Blue,1,64285,64686,401
2022-02-07,70045,70039,Blue,0,80294,80549,255
2022-10-03,70057,70045,Blue,0,23920,24568,648
2022-01-15,70051,70838,Blue,0,36108,36903,795
2022-09-17,70043,70041,Blue,0,62566,62594,28
2022-11-16,70053,70051,Blue,0,32933,32987,54
2022-11-01,70038,70054,Blue,1,76701,77499,798
2022-07-24,70038,70052,Blue,1,44946,45640,694
2022-02-28,70057,70039,Blue,0,23734,24640,906
2022-07-07,70044,70060,Blue,1,23632,24570,938
2022-08-18,70047,70039,Blue,0,82494,82898,404
2022-06-18,70057,70055,Blue,0,39033,39101,68
2022-11-09,70040,70054,Blue,1,62791,63545,754
2022-06-09,70059,70039,Blue,0,35240,36357,1117
2022-04-13,70040,70056,Blue,1,68671,69506,835
2022-07-14,70039,70838,Blue,0,88465,88500,35
2022-02-20,70050,70054,Blue,1,30580,30774,194
2022-06-29,70057,70047,Blue,0,61835,62320,485
2022-12-26,70038,70042,Blue,1,79096,79202,106
2022-08-16,70049,70041,Blue,0,67569,67988,419
2022-10-28,70044,70046,Blue,1,47377,47481,104
2022-09-29,70057,70055,Blue,0,27694,27762,68
2022-03-22,70053,70041,Blue,0,21665,22376,711
2022-04-20,70053,70051,Blue,0,76914,76970,56
2022-01-05,70042,70048,Blue,1,86115,86412,297
2022-03-03,70044,70054,Blue,1,21554,22205,651
2022-02-20,70041,70039,Blue,0,61421,61456,35
2022-11-01,70038,70048,Blue,1,51375,51848,473
2022-01-22,70042,70052,Blue,1,70425,70979,554
2022-11-14,70052,70060,Blue,1,59435,59819,384
2022-02-13,70046,70058,Blue,1,81736,82462,726
2022-08-06,70055,70041,Blue,0,80064,80816,752
2022-11-29,70046,70056,Blue,1,37641,38176,535
2022-01-23,70043,70041,Blue,0,40486,40513,27
2022-11-16,70057,70053,Blue,0,81397,81549,152
2022-10-27,70054,70056,Blue,1,57707,57753,46
2022-03-24,70049,70043,Blue,0,80032,80409,377
2022-08-12,70057,70043,Blue,0,69209,70029,820
2022-05-22,70044,70046,Blue,1,34747,34897,150
2022-04-23,70049,70041,Blue,0,32425,32820,395
2022-03-31,70057,70045,Blue,0,79548,80259,711
2022-06-15,70042,70054,Blue,1,48816,49510,694
2022-04-17,70046,70060,Blue,1,79472,80322,850
2022-03-31,70038,70042,Blue,1,89790,91074,1284
2022-06-28,70057,70045,Blue,0,60006,60642,636
2022-06-13,70047,70041,Blue,0,19849,20255,406
2022-01-29,70040,70052,Blue,1,89326,90083,757
2022-05-14,70051,70049,Blue,0,31584,31689,105
2022-10-04,70048,70052,Blue,1,73725,73946,221
2022-03-11,70057,70039,Blue,0,31567,32516,949
2022-12-13,70052,70054,Blue,1,46858,46974,116
2022-01-14,70049,70043,Blue,0,26340,26726,386
2022-12-19,70044,70056,Blue,1,85861,86483,622
2022-05-05,70050,70060,Blue,1,59135,59720,585
2022-08-12,70049,70047,Blue,0,35052,35123,71
2022-03-17,70055,70047,Blue,0,38832,39220,388
2022-12-11,70053,70838,Blue,0,81815,82608,793
2022-11-16,70042,70048,Blue,1,53062,53388,326
2022-10-08,70053,70041,Blue,0,29503,30154,651
2022-07-20,70055,70838,Blue,0,43876,44845,969
2022-05-19,70055,70045,Blue,0,42263,43013,750
2022-07-18,70048,70054,Blue,1,76378,76697,319
2022-06-29,70058,70060,Blue,1,46366,46435,69
2022-11-15,70038,70052,Blue,1,31942,32640,698
2022-04-26,70058,70060,Blue,1,29082,29151,69
2022-06-13,70042,70058,Blue,1,55831,57069,1238
2022-11-11,70040,70050,Blue,1,37122,37679,557
2022-01-28,70051,70049,Blue,0,26473,26577,104
2022-12-10,70043,70838,Blue,0,36096,36302,206
2022-11-23,70055,70051,Blue,0,57380,57511,131
2022-02-21,70044,70050,Blue,1,39584,40005,421
2022-03-01,70057,70838,Blue,0,85234,86269,1035
2022-11-13,70051,70039,Blue,0,28108,28749,641
2022-07-29,70046,70052,Blue,1,31440,31768,328
2022-03-06,70042,70058,Blue,1,25469,26270,801
2022-12-05,70051,70049,Blue,0,20346,20459,113
2022-01-09,70059,70039,Blue,0,70057,71082,1025
2022-08-12,70053,70051,Blue,0,78680,78737,57
2022-10-18,70049,70045,Blue,0,63595,63777,182
2022-04-07,70055,70051,Blue,0,34033,34165,132
2022-04-12,70040,70048,Blue,1,54908,55330,422
2022-10-28,70038,70040,Blue,1,28212,28227,15
2022-11-15,70053,70039,Blue,0,37319,38162,843
2022-02-01,70055,70051,Blue,0,76804,76938,134
2022-10-17,70049,70838,Blue,0,58338,58990,652
2022-12-05,70052,70058,Blue,1,83490,83750,260
2022-10-26,70040,70046,Blue,1,27841,28116,275
2022-03-13,70051,70045,Blue,0,56888,57234,346
2022-05-31,70038,70048,Blue,1,76815,77340,525
2022-06-07,70044,70052,Blue,1,62532,63179,647
2022-08-17,70038,70052,Blue,1,51475,52235,760
2022-01-06,70057,70838,Blue,0,65687,66731,1044
2022-06-03,70048,70050,Blue,1,22480,22541,61
2022-02-08,70044,70058,Blue,1,76095,76919,824
2022-04-02,70055,70039,Blue,0,46701,47625,924
2022-07-19,70051,70039,Blue,0,57027,57690,663
2022-04-25,70059,70049,Blue,0,53075,53527,452
2022-03-09,70051,70045,Blue,0,52942,53278,336
2022-02-10,70059,70051,Blue,0,65602,65948,346
2022-08-06,70041,70838,Blue,0,85965,86094,129
2022-08-19,70052,70058,Blue,1,41591,41838,247
2022-06-25,70038,70056,Blue,1,24316,25238,922
2022-11-27,70059,70049,Blue,0,63047,63524,477
2022-01-10,70042,70052,Blue,1,21572,22279,707
2022-09-29,70044,70046,Blue,1,65559,65669,110
2022-08-27,70044,70046,Blue,1,41243,41344,101
2022-08-31,70049,70047,Blue,0,31513,31564,51
2022-10-16,70043,70041,Blue,0,75604,75632,28
2022-12-27,70057,70039,Blue,0,28446,29416,970
2022-12-09,70055,70039,Blue,0,23216,24120,904
2022-01-24,70052,70058,Blue,1,43180,43425,245
2022-12-01,70050,70054,Blue,1,82485,82689,204
2022-02-24,70051,70049,Blue,0,31586,31692,106
2022-09-11,70055,70053,Blue,0,28057,28103,46
2022-03-06,70045,70041,Blue,0,77260,77427,167
2022-09-07,70038,70044,Blue,1,66912,67105,193
2022-12-04,70050,70058,Blue,1,58527,58914,387
2022-11-13,70047,70045,Blue,0,70646,70742,96
2022-07-05,70059,70055,Blue,0,22172,22324,152
2022-03-01,70057,70039,Blue,0,50309,51212,903
2022-06-09,70057,70041,Blue,0,27096,28069,973
2022-10-29,70059,70039,Blue,0,85698,86847,1149
2022-02-28,70049,70039,Blue,0,32572,33058,486
2022-08-30,70057,70049,Blue,0,65550,65945,395
2022-11-29,70046,70052,Blue,1,40792,41132,340
2022-12-01,70038,70054,Blue,1,33196,34026,830
2022-12-09,70046,70058,Blue,1,25965,26576,611
2022-09-27,70047,70041,Blue,0,23714,24170,456
2022-09-30,70050,70056,Blue,1,39583,39910,327
2022-11-13,70038,70054,Blue,1,35467,36238,771
2022-04-08,70045,70043,Blue,0,31926,32063,137
2022-02-02,70053,70047,Blue,0,38409,38825,416
2022-10-11,70044,70054,Blue,1,25404,25975,571
2022-02-27,70049,70047,Blue,0,41952,42003,51
2022-01-10,70046,70048,Blue,1,55936,56037,101
2022-09-09,70038,70042,Blue,1,59595,59695,100
2022-03-13,70055,70838,Blue,0,24017,24931,914
2022-04-22,70038,70044,Blue,1,45793,45968,175
2022-08-06,70059,70045,Blue,0,54620,55341,721
2022-09-26,70049,70045,Blue,0,65171,65406,235
2022-01-07,70042,70046,Blue,1,21201,21384,183
2022-01-07,70044,70048,Blue,1,70768,70997,229
2022-02-15,70044,70054,Blue,1,26935,27573,638
2022-08-07,70047,70039,Blue,0,27518,27907,389
2022-02-08,70055,70051,Blue,0,60967,61104,137
2022-04-01,70048,70056,Blue,1,70694,71168,474
2022-09-28,70055,70838,Blue,0,82225,83049,824
2022-02-24,70040,70048,Blue,1,75853,76246,393
2022-09-19,70047,70838,Blue,0,27568,28148,580
2022-09-10,70044,70050,Blue,1,85806,86205,399
2022-02-24,70050,70056,Blue,1,28813,29115,302
2022-12-21,70046,70052,Blue,1,88067,88797,730
2022-06-22,70057,70047,Blue,0,63769,64265,496
2022-08-07,70057,70049,Blue,0,30184,30557,373
2022-10-01,70058,70060,Blue,1,46343,46403,60
2022-11-09,70053,70039,Blue,0,78930,79608,678
2022-10-01,70051,70838,Blue,0,31765,32510,745
2022-12-04,70053,70049,Blue,0,58935,59131,196
2022-10-21,70050,70052,Blue,1,28364,28478,114
2022-01-27,70042,70050,Blue,1,64180,64595,415
2022-10-09,70057,70051,Blue,0,48519,48759,240
2022-02-03,70055,70053,Blue,0,47296,47342,46
2022-05-30,70041,70039,Blue,0,68190,68231,41
2022-07-05,70058,70060,Blue,1,64833,64894,61
2022-04-16,70040,70060,Blue,1,46460,47530,1070
2022-04-26,70057,70053,Blue,0,78364,78522,158
2022-01-27,70057,70039,Blue,0,59669,60587,918
2022-03-28,70054,70060,Blue,1,32722,33074,352
2022-09-08,70046,70056,Blue,1,45677,46197,520
2022-09-14,70040,70060,Blue,1,24701,25804,1103
2022-03-17,70048,70050,Blue,1,66206,66268,62
2022-03-30,70049,70041,Blue,0,63394,63816,422
2022-11-26,70051,70047,Blue,0,45793,45994,201
2022-08-08,70045,70041,Blue,0,65544,65755,211
2022-06-28,70049,70047,Blue,0,66132,66187,55
2022-11-15,70048,70060,Blue,1,67623,68271,648
2022-02-05,70057,70047,Blue,0,43889,44360,471
2022-07-21,70047,70043,Blue,0,24887,25160,273
2022-07-10,70046,70048,Blue,1,33512,33584,72
2022-08-16,70045,70039,Blue,0,20386,20684,298
2022-06-29,70057,70049,Blue,0,20910,21287,377
2022-01-02,70050,70054,Blue,1,66183,66373,190
2022-10-12,70048,70058,Blue,1,77984,78484,500
2022-04-21,70057,70043,Blue,0,23132,23896,764
2022-07-14,70038,70042,Blue,1,21127,21230,103
2022-04-16,70040,70048,Blue,1,35135,35553,418
2022-11-03,70038,70046,Blue,1,37280,37659,379
2022-12-12,70040,70060,Blue,1,53418,54517,1099
2022-06-09,70044,70052,Blue,1,76161,76700,539
2022-02-22,70053,70049,Blue,0,22596,22805,209
2022-08-18,70053,70838,Blue,0,25264,26191,927
2022-10-20,70046,70048,Blue,1,64673,64750,77
2022-01-14,70054,70058,Blue,1,35427,35593,166
2022-11-03,70057,70045,Blue,0,23861,24503,642
2022-06-06,70040,70046,Blue,1,23892,24192,300
2022-09-10,70040,70054,Blue,1,81567,82374,807
2022-10-07,70043,70838,Blue,0,45064,45246,182
2022-03-02,70059,70838,Blue,0,48676,49771,1095
2022-02-04,70051,70049,Blue,0,24256,24362,106
2022-07-03,70051,70039,Blue,0,46112,46798,686
2022-10-09,70038,70048,Blue,1,51009,51485,476
2022-02-05,70057,70047,Blue,0,49287,49831,544
2022-11-05,70043,70041,Blue,0,38752,38780,28
2022-12-02,70051,70838,Blue,0,27456,28242,786
2022-10-22,70057,70041,Blue,0,79950,80885,935
2022-04-06,70059,70045,Blue,0,30851,31544,693
2022-10-05,70049,70039,Blue,0,60484,60950,466
2022-02-09,70050,70056,Blue,1,41318,41632,314
2022-11-06,70059,70055,Blue,0,44661,44803,142
2022-03-01,70038,70058,Blue,1,38077,39224,1147
2022-05-02,70057,70055,Blue,0,51864,51932,68
2022-03-30,70043,70838,Blue,0,27560,27777,217
2022-06-22,70046,70050,Blue,1,30686,30889,203
2022-08-31,70042,70056,Blue,1,37420,38183,763
2022-08-17,70046,70056,Blue,1,88558,89057,499
2022-02-09,70050,70056,Blue,1,52559,52847,288
2022-04-07,70048,70058,Blue,1,46543,47029,486
2022-04-19,70040,70046,Blue,1,86635,86912,277
2022-09-28,70042,70060,Blue,1,63073,64203,1130
2022-03-02,70043,70041,Blue,0,36159,36185,26
2022-08-02,70046,70052,Blue,1,84000,84341,341
2022-12-27,70056,70058,Blue,1,26537,26626,89
2022-07-06,70048,70050,Blue,1,85759,85812,53
2022-08-26,70054,70058,Blue,1,47013,47171,158
2022-11-20,70044,70058,Blue,1,89315,90116,801
2022-03-17,70046,70050,Blue,1,64418,64625,207
2022-02-09,70049,70043,Blue,0,52600,52960,360
2022-08-21,70053,70043,Blue,0,32680,33269,589
2022-03-21,70044,70056,Blue,1,51017,51755,738
2022-12-04,70044,70058,Blue,1,55581,56480,899
2022-07-09,70057,70043,Blue,0,79178,79938,760
2022-04-20,70041,70039,Blue,0,43824,43856,32
2022-06-10,70045,70041,Blue,0,87647,87841,194
2022-01-20,70054,70058,Blue,1,50580,50738,158
2022-05-05,70052,70058,Blue,1,38861,39148,287
2022-07-20,70040,70050,Blue,1,25050,25536,486
2022-12-20,70048,70056,Blue,1,32637,33033,396
2022-03-30,70040,70052,Blue,1,85447,86040,593
2022-08-30,70052,70060,Blue,1,59828,60180,352
2022-07-08,70040,70052,Blue,1,70767,71476,709
2022-04-06,70055,70039,Blue,0,28953,29828,875
2022-06-18,70042,70058,Blue,1,82311,83251,940
2022-12-01,70059,70057,Blue,0,44807,44847,40
2022-07-20,70043,70039,Blue,0,65241,65349,108
2022-02-28,70040,70060,Blue,1,32433,33777,1344
2022-11-20,70042,70056,Blue,1,38470,39176,706
2022-09-12,70049,70041,Blue,0,66518,66976,458
2022-08-30,70038,70040,Blue,1,26067,26083,16
2022-10-08,70055,70043,Blue,0,69386,70048,662
2022-01-28,70053,70047,Blue,0,63782,64080,298
2022-07-24,70051,70049,Blue,0,41198,41300,102
2022-07-07,70057,70041,Blue,0,68646,69526,880
2022-01-27,70049,70041,Blue,0,30243,30694,451
2022-03-18,70051,70049,Blue,0,83221,83325,104
2022-06-15,70049,70838,Blue,0,27835,28476,641
2022-10-11,70057,70039,Blue,0,22269,23307,1038
2022-10-09,70049,70838,Blue,0,63230,63821,591
2022-11-01,70041,70039,Blue,0,28802,28835,33
2022-08-08,70059,70057,Blue,0,32240,32275,35
2022-03-21,70039,70838,Blue,0,22869,22909,40
2022-10-25,70048,70050,Blue,1,71638,71694,56
2022-02-24,70057,70043,Blue,0,28842,29710,868
2022-08-31,70059,70057,Blue,0,38475,38529,54
2022-12-11,70038,70046,Blue,1,48319,48672,353
2022-02-26,70055,70053,Blue,0,88547,88612,65
2022-01-29,70050,70058,Blue,1,54246,54852,606
2022-10-26,70057,70055,Blue,0,72655,72722,67
2022-12-14,70050,70060,Blue,1,28448,28974,526
2022-12-28,70049,70047,Blue,0,49887,49942,55
2022-08-10,70043,70838,Blue,0,45220,45407,187
2022-10-27,70044,70058,Blue,1,76041,76857,816
2022-09-10,70044,70054,Blue,1,62786,63331,545
2022-07-25,70057,70055,Blue,0,60253,60335,82
2022-02-10,70055,70053,Blue,0,55265,55327,62
2022-11-16,70038,70042,Blue,1,53411,53519,108
2022-04-15,70042,70054,Blue,1,23494,24218,724
2022-03-09,70044,70060,Blue,1,41451,42350,899
2022-04-04,70042,70058,Blue,1,62097,62974,877
2022-04-18,70049,70838,Blue,0,26888,27542,654
2022-02-24,70059,70051,Blue,0,32957,33331,374
2022-03-15,70042,70046,Blue,1,55818,56002,184
2022-02-24,70045,70041,Blue,0,67282,67449,167
2022-05-20,70057,70039,Blue,0,56669,57708,1039
2022-12-14,70045,70039,Blue,0,53858,54116,258
2022-12-28,70059,70045,Blue,0,53034,53733,699
2022-03-30,70059,70838,Blue,0,25454,26726,1272
2022-07-01,70057,70041,Blue,0,30214,31084,870
2022-08-13,70048,70050,Blue,1,82730,82790,60
2022-04-02,70040,70058,Blue,1,38364,39309,945
2022-08-03,70040,70050,Blue,1,31276,31806,530
2022-08-01,70053,70047,Blue,0,36191,36513,322
2022-03-02,70055,70045,Blue,0,61203,61860,657
2022-03-14,70046,70056,Blue,1,43328,43816,488
2022-08-18,70047,70043,Blue,0,84662,84903,241
2022-01-21,70058,70060,Blue,1,83724,83795,71
2022-08-20,70042,70046,Blue,1,33609,33779,170
2022-06-20,70038,70044,Blue,1,61693,61881,188
2022-12-04,70055,70053,Blue,0,63202,63248,46
2022-07-29,70047,70045,Blue,0,80242,80353,111
2022-09-30,70059,70049,Blue,0,55102,55578,476
2022-11-11,70040,70050,Blue,1,71741,72281,540
2022-11-25,70040,70052,Blue,1,71100,71743,643
2022-03-27,70047,70039,Blue,0,36824,37240,416
2022-01-28,70038,70040,Blue,1,65535,65550,15
2022-12-08,70051,70041,Blue,0,47222,47781,559
2022-11-01,70046,70052,Blue,1,70905,71228,323
2022-02-09,70055,70047,Blue,0,32557,32964,407
2022-09-20,70038,70050,Blue,1,36747,37301,554
2022-06-25,70054,70060,Blue,1,53933,54212,279
2022-06-06,70040,70048,Blue,1,21228,21747,519
2022-05-04,70050,70060,Blue,1,62149,62704,555
2022-07-17,70053,70838,Blue,0,54119,54974,855
2022-09-27,70045,70043,Blue,0,31529,31645,116
2022-05-21,70057,70041,Blue,0,82418,83319,901
2022-03-18,70048,70054,Blue,1,28999,29298,299
2022-10-20,70055,70041,Blue,0,70874,71596,722
2022-10-28,70040,70048,Blue,1,76436,76837,401
2022-12-21,70058,70060,Blue,1,89959,90029,70
2022-04-08,70044,70052,Blue,1,59800,60298,498
2022-12-23,70046,70050,Blue,1,70867,71103,236
2022-02-28,70044,70052,Blue,1,71184,71674,490
2022-01-13,70059,70055,Blue,0,32666,32845,179
2022-02-24,70038,70052,Blue,1,74171,74980,809
2022-11-14,70044,70052,Blue,1,27226,27729,503
2022-04-17,70053,70045,Blue,0,23317,23719,402
2022-04-19,70050,70052,Blue,1,30470,30580,110
2022-03-04,70044,70060,Blue,1,42459,43350,891
2022-09-13,70042,70056,Blue,1,49394,50152,758
2022-07-17,70053,70043,Blue,0,43073,43654,581
2022-12-01,70051,70049,Blue,0,58082,58184,102
2022-09-07,70049,70047,Blue,0,60819,60872,53
2022-02-17,70040,70046,Blue,1,21648,21937,289
2022-02-23,70059,70049,Blue,0,63495,63986,491
2022-03-01,70038,70056,Blue,1,38077,39101,1024
2022-07-05,70057,70055,Blue,0,33157,33227,70
2022-04-05,70053,70043,Blue,0,64055,64623,568
2022-12-15,70038,70040,Blue,1,51921,51935,14
2022-11-01,70059,70041,Blue,0,67577,68453,876
2022-02-03,70046,70060,Blue,1,55005,55775,770
2022-12-17,70050,70060,Blue,1,58874,59411,537
2022-07-12,70048,70054,Blue,1,52079,52396,317
2022-09-16,70050,70058,Blue,1,87177,87580,403
2022-06-17,70052,70054,Blue,1,25713,25774,61
2022-10-08,70053,70041,Blue,0,35430,36067,637
2022-03-01,70053,70051,Blue,0,20854,20904,50
2022-01-05,70049,70838,Blue,0,65263,65846,583
2022-11-29,70057,70838,Blue,0,62969,64032,1063
2022-12-12,70053,70047,Blue,0,52222,52505,283
2022-03-15,70040,70058,Blue,1,22214,23080,866
2022-01-14,70041,70039,Blue,0,71064,71097,33
2022-08-09,70052,70056,Blue,1,22237,22399,162
2022-11-14,70038,70042,Blue,1,46170,46275,105
2022-04-01,70038,70056,Blue,1,56227,57138,911
2022-04-14,70038,70048,Blue,1,67338,67870,532
2022-06-26,70057,70045,Blue,0,73882,74470,588
2022-02-04,70038,70040,Blue,1,20308,20325,17
2022-03-11,70040,70048,Blue,1,21627,22039,412
2022-05-10,70050,70052,Blue,1,63080,63201,121
2022-01-26,70050,70060,Blue,1,61460,62021,561
2022-11-28,70040,70054,Blue,1,44685,45390,705
2022-09-14,70040,70044,Blue,1,78914,79034,120
2022-11-27,70059,70838,Blue,0,37430,38542,1112
2022-02-01,70054,70056,Blue,1,36156,36204,48
2022-12-22,70051,70039,Blue,0,20822,21493,671
2022-12-28,70053,70838,Blue,0,38309,39098,789
2022-04-07,70052,70060,Blue,1,52668,53195,527
2022-06-30,70044,70050,Blue,1,47758,48123,365
2022-10-24,70055,70041,Blue,0,78693,79414,721
2022-11-18,70042,70054,Blue,1,58001,58619,618
2022-08-21,70059,70045,Blue,0,34755,35458,703
2022-02-26,70053,70045,Blue,0,38735,39185,450
2022-07-30,70051,70039,Blue,0,31222,31897,675
2022-02-24,70042,70056,Blue,1,50698,51415,717
2022-10-20,70051,70041,Blue,0,41054,41642,588
2022-01-26,70043,70838,Blue,0,56600,56843,243
2022-10-01,70045,70039,Blue,0,22892,23135,243
2022-10-04,70040,70060,Blue,1,46700,47722,1022
2022-07-09,70055,70051,Blue,0,42919,43052,133
2022-04-22,70053,70051,Blue,0,64058,64114,56
2022-06-23,70053,70039,Blue,0,32139,33038,899
2022-12-28,70048,70054,Blue,1,61742,62076,334
2022-01-28,70046,70048,Blue,1,36086,36186,100
2022-05-29,70040,70052,Blue,1,24382,25194,812
2022-05-11,70059,70049,Blue,0,48320,48772,452
2022-12-07,70047,70039,Blue,0,58666,59085,419
2022-07-16,70045,70039,Blue,0,66699,66954,255
2022-01-22,70046,70048,Blue,1,40828,40923,95
2022-12-16,70049,70043,Blue,0,51076,51394,318
2022-12-19,70040,70046,Blue,1,58053,58340,287
2022-06-28,70059,70838,Blue,0,41599,42891,1292
2022-06-26,70048,70052,Blue,1,66822,67037,215
2022-03-21,70052,70058,Blue,1,30795,31059,264
2022-03-09,70046,70054,Blue,1,31223,31668,445
2022-03-01,70040,70048,Blue,1,44185,44647,462
2022-07-15,70046,70054,Blue,1,67389,67870,481
2022-02-23,70040,70054,Blue,1,87795,88492,697
2022-08-24,70038,70054,Blue,1,61609,62507,898
2022-07-03,70059,70045,Blue,0,72753,73448,695
2022-03-02,70038,70058,Blue,1,59236,60808,1572
2022-05-20,70059,70838,Blue,0,63199,64436,1237
2022-07-12,70051,70045,Blue,0,84576,84901,325
2022-08-26,70057,70838,Blue,0,38558,39580,1022
2022-10-31,70043,70838,Blue,0,31897,32092,195
2022-07-26,70051,70047,Blue,0,46779,46989,210
2022-11-08,70047,70039,Blue,0,70076,70457,381
2022-03-18,70042,70048,Blue,1,57048,57391,343
2022-02-10,70055,70043,Blue,0,25695,26413,718
2022-04-23,70055,70041,Blue,0,74813,75610,797
2022-04-16,70046,70060,Blue,1,68939,69693,754
2022-08-06,70038,70054,Blue,1,74479,75318,839
2022-04-08,70046,70050,Blue,1,27592,27767,175
2022-04-05,70053,70041,Blue,0,33208,33880,672
2022-07-19,70044,70048,Blue,1,24343,24598,255
2022-06-23,70049,70041,Blue,0,74287,74751,464
2022-03-08,70055,70051,Blue,0,70734,70892,158
2022-09-27,70057,70039,Blue,0,74975,75979,1004
2022-07-17,70045,70838,Blue,0,85394,85723,329
2022-08-10,70054,70056,Blue,1,52900,52946,46
2022-06-28,70049,70041,Blue,0,46297,46715,418
2022-09-27,70047,70838,Blue,0,27261,27944,683
2022-06-11,70040,70042,Blue,1,66432,66464,32
2022-04-13,70045,70043,Blue,0,61892,61995,103
2022-12-23,70055,70045,Blue,0,30423,30958,535
2022-09-17,70055,70049,Blue,0,31035,31303,268
2022-03-11,70053,70043,Blue,0,27826,28407,581
2022-09-12,70039,70838,Blue,0,73888,73922,34
2022-02-04,70057,70041,Blue,0,74086,75004,918
2022-12-20,70040,70048,Blue,1,53112,53499,387
2022-12-25,70057,70053,Blue,0,83844,83991,147
2022-12-03,70044,70052,Blue,1,56330,56823,493
2022-12-20,70052,70054,Blue,1,28673,28732,59
2022-11-26,70057,70045,Blue,0,21585,22226,641
2022-07-13,70042,70052,Blue,1,22107,22690,583
2022-04-14,70045,70041,Blue,0,45996,46179,183
2022-07-20,70046,70048,Blue,1,48076,48178,102
2022-01-17,70040,70058,Blue,1,88261,89206,945
2022-03-25,70038,70054,Blue,1,76336,77184,848
2022-01-26,70055,70049,Blue,0,42863,43228,365
2022-04-17,70059,70055,Blue,0,26952,27102,150
2022-03-27,70051,70047,Blue,0,67166,67370,204
2022-02-26,70044,70060,Blue,1,23886,24787,901
2022-06-16,70047,70045,Blue,0,86898,87002,104
2022-09-08,70040,70044,Blue,1,44724,44834,110
2022-02-08,70052,70054,Blue,1,56457,56510,53
2022-11-10,70057,70047,Blue,0,47263,47756,493
2022-12-29,70051,70838,Blue,0,73671,74383,712
2022-02-09,70038,70046,Blue,1,68416,68751,335
2022-05-20,70055,70047,Blue,0,26830,27202,372
2022-03-26,70038,70058,Blue,1,24312,25269,957
2022-03-30,70053,70043,Blue,0,20145,20698,553
2022-03-08,70052,70058,Blue,1,64249,64498,249
2022-02-18,70043,70039,Blue,0,51710,51822,112
2022-10-03,70050,70056,Blue,1,49409,49712,303
2022-04-07,70054,70056,Blue,1,25763,25811,48
2022-05-05,70049,70047,Blue,0,24819,24886,67
2022-04-19,70046,70058,Blue,1,25094,25750,656
2022-09-26,70044,70058,Blue,1,47585,48395,810
2022-06-18,70051,70043,Blue,0,20103,20622,519
2022-10-24,70038,70056,Blue,1,59174,60061,887
2022-11-30,70044,70054,Blue,1,55459,56133,674
2022-01-05,70042,70052,Blue,1,26192,26729,537
2022-08-11,70057,70051,Blue,0,68724,68952,228
2022-10-10,70053,70041,Blue,0,72515,73165,650
2022-06-29,70059,70039,Blue,0,63326,64376,1050
2022-08-24,70059,70053,Blue,0,59443,59677,234
2022-11-25,70047,70045,Blue,0,83392,83484,92
2022-12-16,70050,70054,Blue,1,75856,76069,213
2022-02-03,70044,70060,Blue,1,40364,41295,931
2022-08-25,70053,70047,Blue,0,58484,58776,292
2022-06-04,70047,70838,Blue,0,83359,83868,509
2022-04-10,70042,70050,Blue,1,59310,59752,442
2022-03-10,70053,70041,Blue,0,86018,86688,670
2022-11-11,70059,70047,Blue,0,73815,74376,561
2022-06-28,70050,70052,Blue,1,44528,44657,129
2022-09-22,70059,70057,Blue,0,25936,25974,38
2022-11-29,70059,70043,Blue,0,27936,28852,916
2022-10-01,70040,70044,Blue,1,73451,73559,108
2022-07-22,70059,70053,Blue,0,64997,65221,224
2022-07-11,70042,70058,Blue,1,55770,56685,915
2022-07-29,70053,70041,Blue,0,76310,77049,739
2022-11-16,70055,70041,Blue,0,42233,42996,763
2022-01-20,70040,70044,Blue,1,55462,55580,118
2022-05-05,70055,70053,Blue,0,80601,80646,45
2022-10-27,70057,70053,Blue,0,21548,21720,172
2022-08-11,70045,70838,Blue,0,21655,22038,383
2022-04-21,70055,70039,Blue,0,36020,36863,843
2022-01-26,70038,70050,Blue,1,64632,65207,575
2022-09-16,70046,70048,Blue,1,49024,49096,72
2022-05-20,70059,70045,Blue,0,31757,32533,776
2022-02-21,70055,70047,Blue,0,66675,67051,376
2022-03-02,70053,70039,Blue,0,59921,60704,783
2022-03-15,70045,70838,Blue,0,43589,43982,393
2022-09-15,70052,70056,Blue,1,41492,41668,176
2022-08-22,70057,70838,Blue,0,60690,61823,1133
2022-02-19,70053,70045,Blue,0,60298,60763,465
2022-03-05,70059,70045,Blue,0,47596,48326,730
2022-07-16,70042,70048,Blue,1,70447,70775,328
2022-10-06,70046,70048,Blue,1,67418,67506,88
2022-08-05,70040,70058,Blue,1,60293,61323,1030
2022-01-04,70042,70050,Blue,1,84386,84768,382
2022-12-15,70044,70060,Blue,1,49080,49951,871
2022-12-21,70042,70050,Blue,1,41904,42296,392
2022-05-31,70049,70041,Blue,0,35929,36474,545
2022-08-23,70058,70060,Blue,1,41956,42020,64
2022-03-16,70057,70045,Blue,0,73826,74456,630
2022-01-12,70040,70060,Blue,1,35100,36260,1160
2022-08-06,70044,70050,Blue,1,62975,63316,341
2022-03-26,70042,70056,Blue,1,21807,22612,805
2022-09-12,70046,70058,Blue,1,40214,40875,661
2022-06-25,70053,70049,Blue,0,84406,84718,312
2022-01-27,70057,70051,Blue,0,51272,51541,269
2022-07-15,70038,70044,Blue,1,23589,23767,178
2022-02-28,70051,70049,Blue,0,65103,65210,107
2022-04-05,70057,70055,Blue,0,58465,58533,68
2022-11-10,70038,70044,Blue,1,60265,60496,231
2022-02-07,70040,70046,Blue,1,42256,42538,282
2022-05-24,70040,70042,Blue,1,57521,57555,34
2022-01-09,70056,70058,Blue,1,62132,62206,74
2022-11-18,70042,70050,Blue,1,78168,78671,503
2022-08-02,70055,70047,Blue,0,29056,29466,410
2022-01-12,70043,70041,Blue,0,34908,34936,28
2022-05-11,70059,70051,Blue,0,65232,65554,322
2022-04-15,70042,70060,Blue,1,26490,27541,1051
2022-12-30,70045,70043,Blue,0,80056,80144,88
2022-01-07,70055,70053,Blue,0,76841,76904,63
2022-09-20,70042,70060,Blue,1,68654,69629,975
2022-07-06,70040,70056,Blue,1,22009,22988,979
2022-02-11,70038,70056,Blue,1,42429,43367,938
2022-05-11,70056,70060,Blue,1,23742,23902,160
2022-03-31,70038,70046,Blue,1,48068,48384,316
2022-10-21,70038,70046,Blue,1,24887,25214,327
2022-11-28,70042,70050,Blue,1,21278,21723,445
2022-05-02,70055,70053,Blue,0,45498,45547,49
2022-10-03,70059,70057,Blue,0,41808,41847,39
2022-06-27,70038,70046,Blue,1,58627,59028,401
2022-10-23,70038,70044,Blue,1,71532,71717,185
2022-01-13,70059,70039,Blue,0,78315,79347,1032
2022-01-25,70038,70052,Blue,1,73110,73837,727
2022-08-15,70053,70051,Blue,0,83723,83786,63
2022-01-21,70048,70050,Blue,1,82036,82102,66
2022-12-12,70055,70045,Blue,0,29478,30007,529
2022-01-15,70044,70054,Blue,1,86666,87385,719
2022-08-09,70053,70045,Blue,0,47077,47514,437
2022-05-20,70055,70039,Blue,0,63972,64995,1023
2022-09-22,70052,70060,Blue,1,85665,86027,362
2022-03-26,70047,70838,Blue,0,47651,48144,493
2022-09-10,70052,70058,Blue,1,26387,26637,250
2022-06-12,70038,70056,Blue,1,81667,82626,959
2022-12-20,70057,70047,Blue,0,72235,72785,550
2022-02-14,70041,70838,Blue,0,79895,80008,113
2022-09-27,70055,70051,Blue,0,31171,31315,144
2022-04-07,70045,70838,Blue,0,21305,21661,356
2022-12-15,70051,70043,Blue,0,20804,21318,514
2022-07-18,70050,70052,Blue,1,47754,47874,120
2022-02-08,70040,70050,Blue,1,30092,30613,521
2022-06-13,70044,70054,Blue,1,44876,45496,620
2022-06-06,70046,70052,Blue,1,77885,78358,473
2022-07-12,70050,70054,Blue,1,56165,56391,226
2022-03-07,70045,70043,Blue,0,64289,64390,101
2022-02-23,70053,70838,Blue,0,79169,80068,899
2022-01-04,70040,70050,Blue,1,24974,25499,525
2022-11-11,70052,70056,Blue,1,63471,63623,152
2022-01-19,70048,70058,Blue,1,29939,30454,515
2022-07-31,70047,70838,Blue,0,58201,58701,500
2022-08-15,70038,70040,Blue,1,28577,28593,16
2022-03-15,70059,70053,Blue,0,54206,54443,237
2022-08-06,70044,70058,Blue,1,37423,38224,801
2022-12-08,70040,70058,Blue,1,45609,46514,905
2022-11-17,70040,70050,Blue,1,58168,58656,488
2022-12-20,70046,70052,Blue,1,54707,55073,366
2022-03-02,70049,70045,Blue,0,81707,81921,214
2022-02-02,70042,70052,Blue,1,28295,28866,571
2022-07-28,70038,70056,Blue,1,47665,48665,1000
2022-03-15,70044,70048,Blue,1,73206,73477,271
2022-12-13,70049,70039,Blue,0,56778,57278,500
2022-10-31,70038,70042,Blue,1,90140,90968,828
2022-07-30,70055,70053,Blue,0,74269,74315,46
2022-10-25,70048,70054,Blue,1,49185,49597,412
2022-09-20,70049,70039,Blue,0,76420,76964,544
2022-09-17,70051,70039,Blue,0,27983,28646,663
2022-10-02,70059,70045,Blue,0,71906,72625,719
2022-03-08,70054,70060,Blue,1,63677,64023,346
2022-01-02,70050,70052,Blue,1,64007,64120,113
2022-07-08,70059,70055,Blue,0,30139,30280,141
2022-08-21,70049,70039,Blue,0,58116,58640,524
2022-01-23,70046,70052,Blue,1,62289,62657,368
2022-10-20,70044,70060,Blue,1,76956,77788,832
2022-10-13,70052,70056,Blue,1,61231,61395,164
2022-03-07,70044,70060,Blue,1,32859,33807,948
2022-04-27,70057,70049,Blue,0,69514,69915,401
2022-03-23,70044,70046,Blue,1,65172,65278,106
2022-01-10,70048,70050,Blue,1,41753,41822,69
2022-05-28,70042,70050,Blue,1,26189,26644,455
2022-09-11,70057,70055,Blue,0,71735,71803,68
2022-02-15,70040,70058,Blue,1,60812,61786,974
2022-12-11,70040,70044,Blue,1,86476,86586,110
2022-11-28,70048,70052,Blue,1,50024,50244,220
2022-10-02,70044,70054,Blue,1,81905,82488,583
2022-12-06,70040,70056,Blue,1,78374,79207,833
2022-09-14,70059,70051,Blue,0,51486,51803,317
2022-12-04,70048,70056,Blue,1,42248,42677,429
2022-05-20,70057,70041,Blue,0,60563,61507,944
2022-08-18,70053,70039,Blue,0,23820,24683,863
2022-06-12,70046,70048,Blue,1,70339,70418,79
2022-04-08,70042,70058,Blue,1,29485,30291,806
2022-11-18,70046,70060,Blue,1,89533,90290,757
2022-09-02,70055,70045,Blue,0,24430,24932,502
2022-07-14,70054,70056,Blue,1,62105,62152,47
2022-08-20,70059,70838,Blue,0,58393,59544,1151
2022-12-31,70057,70053,Blue,0,62931,63111,180
2022-02-22,70057,70051,Blue,0,49297,49555,258
2022-12-22,70041,70838,Blue,0,48129,48238,109
2022-12-10,70038,70060,Blue,1,50179,51284,1105
2022-03-06,70044,70046,Blue,1,56098,56199,101
2022-03-12,70044,70054,Blue,1,34194,34765,571
2022-03-26,70038,70042,Blue,1,25630,25723,93
2022-11-01,70055,70043,Blue,0,71960,72616,656
2022-06-25,70040,70048,Blue,1,84679,85153,474
2022-07-25,70046,70054,Blue,1,35692,36177,485
2022-08-11,70042,70050,Blue,1,37122,37555,433
2022-11-09,70043,70041,Blue,0,28988,29018,30
2022-03-25,70042,70058,Blue,1,45007,45833,826
2022-01-14,70057,70051,Blue,0,85241,85518,277
2022-08-28,70042,70058,Blue,1,58722,59644,922
2022-11-13,70038,70054,Blue,1,67959,68728,769
2022-07-01,70046,70056,Blue,1,56215,56802,587
2022-04-02,70042,70060,Blue,1,37897,38890,993
2022-06-16,70048,70060,Blue,1,83685,84316,631
2022-07-19,70038,70052,Blue,1,26214,26924,710
2022-12-12,70046,70060,Blue,1,31010,31809,799
2022-10-27,70059,70051,Blue,0,35310,35670,360
2022-10-31,70059,70053,Blue,0,41597,41831,234
2022-01-06,70047,70838,Blue,0,26104,26616,512
2022-01-14,70050,70052,Blue,1,49257,49364,107
2022-02-04,70055,70039,Blue,0,32507,33366,859
2022-10-10,70040,70056,Blue,1,43731,44580,849
2022-12-02,70046,70048,Blue,1,39235,39319,84
2022-06-10,70051,70039,Blue,0,19993,20710,717
2022-07-12,70042,70054,Blue,1,70676,71401,725
2022-12-22,70047,70041,Blue,0,33914,34254,340
2022-04-05,70038,70046,Blue,1,51199,51548,349
2022-11-14,70047,70045,Blue,0,51030,51124,94
2022-07-26,70039,70838,Blue,0,80456,80516,60
2022-06-15,70043,70838,Blue,0,43755,43954,199
2022-08-15,70038,70056,Blue,1,27869,28833,964
2022-02-04,70040,70044,Blue,1,67061,67178,117
2022-01-23,70059,70838,Blue,0,50053,51209,1156
2022-12-14,70048,70058,Blue,1,67544,68054,510
2022-03-23,70049,70039,Blue,0,35424,35947,523
2022-06-16,70057,70047,Blue,0,44419,45122,703
2022-12-15,70038,70044,Blue,1,61692,61927,235
2022-10-20,70041,70838,Blue,0,57708,57824,116
2022-12-21,70043,70041,Blue,0,21049,21080,31
2022-12-19,70052,70054,Blue,1,54994,55054,60
2022-06-25,70055,70838,Blue,0,21034,22032,998
2022-12-26,70050,70058,Blue,1,56984,57398,414
2022-11-05,70042,70044,Blue,1,21547,21578,31
2022-06-28,70055,70051,Blue,0,67309,67454,145
2022-11-10,70053,70041,Blue,0,39949,40581,632
2022-02-18,70057,70047,Blue,0,23758,24262,504
2022-07-26,70048,70050,Blue,1,30027,30081,54
2022-02-15,70059,70049,Blue,0,30498,31006,508
2022-11-16,70057,70045,Blue,0,64057,64652,595
2022-09-09,70042,70052,Blue,1,44993,45571,578
2022-08-02,70055,70049,Blue,0,83577,83833,256
2022-07-01,70038,70048,Blue,1,68110,68630,520
2022-10-23,70053,70838,Blue,0,49795,50645,850
2022-02-17,70040,70060,Blue,1,73047,74094,1047
2022-02-12,70057,70838,Blue,0,50379,51553,1174
2022-11-17,70038,70060,Blue,1,61165,62333,1168
2022-11-03,70053,70838,Blue,0,42885,43852,967
2022-12-16,70046,70052,Blue,1,76674,77006,332
2022-04-09,70051,70049,Blue,0,54977,55077,100
2022-09-30,70059,70039,Blue,0,33073,34120,1047
2022-12-05,70044,70054,Blue,1,30044,30643,599
2022-08-13,70047,70039,Blue,0,45018,45441,423
2022-01-18,70057,70045,Blue,0,71609,72322,713
2022-04-04,70040,70048,Blue,1,67098,67485,387
2022-06-30,70055,70049,Blue,0,60609,60932,323
2022-01-03,70051,70039,Blue,0,28788,29362,574
2022-12-03,70040,70042,Blue,1,58613,58644,31
2022-08-20,70059,70838,Blue,0,52992,54165,1173
2022-04-11,70040,70044,Blue,1,41289,41401,112
2022-03-03,70059,70057,Blue,0,24783,24819,36
2022-12-23,70053,70039,Blue,0,34115,34880,765
2022-03-15,70046,70060,Blue,1,39209,40102,893
2022-07-14,70044,70046,Blue,1,45599,45734,135
2022-11-11,70038,70058,Blue,1,60769,61913,1144
2022-09-30,70057,70051,Blue,0,26440,26701,261
2022-10-23,70038,70052,Blue,1,44329,45063,734
2022-09-29,70038,70054,Blue,1,66376,67195,819
2022-04-20,70042,70050,Blue,1,60009,60427,418
2022-06-30,70054,70058,Blue,1,86562,86820,258
2022-11-09,70050,70054,Blue,1,64456,64650,194
2022-10-15,70038,70054,Blue,1,80593,81481,888
2022-07-25,70053,70838,Blue,0,49738,50676,938
2022-10-06,70046,70054,Blue,1,55864,56300,436
2022-12-03,70059,70838,Blue,0,38954,40139,1185
2022-01-11,70044,70054,Blue,1,54760,55471,711
2022-01-15,70058,70060,Blue,1,63282,63346,64
2022-07-26,70052,70054,Blue,1,31802,31875,73
2022-04-06,70054,70056,Blue,1,58807,58856,49
2022-04-04,70047,70043,Blue,0,60495,60737,242
2022-11-08,70055,70047,Blue,0,79122,79491,369
2022-03-08,70049,70043,Blue,0,87966,88283,317
2022-03-02,70050,70056,Blue,1,69190,69475,285
2022-02-21,70054,70058,Blue,1,60066,60301,235
2022-03-10,70046,70054,Blue,1,37067,37482,415
2022-10-13,70053,70039,Blue,0,66291,67064,773
2022-09-21,70049,70041,Blue,0,39111,39622,511
2022-12-23,70047,70045,Blue,0,75302,75409,107
2022-01-14,70050,70058,Blue,1,56539,56961,422
2022-07-04,70044,70052,Blue,1,89361,89872,511
2022-03-17,70043,70039,Blue,0,34751,34860,109
2022-02-09,70049,70043,Blue,0,54698,55068,370
2022-11-19,70040,70052,Blue,1,42157,42985,828
2022-07-06,70049,70041,Blue,0,75392,75813,421
2022-10-05,70051,70047,Blue,0,71043,71232,189
2022-07-01,70044,70048,Blue,1,73083,73536,453
2022-06-24,70053,70039,Blue,0,76217,76982,765
2022-04-17,70048,70056,Blue,1,72589,73016,427
2022-02-13,70041,70838,Blue,0,57533,57656,123
2022-03-23,70039,70838,Blue,0,57364,57400,36
2022-10-06,70055,70043,Blue,0,65127,65785,658
2022-05-18,70048,70052,Blue,1,76491,76709,218
2022-01-21,70040,70042,Blue,1,24066,24099,33
2022-06-22,70045,70838,Blue,0,42071,42453,382
2022-10-11,70056,70060,Blue,1,62818,62997,179
2022-12-07,70057,70045,Blue,0,74980,75614,634
2022-09-23,70050,70052,Blue,1,33188,33311,123
2022-04-09,70059,70051,Blue,0,41656,42006,350
2022-01-25,70051,70043,Blue,0,34239,34782,543
2022-08-01,70038,70046,Blue,1,76265,76560,295
2022-09-06,70040,70054,Blue,1,29489,30234,745
2022-01-26,70051,70045,Blue,0,32771,33125,354
2022-12-08,70042,70054,Blue,1,30000,30666,666
2022-04-20,70040,70056,Blue,1,64128,65001,873
2022-12-31,70059,70051,Blue,0,53003,53322,319
2022-10-21,70051,70039,Blue,0,45702,46343,641
2022-10-19,70055,70043,Blue,0,28685,29412,727
2022-09-02,70055,70047,Blue,0,75164,75518,354
2022-10-14,70046,70056,Blue,1,46531,47057,526
2022-06-10,70053,70039,Blue,0,25152,25959,807
2022-01-07,70055,70047,Blue,0,70152,70525,373
2022-04-04,70051,70045,Blue,0,21377,21752,375
2022-01-17,70057,70049,Blue,0,67655,68064,409
2022-05-11,70055,70047,Blue,0,64578,64959,381
2022-03-11,70051,70045,Blue,0,19540,19917,377
2022-07-26,70057,70049,Blue,0,67716,68098,382
2022-02-07,70038,70048,Blue,1,60132,60604,472
2022-01-04,70059,70045,Blue,0,52102,52846,744
2022-01-14,70050,70060,Blue,1,47592,48137,545
2022-08-05,70056,70058,Blue,1,67211,67285,74
2022-01-01,70038,70056,Blue,1,65754,66746,992
2022-01-28,70055,70047,Blue,0,21860,22262,402
2022-11-04,70059,70053,Blue,0,34387,34612,225
2022-02-11,70040,70044,Blue,1,53788,53893,105
2022-03-02,70059,70838,Blue,0,57199,58288,1089
2022-05-18,70044,70046,Blue,1,52250,52413,163
2022-07-14,70058,70060,Blue,1,68025,68094,69
2022-11-06,70042,70060,Blue,1,78152,79160,1008
2022-11-29,70040,70046,Blue,1,80844,81101,257
2022-08-10,70057,70053,Blue,0,86697,86847,150
2022-10-15,70055,70045,Blue,0,25011,25566,555
2022-08-07,70057,70051,Blue,0,30985,31226,241
2022-03-07,70044,70046,Blue,1,54220,54324,104
2022-04-12,70045,70838,Blue,0,44815,45194,379
2022-05-21,70038,70044,Blue,1,77380,77560,180
2022-09-09,70057,70047,Blue,0,69631,70144,513
2022-12-22,70038,70042,Blue,1,34884,34973,89
2022-09-11,70044,70058,Blue,1,64186,64953,767
2022-04-01,70038,70058,Blue,1,66136,67404,1268
2022-06-25,70049,70047,Blue,0,58224,58278,54
2022-07-19,70049,70838,Blue,0,48880,49474,594
2022-09-28,70052,70054,Blue,1,32728,32783,55
2022-09-27,70052,70060,Blue,1,56224,56574,350
2022-12-21,70052,70054,Blue,1,29004,29054,50
2022-09-02,70053,70041,Blue,0,64228,64918,690
2022-06-25,70048,70052,Blue,1,81313,81532,219
2022-01-11,70038,70058,Blue,1,56286,57470,1184
2022-04-18,70052,70054,Blue,1,79079,79136,57
2022-10-06,70038,70044,Blue,1,58030,58209,179
2022-08-29,70055,70039,Blue,0,76096,76947,851
2022-11-30,70059,70049,Blue,0,53538,54047,509
2022-01-18,70041,70039,Blue,0,83802,83838,36
2022-08-26,70056,70058,Blue,1,29695,29781,86
2022-10-21,70055,70051,Blue,0,48029,48178,149
2022-11-14,70038,70040,Blue,1,73146,73164,18
2022-08-31,70040,70042,Blue,1,64371,64401,30
2022-08-25,70050,70052,Blue,1,46517,46648,131
2022-04-17,70043,70838,Blue,0,73170,73377,207
2022-03-01,70059,70055,Blue,0,24555,24708,153
2022-03-01,70041,70838,Blue,0,28037,28180,143
2022-12-04,70039,70838,Blue,0,79354,79388,34
2022-10-11,70049,70047,Blue,0,40920,40977,57
2022-03-14,70046,70048,Blue,1,28841,28935,94
2022-06-28,70047,70039,Blue,0,82566,82955,389
2022-10-05,70052,70058,Blue,1,22537,22809,272
2022-05-22,70041,70039,Blue,0,83949,83989,40
2022-05-30,70039,70838,Blue,0,25621,25658,37
2022-04-11,70046,70060,Blue,1,65943,66782,839
2022-01-23,70038,70048,Blue,1,41649,42169,520
2022-01-26,70059,70053,Blue,0,53901,54159,258
2022-10-25,70059,70047,Blue,0,35363,36032,669
2022-10-28,70057,70049,Blue,0,45324,45766,442
2022-03-25,70055,70045,Blue,0,33453,34040,587
2022-02-28,70052,70058,Blue,1,33087,33349,262
2022-02-11,70040,70050,Blue,1,22231,22682,451
2022-09-04,70057,70051,Blue,0,30945,31181,236
2022-08-22,70050,70058,Blue,1,69938,70820,882
2022-07-17,70059,70055,Blue,0,38848,38991,143
2022-05-25,70040,70050,Blue,1,69509,70083,574
2022-04-16,70051,70049,Blue,0,66400,66507,107
2022-08-08,70044,70056,Blue,1,25595,26309,714
2022-03-08,70042,70060,Blue,1,77020,77945,925
2022-08-02,70057,70043,Blue,0,34470,35244,774
2022-02-08,70045,70039,Blue,0,88216,88437,221
2022-03-10,70048,70060,Blue,1,39568,40311,743
2022-04-21,70038,70060,Blue,1,32946,34103,1157
2022-02-07,70059,70047,Blue,0,85153,85736,583
2022-02-26,70043,70838,Blue,0,55606,55808,202
2022-04-19,70046,70056,Blue,1,69841,70414,573
2022-11-25,70046,70060,Blue,1,47487,48248,761
2022-08-08,70049,70047,Blue,0,81715,81767,52
2022-01-21,70057,70041,Blue,0,31231,32532,1301
2022-03-19,70049,70039,Blue,0,84511,85012,501
2022-10-10,70058,70060,Blue,1,36273,36333,60
2022-09-21,70053,70043,Blue,0,64242,65143,901
2022-03-28,70059,70055,Blue,0,19520,19668,148
2022-12-21,70040,70042,Blue,1,54657,54687,30
2022-10-14,70038,70054,Blue,1,57140,57962,822
2022-07-05,70043,70039,Blue,0,27739,27861,122
2022-03-23,70055,70051,Blue,0,34425,34588,163
2022-11-28,70053,70051,Blue,0,74620,74676,56
2022-02-12,70057,70045,Blue,0,63410,64052,642
2022-03-09,70043,70039,Blue,0,47538,47652,114
2022-10-28,70059,70043,Blue,0,26479,27407,928
2022-01-04,70040,70052,Blue,1,23483,24163,680
2022-03-07,70057,70051,Blue,0,20301,20553,252
2022-08-01,70045,70041,Blue,0,46571,46759,188
2022-09-08,70049,70039,Blue,0,47433,47942,509
2022-08-03,70040,70044,Blue,1,75987,76099,112
2022-03-06,70059,70039,Blue,0,51671,52725,1054
2022-03-02,70059,70055,Blue,0,38116,38268,152
2022-11-25,70047,70045,Blue,0,24080,24172,92
2022-11-30,70047,70039,Blue,0,30290,30785,495
2022-08-25,70048,70054,Blue,1,62574,62877,303
2022-03-08,70040,70048,Blue,1,56349,56834,485
2022-03-31,70053,70047,Blue,0,76329,76648,319
2022-02-22,70048,70056,Blue,1,50234,50593,359
2022-03-24,70049,70039,Blue,0,76559,77118,559
2022-08-11,70050,70054,Blue,1,36006,36246,240
2022-01-13,70038,70046,Blue,1,57191,57515,324
2022-08-24,70040,70042,Blue,1,45608,45644,36
2022-08-24,70042,70046,Blue,1,57824,58005,181
2022-02-09,70043,70039,Blue,0,71864,71963,99
2022-01-05,70045,70043,Blue,0,57683,57777,94
2022-11-29,70057,70049,Blue,0,48932,49304,372
2022-12-29,70038,70046,Blue,1,66292,66601,309
2022-07-12,70059,70039,Blue,0,55445,56440,995
2022-03-17,70040,70060,Blue,1,64408,66036,1628
2022-06-27,70046,70050,Blue,1,62069,62273,204
2022-04-27,70056,70058,Blue,1,29832,29901,69
2022-12-22,70038,70054,Blue,1,53608,54466,858
2022-08-05,70043,70041,Blue,0,32258,32287,29
2022-03-17,70050,70060,Blue,1,55750,56277,527
2022-07-11,70054,70060,Blue,1,69492,69796,304
2022-11-15,70044,70048,Blue,1,23693,23944,251
2022-11-04,70040,70060,Blue,1,79523,80593,1070
2022-10-07,70044,70058,Blue,1,24699,25535,836
2022-09-07,70057,70053,Blue,0,41058,41222,164
2022-04-23,70059,70055,Blue,0,42198,42345,147
2022-12-29,70048,70058,Blue,1,85618,86101,483
2022-07-12,70055,70838,Blue,0,53509,54459,950
2022-11-21,70052,70060,Blue,1,86462,86820,358
2022-01-18,70048,70058,Blue,1,87730,88227,497
2022-02-10,70052,70054,Blue,1,40890,40952,62
2022-08-01,70059,70049,Blue,0,30564,31085,521
2022-12-07,70045,70039,Blue,0,26209,26463,254
2022-07-20,70047,70041,Blue,0,50858,51247,389
2022-01-12,70053,70041,Blue,0,28441,29143,702
2022-07-18,70038,70058,Blue,1,50313,51370,1057
2022-04-18,70038,70042,Blue,1,49222,49321,99
2022-01-04,70046,70054,Blue,1,20542,21060,518
2022-07-31,70059,70047,Blue,0,77595,78164,569
2022-01-07,70057,70045,Blue,0,70050,70648,598
2022-01-08,70042,70054,Blue,1,68705,69352,647
2022-07-27,70040,70060,Blue,1,89162,90156,994
2022-03-24,70041,70838,Blue,0,80959,81065,106
2022-07-15,70038,70044,Blue,1,47979,48171,192
2022-10-15,70042,70058,Blue,1,54671,55586,915
2022-08-20,70040,70054,Blue,1,56207,57010,803
2022-09-09,70038,70040,Blue,1,41628,41644,16
2022-02-07,70043,70039,Blue,0,25169,25279,110
2022-06-17,70053,70041,Blue,0,85435,86140,705
2022-07-18,70040,70060,Blue,1,31655,32887,1232
2022-01-21,70048,70058,Blue,1,76318,76839,521
2022-07-13,70055,70838,Blue,0,46155,47228,1073
2022-05-24,70046,70052,Blue,1,44651,45653,1002
2022-10-27,70059,70049,Blue,0,24258,24714,456
2022-11-23,70050,70058,Blue,1,86332,86743,411
2022-07-04,70045,70838,Blue,0,59148,59524,376
2022-08-03,70051,70838,Blue,0,74145,74871,726
2022-10-02,70051,70047,Blue,0,31188,31428,240
2022-12-02,70042,70048,Blue,1,54095,54390,295
2022-07-04,70038,70048,Blue,1,28032,28498,466
2022-12-04,70047,70039,Blue,0,75510,75917,407
2022-11-27,70055,70041,Blue,0,64813,65535,722
2022-08-25,70057,70047,Blue,0,48579,49082,503
2022-09-15,70052,70058,Blue,1,56865,57112,247
2022-04-11,70048,70060,Blue,1,32337,32947,610
2022-11-05,70043,70041,Blue,0,31265,31296,31
2022-02-23,70059,70041,Blue,0,52520,53489,969
2022-12-09,70050,70060,Blue,1,70639,71147,508
2022-12-06,70057,70049,Blue,0,79361,79731,370
2022-02-03,70052,70054,Blue,1,65437,65493,56
2022-03-21,70056,70060,Blue,1,58725,58948,223
2022-12-25,70040,70056,Blue,1,70507,71318,811
2022-12-28,70047,70045,Blue,0,52355,52446,91
2022-02-08,70045,70041,Blue,0,37257,37500,243
2022-07-13,70050,70060,Blue,1,63932,64506,574
2022-10-23,70056,70060,Blue,1,34767,34930,163
2022-03-16,70042,70056,Blue,1,28627,29464,837
2022-09-09,70046,70050,Blue,1,73564,73737,173
2022-06-17,70040,70054,Blue,1,56324,57114,790
2022-07-12,70051,70043,Blue,0,24271,24830,559
2022-09-15,70055,70047,Blue,0,38683,39068,385
2022-04-18,70057,70051,Blue,0,63564,63799,235
2022-12-10,70055,70047,Blue,0,28885,29261,376
2022-03-04,70055,70039,Blue,0,45162,45972,810
2022-03-14,70046,70058,Blue,1,59936,60559,623
2022-02-09,70044,70060,Blue,1,60645,61713,1068
2022-03-05,70053,70041,Blue,0,26802,27406,604
2022-09-23,70057,70045,Blue,0,88241,88902,661
2022-07-06,70049,70039,Blue,0,71194,71719,525
2022-12-13,70055,70039,Blue,0,80208,81003,795
2022-09-30,70042,70052,Blue,1,35966,36522,556
2022-12-31,70038,70052,Blue,1,69107,69814,707
2022-04-15,70038,70044,Blue,1,31154,31327,173
2022-11-24,70052,70054,Blue,1,82530,82588,58
2022-11-07,70038,70046,Blue,1,27576,27959,383
2022-12-17,70057,70041,Blue,0,43917,44772,855
2022-07-15,70044,70050,Blue,1,86699,87059,360
2022-11-22,70044,70058,Blue,1,40097,41006,909
2022-02-09,70040,70044,Blue,1,70680,70788,108
2022-12-21,70045,70039,Blue,0,72106,72326,220
2022-10-23,70050,70056,Blue,1,37645,37915,270
2022-11-24,70047,70045,Blue,0,49000,49091,91
2022-03-20,70041,70039,Blue,0,58554,58584,30
2022-09-17,70049,70039,Blue,0,82817,83322,505
2022-04-30,70053,70049,Blue,0,30277,30472,195
2022-02-15,70059,70051,Blue,0,85751,86096,345
2022-01-07,70047,70039,Blue,0,66556,66946,390
2022-08-06,70053,70047,Blue,0,64589,64869,280
2022-07-04,70051,70049,Blue,0,78828,78934,106
2022-08-11,70049,70047,Blue,0,61838,61894,56
2022-03-11,70040,70048,Blue,1,83185,83627,442
2022-10-07,70039,70838,Blue,0,30878,30911,33
2022-03-09,70055,70047,Blue,0,54992,55371,379
2022-02-15,70049,70838,Blue,0,49745,50404,659
2022-09-02,70051,70039,Blue,0,55793,56468,675
2022-08-23,70038,70058,Blue,1,69400,70457,1057
2022-09-16,70059,70045,Blue,0,76952,77659,707
2022-09-29,70053,70047,Blue,0,20193,20521,328
2022-06-27,70046,70048,Blue,1,34225,34305,80
2022-12-10,70048,70056,Blue,1,81944,82353,409
2022-10-15,70059,70838,Blue,0,65413,66556,1143
2022-01-03,70057,70055,Blue,0,27343,27411,68
2022-08-17,70057,70051,Blue,0,75444,75684,240
2022-07-08,70038,70044,Blue,1,59690,59906,216
2022-10-14,70054,70060,Blue,1,29811,30070,259
2022-03-09,70045,70043,Blue,0,48921,49010,89
2022-12-13,70048,70060,Blue,1,30730,31309,579
2022-06-08,70041,70838,Blue,0,26562,26693,131
2022-09-06,70048,70050,Blue,1,26765,26827,62
2022-07-05,70042,70052,Blue,1,55970,56567,597
2022-06-09,70042,70050,Blue,1,76092,76544,452
2022-06-09,70038,70040,Blue,1,25244,25262,18
2022-12-24,70049,70041,Blue,0,22950,23365,415
2022-04-07,70058,70060,Blue,1,63052,63119,67
2022-08-16,70046,70052,Blue,1,59594,59930,336
2022-02-02,70042,70050,Blue,1,41978,42376,398
2022-02-14,70049,70047,Blue,0,73107,73162,55
2022-08-09,70046,70054,Blue,1,27773,28229,456
2022-09-11,70040,70050,Blue,1,48916,49419,503
2022-11-28,70044,70054,Blue,1,40171,40764,593
2022-12-18,70052,70056,Blue,1,32327,32459,132
2022-08-11,70055,70041,Blue,0,73515,74246,731
2022-08-17,70050,70052,Blue,1,42142,42307,165
2022-02-18,70057,70047,Blue,0,34229,34850,621
2022-02-26,70051,70838,Blue,0,71171,71893,722
2022-10-24,70057,70043,Blue,0,60937,61755,818
2022-06-30,70055,70047,Blue,0,67492,67851,359
2022-01-24,70053,70051,Blue,0,56863,56915,52
2022-12-15,70055,70051,Blue,0,69325,69478,153
2022-02-02,70057,70039,Blue,0,26144,27185,1041
2022-06-18,70059,70055,Blue,0,35173,35325,152
2022-07-27,70057,70053,Blue,0,39099,39249,150
2022-07-04,70052,70058,Blue,1,54626,54881,255
2022-03-23,70045,70039,Blue,0,76859,77127,268
2022-02-15,70053,70049,Blue,0,34396,34665,269
2022-05-12,70059,70049,Blue,0,26360,27074,714
2022-04-15,70038,70044,Blue,1,31754,31946,192
2022-08-20,70044,70054,Blue,1,70890,71461,571
2022-11-26,70057,70047,Blue,0,28240,28732,492
2022-12-04,70047,70045,Blue,0,60658,60803,145
2022-07-29,70052,70058,Blue,1,40749,41013,264
2022-08-07,70051,70041,Blue,0,24186,24713,527
2022-09-16,70042,70056,Blue,1,55807,56617,810
2022-04-13,70040,70046,Blue,1,53785,54042,257
2022-10-07,70050,70052,Blue,1,79503,79614,111
2022-06-17,70053,70838,Blue,0,79163,80030,867
2022-07-10,70057,70043,Blue,0,33272,34096,824
2022-07-05,70046,70058,Blue,1,24411,25234,823
2022-01-15,70044,70056,Blue,1,48235,48970,735
2022-02-15,70053,70045,Blue,0,54489,54937,448
2022-05-25,70042,70048,Blue,1,68629,68964,335
2022-11-14,70059,70057,Blue,0,25097,25133,36
2022-07-24,70042,70044,Blue,1,87463,87491,28
2022-12-06,70055,70039,Blue,0,82300,83015,715
2022-01-18,70051,70838,Blue,0,44277,45063,786
2022-11-12,70057,70051,Blue,0,47118,47352,234
2022-11-10,70055,70047,Blue,0,37111,37598,487
2022-01-13,70048,70058,Blue,1,67652,68151,499
2022-01-27,70051,70039,Blue,0,24207,24941,734
2022-04-19,70044,70060,Blue,1,83544,84551,1007
2022-08-08,70046,70052,Blue,1,50683,51024,341
2022-02-20,70052,70058,Blue,1,49605,49848,243
2022-12-21,70038,70056,Blue,1,38501,39490,989
2022-07-31,70038,70054,Blue,1,64507,65410,903
2022-03-16,70059,70045,Blue,0,55997,56694,697
2022-09-20,70040,70052,Blue,1,67697,68272,575
2022-03-17,70042,70058,Blue,1,67238,68201,963
2022-04-20,70048,70060,Blue,1,80392,81075,683
2022-01-07,70055,70051,Blue,0,62794,62970,176
2022-04-23,70038,70052,Blue,1,28029,28734,705
2022-11-20,70048,70052,Blue,1,45463,45656,193
2022-09-13,70055,70053,Blue,0,55824,55869,45
2022-08-17,70051,70838,Blue,0,42490,43376,886
2022-10-22,70055,70039,Blue,0,81666,82485,819
2022-12-29,70041,70838,Blue,0,58814,58940,126
2022-07-23,70045,70043,Blue,0,80297,80401,104
2022-12-15,70046,70054,Blue,1,89509,89963,454
2022-10-20,70051,70838,Blue,0,76272,77001,729
2022-04-01,70050,70052,Blue,1,35017,35133,116
2022-12-12,70059,70045,Blue,0,67639,68311,672
2022-12-06,70052,70060,Blue,1,68763,69153,390
2022-06-07,70044,70046,Blue,1,21636,21750,114
2022-02-16,70051,70049,Blue,0,58509,58612,103
2022-08-05,70046,70056,Blue,1,76434,77019,585
2022-11-30,70042,70048,Blue,1,77070,77357,287
2022-02-11,70046,70060,Blue,1,21341,22153,812
2022-03-24,70041,70039,Blue,0,29183,29214,31
2022-12-29,70040,70058,Blue,1,25417,26302,885
2022-01-27,70050,70056,Blue,1,55613,55890,277
2022-05-02,70057,70047,Blue,0,40023,40546,523
2022-02-08,70058,70060,Blue,1,75693,75776,83
2022-05-09,70054,70058,Blue,1,29980,30135,155
2022-01-05,70040,70058,Blue,1,21601,22596,995
2022-07-20,70045,70043,Blue,0,74478,74575,97
2022-01-24,70040,70046,Blue,1,57189,57443,254
2022-04-20,70055,70838,Blue,0,28342,29335,993
2022-11-18,70053,70041,Blue,0,32862,33536,674
2022-03-07,70055,70049,Blue,0,24745,25057,312
2022-08-19,70049,70043,Blue,0,36428,36785,357
2022-07-01,70058,70060,Blue,1,23125,23328,203
2022-02-14,70049,70047,Blue,0,56519,56573,54
2022-08-05,70059,70039,Blue,0,83218,84239,1021
2022-02-03,70059,70045,Blue,0,22783,23598,815
2022-02-02,70044,70058,Blue,1,63444,64269,825
2022-09-07,70040,70060,Blue,1,59845,60956,1111
2022-06-13,70059,70053,Blue,0,30558,30806,248
2022-04-10,70054,70056,Blue,1,41299,41354,55
2022-08-17,70049,70039,Blue,0,82313,82817,504
2022-01-03,70057,70041,Blue,0,33030,33818,788
2022-03-04,70053,70051,Blue,0,33861,33925,64
2022-12-23,70051,70049,Blue,0,62193,62343,150
2022-09-06,70055,70045,Blue,0,50603,51122,519
2022-11-06,70054,70060,Blue,1,88161,88432,271
2022-02-07,70040,70042,Blue,1,55113,55148,35
2022-10-13,70040,70050,Blue,1,53460,53962,502
2022-09-28,70053,70049,Blue,0,34521,34732,211
2022-08-30,70057,70045,Blue,0,47915,48514,599
2022-04-01,70055,70043,Blue,0,33139,33814,675
2022-11-13,70047,70045,Blue,0,49042,49128,86
2022-09-22,70049,70047,Blue,0,28586,28644,58
2022-02-22,70053,70049,Blue,0,55066,55257,191
2022-12-11,70057,70045,Blue,0,67419,68090,671
2022-12-29,70049,70045,Blue,0,62538,62727,189
2022-01-24,70042,70054,Blue,1,21595,22327,732
2022-12-26,70050,70058,Blue,1,40232,40652,420
2022-03-10,70043,70041,Blue,0,77568,77596,28
2022-02-17,70050,70052,Blue,1,57784,57921,137
2022-12-28,70056,70060,Blue,1,43907,44097,190
2022-04-18,70043,70838,Blue,0,52104,52475,371
2022-03-09,70055,70045,Blue,0,42240,42773,533
2022-02-25,70044,70052,Blue,1,27325,27874,549
2022-07-23,70046,70050,Blue,1,25378,25564,186
2022-08-14,70046,70052,Blue,1,60112,60443,331
2022-03-04,70048,70052,Blue,1,31650,31854,204
2022-12-09,70049,70045,Blue,0,24742,24937,195
2022-06-29,70038,70040,Blue,1,75192,75207,15
2022-02-18,70059,70045,Blue,0,40409,41156,747
2022-06-24,70053,70039,Blue,0,56372,57227,855
2022-10-30,70053,70041,Blue,0,27993,28658,665
2022-06-11,70040,70058,Blue,1,75615,76598,983
2022-09-23,70042,70052,Blue,1,67551,68131,580
2022-06-24,70053,70047,Blue,0,77817,78111,294
2022-09-05,70050,70060,Blue,1,36881,37379,498
2022-03-20,70049,70838,Blue,0,79499,80074,575
2022-04-21,70052,70054,Blue,1,60443,60495,52
2022-09-03,70059,70838,Blue,0,20175,21438,1263
2022-10-17,70043,70039,Blue,0,70020,70133,113
2022-02-20,70038,70048,Blue,1,61859,62369,510
2022-04-14,70048,70050,Blue,1,55358,55414,56
2022-11-04,70055,70043,Blue,0,66538,67419,881
2022-11-20,70051,70047,Blue,0,47041,47232,191
2022-09-07,70046,70054,Blue,1,54648,55069,421
2022-12-24,70046,70054,Blue,1,80968,81402,434
2022-03-02,70042,70044,Blue,1,64376,64415,39
2022-03-19,70059,70039,Blue,0,54074,55113,1039
2022-10-25,70057,70055,Blue,0,53623,53694,71
2022-08-19,70044,70048,Blue,1,27628,27862,234
2022-12-19,70053,70043,Blue,0,63648,64236,588
2022-01-25,70038,70042,Blue,1,69909,70002,93
2022-08-03,70047,70041,Blue,0,33836,34184,348
2022-06-25,70040,70046,Blue,1,73351,73667,316
2022-12-28,70043,70039,Blue,0,42516,42614,98
2022-06-09,70042,70058,Blue,1,68166,69213,1047
2022-12-29,70053,70051,Blue,0,32289,32352,63
2022-06-15,70059,70047,Blue,0,31754,32339,585
2022-10-07,70040,70042,Blue,1,43269,43305,36
2022-04-20,70057,70055,Blue,0,81280,81349,69
2022-01-19,70049,70838,Blue,0,68431,69064,633
2022-06-14,70042,70054,Blue,1,30684,31379,695
2022-09-05,70045,70838,Blue,0,38922,39266,344
2022-11-19,70048,70054,Blue,1,67390,67676,286
2022-02-25,70053,70049,Blue,0,28172,28381,209
2022-11-16,70048,70056,Blue,1,37878,38256,378
2022-12-21,70045,70043,Blue,0,52003,52100,97
2022-06-08,70047,70838,Blue,0,28052,28600,548
2022-06-08,70048,70050,Blue,1,25857,25918,61
2022-01-27,70049,70041,Blue,0,23703,24221,518
2022-01-02,70053,70045,Blue,0,46037,46509,472
2022-08-25,70051,70043,Blue,0,74193,74656,463
2022-10-18,70050,70054,Blue,1,42284,42503,219
2022-06-06,70047,70041,Blue,0,80135,80507,372
2022-05-28,70042,70052,Blue,1,32791,33473,682
2022-04-17,70046,70052,Blue,1,70800,71108,308
2022-07-08,70042,70060,Blue,1,67170,68376,1206
2022-12-19,70046,70060,Blue,1,53108,54006,898
2022-05-20,70057,70838,Blue,0,53681,54897,1216
2022-12-21,70050,70054,Blue,1,56061,56273,212
2022-11-24,70048,70052,Blue,1,69324,69556,232
2022-02-22,70057,70047,Blue,0,58761,59263,502
2022-12-21,70049,70838,Blue,0,58654,59251,597
2022-01-05,70057,70041,Blue,0,41625,42437,812
2022-05-02,70050,70058,Blue,1,38622,39100,478
2022-07-22,70059,70039,Blue,0,33914,34883,969
2022-01-22,70055,70047,Blue,0,54871,55280,409
2022-02-28,70042,70054,Blue,1,24401,25112,711
2022-12-21,70044,70046,Blue,1,60435,60543,108
2022-05-19,70042,70054,Blue,1,22904,23661,757
2022-04-09,70059,70041,Blue,0,76453,77397,944
2022-02-18,70056,70058,Blue,1,52965,53052,87
2022-08-20,70041,70039,Blue,0,20540,20576,36
2022-02-01,70056,70058,Blue,1,60795,60890,95
2022-09-21,70050,70054,Blue,1,82023,82225,202
2022-03-02,70046,70050,Blue,1,28563,28772,209
2022-01-12,70047,70838,Blue,0,67714,68199,485
2022-03-12,70043,70039,Blue,0,61436,61541,105
2022-06-14,70045,70041,Blue,0,49447,49658,211
2022-02-15,70057,70838,Blue,0,32702,33785,1083
2022-11-15,70044,70050,Blue,1,72312,72636,324
2022-07-10,70046,70060,Blue,1,64898,65662,764
2022-01-20,70044,70058,Blue,1,67308,68099,791
2022-09-06,70043,70041,Blue,0,55290,55318,28
2022-12-27,70055,70041,Blue,0,82567,83264,697
2022-12-13,70038,70052,Blue,1,30668,31366,698
2022-06-16,70053,70047,Blue,0,64691,64993,302
2022-06-30,70048,70050,Blue,1,28712,28770,58
2022-06-24,70040,70048,Blue,1,25375,25886,511
2022-04-22,70040,70058,Blue,1,54858,55855,997
2022-11-12,70048,70056,Blue,1,69591,69988,397
2022-06-19,70040,70056,Blue,1,72147,72995,848
2022-08-07,70038,70050,Blue,1,73801,74390,589
2022-09-12,70048,70056,Blue,1,48170,48555,385
2022-08-07,70059,70047,Blue,0,46272,46838,566
2022-09-08,70048,70058,Blue,1,29471,30005,534
2022-10-06,70055,70051,Blue,0,52716,52985,269
2022-10-24,70040,70044,Blue,1,86007,86139,132
2022-02-07,70059,70053,Blue,0,24562,24827,265
2022-05-17,70050,70054,Blue,1,43513,43725,212
2022-01-28,70044,70050,Blue,1,44926,45294,368
2022-08-24,70048,70058,Blue,1,84595,85223,628
2022-08-14,70040,70044,Blue,1,68355,68466,111
2022-12-24,70045,70039,Blue,0,40278,40538,260
2022-07-05,70038,70060,Blue,1,50296,51603,1307
2022-12-06,70038,70040,Blue,1,48776,48796,20
2022-09-20,70055,70838,Blue,0,21960,23062,1102
2022-07-26,70059,70051,Blue,0,69205,69522,317
2022-09-08,70047,70043,Blue,0,83334,83563,229
2022-12-24,70038,70056,Blue,1,36132,37006,874
2022-09-06,70057,70045,Blue,0,34307,34959,652
2022-12-13,70051,70047,Blue,0,23443,23653,210
2022-07-01,70042,70050,Blue,1,22004,22501,497
2022-08-24,70042,70048,Blue,1,27956,28293,337
2022-04-10,70047,70043,Blue,0,22255,22523,268
2022-07-07,70057,70043,Blue,0,25608,26439,831
2022-11-19,70057,70045,Blue,0,63883,64543,660
2022-07-19,70045,70043,Blue,0,19232,19329,97
2022-11-21,70044,70048,Blue,1,38265,38496,231
2022-10-30,70055,70053,Blue,0,71303,71351,48
2022-06-14,70058,70060,Blue,1,59175,59246,71
2022-04-23,70057,70041,Blue,0,84932,85803,871
2022-08-10,70042,70054,Blue,1,64505,65199,694
2022-01-05,70055,70045,Blue,0,56489,57050,561
2022-04-12,70053,70043,Blue,0,85425,86011,586
2022-07-24,70041,70039,Blue,0,70456,70492,36
2022-11-02,70048,70056,Blue,1,24256,24695,439
2022-07-18,70044,70060,Blue,1,78078,78962,884
2022-06-27,70044,70050,Blue,1,54767,55283,516
2022-11-18,70055,70047,Blue,0,74665,75180,515
2022-12-18,70055,70043,Blue,0,50235,50988,753
2022-03-03,70052,70056,Blue,1,33407,33550,143
2022-07-08,70038,70046,Blue,1,40680,41030,350
2022-01-28,70042,70046,Blue,1,40287,40457,170
2022-10-01,70048,70052,Blue,1,33874,34064,190
2022-04-18,70047,70039,Blue,0,67400,67786,386
2022-01-19,70048,70060,Blue,1,55312,55941,629
2022-09-17,70045,70838,Blue,0,48921,49285,364
2022-05-04,70059,70055,Blue,0,50116,50278,162
2022-10-12,70049,70047,Blue,0,30710,30770,60
2022-09-27,70050,70054,Blue,1,56068,56274,206
2022-01-20,70043,70838,Blue,0,55394,55652,258
2022-04-10,70048,70050,Blue,1,60685,60742,57
2022-12-20,70053,70043,Blue,0,65709,66270,561
2022-01-14,70057,70051,Blue,0,56094,56401,307
2022-02-07,70044,70060,Blue,1,64291,65297,1006
2022-06-20,70057,70047,Blue,0,46487,46997,510
2022-05-27,70038,70040,Blue,1,67515,67532,17
2022-01-13,70049,70838,Blue,0,87956,88519,563
2022-02-18,70042,70058,Blue,1,72584,73649,1065
2022-12-16,70050,70054,Blue,1,26130,26369,239
2022-01-05,70051,70041,Blue,0,41902,42437,535
2022-01-21,70059,70047,Blue,0,29069,29688,619
2022-03-17,70055,70041,Blue,0,35880,36611,731
2022-02-12,70053,70041,Blue,0,29496,30137,641
2022-03-10,70040,70044,Blue,1,83181,83293,112
2022-02-23,70043,70039,Blue,0,34020,34132,112
2022-04-18,70044,70056,Blue,1,68484,69221,737
2022-09-22,70054,70058,Blue,1,48599,48763,164
2022-08-06,70040,70044,Blue,1,78682,78794,112
2022-07-08,70038,70060,Blue,1,77486,78659,1173
2022-11-07,70049,70041,Blue,0,67253,67665,412
2022-10-04,70052,70058,Blue,1,45485,45752,267
2022-12-12,70044,70058,Blue,1,23884,24718,834
2022-01-26,70059,70057,Blue,0,63500,63537,37
2022-07-19,70041,70838,Blue,0,82210,82321,111
2022-01-22,70046,70054,Blue,1,58094,58594,500
2022-02-01,70038,70048,Blue,1,64338,64811,473
2022-06-09,70051,70043,Blue,0,35661,36207,546
2022-04-01,70038,70056,Blue,1,80843,81719,876
2022-02-23,70047,70838,Blue,0,38214,38775,561
2022-06-20,70052,70058,Blue,1,32837,33100,263
2022-04-22,70042,70058,Blue,1,87868,88673,805
2022-09-29,70048,70056,Blue,1,33278,33676,398
2022-12-21,70051,70039,Blue,0,84803,87000,2197
2022-09-28,70053,70045,Blue,0,49119,49554,435
2022-08-04,70052,70060,Blue,1,29656,30051,395
2022-02-23,70048,70050,Blue,1,41297,41356,59
2022-10-02,70045,70043,Blue,0,38317,38414,97
2022-08-11,70042,70048,Blue,1,71202,71508,306
2022-02-24,70039,70838,Blue,0,36323,36360,37
2022-10-03,70045,70043,Blue,0,47088,47188,100
2022-10-28,70042,70046,Blue,1,26636,26810,174
2022-03-12,70040,70050,Blue,1,66448,66993,545
2022-06-29,70053,70045,Blue,0,76709,77166,457
2022-02-23,70045,70838,Blue,0,38394,38775,381
2022-07-25,70042,70050,Blue,1,53138,53569,431
2022-10-05,70038,70044,Blue,1,41677,41898,221
2022-10-15,70046,70054,Blue,1,50563,50996,433
2022-05-18,70059,70043,Blue,0,25577,26605,1028
2022-02-22,70042,70054,Blue,1,45447,46122,675
2022-02-13,70059,70047,Blue,0,55995,56567,572
2022-07-06,70040,70056,Blue,1,78375,79281,906
2022-06-23,70059,70053,Blue,0,19936,20182,246
2022-05-09,70054,70056,Blue,1,86739,86786,47
2022-05-06,70059,70049,Blue,0,65655,66267,612
2022-08-27,70055,70045,Blue,0,73170,73675,505
2022-06-21,70049,70047,Blue,0,44129,44195,66
2022-01-13,70056,70060,Blue,1,73425,73611,186
2022-07-26,70053,70041,Blue,0,28806,29575,769
2022-05-18,70038,70046,Blue,1,23429,23767,338
2022-01-26,70053,70047,Blue,0,47387,47672,285
2022-12-02,70047,70838,Blue,0,69238,69734,496
2022-01-09,70041,70838,Blue,0,47734,47855,121
2022-02-04,70042,70046,Blue,1,79493,79670,177
2022-04-11,70038,70046,Blue,1,24306,24659,353
2022-11-02,70049,70041,Blue,0,22865,23354,489
2022-12-29,70047,70838,Blue,0,60244,60745,501
2022-05-31,70043,70838,Blue,0,74328,74555,227
2022-04-21,70049,70047,Blue,0,60686,60741,55
2022-01-01,70038,70044,Blue,1,23767,23935,168
2022-08-25,70038,70050,Blue,1,66551,67176,625
2022-12-14,70050,70054,Blue,1,34149,34380,231
2022-11-24,70057,70045,Blue,0,85584,86172,588
2022-04-10,70050,70054,Blue,1,46207,46391,184
2022-06-10,70038,70042,Blue,1,86013,86123,110
2022-08-06,70048,70050,Blue,1,36083,36136,53
2022-04-22,70059,70049,Blue,0,85159,85644,485
2022-12-31,70047,70039,Blue,0,46074,46506,432
2022-04-11,70053,70049,Blue,0,38948,39157,209
2022-02-01,70047,70039,Blue,0,64132,64562,430
2022-04-21,70057,70039,Blue,0,51626,52539,913
2022-11-22,70051,70047,Blue,0,66616,66805,189
2022-12-28,70059,70039,Blue,0,30252,31260,1008
2022-08-21,70051,70045,Blue,0,76914,77244,330
2022-08-05,70055,70043,Blue,0,79267,79921,654
2022-12-22,70047,70045,Blue,0,54521,54606,85
2022-12-07,70050,70054,Blue,1,84010,84242,232
2022-02-26,70044,70052,Blue,1,35822,36339,517
2022-02-10,70054,70056,Blue,1,89486,89533,47
2022-10-11,70055,70051,Blue,0,34103,34254,151
2022-02-28,70038,70042,Blue,1,23072,23176,104
2022-04-27,70059,70055,Blue,0,52649,52791,142
2022-04-22,70047,70041,Blue,0,37744,38102,358
2022-02-02,70040,70046,Blue,1,38916,39226,310
2022-03-17,70042,70054,Blue,1,77714,78477,763
2022-06-19,70044,70056,Blue,1,36473,37151,678
2022-12-24,70044,70060,Blue,1,49110,50015,905
2022-07-24,70044,70054,Blue,1,60970,61557,587
2022-08-17,70040,70050,Blue,1,37475,38013,538
2022-03-04,70055,70053,Blue,0,68075,68165,90
2022-03-17,70055,70047,Blue,0,23573,23963,390
2022-08-03,70054,70060,Blue,1,24388,24648,260
2022-07-24,70044,70056,Blue,1,69615,70367,752
2022-06-29,70057,70055,Blue,0,55592,55661,69
2022-03-24,70038,70052,Blue,1,23647,24327,680
2022-01-14,70052,70060,Blue,1,54118,54542,424
2022-08-24,70051,70045,Blue,0,31484,31846,362
2022-09-26,70040,70042,Blue,1,62308,62342,34
2022-12-10,70051,70049,Blue,0,78126,78233,107
2022-06-26,70047,70041,Blue,0,30711,31069,358
2022-01-14,70042,70052,Blue,1,55784,56335,551
2022-05-07,70057,70051,Blue,0,57691,57956,265
2022-08-02,70041,70039,Blue,0,30687,30718,31
2022-01-09,70040,70056,Blue,1,72669,73494,825
2022-09-02,70048,70056,Blue,1,81574,81994,420
2022-03-04,70044,70054,Blue,1,87941,88539,598
2022-11-27,70046,70058,Blue,1,26463,27073,610
2022-11-28,70044,70054,Blue,1,63642,64254,612
2022-10-19,70042,70056,Blue,1,62356,63178,822
2022-08-08,70048,70058,Blue,1,31183,31699,516
2022-04-23,70059,70053,Blue,0,70840,71062,222
2022-10-03,70042,70052,Blue,1,20253,20831,578
2022-11-04,70044,70060,Blue,1,56037,56892,855
2022-04-03,70043,70838,Blue,0,47181,47383,202
2022-09-27,70039,70838,Blue,0,82282,82313,31
2022-04-18,70055,70838,Blue,0,21509,22525,1016
2022-04-23,70053,70045,Blue,0,57620,58078,458
2022-07-22,70053,70049,Blue,0,56913,57133,220
2022-09-28,70047,70039,Blue,0,64041,64443,402
2022-02-16,70044,70052,Blue,1,33456,33925,469
2022-04-09,70055,70043,Blue,0,31044,31719,675
2022-11-17,70053,70039,Blue,0,32888,33676,788
2022-11-02,70050,70056,Blue,1,74202,74484,282
2022-04-10,70048,70060,Blue,1,67211,67898,687
2022-03-20,70057,70043,Blue,0,71186,71930,744
2022-03-25,70059,70043,Blue,0,80595,81439,844
2022-10-18,70047,70838,Blue,0,79387,79877,490
2022-07-15,70047,70043,Blue,0,19061,19326,265
2022-05-27,70039,70838,Blue,0,69414,69445,31
2022-10-22,70055,70039,Blue,0,61271,62063,792
2022-06-12,70047,70039,Blue,0,70627,71062,435
2022-10-31,70041,70838,Blue,0,41226,41355,129
2022-07-12,70055,70838,Blue,0,61541,62531,990
2022-03-22,70047,70838,Blue,0,46726,47196,470
2022-09-01,70041,70039,Blue,0,79705,79734,29
2022-05-19,70049,70039,Blue,0,86231,86853,622
2022-11-01,70038,70048,Blue,1,62227,62711,484
2022-07-10,70055,70045,Blue,0,75077,75594,517
2022-11-04,70038,70060,Blue,1,20073,21611,1538
2022-11-15,70052,70060,Blue,1,59559,59969,410
2022-11-11,70044,70052,Blue,1,64481,64945,464
2022-05-21,70059,70838,Blue,0,78283,79785,1502
2022-12-19,70055,70838,Blue,0,39104,40460,1356
2022-03-08,70040,70048,Blue,1,24652,25121,469
2022-11-05,70049,70041,Blue,0,33566,34032,466
2022-11-24,70051,70047,Blue,0,73126,73317,191
2022-07-29,70038,70054,Blue,1,81912,82820,908
2022-01-17,70052,70054,Blue,1,34297,34357,60
2022-06-16,70046,70060,Blue,1,35638,36518,880
2022-03-22,70048,70050,Blue,1,75767,75829,62
2022-02-22,70046,70058,Blue,1,56043,56679,636
2022-12-01,70038,70044,Blue,1,84921,85105,184
2022-07-29,70056,70060,Blue,1,27856,28030,174
2022-11-01,70053,70047,Blue,0,24193,24510,317
2022-03-29,70044,70054,Blue,1,46581,47135,554
2022-09-29,70055,70049,Blue,0,35072,35466,394
2022-02-20,70057,70049,Blue,0,40889,41314,425
2022-11-04,70040,70054,Blue,1,37771,38604,833
2022-06-08,70043,70838,Blue,0,26483,26693,210
2022-10-13,70040,70042,Blue,1,39976,40007,31
2022-02-13,70038,70040,Blue,1,67215,67231,16
2022-09-13,70042,70048,Blue,1,31862,32177,315
2022-10-20,70055,70043,Blue,0,30981,31665,684
2022-09-21,70047,70045,Blue,0,38136,38237,101
2022-09-11,70048,70054,Blue,1,73099,73400,301
2022-08-13,70040,70054,Blue,1,74540,75287,747
2022-08-16,70040,70044,Blue,1,40508,40687,179
2022-10-16,70038,70058,Blue,1,52079,53102,1023
2022-09-07,70051,70045,Blue,0,47426,48013,587
2022-12-22,70057,70041,Blue,0,49541,50431,890
2022-01-27,70051,70039,Blue,0,42550,43175,625
2022-08-12,70057,70051,Blue,0,77690,77943,253
2022-09-16,70046,70052,Blue,1,73008,73334,326
2022-05-25,70041,70838,Blue,0,69797,69902,105
2022-02-11,70059,70047,Blue,0,39247,39829,582
2022-12-12,70038,70050,Blue,1,27314,27848,534
2022-09-06,70042,70052,Blue,1,44494,45088,594
2022-12-06,70049,70838,Blue,0,58466,59116,650
2022-09-29,70042,70044,Blue,1,70664,70691,27
2022-02-13,70055,70049,Blue,0,70767,71092,325
2022-02-02,70049,70043,Blue,0,78919,79282,363
2022-02-02,70052,70054,Blue,1,31271,31330,59
2022-06-20,70059,70041,Blue,0,33074,34058,984
2022-09-17,70059,70055,Blue,0,69197,69336,139
2022-09-16,70057,70047,Blue,0,60404,60890,486
2022-03-03,70046,70052,Blue,1,60222,60539,317
2022-10-02,70042,70060,Blue,1,87442,88475,1033
2022-11-29,70038,70048,Blue,1,74719,75210,491
2022-11-09,70044,70048,Blue,1,51545,51773,228
2022-02-16,70053,70047,Blue,0,63791,64083,292
2022-08-26,70053,70838,Blue,0,63731,64618,887
2022-08-30,70038,70042,Blue,1,41048,41134,86
2022-01-09,70052,70054,Blue,1,47630,47685,55
2022-02-02,70046,70048,Blue,1,76331,76413,82
2022-06-04,70038,70048,Blue,1,81860,82324,464
2022-01-08,70057,70043,Blue,0,43625,44414,789
2022-08-21,70038,70052,Blue,1,73697,74397,700
2022-10-27,70057,70049,Blue,0,77603,77992,389
2022-02-16,70053,70049,Blue,0,58381,58612,231
2022-09-21,70057,70053,Blue,0,34989,35151,162
2022-03-30,70059,70051,Blue,0,58698,59051,353
2022-03-30,70059,70043,Blue,0,57495,58331,836
2022-06-04,70047,70043,Blue,0,40182,40471,289
2022-06-21,70042,70046,Blue,1,40594,40813,219
2022-04-10,70053,70041,Blue,0,37791,38498,707
2022-12-11,70040,70050,Blue,1,39096,39580,484
2022-03-30,70040,70058,Blue,1,58801,59753,952
2022-04-12,70041,70039,Blue,0,66548,66583,35
2022-09-03,70042,70046,Blue,1,49794,49966,172
2022-06-27,70040,70052,Blue,1,77959,78623,664
2022-12-19,70052,70058,Blue,1,28178,28416,238
2022-07-26,70038,70046,Blue,1,76351,76715,364
2022-08-29,70043,70039,Blue,0,45626,45747,121
2022-02-07,70038,70040,Blue,1,22148,22163,15
2022-12-31,70053,70041,Blue,0,28442,29091,649
2022-04-18,70051,70049,Blue,0,65048,65164,116
2022-01-03,70055,70041,Blue,0,83052,83761,709
2022-10-13,70045,70043,Blue,0,86735,86822,87
2022-10-31,70059,70051,Blue,0,42620,42943,323
2022-11-20,70048,70050,Blue,1,52022,52077,55
2022-12-23,70038,70058,Blue,1,72575,73726,1151
2022-07-12,70053,70045,Blue,0,45540,46076,536
2022-04-24,70053,70045,Blue,0,60702,61154,452
2022-09-15,70059,70838,Blue,0,27592,28737,1145
2022-12-23,70038,70056,Blue,1,47083,47969,886
2022-10-16,70055,70049,Blue,0,35722,36010,288
2022-02-13,70046,70058,Blue,1,47238,47871,633
2022-11-23,70046,70058,Blue,1,49243,49866,623
2022-10-21,70046,70054,Blue,1,32696,33107,411
2022-02-28,70055,70051,Blue,0,51730,51904,174
2022-09-25,70055,70043,Blue,0,42314,43111,797
2022-03-23,70041,70039,Blue,0,31639,31672,33
2022-10-23,70038,70054,Blue,1,52081,52923,842
2022-03-14,70040,70042,Blue,1,57502,57536,34
2022-05-29,70038,70048,Blue,1,41712,42187,475
2022-06-17,70038,70048,Blue,1,59240,59749,509
2022-09-09,70047,70045,Blue,0,31654,31763,109
2022-04-05,70038,70054,Blue,1,84381,85283,902
2022-05-21,70057,70055,Blue,0,56933,57005,72
2022-08-21,70044,70060,Blue,1,49093,49995,902
2022-06-09,70043,70041,Blue,0,60674,60704,30
2022-03-17,70053,70049,Blue,0,23660,23866,206
2022-06-05,70040,70042,Blue,1,42977,43008,31
2022-01-26,70057,70838,Blue,0,86380,87563,1183
2022-08-26,70048,70056,Blue,1,28607,28993,386
2022-06-22,70059,70055,Blue,0,49484,49636,152
2022-08-09,70057,70041,Blue,0,75989,76904,915
2022-02-25,70046,70054,Blue,1,61099,61546,447
2022-11-29,70049,70047,Blue,0,32215,32269,54
2022-07-20,70058,70060,Blue,1,84709,84799,90
2022-04-25,70057,70047,Blue,0,78824,79400,576
2022-11-17,70053,70041,Blue,0,57991,58643,652
2022-04-14,70043,70039,Blue,0,33840,33959,119
2022-11-10,70044,70052,Blue,1,56935,57454,519
2022-04-20,70051,70045,Blue,0,62963,63329,366
2022-11-27,70057,70051,Blue,0,63631,63884,253
2022-11-13,70050,70054,Blue,1,30610,30822,212
2022-12-28,70046,70054,Blue,1,55437,55855,418
2022-07-29,70042,70058,Blue,1,64847,65804,957
2022-06-03,70040,70042,Blue,1,65667,65699,32
2022-06-12,70040,70046,Blue,1,72704,72991,287
2022-10-13,70050,70060,Blue,1,71967,72510,543
2022-06-15,70050,70052,Blue,1,29350,29464,114
2022-02-11,70051,70049,Blue,0,52922,53023,101
2022-07-11,70057,70041,Blue,0,64806,65628,822
2022-03-15,70057,70049,Blue,0,53973,54350,377
2022-08-16,70044,70050,Blue,1,54879,55296,417
2022-12-06,70038,70060,Blue,1,60683,61845,1162
2022-01-09,70042,70050,Blue,1,48970,49347,377
2022-12-24,70044,70058,Blue,1,64971,65737,766
2022-04-13,70050,70054,Blue,1,82056,83111,1055
2022-07-16,70057,70041,Blue,0,28233,29143,910
2022-04-21,70051,70043,Blue,0,33650,34258,608
2022-03-10,70057,70051,Blue,0,25525,25798,273
2022-11-23,70048,70050,Blue,1,28290,28353,63
2022-03-19,70057,70047,Blue,0,83263,83750,487
2022-10-29,70038,70040,Blue,1,46937,46951,14
2022-09-08,70040,70048,Blue,1,85016,85473,457
2022-12-10,70053,70045,Blue,0,42460,42890,430
2022-03-28,70040,70060,Blue,1,86065,87101,1036
2022-09-27,70047,70043,Blue,0,76509,76756,247
2022-10-18,70040,70054,Blue,1,45969,46714,745
2022-03-23,70046,70050,Blue,1,75592,75797,205
2022-06-10,70040,70044,Blue,1,24113,24235,122
2022-10-15,70059,70047,Blue,0,41668,42313,645
2022-12-10,70055,70041,Blue,0,61818,62540,722
2022-01-15,70049,70045,Blue,0,87050,87248,198
2022-02-25,70049,70039,Blue,0,31733,32270,537
2022-08-19,70045,70041,Blue,0,86651,86820,169
2022-12-18,70038,70042,Blue,1,65053,65147,94
2022-03-27,70048,70060,Blue,1,42085,42640,555
2022-02-25,70040,70042,Blue,1,60297,60334,37
2022-06-18,70049,70047,Blue,0,54039,54095,56
2022-03-23,70038,70046,Blue,1,64927,65278,351
2022-10-06,70044,70058,Blue,1,75433,76223,790
2022-09-02,70046,70058,Blue,1,33910,34601,691
2022-10-18,70045,70838,Blue,0,88082,88405,323
2022-10-02,70038,70040,Blue,1,73699,73715,16
2022-10-21,70053,70047,Blue,0,29587,29885,298
2022-03-08,70048,70052,Blue,1,52761,52958,197
2022-01-25,70049,70838,Blue,0,39287,39926,639
2022-06-09,70053,70041,Blue,0,22682,23543,861
2022-04-09,70048,70056,Blue,1,22840,23285,445
2022-08-10,70059,70053,Blue,0,28881,29114,233
2022-04-04,70040,70054,Blue,1,66818,67633,815
2022-10-24,70044,70056,Blue,1,24117,24865,748
2022-02-08,70043,70838,Blue,0,31213,31460,247
2022-08-16,70055,70053,Blue,0,30333,30381,48
2022-05-19,70045,70043,Blue,0,38588,38739,151
2022-05-19,70038,70056,Blue,1,32059,33065,1006
2022-10-11,70044,70060,Blue,1,22009,22869,860
2022-03-28,70055,70041,Blue,0,49927,50648,721
2022-10-20,70045,70039,Blue,0,27882,28128,246
2022-03-08,70057,70838,Blue,0,74429,75483,1054
2022-05-16,70050,70054,Blue,1,30697,30905,208
2022-03-22,70038,70042,Blue,1,67360,67475,115
2022-11-25,70047,70043,Blue,0,45917,46152,235
2022-08-25,70054,70058,Blue,1,46781,46933,152
2022-11-25,70053,70039,Blue,0,52251,52979,728
2022-05-19,70040,70044,Blue,1,48740,48843,103
2022-01-04,70046,70052,Blue,1,69849,70180,331
2022-06-30,70053,70043,Blue,0,45663,46290,627
2022-04-21,70038,70040,Blue,1,26048,26064,16
2022-02-05,70051,70838,Blue,0,44692,45372,680
2022-07-05,70044,70052,Blue,1,50528,51079,551
2022-09-26,70051,70043,Blue,0,59637,60140,503
2022-03-05,70038,70054,Blue,1,70150,70953,803
2022-12-02,70040,70044,Blue,1,19902,20021,119
2022-02-25,70038,70056,Blue,1,81987,82910,923
2022-03-07,70044,70058,Blue,1,56735,57504,769
2022-10-28,70059,70057,Blue,0,31823,31858,35
2022-04-25,70052,70056,Blue,1,50861,51004,143
2022-12-23,70051,70838,Blue,0,69041,69859,818
2022-12-12,70053,70051,Blue,0,80503,80559,56
2022-07-10,70053,70043,Blue,0,52636,53233,597
2022-07-18,70059,70051,Blue,0,19519,19889,370
2022-02-19,70048,70054,Blue,1,52422,52717,295
2022-04-19,70053,70041,Blue,0,56552,57268,716
2022-09-21,70057,70039,Blue,0,41237,42300,1063
2022-09-29,70049,70043,Blue,0,25402,25754,352
2022-06-30,70040,70052,Blue,1,34101,34777,676
2022-09-11,70057,70049,Blue,0,73891,74272,381
2022-04-23,70054,70056,Blue,1,48941,48991,50
2022-10-04,70046,70048,Blue,1,56915,56984,69
2022-06-16,70050,70056,Blue,1,89747,90155,408
2022-01-16,70043,70838,Blue,0,67175,67366,191
2022-10-22,70052,70060,Blue,1,62858,63266,408
2022-10-12,70051,70043,Blue,0,33869,34395,526
2022-01-31,70038,70056,Blue,1,54010,54944,934
2022-07-27,70044,70046,Blue,1,91163,91274,111
2022-01-12,70044,70054,Blue,1,25688,26348,660
2022-11-20,70059,70045,Blue,0,49516,50244,728
2022-08-18,70041,70039,Blue,0,77972,78004,32
2022-02-15,70038,70040,Blue,1,59540,59564,24
2022-12-14,70043,70039,Blue,0,46210,46322,112
2022-11-19,70046,70052,Blue,1,32146,32459,313
2022-11-11,70053,70039,Blue,0,37710,38420,710
2022-03-04,70038,70044,Blue,1,74091,74288,197
2022-04-19,70054,70060,Blue,1,65530,65805,275
2022-04-13,70048,70054,Blue,1,64007,64398,391
2022-09-02,70057,70055,Blue,0,60922,60991,69
2022-03-23,70042,70046,Blue,1,60605,60779,174
2022-06-28,70049,70043,Blue,0,83211,83550,339
2022-03-03,70057,70043,Blue,0,64485,65376,891
2022-12-27,70044,70058,Blue,1,76796,77587,791
2022-07-26,70055,70039,Blue,0,36116,37119,1003
2022-09-27,70053,70838,Blue,0,25983,27001,1018
2022-10-03,70040,70052,Blue,1,48826,49519,693
2022-10-19,70059,70049,Blue,0,40579,41053,474
2022-07-19,70053,70049,Blue,0,54405,54611,206
2022-03-18,70059,70838,Blue,0,27181,28261,1080
2022-11-28,70055,70053,Blue,0,39234,39279,45
2022-06-29,70059,70049,Blue,0,30628,31109,481
2022-10-12,70053,70039,Blue,0,47560,48307,747
2022-07-04,70040,70052,Blue,1,60486,61114,628
2022-10-10,70047,70043,Blue,0,30739,31013,274
2022-04-24,70048,70054,Blue,1,38232,38535,303
2022-03-16,70059,70053,Blue,0,81741,81970,229
2022-03-20,70038,70050,Blue,1,75846,76379,533
2022-01-21,70040,70044,Blue,1,40829,40943,114
2022-03-01,70049,70045,Blue,0,56195,56386,191
2022-05-12,70055,70049,Blue,0,38909,39231,322
2022-09-25,70055,70041,Blue,0,31814,32557,743
2022-01-16,70059,70053,Blue,0,56549,56783,234
2022-08-09,70042,70052,Blue,1,69137,69691,554
2022-11-07,70042,70050,Blue,1,45328,45740,412
2022-12-10,70051,70049,Blue,0,37133,37234,101
2022-04-09,70053,70047,Blue,0,32183,32457,274
2022-02-03,70050,70052,Blue,1,68224,68337,113
2022-10-24,70047,70838,Blue,0,77619,78095,476
2022-09-17,70051,70838,Blue,0,60379,61211,832
2022-10-08,70055,70051,Blue,0,81674,81810,136
2022-06-28,70050,70060,Blue,1,27596,28186,590
2022-08-01,70043,70039,Blue,0,44649,44765,116
2022-07-14,70039,70838,Blue,0,46848,46885,37
2022-02-05,70038,70054,Blue,1,39915,40777,862
2022-02-01,70044,70056,Blue,1,62750,63438,688
2022-07-20,70042,70044,Blue,1,57018,57047,29
2022-09-17,70055,70041,Blue,0,22338,23050,712
2022-03-15,70042,70050,Blue,1,46557,46959,402
2022-12-06,70056,70058,Blue,1,66796,66869,73
2022-10-07,70057,70039,Blue,0,56023,56976,953
2022-12-18,70044,70046,Blue,1,72287,72389,102
2022-04-13,70043,70039,Blue,0,86611,86711,100
2022-07-10,70050,70054,Blue,1,47870,48083,213
2022-04-16,70042,70056,Blue,1,40070,40937,867
2022-10-07,70044,70048,Blue,1,62728,62977,249
2022-11-15,70051,70039,Blue,0,60303,61128,825
2022-03-10,70040,70056,Blue,1,79213,80060,847
2022-10-07,70048,70056,Blue,1,76828,77242,414
2022-01-11,70038,70040,Blue,1,48092,48106,14
2022-08-14,70051,70039,Blue,0,60666,61340,674
2022-08-02,70042,70058,Blue,1,43735,44700,965
2022-11-17,70055,70043,Blue,0,34518,35176,658
2022-08-10,70040,70044,Blue,1,68004,68141,137
2022-12-26,70047,70838,Blue,0,87017,87493,476
2022-03-27,70049,70041,Blue,0,33671,34075,404
2022-12-11,70051,70045,Blue,0,64992,65330,338
2022-01-02,70045,70041,Blue,0,88983,89161,178
2022-06-07,70040,70052,Blue,1,78083,78815,732
2022-11-22,70038,70046,Blue,1,20980,21313,333
2022-03-23,70048,70052,Blue,1,22335,22552,217
2022-08-27,70057,70055,Blue,0,47667,47737,70
2022-03-14,70045,70043,Blue,0,83058,83150,92
2022-07-17,70050,70060,Blue,1,73244,73795,551
2022-08-03,70052,70054,Blue,1,56996,57059,63
2022-12-14,70047,70045,Blue,0,72859,72942,83
2022-08-04,70042,70056,Blue,1,44718,45682,964
2022-07-24,70038,70060,Blue,1,56407,57789,1382
2022-08-26,70059,70047,Blue,0,84979,85583,604
2022-12-16,70059,70057,Blue,0,22774,22820,46
2022-09-28,70059,70838,Blue,0,58215,59341,1126
2022-02-04,70048,70056,Blue,1,56808,57197,389
2022-04-20,70042,70046,Blue,1,60009,60195,186
2022-03-20,70040,70054,Blue,1,45015,45801,786
2022-03-12,70052,70056,Blue,1,37480,37624,144
2022-08-11,70057,70045,Blue,0,84455,85024,569
2022-10-29,70040,70046,Blue,1,60508,60805,297
2022-09-19,70059,70051,Blue,0,22575,22901,326
2022-02-28,70044,70058,Blue,1,30852,31676,824
2022-11-28,70059,70838,Blue,0,47842,49183,1341
2022-08-18,70058,70060,Blue,1,48885,48947,62
2022-07-19,70038,70058,Blue,1,23110,24162,1052
2022-09-10,70042,70056,Blue,1,55249,56010,761
2022-03-11,70038,70042,Blue,1,58333,58427,94
2022-05-23,70049,70041,Blue,0,26666,27216,550
2022-04-21,70059,70053,Blue,0,81196,81425,229
2022-06-29,70049,70838,Blue,0,45355,45973,618
2022-07-02,70057,70053,Blue,0,84091,84240,149
2022-04-29,70054,70058,Blue,1,22197,22349,152
2022-01-06,70059,70043,Blue,0,80598,81421,823
2022-06-30,70050,70056,Blue,1,87210,87532,322
2022-09-29,70054,70058,Blue,1,51567,51726,159
2022-10-31,70046,70054,Blue,1,39219,39681,462
2022-02-08,70057,70047,Blue,0,37873,38437,564
2022-06-28,70040,70058,Blue,1,52525,53551,1026
2022-12-26,70045,70039,Blue,0,52975,53241,266
2022-04-21,70051,70045,Blue,0,45315,45649,334
2022-11-02,70055,70053,Blue,0,24412,24458,46
2022-09-17,70044,70058,Blue,1,68772,69565,793
2022-09-02,70038,70042,Blue,1,42436,42532,96
2022-01-28,70043,70041,Blue,0,55067,55097,30
2022-02-09,70038,70056,Blue,1,67734,68689,955
2022-08-17,70057,70053,Blue,0,70766,70911,145
2022-03-03,70055,70039,Blue,0,61588,62519,931
2022-05-31,70038,70052,Blue,1,28152,29040,888
2022-06-09,70057,70041,Blue,0,77886,78757,871
2022-12-02,70040,70056,Blue,1,47714,48545,831
2022-01-20,70040,70042,Blue,1,29708,29743,35
2022-04-04,70059,70041,Blue,0,83467,84350,883
2022-10-29,70053,70043,Blue,0,78039,78660,621
2022-06-02,70045,70041,Blue,0,43686,43912,226
2022-10-18,70057,70041,Blue,0,76530,77353,823
2022-07-26,70040,70050,Blue,1,33405,33928,523
2022-09-08,70055,70051,Blue,0,71957,72099,142
2022-12-09,70040,70050,Blue,1,20065,20550,485
2022-06-04,70049,70045,Blue,0,32846,33141,295
2022-07-09,70047,70838,Blue,0,39702,40237,535
2022-02-13,70054,70060,Blue,1,56279,56559,280
2022-09-29,70051,70838,Blue,0,65028,65781,753
2022-07-23,70044,70058,Blue,1,46622,47453,831
2022-01-10,70038,70052,Blue,1,50776,51583,807
2022-10-13,70053,70838,Blue,0,35160,36096,936
2022-06-17,70040,70060,Blue,1,23702,24816,1114
2022-03-03,70038,70042,Blue,1,73520,73638,118
2022-07-26,70051,70049,Blue,0,58803,58906,103
2022-01-03,70057,70045,Blue,0,41604,42187,583
2022-10-27,70056,70058,Blue,1,66030,66100,70
2022-07-04,70040,70042,Blue,1,74479,74509,30
2022-08-08,70040,70044,Blue,1,47732,47843,111
2022-10-19,70057,70045,Blue,0,69631,70318,687
2022-04-05,70057,70047,Blue,0,40489,41030,541
2022-07-16,70038,70042,Blue,1,49090,49209,119
2022-06-14,70055,70039,Blue,0,61896,62807,911
2022-09-21,70047,70039,Blue,0,55700,56112,412
2022-03-19,70059,70057,Blue,0,72994,73030,36
2022-01-24,70057,70045,Blue,0,31846,32649,803
2022-11-09,70059,70039,Blue,0,51982,53011,1029
2022-03-18,70050,70052,Blue,1,80887,81004,117
2022-02-05,70054,70056,Blue,1,84607,84654,47
2022-04-18,70049,70043,Blue,0,26076,26476,400
2022-04-18,70059,70047,Blue,0,76637,77265,628
2022-11-01,70056,70058,Blue,1,45026,45098,72
2022-01-31,70055,70041,Blue,0,39209,40059,850
2022-12-10,70042,70050,Blue,1,32500,32937,437
2022-04-14,70051,70039,Blue,0,52468,53123,655
2022-06-25,70042,70060,Blue,1,40196,41183,987
2022-11-02,70059,70051,Blue,0,35898,36259,361
2022-06-09,70051,70043,Blue,0,50612,51173,561
2022-04-03,70038,70048,Blue,1,75309,75801,492
2022-07-11,70044,70054,Blue,1,70651,71244,593
2022-09-16,70043,70041,Blue,0,68319,68347,28
2022-08-26,70038,70054,Blue,1,24793,25549,756
2022-09-16,70038,70042,Blue,1,76274,76378,104
2022-06-24,70040,70060,Blue,1,50860,52159,1299
2022-11-30,70040,70056,Blue,1,22261,23044,783
2022-10-07,70044,70046,Blue,1,76961,77066,105
2022-02-25,70059,70041,Blue,0,56000,56890,890
2022-06-07,70046,70048,Blue,1,30003,30111,108
2022-11-11,70048,70050,Blue,1,40990,41052,62
2022-10-09,70038,70050,Blue,1,42313,42903,590
2022-05-18,70056,70058,Blue,1,53093,53162,69
2022-12-13,70057,70039,Blue,0,66632,67504,872
2022-12-09,70042,70044,Blue,1,43136,43174,38
2022-01-26,70051,70047,Blue,0,55000,55207,207
2022-09-30,70059,70051,Blue,0,39496,39824,328
2022-03-28,70059,70055,Blue,0,34160,34306,146
2022-02-20,70057,70838,Blue,0,34829,35871,1042
2022-02-26,70049,70039,Blue,0,23955,24595,640
2022-05-21,70050,70058,Blue,1,79457,79898,441
2022-10-03,70040,70054,Blue,1,29550,30322,772
2022-03-13,70038,70060,Blue,1,60734,61913,1179
2022-11-13,70048,70050,Blue,1,73095,73152,57
2022-03-30,70059,70057,Blue,0,80603,80638,35
2022-10-02,70057,70838,Blue,0,70657,71637,980
2022-03-31,70057,70053,Blue,0,58461,58607,146
2022-08-24,70045,70838,Blue,0,34271,34684,413
2022-09-30,70042,70058,Blue,1,44341,45174,833
2022-01-14,70051,70047,Blue,0,23824,24032,208
2022-10-10,70051,70041,Blue,0,36239,36800,561
2022-12-13,70051,70838,Blue,0,24214,24975,761
2022-12-27,70049,70838,Blue,0,58423,59060,637
2022-04-08,70044,70050,Blue,1,70104,70415,311
2022-11-12,70044,70060,Blue,1,42837,43729,892
2022-04-16,70057,70043,Blue,0,41193,42091,898
2022-02-15,70045,70039,Blue,0,19198,19489,291
2022-06-18,70045,70838,Blue,0,72103,72463,360
2022-09-13,70051,70043,Blue,0,30120,30752,632
2022-04-08,70049,70041,Blue,0,61272,61665,393
2022-03-23,70038,70058,Blue,1,54010,55043,1033
2022-03-25,70044,70048,Blue,1,67861,68095,234
2022-01-14,70039,70838,Blue,0,53684,53731,47
2022-10-27,70038,70060,Blue,1,38514,39722,1208
2022-12-22,70051,70047,Blue,0,88519,88721,202
2022-07-12,70047,70838,Blue,0,84030,84492,462
2022-05-17,70049,70047,Blue,0,64166,64204,38
2022-10-01,70040,70054,Blue,1,41593,42851,1258
2022-06-10,70042,70050,Blue,1,68998,69461,463
2022-11-29,70053,70039,Blue,0,31156,31964,808
2022-10-03,70057,70049,Blue,0,43391,43804,413
2022-10-28,70047,70045,Blue,0,68178,68272,94
2022-03-25,70054,70060,Blue,1,85088,85349,261
2022-02-25,70046,70056,Blue,1,64729,65438,709
2022-09-04,70051,70047,Blue,0,61756,61941,185
2022-04-11,70042,70044,Blue,1,32805,32841,36
2022-01-11,70057,70051,Blue,0,30712,30978,266
2022-10-06,70050,70054,Blue,1,34228,34476,248
2022-09-13,70047,70838,Blue,0,77032,77491,459
2022-02-19,70046,70058,Blue,1,26713,27363,650
2022-10-24,70059,70043,Blue,0,85252,86079,827
2022-04-22,70040,70056,Blue,1,71028,71905,877
2022-10-05,70046,70058,Blue,1,37651,38278,627
2022-12-27,70054,70056,Blue,1,61417,61464,47
2022-04-09,70059,70055,Blue,0,66495,66643,148
2022-08-09,70051,70041,Blue,0,19924,20574,650
2022-07-30,70057,70049,Blue,0,36335,36739,404
2022-11-15,70038,70054,Blue,1,30672,31470,798
2022-04-19,70057,70838,Blue,0,59026,60089,1063
2022-04-06,70038,70048,Blue,1,65826,66306,480
2022-02-26,70053,70047,Blue,0,55973,56266,293
2022-09-09,70046,70052,Blue,1,38891,39269,378
2022-12-21,70038,70044,Blue,1,21305,21504,199
2022-11-23,70057,70045,Blue,0,23395,24068,673
2022-03-29,70059,70051,Blue,0,40935,41279,344
2022-12-06,70044,70052,Blue,1,43211,43724,513
2022-07-18,70040,70060,Blue,1,70291,71357,1066
2022-01-11,70051,70045,Blue,0,54551,54896,345
2022-04-12,70057,70043,Blue,0,28852,29686,834
2022-02-27,70040,70056,Blue,1,26962,27774,812
2022-10-05,70053,70049,Blue,0,51270,51473,203
2022-01-04,70059,70045,Blue,0,59598,60252,654
2022-08-11,70059,70043,Blue,0,44718,45584,866
2022-03-11,70046,70054,Blue,1,54954,55402,448
2022-04-05,70040,70054,Blue,1,69520,70289,769
2022-08-29,70055,70041,Blue,0,66425,67131,706
2022-06-28,70059,70043,Blue,0,64029,64919,890
2022-09-11,70040,70050,Blue,1,71051,71564,513
2022-01-11,70048,70060,Blue,1,30817,31773,956
2022-10-11,70052,70058,Blue,1,24193,24473,280
2022-02-10,70038,70060,Blue,1,43513,44624,1111
2022-12-20,70050,70058,Blue,1,32003,32468,465
2022-03-31,70056,70058,Blue,1,46700,46772,72
2022-11-20,70046,70060,Blue,1,40074,40807,733
2022-01-28,70043,70039,Blue,0,30127,30241,114
2022-04-20,70049,70043,Blue,0,67279,67632,353
2022-05-01,70059,70057,Blue,0,39610,39646,36
2022-07-27,70045,70039,Blue,0,69885,70151,266
2022-10-08,70042,70056,Blue,1,26497,27265,768
2022-12-29,70040,70044,Blue,1,69174,69289,115
2022-10-12,70040,70058,Blue,1,51856,52803,947
2022-06-12,70040,70052,Blue,1,37762,38421,659
2022-03-09,70038,70042,Blue,1,33860,33957,97
2022-09-01,70047,70045,Blue,0,57569,57665,96
2022-05-18,70057,70055,Blue,0,42005,42090,85
2022-04-21,70042,70052,Blue,1,85525,86042,517
2022-03-15,70051,70047,Blue,0,61152,61338,186
2022-03-09,70041,70838,Blue,0,27514,27655,141
2022-06-24,70057,70047,Blue,0,35951,36546,595
2022-10-18,70049,70041,Blue,0,74910,75372,462
2022-08-04,70044,70048,Blue,1,28345,28561,216
2022-06-10,70043,70041,Blue,0,75895,75923,28
2022-07-03,70057,70043,Blue,0,71237,72006,769
2022-01-06,70049,70039,Blue,0,22642,23139,497
2022-11-13,70042,70048,Blue,1,51165,51473,308
2022-02-22,70059,70039,Blue,0,72625,73675,1050
2022-01-11,70051,70838,Blue,0,54245,55074,829
2022-01-19,70057,70047,Blue,0,34452,35026,574
2022-08-15,70051,70045,Blue,0,37912,38304,392
2022-02-04,70057,70043,Blue,0,62381,63236,855
2022-04-09,70046,70050,Blue,1,22089,22306,217
2022-02-28,70043,70039,Blue,0,82642,82742,100
2022-08-13,70042,70060,Blue,1,64363,65349,986
2022-12-31,70056,70060,Blue,1,31095,31278,183
2022-07-04,70051,70039,Blue,0,72570,73230,660
2022-04-17,70054,70058,Blue,1,39263,39421,158
2022-07-22,70059,70043,Blue,0,68661,69547,886
2022-07-11,70055,70041,Blue,0,53001,53758,757
2022-01-26,70052,70056,Blue,1,72290,72469,179
2022-01-01,70038,70054,Blue,1,89115,89895,780
2022-03-03,70043,70838,Blue,0,66448,66641,193
2022-05-20,70046,70060,Blue,1,77572,78362,790
2022-07-08,70040,70044,Blue,1,61702,61837,135
2022-04-05,70058,70060,Blue,1,25925,26016,91
2022-04-23,70051,70041,Blue,0,25190,25807,617
2022-09-22,70054,70056,Blue,1,59975,60023,48
2022-01-09,70048,70052,Blue,1,71500,71704,204
2022-05-17,70055,70051,Blue,0,56607,56749,142
2022-08-07,70054,70060,Blue,1,35501,35754,253
2022-10-05,70056,70058,Blue,1,42973,43043,70
2022-01-10,70057,70045,Blue,0,85829,86447,618
2022-10-29,70055,70049,Blue,0,79277,79550,273
2022-08-19,70057,70043,Blue,0,88645,89506,861
2022-02-07,70059,70045,Blue,0,64432,65135,703
2022-11-07,70041,70039,Blue,0,67706,67740,34
2022-09-09,70055,70053,Blue,0,29954,30007,53
2022-12-30,70038,70054,Blue,1,78274,79110,836
2022-07-27,70038,70046,Blue,1,51742,52116,374
2022-02-10,70059,70051,Blue,0,42073,42390,317
2022-07-04,70055,70047,Blue,0,68058,68492,434
2022-04-12,70053,70049,Blue,0,36229,36556,327
2022-01-25,70050,70056,Blue,1,81018,81328,310
2022-07-23,70046,70054,Blue,1,86575,87063,488
2022-07-08,70039,70838,Blue,0,65864,66038,174
2022-10-22,70056,70058,Blue,1,43464,43533,69
2022-12-29,70041,70838,Blue,0,38170,38312,142
2022-11-24,70048,70054,Blue,1,65504,65788,284
2022-09-06,70038,70050,Blue,1,42107,42698,591
2022-07-09,70038,70050,Blue,1,39371,39966,595
2022-05-17,70054,70060,Blue,1,65264,65543,279
2022-11-24,70052,70060,Blue,1,72868,73241,373
2022-01-09,70047,70041,Blue,0,56069,56369,300
2022-11-21,70050,70054,Blue,1,72900,73123,223
2022-11-14,70044,70052,Blue,1,51596,52109,513
2022-01-19,70038,70050,Blue,1,59876,60461,585
2022-05-19,70048,70050,Blue,1,76536,76594,58
2022-07-20,70059,70049,Blue,0,57300,57788,488
2022-12-10,70049,70045,Blue,0,81981,82173,192
2022-09-16,70048,70056,Blue,1,32497,32945,448
2022-06-07,70040,70044,Blue,1,21030,21161,131
2022-12-05,70046,70050,Blue,1,27251,27427,176
2022-02-19,70038,70054,Blue,1,19921,20793,872
2022-09-09,70038,70058,Blue,1,55474,56477,1003
2022-09-19,70039,70838,Blue,0,36998,37031,33
2022-03-24,70050,70058,Blue,1,72543,72935,392
2022-08-05,70057,70039,Blue,0,26848,27804,956
2022-08-10,70046,70058,Blue,1,37678,38322,644
2022-04-21,70053,70039,Blue,0,51818,52539,721
2022-12-22,70045,70041,Blue,0,30331,30484,153
2022-04-26,70056,70060,Blue,1,30229,30412,183
2022-11-02,70042,70048,Blue,1,65523,65843,320
2022-04-19,70053,70047,Blue,0,85443,85790,347
2022-08-01,70050,70060,Blue,1,37373,37947,574
2022-07-06,70040,70042,Blue,1,23292,23327,35
2022-08-24,70048,70052,Blue,1,60004,60209,205
2022-07-11,70052,70058,Blue,1,66223,66495,272
2022-09-14,70047,70045,Blue,0,35543,35638,95
2022-02-24,70056,70058,Blue,1,59857,59930,73
2022-08-29,70054,70058,Blue,1,52996,53144,148
2022-01-28,70044,70058,Blue,1,31064,32009,945
2022-08-28,70045,70041,Blue,0,41597,41802,205
2022-03-16,70050,70052,Blue,1,73522,73643,121
2022-02-06,70047,70043,Blue,0,59888,60150,262
2022-08-09,70045,70039,Blue,0,24229,24645,416
2022-01-13,70041,70838,Blue,0,53531,53665,134
2022-08-27,70059,70041,Blue,0,56775,57716,941
2022-03-29,70059,70053,Blue,0,53587,53813,226
2022-07-28,70055,70049,Blue,0,74551,74877,326
2022-07-21,70048,70056,Blue,1,48221,48647,426
2022-07-22,70040,70044,Blue,1,28927,29036,109
2022-06-27,70051,70049,Blue,0,23789,23894,105
2022-01-24,70051,70041,Blue,0,75846,76408,562
2022-11-23,70044,70060,Blue,1,79750,80594,844
2022-10-08,70048,70058,Blue,1,26439,26930,491
2022-09-23,70055,70838,Blue,0,24453,25495,1042
2022-10-10,70053,70043,Blue,0,56463,57074,611
2022-10-28,70038,70056,Blue,1,50791,51749,958
2022-09-18,70057,70838,Blue,0,39570,40625,1055
2022-09-23,70043,70838,Blue,0,45555,45764,209
2022-10-04,70049,70041,Blue,0,74325,74742,417
2022-06-30,70050,70060,Blue,1,27913,28492,579
2022-07-01,70040,70042,Blue,1,28792,28827,35
2022-12-01,70038,70058,Blue,1,23946,24955,1009
2022-12-08,70058,70060,Blue,1,28465,28532,67
2022-12-04,70038,70050,Blue,1,57494,58062,568
2022-09-23,70048,70060,Blue,1,37890,38507,617
2022-11-09,70057,70043,Blue,0,30095,30899,804
2022-10-24,70042,70052,Blue,1,34893,35464,571
2022-02-23,70045,70041,Blue,0,38394,38589,195
2022-10-03,70042,70054,Blue,1,73370,74059,689
2022-04-23,70059,70041,Blue,0,24130,25100,970
2022-07-15,70040,70056,Blue,1,45624,46498,874
2022-07-07,70051,70838,Blue,0,42988,44033,1045
2022-02-05,70049,70043,Blue,0,43227,43593,366
2022-11-14,70059,70045,Blue,0,24494,25153,659
2022-08-16,70042,70046,Blue,1,58251,58440,189
2022-10-03,70044,70050,Blue,1,32595,32929,334
2022-01-27,70052,70054,Blue,1,36301,36360,59
2022-03-07,70040,70060,Blue,1,26780,27859,1079
2022-08-03,70040,70046,Blue,1,25686,25935,249
2022-02-14,70040,70042,Blue,1,50850,50885,35
2022-01-21,70044,70050,Blue,1,60036,60441,405
2022-09-07,70056,70058,Blue,1,65236,65305,69
2022-12-16,70058,70060,Blue,1,27512,27593,81
2022-03-11,70038,70054,Blue,1,25759,26641,882
2022-06-30,70051,70838,Blue,0,74664,75461,797
2022-07-27,70043,70039,Blue,0,73678,73783,105
2022-11-30,70038,70058,Blue,1,68962,70058,1096
2022-06-15,70059,70055,Blue,0,19081,19234,153
2022-11-03,70048,70054,Blue,1,21625,21955,330
2022-10-10,70042,70056,Blue,1,32756,33552,796
2022-02-27,70055,70047,Blue,0,72926,73328,402
2022-01-08,70048,70052,Blue,1,50695,50886,191
2022-11-23,70049,70047,Blue,0,55098,55151,53
2022-10-15,70048,70054,Blue,1,81172,81481,309
2022-10-31,70043,70838,Blue,0,28132,28341,209
2022-04-11,70051,70039,Blue,0,74755,75452,697
2022-08-23,70055,70049,Blue,0,26148,26441,293
2022-12-29,70044,70052,Blue,1,20037,20679,642
2022-08-03,70059,70043,Blue,0,23010,23927,917
2022-10-20,70043,70838,Blue,0,73783,73974,191
2022-06-19,70038,70060,Blue,1,36256,37354,1098
2022-02-12,70038,70052,Blue,1,43152,43958,806
2022-01-14,70042,70054,Blue,1,69099,69750,651
2022-12-23,70057,70055,Blue,0,55315,55385,70
2022-10-20,70055,70041,Blue,0,26547,27358,811
2022-02-03,70053,70039,Blue,0,86041,86749,708
2022-01-12,70050,70054,Blue,1,81805,82028,223
2022-10-26,70052,70060,Blue,1,47937,48329,392
2022-01-01,70055,70049,Blue,0,49219,49539,320
2022-02-27,70057,70051,Blue,0,76054,76310,256
2022-03-23,70038,70048,Blue,1,59844,60321,477
2022-03-15,70038,70040,Blue,1,39699,39716,17
2022-11-20,70047,70039,Blue,0,40615,41004,389
2022-04-22,70057,70039,Blue,0,67265,68172,907
2022-10-27,70050,70058,Blue,1,79562,79991,429
2022-09-29,70052,70056,Blue,1,80290,80424,134
2022-06-11,70054,70056,Blue,1,72753,72800,47
2022-07-27,70057,70053,Blue,0,22248,22424,176
2022-10-22,70040,70054,Blue,1,27645,28374,729
2022-12-02,70042,70048,Blue,1,57784,58102,318
2022-07-07,70048,70054,Blue,1,46270,46572,302
2022-09-06,70052,70058,Blue,1,67474,67792,318
2022-07-18,70053,70838,Blue,0,32532,33576,1044
2022-06-11,70048,70060,Blue,1,71232,71819,587
2022-11-16,70052,70054,Blue,1,68201,68248,47
2022-03-08,70048,70052,Blue,1,57188,57378,190
2022-07-21,70046,70056,Blue,1,74625,75214,589
2022-12-08,70055,70039,Blue,0,71296,72096,800
2022-10-22,70055,70047,Blue,0,33204,33606,402
2022-08-16,70045,70039,Blue,0,71000,71260,260
2022-04-17,70053,70043,Blue,0,48151,48802,651
2022-07-24,70054,70060,Blue,1,39230,39490,260
2022-06-14,70053,70043,Blue,0,47924,48542,618
2022-12-05,70053,70838,Blue,0,74614,75522,908
2022-06-16,70046,70048,Blue,1,41754,41974,220
2022-08-20,70057,70043,Blue,0,36334,37204,870
2022-02-09,70044,70056,Blue,1,26617,27304,687
2022-03-03,70057,70047,Blue,0,66265,66753,488
2022-11-25,70057,70055,Blue,0,54161,54230,69
2022-10-01,70046,70048,Blue,1,55957,56029,72
2022-04-05,70057,70039,Blue,0,38729,39737,1008
2022-12-13,70048,70054,Blue,1,56511,56889,378
2022-03-24,70042,70046,Blue,1,75333,75529,196
2022-11-27,70044,70056,Blue,1,63115,63800,685
2022-07-06,70052,70056,Blue,1,63685,63833,148
2022-03-24,70045,70043,Blue,0,84733,84820,87
2022-09-20,70041,70838,Blue,0,49856,49968,112
2022-02-22,70042,70046,Blue,1,37519,37708,189
2022-12-31,70057,70047,Blue,0,60698,61194,496
2022-09-28,70051,70838,Blue,0,20317,21167,850
2022-06-29,70040,70044,Blue,1,35110,35221,111
2022-09-13,70056,70058,Blue,1,63333,63506,173
2022-09-11,70042,70058,Blue,1,52803,53627,824
2022-09-18,70049,70838,Blue,0,51105,51804,699
2022-02-25,70049,70045,Blue,0,62890,63092,202
2022-03-23,70055,70039,Blue,0,72252,73012,760
2022-10-22,70042,70052,Blue,1,68153,68760,607
2022-02-02,70042,70044,Blue,1,30396,30423,27
2022-04-02,70055,70045,Blue,0,50007,50543,536
2022-05-25,70038,70046,Blue,1,67040,67437,397
2022-05-05,70055,70053,Blue,0,42526,42587,61
2022-01-15,70055,70039,Blue,0,62546,63990,1444
2022-03-14,70053,70838,Blue,0,38961,39888,927
2022-02-04,70046,70056,Blue,1,82056,82623,567
2022-07-18,70050,70052,Blue,1,33526,33653,127
2022-01-13,70046,70048,Blue,1,52839,52917,78
2022-07-29,70051,70043,Blue,0,36734,37291,557
2022-10-13,70044,70054,Blue,1,26599,27180,581
2022-10-10,70042,70048,Blue,1,35082,35397,315
2022-12-01,70042,70050,Blue,1,57689,58141,452
2022-01-18,70040,70056,Blue,1,45983,47085,1102
2022-06-16,70057,70051,Blue,0,75244,75512,268
2022-04-18,70059,70041,Blue,0,58394,59311,917
2022-08-08,70040,70044,Blue,1,38885,38988,103
2022-01-24,70059,70053,Blue,0,82362,82619,257
2022-11-01,70042,70046,Blue,1,77686,77862,176
2022-03-10,70059,70838,Blue,0,26682,27922,1240
2022-09-04,70056,70060,Blue,1,81960,82132,172
2022-06-24,70051,70049,Blue,0,61853,61959,106
2022-02-07,70038,70056,Blue,1,64087,64953,866
2022-09-26,70056,70058,Blue,1,74046,74119,73
2022-12-09,70053,70041,Blue,0,31673,32466,793
2022-01-01,70059,70838,Blue,0,40819,41994,1175
2022-07-20,70059,70047,Blue,0,70743,71301,558
2022-04-04,70049,70041,Blue,0,22531,22967,436
2022-01-22,70042,70048,Blue,1,48709,49042,333
2022-08-29,70057,70043,Blue,0,34000,34749,749
2022-12-17,70051,70041,Blue,0,77599,78156,557
2022-10-21,70052,70054,Blue,1,70925,70980,55
2022-04-20,70040,70054,Blue,1,61758,62625,867
2022-09-29,70055,70047,Blue,0,55284,55711,427
2022-10-11,70053,70039,Blue,0,78413,79105,692
2022-01-20,70040,70054,Blue,1,47759,48563,804
2022-01-04,70040,70058,Blue,1,31215,32144,929
2022-11-21,70055,70047,Blue,0,72424,72789,365
2022-08-16,70040,70048,Blue,1,82009,82433,424
2022-03-28,70049,70047,Blue,0,33504,33563,59
2022-11-12,70038,70058,Blue,1,70699,71667,968
2022-01-21,70057,70055,Blue,0,51630,51697,67
2022-01-20,70050,70060,Blue,1,56951,57546,595
2022-08-31,70050,70058,Blue,1,81613,82021,408
2022-06-09,70055,70053,Blue,0,40611,40673,62
2022-03-31,70040,70044,Blue,1,67397,67515,118
2022-06-23,70059,70838,Blue,0,78410,79551,1141
2022-02-25,70055,70838,Blue,0,44032,45025,993
2022-02-26,70053,70838,Blue,0,72255,73086,831
2022-07-13,70059,70039,Blue,0,25986,27194,1208
2022-02-20,70049,70041,Blue,0,69457,69914,457
2022-07-31,70054,70058,Blue,1,45144,45305,161
2022-07-14,70048,70050,Blue,1,21901,21960,59
2022-09-06,70059,70051,Blue,0,54688,55014,326
2022-06-14,70044,70050,Blue,1,42719,43109,390
2022-02-06,70045,70043,Blue,0,65914,66043,129
2022-10-28,70045,70838,Blue,0,81386,81754,368
2022-08-07,70038,70046,Blue,1,31591,31913,322
2022-02-04,70054,70058,Blue,1,75803,75977,174
2022-11-02,70057,70047,Blue,0,55758,56270,512
2022-09-12,70057,70047,Blue,0,32755,33285,530
2022-12-02,70042,70046,Blue,1,24580,24768,188
2022-02-13,70057,70047,Blue,0,77675,78146,471
2022-03-06,70057,70045,Blue,0,54452,55060,608
2022-12-31,70054,70060,Blue,1,58166,58438,272
2022-12-26,70047,70039,Blue,0,88861,89666,805
2022-03-04,70042,70060,Blue,1,25348,26434,1086
2022-04-15,70056,70060,Blue,1,69017,69349,332
2022-12-28,70046,70058,Blue,1,52428,53091,663
2022-11-30,70059,70049,Blue,0,43706,44230,524
2022-12-23,70042,70044,Blue,1,75855,75882,27
2022-04-13,70041,70039,Blue,0,52087,52125,38
2022-10-28,70048,70056,Blue,1,26598,26981,383
2022-07-19,70038,70052,Blue,1,58634,59393,759
2022-04-05,70046,70050,Blue,1,37779,37966,187
2022-10-28,70049,70041,Blue,0,24965,25420,455
2022-02-09,70049,70039,Blue,0,61035,61529,494
2022-04-11,70053,70039,Blue,0,43464,44207,743
2022-04-05,70055,70043,Blue,0,43383,44047,664
2022-09-12,70056,70058,Blue,1,59488,59557,69
2022-07-05,70051,70047,Blue,0,58088,58289,201
2022-10-26,70046,70050,Blue,1,30804,30982,178
2022-08-02,70057,70838,Blue,0,41878,42964,1086
2022-07-29,70053,70041,Blue,0,37774,38571,797
2022-10-13,70040,70046,Blue,1,70170,70445,275
2022-07-14,70047,70041,Blue,0,36028,36384,356
2022-01-12,70042,70044,Blue,1,61181,61213,32
2022-10-18,70057,70043,Blue,0,26020,26874,854
2022-12-23,70047,70045,Blue,0,67701,67810,109
2022-04-07,70038,70058,Blue,1,85386,86319,933
2022-10-27,70058,70060,Blue,1,54664,54834,170
2022-08-15,70057,70053,Blue,0,68207,68365,158
2022-04-25,70053,70047,Blue,0,27450,27780,330
2022-02-24,70059,70049,Blue,0,19161,19683,522
2022-11-19,70052,70054,Blue,1,76284,76330,46
2022-02-03,70044,70052,Blue,1,59518,60027,509
2022-10-08,70050,70060,Blue,1,31285,31807,522
2022-12-14,70047,70043,Blue,0,59449,59685,236
2022-11-10,70045,70838,Blue,0,51767,52129,362
2022-11-01,70046,70060,Blue,1,38088,38787,699
2022-09-09,70057,70045,Blue,0,86630,87299,669
2022-12-12,70042,70048,Blue,1,60401,60730,329
2022-06-28,70040,70042,Blue,1,83450,83483,33
2022-01-02,70051,70838,Blue,0,71481,72154,673
2022-02-15,70048,70056,Blue,1,39222,39689,467
2022-01-07,70038,70050,Blue,1,19992,20579,587
2022-07-07,70038,70054,Blue,1,35802,36719,917
2022-02-23,70044,70056,Blue,1,73278,73966,688
2022-04-18,70052,70056,Blue,1,55126,55254,128
2022-12-02,70055,70049,Blue,0,47540,47818,278
2022-03-14,70051,70047,Blue,0,62673,62894,221
2022-01-17,70040,70050,Blue,1,59429,60001,572
2022-08-25,70057,70043,Blue,0,43044,43896,852
2022-08-20,70059,70045,Blue,0,36254,36985,731
2022-02-07,70044,70052,Blue,1,28361,28885,524
2022-08-22,70049,70041,Blue,0,75215,75690,475
2022-02-07,70051,70043,Blue,0,57030,57561,531
2022-06-24,70048,70060,Blue,1,49457,50100,643
2022-04-14,70048,70056,Blue,1,66401,66762,361
2022-10-11,70049,70039,Blue,0,74889,75484,595
2022-09-26,70059,70838,Blue,0,53072,54248,1176
2022-01-25,70047,70045,Blue,0,57549,57640,91
2022-12-28,70051,70043,Blue,0,72375,72870,495
2022-12-04,70058,70060,Blue,1,76291,76350,59
2022-11-16,70049,70043,Blue,0,47314,47660,346
2022-01-05,70053,70049,Blue,0,51717,51951,234
2022-08-07,70050,70052,Blue,1,88038,88154,116
2022-03-16,70056,70060,Blue,1,48937,49110,173
2022-01-18,70059,70055,Blue,0,61092,61228,136
2022-02-20,70042,70050,Blue,1,62032,62486,454
2022-09-01,70044,70056,Blue,1,39870,41759,1889
2022-03-27,70045,70039,Blue,0,54042,54296,254
2022-11-30,70057,70047,Blue,0,42185,42694,509
2022-05-18,70053,70049,Blue,0,45790,46022,232
2022-01-04,70040,70042,Blue,1,26481,26518,37
2022-05-07,70059,70049,Blue,0,42025,42544,519
2022-03-27,70052,70060,Blue,1,41789,42148,359
2022-01-07,70046,70048,Blue,1,65273,65347,74
2022-02-04,70040,70058,Blue,1,33589,35039,1450
2022-12-19,70040,70042,Blue,1,30487,30518,31
2022-05-20,70055,70041,Blue,0,84200,85047,847
2022-01-18,70038,70044,Blue,1,61933,62220,287
2022-09-27,70048,70056,Blue,1,81808,82204,396
2022-02-28,70059,70053,Blue,0,82329,82556,227
2022-04-20,70042,70046,Blue,1,49881,50050,169
2022-02-08,70055,70041,Blue,0,33465,34283,818
2022-01-03,70047,70039,Blue,0,19486,19917,431
2022-03-16,70042,70046,Blue,1,33069,33233,164
2022-11-25,70047,70045,Blue,0,73398,73491,93
2022-03-09,70038,70052,Blue,1,64935,65610,675
2022-12-18,70059,70043,Blue,0,38174,38969,795
2022-10-14,70059,70043,Blue,0,64996,65820,824
2022-10-06,70044,70054,Blue,1,37008,37694,686
2022-01-11,70051,70043,Blue,0,33995,34492,497
2022-03-11,70052,70054,Blue,1,56037,56085,48
2022-07-03,70057,70055,Blue,0,30149,30218,69
2022-07-08,70055,70043,Blue,0,66999,67647,648
2022-11-05,70038,70048,Blue,1,31814,32268,454
2022-06-13,70055,70838,Blue,0,86476,87358,882
2022-12-19,70057,70051,Blue,0,40203,40469,266
2022-02-24,70051,70045,Blue,0,77575,77923,348
2022-09-18,70053,70047,Blue,0,62215,62534,319
2022-09-10,70046,70052,Blue,1,64617,64949,332
2022-08-10,70057,70051,Blue,0,74432,74688,256
2022-10-02,70049,70043,Blue,0,25131,25493,362
2022-03-05,70059,70053,Blue,0,25455,25707,252
2022-08-27,70048,70054,Blue,1,89420,89759,339
2022-12-12,70049,70838,Blue,0,63415,64011,596
2022-09-17,70042,70050,Blue,1,43422,43849,427
2022-08-14,70045,70043,Blue,0,82293,82385,92
2022-12-03,70042,70052,Blue,1,55754,56307,553
2022-09-22,70042,70056,Blue,1,50970,51769,799
2022-08-29,70042,70052,Blue,1,64444,65042,598
2022-04-16,70059,70049,Blue,0,19516,20014,498
2022-11-24,70059,70047,Blue,0,58157,58717,560
2022-12-20,70059,70057,Blue,0,23955,23991,36
2022-10-15,70048,70050,Blue,1,30665,30720,55
2022-03-21,70059,70045,Blue,0,68471,69160,689
2022-07-30,70046,70054,Blue,1,73805,74242,437
2022-04-30,70050,70060,Blue,1,23003,23489,486
2022-06-07,70049,70039,Blue,0,64474,65043,569
2022-01-31,70038,70058,Blue,1,79832,81015,1183
2022-12-25,70050,70054,Blue,1,38300,38510,210
2022-01-14,70054,70058,Blue,1,68826,68998,172
2022-06-17,70049,70838,Blue,0,29635,30250,615
2022-08-16,70052,70054,Blue,1,23668,23738,70
2022-01-02,70057,70039,Blue,0,27843,28754,911
2022-12-07,70043,70838,Blue,0,73603,73772,169
2022-11-05,70040,70044,Blue,1,66528,66882,354
2022-10-08,70048,70058,Blue,1,73914,74434,520
2022-10-19,70040,70042,Blue,1,38900,38931,31
2022-04-05,70045,70838,Blue,0,58274,58606,332
2022-06-20,70046,70056,Blue,1,71549,72133,584
2022-12-26,70042,70046,Blue,1,91180,91358,178
2022-04-02,70041,70039,Blue,0,80021,80051,30
2022-11-28,70048,70050,Blue,1,57014,57069,55
2022-05-29,70038,70042,Blue,1,83725,83837,112
2022-02-18,70046,70060,Blue,1,55345,56133,788
2022-12-25,70058,70060,Blue,1,46563,46620,57
2022-12-11,70057,70838,Blue,0,67419,68469,1050
2022-08-25,70055,70053,Blue,0,71948,71994,46
2022-06-30,70049,70045,Blue,0,53773,53970,197
2022-08-24,70038,70046,Blue,1,51292,51619,327
2022-06-04,70042,70048,Blue,1,75404,75765,361
2022-01-03,70045,70039,Blue,0,85959,86192,233
2022-10-03,70038,70052,Blue,1,77836,78652,816
2022-10-23,70042,70044,Blue,1,61462,61488,26
2022-03-23,70059,70053,Blue,0,77788,78018,230
2022-09-22,70051,70047,Blue,0,65905,66163,258
2022-08-12,70040,70050,Blue,1,49372,49874,502
2022-03-25,70048,70060,Blue,1,59479,60134,655
2022-05-03,70050,70060,Blue,1,25193,25715,522
2022-03-02,70053,70041,Blue,0,23914,24545,631
2022-10-29,70044,70056,Blue,1,36398,37065,667
2022-07-02,70055,70051,Blue,0,80053,80199,146
2022-06-16,70038,70042,Blue,1,78688,78787,99
2022-08-29,70048,70058,Blue,1,48195,48729,534
2022-10-27,70040,70042,Blue,1,51089,51124,35
2022-07-21,70041,70838,Blue,0,63496,63621,125
2022-02-10,70040,70056,Blue,1,39319,40255,936
2022-01-18,70038,70046,Blue,1,68700,69012,312
2022-06-19,70048,70050,Blue,1,60246,60304,58
2022-12-06,70038,70050,Blue,1,34047,34602,555
2022-10-18,70058,70060,Blue,1,31448,31522,74
2022-01-13,70051,70039,Blue,0,39673,40463,790
2022-07-24,70047,70041,Blue,0,85268,85568,300
2022-01-27,70044,70056,Blue,1,20505,21414,909
2022-10-08,70050,70060,Blue,1,22507,23071,564
2022-01-20,70038,70050,Blue,1,68585,69122,537
2022-10-18,70038,70046,Blue,1,54454,54843,389
2022-06-13,70044,70056,Blue,1,41216,42060,844
2022-01-11,70046,70050,Blue,1,73446,73657,211
2022-03-02,70038,70050,Blue,1,30562,31156,594
2022-08-22,70046,70058,Blue,1,80111,80730,619
2022-02-04,70053,70051,Blue,0,72018,72082,64
2022-07-26,70051,70045,Blue,0,83947,84289,342
2022-06-23,70057,70055,Blue,0,57775,57844,69
2022-01-13,70042,70060,Blue,1,39286,40370,1084
2022-07-11,70049,70041,Blue,0,61383,61832,449
2022-11-28,70044,70046,Blue,1,67612,67713,101
2022-10-28,70051,70039,Blue,0,66376,67049,673
2022-06-15,70040,70042,Blue,1,53424,53458,34
2022-08-11,70053,70041,Blue,0,66870,67530,660
2022-04-05,70045,70838,Blue,0,64019,64380,361
2022-07-16,70048,70060,Blue,1,32299,32998,699
2022-12-22,70040,70042,Blue,1,61831,61867,36
2022-04-15,70051,70047,Blue,0,74718,74933,215
2022-12-24,70053,70039,Blue,0,34509,35305,796
2022-06-23,70042,70046,Blue,1,76919,77165,246
2022-01-26,70045,70041,Blue,0,53914,54142,228
2022-12-27,70042,70054,Blue,1,29605,30253,648
2022-09-17,70057,70043,Blue,0,68186,68956,770
2022-10-11,70050,70058,Blue,1,89737,90144,407
2022-07-13,70040,70060,Blue,1,23300,24427,1127
2022-04-06,70051,70838,Blue,0,86679,87479,800
2022-07-19,70045,70043,Blue,0,72986,73076,90
2022-12-16,70052,70054,Blue,1,71822,71888,66
2022-01-08,70056,70058,Blue,1,72717,72793,76
2022-10-05,70057,70051,Blue,0,78899,79179,280
2022-08-02,70050,70060,Blue,1,21556,22068,512
2022-02-03,70051,70041,Blue,0,37399,38064,665
2022-12-20,70038,70050,Blue,1,54739,55249,510
2022-09-01,70058,70060,Blue,1,32924,32989,65
2022-03-09,70043,70838,Blue,0,31494,31701,207
2022-05-06,70057,70049,Blue,0,52424,52848,424
2022-01-04,70051,70838,Blue,0,60936,61674,738
2022-06-04,70040,70048,Blue,1,84954,85426,472
2022-03-14,70053,70049,Blue,0,21600,21792,192
2022-01-26,70052,70060,Blue,1,32820,33189,369
2022-01-06,70053,70039,Blue,0,50529,51725,1196
2022-09-12,70057,70041,Blue,0,31095,31978,883
2022-11-08,70052,70056,Blue,1,84256,84386,130
2022-12-20,70050,70058,Blue,1,36153,36601,448
2022-12-04,70051,70045,Blue,0,46422,46775,353
2022-03-22,70045,70043,Blue,0,54601,54703,102
2022-02-04,70053,70039,Blue,0,83794,84644,850
2022-09-27,70055,70047,Blue,0,44004,44472,468
2022-04-01,70053,70049,Blue,0,73743,73971,228
2022-08-09,70044,70048,Blue,1,27626,27859,233
2022-05-19,70043,70041,Blue,0,43261,43289,28
2022-02-07,70042,70046,Blue,1,21686,21850,164
2022-09-01,70057,70047,Blue,0,27286,27757,471
2022-10-21,70050,70054,Blue,1,32110,32306,196
2022-01-18,70057,70047,Blue,0,26438,26988,550
2022-12-30,70055,70041,Blue,0,73444,74143,699
2022-07-23,70049,70043,Blue,0,35125,35456,331
2022-10-15,70057,70838,Blue,0,74669,75704,1035
2022-10-12,70054,70058,Blue,1,32547,32705,158
2022-09-29,70040,70060,Blue,1,80500,81562,1062
2022-08-03,70042,70044,Blue,1,23270,23299,29
2022-12-16,70038,70044,Blue,1,56541,56758,217
2022-11-28,70052,70054,Blue,1,81091,81144,53
2022-06-15,70057,70051,Blue,0,58788,59037,249
2022-12-18,70043,70041,Blue,0,58003,58031,28
2022-07-04,70046,70058,Blue,1,52713,53396,683
2022-12-13,70038,70060,Blue,1,27718,28890,1172
2022-01-04,70055,70838,Blue,0,21597,22669,1072
2022-02-08,70040,70060,Blue,1,26133,27405,1272
2022-10-21,70047,70039,Blue,0,41205,41612,407
2022-08-08,70042,70046,Blue,1,25512,25714,202
2022-03-17,70042,70046,Blue,1,56654,56829,175
2022-08-06,70048,70052,Blue,1,29036,29234,198
2022-05-26,70041,70039,Blue,0,57820,57852,32
2022-02-10,70040,70052,Blue,1,27650,28340,690
2022-08-19,70051,70049,Blue,0,29232,29343,111
2022-11-29,70039,70838,Blue,0,57254,57286,32
2022-12-30,70050,70060,Blue,1,50321,50875,554
2022-12-09,70042,70060,Blue,1,32997,33959,962
2022-03-16,70042,70046,Blue,1,57867,58041,174
2022-05-29,70044,70048,Blue,1,35362,35688,326
2022-10-09,70059,70043,Blue,0,33983,34956,973
2022-11-10,70042,70056,Blue,1,78039,78816,777
2022-06-12,70059,70043,Blue,0,86419,87262,843
2022-01-24,70048,70054,Blue,1,84806,85132,326
2022-11-20,70045,70043,Blue,0,65342,65421,79
2022-06-29,70055,70053,Blue,0,65994,66040,46
2022-12-10,70040,70050,Blue,1,69665,70161,496
2022-12-23,70050,70058,Blue,1,25542,26042,500
2022-10-17,70038,70046,Blue,1,67390,67720,330
2022-07-19,70048,70060,Blue,1,28370,29029,659
2022-08-24,70047,70039,Blue,0,24552,25027,475
2022-03-29,70038,70050,Blue,1,47528,48093,565
2022-08-23,70045,70039,Blue,0,24219,24537,318
2022-12-31,70042,70046,Blue,1,90262,90491,229
2022-07-09,70055,70045,Blue,0,53188,53725,537
2022-08-19,70045,70039,Blue,0,71056,71321,265
2022-06-22,70055,70045,Blue,0,32855,33363,508
2022-01-13,70047,70041,Blue,0,54478,54801,323
2022-01-10,70047,70838,Blue,0,55378,55912,534
2022-03-31,70055,70838,Blue,0,62783,63661,878
2022-11-30,70038,70052,Blue,1,24035,24746,711
2022-06-24,70038,70050,Blue,1,65726,66475,749
2022-04-07,70048,70060,Blue,1,22086,22758,672
2022-11-05,70038,70054,Blue,1,89118,90047,929
2022-06-21,70038,70044,Blue,1,68845,69005,160
2022-02-20,70051,70047,Blue,0,85894,86086,192
2022-10-10,70043,70039,Blue,0,22334,22458,124
2022-02-15,70059,70053,Blue,0,24854,25158,304
2022-10-07,70059,70041,Blue,0,65619,66607,988
2022-03-11,70048,70050,Blue,1,56513,56571,58
2022-05-19,70038,70050,Blue,1,50312,51042,730
2022-09-07,70046,70054,Blue,1,33976,34401,425
2022-01-26,70039,70838,Blue,0,62434,62479,45
2022-02-20,70042,70044,Blue,1,27815,27844,29
2022-11-02,70053,70051,Blue,0,30404,30468,64
2022-01-28,70053,70051,Blue,0,86601,86673,72
2022-07-09,70052,70058,Blue,1,39626,39889,263
2022-10-15,70038,70042,Blue,1,32428,32519,91
2022-05-19,70040,70052,Blue,1,42694,43469,775
2022-01-25,70042,70050,Blue,1,54232,54630,398
2022-06-22,70059,70043,Blue,0,22152,23100,948
2022-10-24,70040,70052,Blue,1,49376,50052,676
2022-02-15,70057,70049,Blue,0,23137,23606,469
2022-07-28,70040,70052,Blue,1,29416,30056,640
2022-10-03,70057,70051,Blue,0,55178,55429,251
2022-03-24,70052,70054,Blue,1,32534,32603,69
2022-01-10,70046,70060,Blue,1,24030,24835,805
2022-02-02,70053,70043,Blue,0,21375,22089,714
2022-01-07,70053,70045,Blue,0,56272,56755,483
2022-12-08,70042,70050,Blue,1,53092,53511,419
2022-02-28,70047,70045,Blue,0,63194,63301,107
2022-11-14,70049,70039,Blue,0,43710,44210,500
2022-06-10,70049,70039,Blue,0,71163,71737,574
2022-12-27,70052,70054,Blue,1,20732,20784,52
2022-05-12,70058,70060,Blue,1,68622,68679,57
2022-12-13,70056,70058,Blue,1,43679,43748,69
2022-09-27,70057,70051,Blue,0,24139,24408,269
2022-04-17,70054,70058,Blue,1,37123,37280,157
2022-04-13,70057,70047,Blue,0,71616,72114,498
2022-06-15,70046,70050,Blue,1,22510,22696,186
2022-12-18,70054,70060,Blue,1,45829,46084,255
2022-12-07,70057,70041,Blue,0,72324,73115,791
2022-12-07,70038,70056,Blue,1,70506,71353,847
2022-12-03,70055,70049,Blue,0,34824,35154,330
2022-08-17,70059,70045,Blue,0,80623,81269,646
2022-01-04,70051,70039,Blue,0,70898,71541,643
2022-02-13,70046,70050,Blue,1,55767,55962,195
2022-01-15,70042,70044,Blue,1,25101,25130,29
2022-09-09,70038,70042,Blue,1,67281,67398,117
2022-10-19,70043,70041,Blue,0,26506,26536,30
2022-10-01,70042,70046,Blue,1,37904,38078,174
2022-02-12,70040,70042,Blue,1,40521,40553,32
2022-05-25,70038,70044,Blue,1,88326,88488,162
2022-10-25,70059,70047,Blue,0,79237,79749,512
2022-01-24,70045,70838,Blue,0,39509,40114,605
2022-03-09,70055,70053,Blue,0,55877,55959,82
2022-11-22,70048,70058,Blue,1,48203,48690,487
2022-06-12,70043,70838,Blue,0,41835,42053,218
2022-09-22,70059,70039,Blue,0,51978,52989,1011
2022-07-17,70057,70041,Blue,0,59313,60202,889
2022-08-24,70044,70048,Blue,1,37057,37290,233
2022-06-14,70059,70041,Blue,0,67546,68436,890
2022-04-12,70059,70053,Blue,0,82874,83125,251
2022-03-17,70045,70043,Blue,0,25920,26014,94
2022-12-07,70057,70051,Blue,0,49467,49782,315
2022-03-21,70042,70052,Blue,1,54481,55069,588
2022-07-18,70057,70047,Blue,0,26453,26975,522
2022-05-15,70057,70051,Blue,0,21582,21845,263
2022-10-29,70056,70060,Blue,1,45179,45364,185
2022-09-15,70051,70838,Blue,0,76188,76869,681
2022-12-24,70056,70060,Blue,1,55413,55586,173
2022-03-27,70057,70053,Blue,0,60923,61072,149
2022-02-08,70046,70060,Blue,1,31388,32370,982
2022-01-18,70038,70054,Blue,1,21051,22034,983
2022-08-23,70057,70045,Blue,0,26385,27064,679
2022-10-03,70044,70048,Blue,1,55713,55959,246
2022-02-09,70051,70047,Blue,0,64189,64384,195
2022-01-05,70044,70060,Blue,1,77624,78503,879
2022-06-22,70039,70838,Blue,0,76718,76750,32
2022-08-19,70048,70050,Blue,1,66934,66992,58
2022-01-08,70042,70056,Blue,1,26428,27179,751
2022-10-19,70043,70041,Blue,0,36020,36049,29
2022-04-11,70050,70054,Blue,1,27001,27211,210
2022-04-24,70051,70047,Blue,0,50408,50596,188
2022-08-31,70047,70045,Blue,0,53685,53781,96
2022-02-22,70057,70053,Blue,0,56991,57166,175
2022-06-29,70057,70838,Blue,0,29802,30919,1117
2022-01-27,70059,70041,Blue,0,81871,82835,964
2022-04-06,70046,70052,Blue,1,23133,23526,393
2022-03-16,70055,70041,Blue,0,77948,78679,731
2022-03-28,70049,70039,Blue,0,45454,45931,477
2022-01-08,70046,70056,Blue,1,44048,44566,518
2022-04-01,70056,70060,Blue,1,64154,64330,176
2022-07-13,70046,70058,Blue,1,46296,46966,670
2022-08-17,70038,70052,Blue,1,33552,34304,752
2022-03-24,70044,70048,Blue,1,44941,45186,245
2022-12-01,70056,70060,Blue,1,40886,41081,195
2022-08-15,70059,70838,Blue,0,40669,41892,1223
2022-03-02,70048,70050,Blue,1,36248,36308,60
2022-02-12,70049,70041,Blue,0,20653,21053,400
2022-09-04,70055,70039,Blue,0,78439,79250,811
2022-12-01,70038,70054,Blue,1,71045,71871,826
2022-02-28,70055,70053,Blue,0,21869,21933,64
2022-12-08,70040,70046,Blue,1,57783,58077,294
2022-12-03,70038,70046,Blue,1,64215,64536,321
2022-01-10,70055,70043,Blue,0,88305,88962,657
2022-12-21,70059,70057,Blue,0,33364,33400,36
2022-05-06,70050,70054,Blue,1,89494,89779,285
2022-01-24,70049,70041,Blue,0,87606,88135,529
2022-11-11,70047,70041,Blue,0,36227,36597,370
2022-06-18,70040,70054,Blue,1,87445,88235,790
2022-02-11,70051,70049,Blue,0,20316,20425,109
2022-01-28,70050,70054,Blue,1,66499,66731,232
2022-01-26,70059,70049,Blue,0,48675,49148,473
2022-12-24,70043,70041,Blue,0,69569,69596,27
2022-08-05,70051,70041,Blue,0,29258,29846,588
2022-03-26,70048,70054,Blue,1,33398,33730,332
2022-08-02,70059,70047,Blue,0,45262,45835,573
2022-10-29,70057,70039,Blue,0,77185,78085,900
2022-08-15,70057,70049,Blue,0,73432,73811,379
2022-01-31,70057,70053,Blue,0,68561,68762,201
2022-07-29,70044,70046,Blue,1,80255,80360,105
2022-03-16,70039,70838,Blue,0,44990,45027,37
2022-12-09,70049,70041,Blue,0,76939,77353,414
2022-04-02,70040,70056,Blue,1,44338,45199,861
2022-10-14,70042,70048,Blue,1,68740,69080,340
2022-07-22,70045,70039,Blue,0,87528,87775,247
2022-01-19,70043,70041,Blue,0,30472,30499,27
2022-10-20,70046,70056,Blue,1,24888,25425,537
2022-03-21,70040,70054,Blue,1,78069,78964,895
2022-09-21,70038,70050,Blue,1,78484,79017,533
2022-08-02,70055,70041,Blue,0,49035,49801,766
2022-08-27,70044,70052,Blue,1,47130,47588,458
2022-12-02,70053,70838,Blue,0,62697,63601,904
2022-01-11,70044,70048,Blue,1,54246,54468,222
2022-01-02,70050,70058,Blue,1,52729,53162,433
2022-05-19,70051,70838,Blue,0,68839,69750,911
2022-04-12,70049,70043,Blue,0,54999,55398,399
2022-01-04,70048,70050,Blue,1,58845,58903,58
2022-05-21,70044,70060,Blue,1,61720,62843,1123
2022-02-07,70044,70060,Blue,1,68791,69668,877
2022-01-12,70050,70054,Blue,1,25517,25722,205
2022-05-20,70059,70053,Blue,0,19163,19409,246
2022-12-12,70059,70049,Blue,0,78593,79030,437
2022-11-15,70053,70047,Blue,0,20699,20991,292
2022-03-21,70046,70058,Blue,1,31533,32198,665
2022-12-22,70059,70045,Blue,0,67685,68400,715
2022-12-12,70042,70046,Blue,1,85451,85635,184
2022-09-03,70042,70056,Blue,1,23112,23792,680
2022-12-04,70057,70055,Blue,0,64774,64843,69
2022-03-28,70040,70048,Blue,1,24950,25358,408
2022-07-11,70046,70054,Blue,1,57434,57909,475
2022-07-15,70046,70052,Blue,1,69198,69507,309
2022-06-28,70057,70049,Blue,0,84407,84779,372
2022-12-27,70046,70052,Blue,1,69435,69815,380
2022-04-04,70050,70058,Blue,1,44409,44828,419
2022-02-28,70059,70041,Blue,0,32966,34012,1046
2022-01-26,70040,70046,Blue,1,32729,32984,255
2022-10-27,70040,70052,Blue,1,31888,32524,636
2022-04-11,70040,70056,Blue,1,28510,29422,912
2022-03-03,70053,70047,Blue,0,83781,84094,313
2022-04-13,70052,70054,Blue,1,67509,67562,53
2022-08-11,70055,70053,Blue,0,45929,45975,46
2022-09-15,70044,70046,Blue,1,75645,75751,106
2022-11-29,70059,70838,Blue,0,60352,61473,1121
2022-12-30,70059,70051,Blue,0,31936,32247,311
2022-06-28,70057,70047,Blue,0,59426,59895,469
2022-03-14,70055,70051,Blue,0,72907,73041,134
2022-03-28,70057,70838,Blue,0,49314,50413,1099
2022-04-08,70050,70058,Blue,1,39666,40112,446
2022-02-15,70038,70058,Blue,1,63729,64784,1055
2022-02-21,70046,70056,Blue,1,72681,73193,512
2022-10-05,70049,70041,Blue,0,20450,20927,477
2022-01-14,70059,70053,Blue,0,22036,22330,294
2022-03-28,70049,70043,Blue,0,64275,64599,324
2022-03-10,70048,70058,Blue,1,71956,72453,497
2022-07-01,70051,70049,Blue,0,44678,44780,102
2022-03-24,70038,70048,Blue,1,19878,20354,476
2022-08-26,70057,70055,Blue,0,64933,65017,84
2022-07-16,70046,70056,Blue,1,73783,74303,520
2022-11-25,70040,70058,Blue,1,30772,31687,915
2022-02-02,70040,70060,Blue,1,26712,27857,1145
2022-12-27,70040,70052,Blue,1,45680,46330,650
2022-10-12,70040,70044,Blue,1,24879,24996,117
2022-10-14,70059,70049,Blue,0,67576,68027,451
2022-11-07,70056,70058,Blue,1,32667,32744,77
2022-08-17,70040,70048,Blue,1,80148,80608,460
2022-01-19,70055,70041,Blue,0,85926,86577,651
2022-03-06,70049,70041,Blue,0,61934,62382,448
2022-04-11,70042,70044,Blue,1,61192,61225,33
2022-01-09,70038,70046,Blue,1,69530,69879,349
2022-04-09,70048,70056,Blue,1,26800,27210,410
2022-01-14,70051,70047,Blue,0,68298,68527,229
2022-07-23,70047,70045,Blue,0,48799,48904,105
2022-04-19,70059,70045,Blue,0,27123,27968,845
2022-07-18,70048,70058,Blue,1,20518,21041,523
2022-06-09,70038,70060,Blue,1,87735,88920,1185
2022-07-22,70047,70838,Blue,0,60240,60726,486
2022-07-22,70042,70044,Blue,1,25335,25362,27
2022-01-08,70038,70044,Blue,1,79969,80153,184
2022-01-03,70051,70047,Blue,0,32728,32917,189
2022-10-03,70054,70060,Blue,1,79232,79497,265
2022-06-23,70040,70044,Blue,1,39704,39821,117
2022-08-09,70057,70041,Blue,0,29410,30341,931
2022-10-28,70040,70058,Blue,1,72759,73705,946
2022-05-03,70050,70060,Blue,1,71796,72340,544
2022-06-29,70059,70047,Blue,0,66368,66894,526
2022-01-06,70041,70039,Blue,0,80401,80433,32
2022-04-25,70050,70052,Blue,1,31557,31664,107
2022-12-29,70047,70041,Blue,0,39128,39466,338
2022-10-01,70042,70046,Blue,1,78109,78278,169
2022-03-21,70053,70049,Blue,0,42959,43188,229
2022-08-30,70040,70044,Blue,1,68186,68294,108
2022-11-23,70038,70056,Blue,1,49756,50614,858
2022-08-25,70040,70060,Blue,1,36503,37667,1164
2022-02-23,70043,70838,Blue,0,21309,21507,198
2022-09-27,70055,70053,Blue,0,29140,29188,48
2022-01-21,70038,70048,Blue,1,66430,66902,472
2022-09-20,70046,70048,Blue,1,51813,51891,78
2022-08-01,70048,70050,Blue,1,27827,27886,59
2022-06-09,70040,70054,Blue,1,38634,39458,824
2022-11-08,70051,70039,Blue,0,27948,28629,681
2022-09-19,70048,70056,Blue,1,53349,53725,376
2022-06-13,70051,70041,Blue,0,40819,41449,630
2022-10-25,70059,70053,Blue,0,52219,52444,225
2022-04-24,70052,70056,Blue,1,70149,70296,147
2022-10-05,70046,70056,Blue,1,78923,79435,512
2022-03-30,70052,70056,Blue,1,53752,53890,138
2022-12-24,70057,70047,Blue,0,36323,36785,462
2022-07-20,70048,70054,Blue,1,46402,46780,378
2022-12-28,70059,70057,Blue,0,72677,72711,34
2022-06-17,70049,70045,Blue,0,57098,57296,198
2022-07-24,70054,70060,Blue,1,26165,26441,276
2022-03-05,70042,70058,Blue,1,27627,28416,789
2022-08-06,70047,70043,Blue,0,36312,36548,236
2022-05-06,70052,70054,Blue,1,79530,79578,48
2022-06-27,70042,70056,Blue,1,24240,25050,810
2022-05-30,70044,70046,Blue,1,50985,51117,132
2022-06-22,70047,70041,Blue,0,22402,22749,347
2022-07-16,70059,70838,Blue,0,59492,60613,1121
2022-08-17,70051,70043,Blue,0,61688,62175,487
2022-04-06,70047,70043,Blue,0,43339,43686,347
2022-04-21,70057,70041,Blue,0,31530,32420,890
2022-04-23,70048,70058,Blue,1,58342,58857,515
2022-06-14,70050,70058,Blue,1,67025,67535,510
2022-10-20,70055,70047,Blue,0,81360,81759,399
2022-08-30,70055,70039,Blue,0,45508,46409,901
2022-02-07,70038,70046,Blue,1,53726,54053,327
2022-12-09,70043,70039,Blue,0,65340,65450,110
2022-08-15,70051,70838,Blue,0,75255,76039,784
2022-02-28,70043,70039,Blue,0,53431,53546,115
2022-03-22,70045,70838,Blue,0,36278,36890,612
2022-12-24,70038,70054,Blue,1,76094,76874,780
2022-06-16,70055,70047,Blue,0,63378,63759,381
2022-04-20,70054,70060,Blue,1,68853,69147,294
2022-03-14,70045,70039,Blue,0,64229,64482,253
2022-11-04,70042,70056,Blue,1,65258,66147,889
2022-08-15,70040,70048,Blue,1,76454,76854,400
2022-04-24,70044,70060,Blue,1,37229,38137,908
2022-12-13,70050,70054,Blue,1,47329,47596,267
2022-07-29,70038,70040,Blue,1,70144,70158,14
2022-09-04,70056,70060,Blue,1,23988,24247,259
2022-01-25,70059,70039,Blue,0,79453,80549,1096
2022-08-29,70059,70047,Blue,0,83062,83612,550
2022-09-01,70040,70050,Blue,1,72386,72882,496
2022-11-09,70038,70056,Blue,1,23128,24022,894
2022-10-26,70046,70058,Blue,1,47029,47613,584
2022-09-16,70038,70046,Blue,1,37970,38308,338
2022-11-25,70059,70051,Blue,0,49944,50293,349
2022-08-01,70051,70039,Blue,0,61230,61850,620
2022-12-13,70052,70056,Blue,1,35654,35795,141
2022-03-11,70059,70043,Blue,0,61993,62846,853
2022-02-22,70052,70060,Blue,1,28871,29291,420
2022-12-30,70044,70056,Blue,1,51923,52559,636
2022-02-20,70038,70054,Blue,1,81592,82608,1016
2022-06-19,70040,70046,Blue,1,65675,65960,285
2022-10-14,70045,70838,Blue,0,56956,57312,356
2022-11-23,70059,70055,Blue,0,68667,68812,145
2022-10-30,70050,70058,Blue,1,51000,51379,379
2022-08-22,70045,70041,Blue,0,25031,25235,204
2022-10-29,70051,70043,Blue,0,66306,66779,473
2022-11-30,70044,70060,Blue,1,73861,74764,903
2022-02-11,70046,70048,Blue,1,54930,55007,77
2022-08-31,70044,70052,Blue,1,79071,79585,514
2022-12-04,70056,70058,Blue,1,69820,69888,68
2022-02-14,70053,70045,Blue,0,57783,58272,489
2022-07-18,70054,70056,Blue,1,62892,62939,47
2022-09-02,70044,70052,Blue,1,43189,43671,482
2022-01-10,70059,70051,Blue,0,56627,56957,330
2022-11-02,70046,70052,Blue,1,64249,64579,330
2022-11-29,70046,70060,Blue,1,46484,47206,722
2022-03-03,70044,70052,Blue,1,63132,63670,538
2022-09-11,70042,70048,Blue,1,34068,34376,308
2022-01-25,70048,70054,Blue,1,78626,78946,320
2022-08-26,70049,70047,Blue,0,55300,55352,52
2022-07-28,70049,70047,Blue,0,62338,62393,55
2022-11-15,70045,70838,Blue,0,66241,66575,334
2022-10-14,70050,70060,Blue,1,30234,30753,519
2022-02-15,70051,70039,Blue,0,72978,73659,681
2022-06-13,70045,70041,Blue,0,60640,60839,199
2022-10-09,70038,70050,Blue,1,24547,25094,547
2022-09-29,70038,70040,Blue,1,64572,64585,13
2022-08-04,70057,70055,Blue,0,21851,21922,71
2022-11-13,70049,70838,Blue,0,56482,57080,598
2022-07-01,70052,70058,Blue,1,29913,30179,266
2022-10-02,70053,70039,Blue,0,28786,29504,718
2022-01-29,70045,70041,Blue,0,53540,53744,204
2022-08-16,70046,70048,Blue,1,39094,39177,83
2022-02-12,70040,70054,Blue,1,74671,75440,769
2022-06-24,70059,70049,Blue,0,42142,42607,465
2022-03-18,70048,70056,Blue,1,30751,31138,387
2022-08-29,70051,70049,Blue,0,67923,68023,100
2022-02-26,70044,70046,Blue,1,81609,81717,108
2022-12-16,70052,70056,Blue,1,59867,60012,145
2022-05-05,70059,70049,Blue,0,22997,23488,491
2022-05-07,70050,70052,Blue,1,69413,69524,111
2022-12-16,70052,70056,Blue,1,54664,54801,137
2022-10-17,70050,70060,Blue,1,42318,42914,596
2022-02-21,70047,70045,Blue,0,33067,33162,95
2022-04-06,70057,70051,Blue,0,64103,64334,231
2022-11-03,70047,70043,Blue,0,71836,72068,232
2022-10-30,70049,70041,Blue,0,69419,69822,403
2022-01-23,70042,70060,Blue,1,49524,50473,949
2022-12-11,70047,70043,Blue,0,87000,87233,233
2022-03-18,70059,70053,Blue,0,47113,47352,239
2022-02-08,70055,70051,Blue,0,63674,63856,182
2022-10-24,70051,70049,Blue,0,71056,71160,104
2022-07-27,70044,70060,Blue,1,50513,51467,954
2022-03-20,70046,70058,Blue,1,45997,46667,670
2022-11-29,70049,70047,Blue,0,83194,83246,52
2022-02-04,70040,70060,Blue,1,87216,88235,1019
2022-03-08,70053,70051,Blue,0,28449,28507,58
2022-04-25,70056,70058,Blue,1,52422,52496,74
2022-07-18,70053,70043,Blue,0,56648,57255,607
2022-09-30,70053,70045,Blue,0,67397,67818,421
2022-01-20,70049,70045,Blue,0,57424,57612,188
2022-01-23,70053,70049,Blue,0,50957,51151,194
2022-03-28,70059,70043,Blue,0,68497,69294,797
2022-08-18,70048,70060,Blue,1,62408,63065,657
2022-07-03,70053,70047,Blue,0,24100,24381,281
2022-11-05,70038,70046,Blue,1,27500,27826,326
2022-09-29,70047,70039,Blue,0,41825,42239,414
2022-12-23,70038,70040,Blue,1,67370,67386,16
2022-12-01,70039,70838,Blue,0,40038,40070,32
2022-11-24,70049,70047,Blue,0,65675,65730,55
2022-10-17,70041,70838,Blue,0,35984,36113,129
2022-10-16,70042,70060,Blue,1,73299,74349,1050
2022-09-24,70044,70048,Blue,1,53684,53939,255
2022-09-26,70049,70047,Blue,0,32791,32872,81
2022-01-21,70042,70056,Blue,1,52852,53586,734
2022-07-16,70055,70053,Blue,0,45089,45135,46
2022-01-10,70038,70054,Blue,1,87728,88586,858
2022-06-15,70057,70051,Blue,0,86978,87207,229
2022-09-18,70059,70045,Blue,0,76515,77257,742
2022-10-17,70057,70053,Blue,0,31939,32097,158
2022-02-11,70059,70057,Blue,0,69992,70027,35
2022-09-14,70044,70058,Blue,1,47858,48709,851
2022-06-28,70049,70838,Blue,0,55007,55627,620
2022-03-06,70047,70043,Blue,0,30651,30878,227
2022-08-04,70050,70060,Blue,1,21842,22516,674
2022-03-29,70057,70041,Blue,0,56967,57826,859
2022-11-23,70038,70044,Blue,1,41244,41400,156
2022-01-13,70045,70043,Blue,0,67513,67631,118
2022-09-13,70059,70838,Blue,0,64785,65861,1076
2022-08-28,70038,70060,Blue,1,52628,53707,1079
2022-02-01,70046,70052,Blue,1,25775,26128,353
2022-08-22,70047,70039,Blue,0,60689,61122,433
2022-02-26,70057,70055,Blue,0,75866,75934,68
2022-03-03,70058,70060,Blue,1,79684,79754,70
2022-07-09,70056,70058,Blue,1,33331,33408,77
2022-09-18,70040,70056,Blue,1,58134,58979,845
2022-06-16,70053,70043,Blue,0,50036,50642,606
2022-09-21,70046,70056,Blue,1,49748,50286,538
2022-01-07,70054,70060,Blue,1,32046,32336,290
2022-03-21,70052,70058,Blue,1,35309,35572,263
2022-12-05,70059,70039,Blue,0,58759,59766,1007
2022-01-06,70044,70060,Blue,1,59163,60138,975
2022-03-03,70038,70058,Blue,1,45727,46808,1081
2022-08-30,70038,70058,Blue,1,55987,57033,1046
2022-01-20,70053,70039,Blue,0,40433,41170,737
2022-04-15,70055,70838,Blue,0,56472,57426,954
2022-07-23,70057,70043,Blue,0,66575,67346,771
2022-10-07,70038,70056,Blue,1,30742,31637,895
2022-11-05,70049,70045,Blue,0,69125,69334,209
2022-01-07,70041,70039,Blue,0,31935,31970,35
2022-04-22,70059,70055,Blue,0,80056,80203,147
2022-10-10,70048,70058,Blue,1,71113,71603,490
2022-06-17,70038,70050,Blue,1,27247,27832,585
2022-04-23,70038,70060,Blue,1,35054,36169,1115
2022-08-21,70055,70041,Blue,0,79842,80577,735
2022-07-20,70042,70046,Blue,1,83752,83926,174
2022-07-24,70051,70043,Blue,0,56338,56831,493
2022-11-22,70038,70040,Blue,1,35773,35792,19
2022-06-25,70038,70046,Blue,1,22988,23317,329
2022-09-11,70044,70046,Blue,1,58298,58415,117
2022-12-30,70038,70050,Blue,1,25629,26203,574
2022-05-13,70059,70057,Blue,0,80055,80092,37
2022-09-04,70044,70056,Blue,1,88437,89090,653
2022-10-11,70048,70058,Blue,1,26109,26629,520
2022-10-09,70059,70043,Blue,0,40152,40998,846
2022-08-19,70038,70040,Blue,1,75213,75229,16
2022-01-19,70044,70050,Blue,1,73448,73823,375
2022-02-24,70053,70041,Blue,0,35012,35779,767
2022-07-26,70044,70058,Blue,1,29737,30538,801
2022-01-20,70048,70058,Blue,1,89605,90067,462
2022-12-30,70054,70056,Blue,1,25811,25859,48
2022-07-07,70052,70058,Blue,1,69254,69545,291
2022-09-22,70059,70057,Blue,0,38482,38519,37
2022-04-15,70048,70058,Blue,1,86489,86970,481
2022-06-21,70041,70838,Blue,0,26252,26385,133
2022-01-18,70059,70055,Blue,0,25759,25912,153
2022-03-07,70044,70046,Blue,1,27472,27581,109
2022-08-29,70057,70053,Blue,0,70366,70517,151
2022-10-16,70046,70052,Blue,1,74605,75015,410
2022-03-18,70048,70052,Blue,1,89755,89985,230
2022-06-09,70046,70052,Blue,1,24866,25275,409
2022-08-11,70039,70838,Blue,0,49513,49545,32
2022-07-11,70038,70040,Blue,1,78341,78356,15
2022-08-13,70048,70058,Blue,1,26145,26656,511
2022-03-21,70048,70058,Blue,1,62855,63465,610
2022-04-14,70038,70050,Blue,1,23056,23612,556
2022-03-05,70051,70838,Blue,0,59852,60581,729
2022-01-13,70038,70042,Blue,1,72982,73078,96
2022-06-13,70047,70039,Blue,0,80095,80496,401
2022-09-05,70052,70054,Blue,1,75084,75147,63
2022-01-14,70049,70039,Blue,0,32841,33336,495
2022-12-30,70053,70045,Blue,0,83998,84420,422
2022-02-03,70050,70056,Blue,1,42979,43396,417
2022-07-28,70050,70054,Blue,1,81005,81209,204
2022-08-21,70040,70060,Blue,1,87384,88464,1080
2022-08-19,70048,70058,Blue,1,66934,67452,518
2022-12-20,70050,70058,Blue,1,37659,38111,452
2022-10-10,70059,70053,Blue,0,62896,63155,259
2022-04-17,70038,70044,Blue,1,89113,89297,184
2022-06-02,70038,70046,Blue,1,33913,34254,341
2022-09-08,70046,70058,Blue,1,53256,53861,605
2022-08-14,70045,70838,Blue,0,50254,50590,336
2022-10-29,70051,70039,Blue,0,69831,70485,654
2022-06-14,70047,70041,Blue,0,25196,25568,372
2022-04-19,70048,70056,Blue,1,52302,52702,400
2022-02-18,70051,70047,Blue,0,60564,60754,190
2022-07-20,70049,70047,Blue,0,72260,72314,54
2022-01-04,70048,70054,Blue,1,27981,28284,303
2022-09-18,70038,70050,Blue,1,55872,56421,549
2022-10-31,70054,70060,Blue,1,50050,50298,248
2022-01-22,70045,70043,Blue,0,38562,38644,82
2022-02-05,70045,70039,Blue,0,45063,45293,230
2022-06-19,70053,70047,Blue,0,52520,52818,298
2022-07-23,70059,70041,Blue,0,56238,57200,962
2022-03-11,70044,70056,Blue,1,68416,69190,774
2022-11-22,70049,70043,Blue,0,29270,29644,374
2022-02-18,70056,70060,Blue,1,84214,84395,181
2022-03-21,70059,70053,Blue,0,51553,51773,220
2022-03-29,70046,70048,Blue,1,30021,30124,103
2022-09-14,70048,70052,Blue,1,77235,77459,224
2022-12-08,70044,70048,Blue,1,48446,48671,225
2022-10-11,70049,70043,Blue,0,85497,85860,363
2022-02-15,70051,70039,Blue,0,50164,50880,716
2022-10-25,70047,70838,Blue,0,88722,89718,996
2022-02-22,70040,70050,Blue,1,52252,52757,505
2022-11-09,70053,70045,Blue,0,58022,58475,453
2022-01-07,70053,70043,Blue,0,58694,59325,631
2022-12-22,70043,70041,Blue,0,69407,69434,27
2022-02-28,70054,70060,Blue,1,82301,82575,274
2022-11-14,70038,70050,Blue,1,28996,29550,554
2022-12-30,70038,70052,Blue,1,65413,66075,662
2022-01-26,70057,70053,Blue,0,34768,35038,270
2022-10-08,70047,70045,Blue,0,53070,53165,95
2022-08-16,70055,70041,Blue,0,29083,29875,792
2022-09-24,70038,70058,Blue,1,79933,80955,1022
2022-11-01,70046,70058,Blue,1,20457,21238,781
2022-03-04,70038,70054,Blue,1,85444,86231,787
2022-02-09,70050,70054,Blue,1,57489,57707,218
2022-06-28,70050,70060,Blue,1,51573,52112,539
2022-11-02,70048,70050,Blue,1,63275,63332,57
2022-01-14,70057,70041,Blue,0,82399,83253,854
2022-07-26,70046,70056,Blue,1,68200,68765,565
2022-10-28,70038,70056,Blue,1,89205,90116,911
2022-02-13,70056,70060,Blue,1,67631,67816,185
2022-10-15,70055,70047,Blue,0,59655,60027,372
2022-01-19,70057,70043,Blue,0,77848,78659,811
2022-03-05,70044,70050,Blue,1,36870,37197,327
2022-12-12,70043,70041,Blue,0,79910,79940,30
2022-03-28,70059,70838,Blue,0,54834,55947,1113
2022-04-12,70051,70041,Blue,0,70472,71068,596
2022-12-30,70059,70051,Blue,0,88100,88428,328
2022-10-16,70049,70045,Blue,0,37355,37557,202
2022-07-16,70051,70047,Blue,0,21852,22053,201
2022-01-25,70054,70060,Blue,1,50173,50428,255
2022-01-26,70057,70051,Blue,0,53670,53919,249
2022-06-24,70052,70056,Blue,1,77059,77195,136
2022-06-06,70044,70048,Blue,1,34629,34933,304
2022-01-23,70055,70053,Blue,0,63849,63897,48
2022-09-25,70042,70056,Blue,1,63659,64470,811
2022-12-16,70058,70060,Blue,1,23458,23534,76
2022-08-19,70042,70056,Blue,1,68145,69162,1017
2022-10-25,70038,70042,Blue,1,72074,72169,95
2022-04-18,70057,70049,Blue,0,26739,27194,455
2022-11-05,70053,70051,Blue,0,54344,54403,59
2022-10-18,70045,70043,Blue,0,57647,57734,87
2022-03-05,70053,70043,Blue,0,66794,67415,621
2022-09-02,70040,70054,Blue,1,47857,48642,785
2022-06-17,70042,70048,Blue,1,75163,75515,352
2022-06-19,70044,70050,Blue,1,64311,64646,335
2022-04-23,70040,70048,Blue,1,43752,44131,379
2022-04-04,70044,70048,Blue,1,26568,26835,267
2022-11-21,70044,70058,Blue,1,54694,55506,812
2022-07-23,70050,70054,Blue,1,71833,72058,225
2022-04-24,70059,70053,Blue,0,63018,63248,230
2022-11-02,70054,70060,Blue,1,85152,85424,272
2022-11-01,70044,70058,Blue,1,71328,72155,827
2022-08-16,70046,70054,Blue,1,82357,82806,449
2022-11-09,70052,70054,Blue,1,86482,86537,55
2022-12-05,70048,70058,Blue,1,39465,40059,594
2022-06-21,70040,70056,Blue,1,65981,66907,926
2022-03-23,70038,70046,Blue,1,44647,44944,297
2022-04-05,70051,70041,Blue,0,65337,65854,517
2022-02-06,70046,70058,Blue,1,80715,81349,634
2022-04-02,70047,70045,Blue,0,35247,35364,117
2022-03-29,70057,70053,Blue,0,65376,65525,149
2022-12-20,70048,70058,Blue,1,26088,26559,471
2022-07-03,70048,70052,Blue,1,43502,43713,211
2022-09-23,70045,70039,Blue,0,71027,71303,276
2022-02-27,70048,70056,Blue,1,23590,24039,449
2022-07-12,70059,70051,Blue,0,54084,54427,343
2022-04-19,70045,70039,Blue,0,28747,28997,250
2022-09-21,70042,70054,Blue,1,55060,55788,728
2022-10-06,70057,70049,Blue,0,79498,79876,378
2022-01-13,70057,70043,Blue,0,65370,66195,825
2022-04-19,70055,70045,Blue,0,70162,70736,574
2022-04-20,70043,70039,Blue,0,26051,26194,143
2022-12-14,70057,70049,Blue,0,26464,26919,455
2022-02-25,70040,70052,Blue,1,24057,24746,689
2022-08-27,70038,70048,Blue,1,49628,50104,476
2022-01-13,70051,70043,Blue,0,57259,57765,506
2022-08-27,70044,70048,Blue,1,46656,46885,229
2022-03-11,70050,70052,Blue,1,33379,33523,144
2022-03-19,70046,70050,Blue,1,50574,50762,188
2022-12-29,70043,70041,Blue,0,46380,46408,28
2022-08-03,70057,70043,Blue,0,55461,56271,810
2022-02-02,70040,70054,Blue,1,85491,86212,721
2022-07-29,70044,70058,Blue,1,39696,40483,787
2022-03-14,70059,70049,Blue,0,57206,57644,438
2022-03-03,70043,70039,Blue,0,55323,55428,105
2022-02-08,70042,70050,Blue,1,37511,37968,457
2022-03-04,70059,70045,Blue,0,85755,86441,686
2022-08-13,70038,70052,Blue,1,27516,28172,656
2022-08-23,70053,70043,Blue,0,75205,75750,545
2022-10-27,70038,70046,Blue,1,59610,59950,340
2022-01-02,70043,70041,Blue,0,55894,55925,31
2022-04-03,70057,70039,Blue,0,82313,83208,895
2022-11-30,70057,70055,Blue,0,61820,61893,73
2022-02-24,70051,70041,Blue,0,84392,84960,568
2022-08-30,70057,70039,Blue,0,53611,54547,936
2022-01-03,70051,70047,Blue,0,22092,22305,213
2022-03-11,70042,70048,Blue,1,87271,87574,303
2022-09-13,70059,70838,Blue,0,70285,71320,1035
2022-07-24,70057,70045,Blue,0,33287,33938,651
2022-04-04,70053,70049,Blue,0,83746,83932,186
2022-10-04,70059,70053,Blue,0,56677,56909,232
2022-04-03,70038,70048,Blue,1,49393,49876,483
2022-01-22,70042,70052,Blue,1,79420,80021,601
2022-11-23,70055,70051,Blue,0,77683,77817,134
2022-03-09,70057,70039,Blue,0,77888,78853,965
2022-10-14,70058,70060,Blue,1,37779,37839,60
2022-02-05,70044,70048,Blue,1,71459,71707,248
2022-03-23,70050,70058,Blue,1,71532,71965,433
2022-01-01,70057,70053,Blue,0,51750,51914,164
2022-07-06,70054,70060,Blue,1,28736,29005,269
2022-02-21,70039,70838,Blue,0,65960,65995,35
2022-07-02,70059,70051,Blue,0,31932,32238,306
2022-08-08,70038,70058,Blue,1,56974,58034,1060
2022-11-23,70051,70045,Blue,0,22050,22405,355
2022-01-10,70057,70041,Blue,0,21399,22265,866
2022-06-12,70046,70060,Blue,1,61718,62465,747
2022-10-01,70053,70047,Blue,0,23761,24077,316
2022-10-10,70052,70060,Blue,1,65278,65694,416
2022-11-12,70055,70041,Blue,0,39157,39944,787
2022-03-22,70040,70058,Blue,1,70096,71141,1045
2022-03-19,70055,70045,Blue,0,23667,24233,566
2022-08-30,70038,70056,Blue,1,77323,78211,888
2022-11-13,70059,70838,Blue,0,30903,32005,1102
2022-10-09,70056,70060,Blue,1,30928,31097,169
2022-07-08,70040,70044,Blue,1,53095,53209,114
2022-11-03,70055,70053,Blue,0,69859,69906,47
2022-09-10,70055,70045,Blue,0,49937,50495,558
2022-02-19,70038,70048,Blue,1,44233,44689,456
2022-08-05,70049,70047,Blue,0,41598,41654,56
2022-07-03,70051,70047,Blue,0,73113,73307,194
2022-01-24,70044,70054,Blue,1,76543,77148,605
2022-03-10,70054,70058,Blue,1,32992,33143,151
2022-08-29,70059,70039,Blue,0,73338,74310,972
2022-08-04,70038,70048,Blue,1,58601,59130,529
2022-01-15,70051,70838,Blue,0,55523,56679,1156
2022-11-30,70050,70060,Blue,1,41101,42131,1030
2022-11-06,70046,70058,Blue,1,53030,53659,629
2022-07-13,70053,70049,Blue,0,55036,55247,211
2022-04-14,70046,70050,Blue,1,52480,52681,201
2022-07-21,70038,70060,Blue,1,26470,27627,1157
2022-11-22,70046,70048,Blue,1,72462,72530,68
2022-04-14,70058,70060,Blue,1,70489,70558,69
2022-03-14,70048,70058,Blue,1,48531,49010,479
2022-02-09,70041,70039,Blue,0,19862,19895,33
2022-01-27,70055,70039,Blue,0,71188,72129,941
2022-12-22,70051,70041,Blue,0,56167,56762,595
2022-06-20,70051,70041,Blue,0,53441,54074,633
2022-06-11,70053,70039,Blue,0,32228,33012,784
2022-08-10,70057,70055,Blue,0,78960,79027,67
2022-06-16,70055,70039,Blue,0,19699,20523,824
2022-12-23,70059,70049,Blue,0,58768,59462,694
2022-03-07,70052,70058,Blue,1,56521,56821,300
2022-12-17,70040,70052,Blue,1,52931,53550,619
2022-02-05,70046,70060,Blue,1,56586,57309,723
2022-08-30,70053,70051,Blue,0,70971,71029,58
2022-02-03,70057,70039,Blue,0,20319,21347,1028
2022-03-26,70057,70051,Blue,0,77845,78086,241
2022-02-24,70059,70838,Blue,0,70512,71560,1048
2022-11-27,70049,70838,Blue,0,80740,81348,608
2022-07-23,70053,70041,Blue,0,63545,64230,685
2022-08-31,70040,70050,Blue,1,63936,64490,554
2022-08-26,70042,70054,Blue,1,60711,61392,681
2022-12-26,70042,70060,Blue,1,52221,53174,953
2022-12-19,70057,70055,Blue,0,50778,50846,68
2022-11-11,70054,70058,Blue,1,24919,25075,156
2022-02-11,70042,70048,Blue,1,81797,82177,380
2022-04-15,70042,70056,Blue,1,35355,36198,843
2022-09-14,70038,70050,Blue,1,83346,83956,610
2022-04-22,70047,70045,Blue,0,63785,63880,95
2022-02-17,70048,70060,Blue,1,28161,28816,655
2022-06-09,70049,70039,Blue,0,67300,67820,520
2022-02-18,70040,70046,Blue,1,75854,76126,272
2022-09-04,70049,70039,Blue,0,78749,79250,501
2022-07-12,70055,70053,Blue,0,86752,86800,48
2022-05-20,70049,70045,Blue,0,63708,63985,277
2022-01-02,70044,70046,Blue,1,44516,44622,106
2022-11-08,70055,70047,Blue,0,60664,61128,464
2022-10-23,70047,70838,Blue,0,60397,60897,500
2022-07-14,70045,70838,Blue,0,33015,33369,354
2022-06-17,70055,70053,Blue,0,46305,46357,52
2022-03-06,70038,70044,Blue,1,76397,76592,195
2022-08-03,70057,70051,Blue,0,61182,61425,243
2022-03-23,70054,70056,Blue,1,73887,73934,47
2022-08-26,70049,70043,Blue,0,33168,33551,383
2022-10-19,70048,70060,Blue,1,60140,61010,870
2022-07-11,70040,70056,Blue,1,50725,51702,977
2022-01-26,70046,70048,Blue,1,85731,85804,73
2022-08-25,70040,70058,Blue,1,55672,56667,995
2022-11-21,70052,70054,Blue,1,20757,20816,59
2022-01-06,70051,70041,Blue,0,23477,24090,613
2022-12-08,70055,70051,Blue,0,38375,38512,137
2022-02-28,70057,70053,Blue,0,38727,38904,177
2022-09-18,70038,70058,Blue,1,66676,67742,1066
2022-01-20,70050,70052,Blue,1,26618,26742,124
2022-01-18,70057,70053,Blue,0,24998,25209,211
2022-08-19,70046,70050,Blue,1,86333,86519,186
2022-09-14,70046,70052,Blue,1,85557,85913,356
2022-09-20,70056,70060,Blue,1,42574,42751,177
2022-04-22,70046,70056,Blue,1,87551,88072,521
2022-07-11,70040,70060,Blue,1,53891,54991,1100
2022-12-28,70042,70054,Blue,1,38087,38691,604
2022-12-19,70059,70049,Blue,0,64189,64674,485
2022-11-02,70055,70045,Blue,0,22507,23107,600
2022-06-14,70047,70838,Blue,0,46121,46672,551
2022-11-15,70050,70056,Blue,1,33403,33725,322
2022-03-07,70055,70047,Blue,0,67457,67817,360
2022-12-07,70038,70058,Blue,1,53399,54465,1066
2022-06-22,70049,70838,Blue,0,68557,69243,686
2022-12-05,70042,70060,Blue,1,53525,54498,973
2022-09-29,70044,70048,Blue,1,75018,75250,232
2022-04-03,70041,70039,Blue,0,69888,69922,34
2022-10-10,70053,70039,Blue,0,19901,20719,818
2022-09-20,70040,70044,Blue,1,65922,66040,118
2022-02-16,70044,70048,Blue,1,61583,61862,279
2022-10-16,70044,70056,Blue,1,50166,50807,641
2022-10-25,70038,70052,Blue,1,77323,78050,727
2022-05-25,70047,70045,Blue,0,83626,83731,105
2022-01-02,70053,70051,Blue,0,78530,78586,56
2022-11-16,70053,70043,Blue,0,26977,27622,645
2022-07-11,70052,70054,Blue,1,29880,29934,54
2022-04-01,70048,70058,Blue,1,29635,30140,505
2022-02-13,70038,70048,Blue,1,56950,57446,496
2022-01-25,70052,70056,Blue,1,66455,66593,138
2022-03-14,70057,70039,Blue,0,81272,82208,936
2022-10-04,70046,70050,Blue,1,75059,75229,170
2022-09-19,70055,70049,Blue,0,38167,38551,384
2022-04-14,70052,70056,Blue,1,80508,80648,140
2022-09-08,70052,70060,Blue,1,89008,89361,353
2022-09-20,70048,70056,Blue,1,61643,62032,389
2022-04-07,70040,70044,Blue,1,52225,52336,111
2022-06-09,70038,70046,Blue,1,36750,37106,356
2022-04-15,70044,70056,Blue,1,22059,22782,723
2022-01-18,70053,70838,Blue,0,38083,39021,938
2022-04-05,70042,70054,Blue,1,40839,41471,632
2022-07-02,70038,70048,Blue,1,78755,79277,522
2022-08-28,70042,70054,Blue,1,77621,78565,944
2022-02-05,70058,70060,Blue,1,34512,34579,67
2022-10-11,70038,70040,Blue,1,67386,67401,15
2022-10-18,70050,70060,Blue,1,75284,75766,482
2022-01-27,70051,70047,Blue,0,82256,82457,201
2022-01-21,70049,70045,Blue,0,81683,81884,201
2022-01-18,70042,70050,Blue,1,47091,47621,530
2022-03-11,70044,70050,Blue,1,37571,37910,339
2022-02-07,70049,70039,Blue,0,34441,34959,518
2022-04-19,70053,70039,Blue,0,21282,22108,826
2022-02-25,70047,70045,Blue,0,29876,29979,103
2022-03-11,70054,70058,Blue,1,37719,37869,150
2022-12-10,70046,70058,Blue,1,63528,64162,634
2022-11-25,70048,70050,Blue,1,50737,50796,59
2022-05-04,70053,70047,Blue,0,48584,48874,290
2022-12-09,70057,70047,Blue,0,21667,22180,513
2022-04-29,70052,70054,Blue,1,80234,80286,52
2022-03-30,70055,70838,Blue,0,27438,28369,931
2022-03-15,70056,70058,Blue,1,62633,62706,73
2022-06-16,70050,70060,Blue,1,58514,59658,1144
2022-12-23,70044,70060,Blue,1,79203,80217,1014
2022-07-27,70047,70838,Blue,0,75474,75960,486
2022-12-28,70038,70056,Blue,1,67033,67895,862
2022-12-26,70051,70041,Blue,0,83446,84004,558
2022-04-20,70040,70058,Blue,1,57234,58250,1016
2022-02-23,70056,70060,Blue,1,34576,34757,181
2022-11-15,70044,70060,Blue,1,41856,42902,1046
2022-10-13,70059,70053,Blue,0,83417,83644,227
2022-06-18,70044,70060,Blue,1,39577,40625,1048
2022-10-20,70038,70044,Blue,1,60267,60458,191
2022-09-06,70049,70045,Blue,0,29889,30122,233
2022-08-25,70044,70046,Blue,1,26279,26388,109
2022-03-31,70040,70058,Blue,1,68664,69563,899
2022-06-28,70044,70054,Blue,1,35991,36631,640
2022-01-19,70040,70046,Blue,1,76924,77175,251
2022-12-12,70042,70052,Blue,1,62877,63435,558
2022-06-12,70041,70039,Blue,0,59750,59782,32
2022-01-10,70038,70046,Blue,1,64640,64991,351
2022-04-10,70042,70048,Blue,1,47913,48232,319
2022-01-23,70055,70838,Blue,0,81753,82783,1030
2022-07-05,70049,70043,Blue,0,22684,23061,377
2022-10-15,70046,70058,Blue,1,73757,74444,687
2022-09-08,70051,70049,Blue,0,31401,31501,100
2022-06-21,70048,70052,Blue,1,24137,24354,217
2022-01-15,70038,70048,Blue,1,89120,89628,508
2022-08-25,70047,70045,Blue,0,27417,27517,100
2022-02-12,70040,70050,Blue,1,44323,44826,503
2022-03-14,70038,70040,Blue,1,89371,89385,14
2022-02-10,70048,70058,Blue,1,55693,56203,510
2022-03-25,70048,70054,Blue,1,36703,37115,412
2022-09-12,70044,70050,Blue,1,87551,87855,304
2022-08-07,70042,70054,Blue,1,73298,73960,662
2022-02-23,70044,70050,Blue,1,83991,84317,326
2022-04-11,70047,70838,Blue,0,32041,32535,494
2022-04-10,70054,70058,Blue,1,60061,60219,158
2022-10-17,70046,70054,Blue,1,70902,71330,428
2022-12-16,70044,70060,Blue,1,57992,58989,997
2022-10-12,70040,70042,Blue,1,60755,60790,35
2022-03-28,70051,70043,Blue,0,41896,42374,478
2022-08-13,70054,70060,Blue,1,25805,26060,255
2022-02-13,70048,70056,Blue,1,28365,28778,413
2022-10-14,70046,70050,Blue,1,51770,51951,181
2022-10-12,70038,70048,Blue,1,31707,32164,457
2022-11-21,70049,70045,Blue,0,67018,67222,204
2022-04-20,70040,70058,Blue,1,52532,53519,987
2022-07-05,70044,70052,Blue,1,30899,31418,519
2022-01-25,70040,70054,Blue,1,26740,27530,790
2022-06-09,70057,70049,Blue,0,40502,40947,445
2022-06-13,70049,70041,Blue,0,20837,21366,529
2022-10-23,70038,70042,Blue,1,48309,48405,96
2022-10-26,70057,70045,Blue,0,65079,65817,738
2022-12-12,70042,70046,Blue,1,24084,24253,169
2022-03-23,70040,70058,Blue,1,69514,70430,916
2022-07-22,70047,70041,Blue,0,24004,24356,352
2022-04-21,70042,70058,Blue,1,32683,33617,934
2022-11-30,70051,70039,Blue,0,50301,50935,634
2022-01-04,70050,70054,Blue,1,84801,85001,200
2022-06-20,70059,70838,Blue,0,57754,58949,1195
2022-03-22,70042,70048,Blue,1,55215,55521,306
2022-09-05,70044,70058,Blue,1,30202,30938,736
2022-12-13,70057,70039,Blue,0,88214,89612,1398
2022-01-07,70046,70050,Blue,1,70379,70569,190
2022-05-09,70053,70049,Blue,0,72411,72602,191
2022-02-14,70055,70047,Blue,0,84233,84601,368
2022-09-12,70040,70050,Blue,1,84222,84741,519
2022-05-21,70047,70043,Blue,0,25431,25780,349
2022-06-10,70053,70041,Blue,0,49495,50230,735
2022-01-14,70045,70838,Blue,0,42830,43183,353
2022-07-15,70055,70838,Blue,0,30771,32197,1426
2022-01-10,70038,70058,Blue,1,60738,61861,1123
2022-10-28,70046,70060,Blue,1,32310,33035,725
2022-02-19,70042,70054,Blue,1,51469,52204,735
2022-06-26,70057,70838,Blue,0,59583,60676,1093
2022-10-06,70048,70054,Blue,1,59999,60310,311
2022-03-28,70040,70056,Blue,1,26426,27315,889
2022-06-26,70048,70052,Blue,1,25096,25294,198
2022-03-02,70046,70060,Blue,1,61189,62420,1231
2022-04-01,70059,70049,Blue,0,45495,46031,536
2022-04-18,70058,70060,Blue,1,88191,88263,72
2022-07-21,70048,70050,Blue,1,34839,34917,78
2022-08-31,70047,70041,Blue,0,64071,64413,342
2022-10-16,70057,70045,Blue,0,63097,63717,620
2022-12-31,70051,70039,Blue,0,36621,37276,655
2022-03-27,70040,70046,Blue,1,25392,25626,234
2022-11-08,70045,70039,Blue,0,40484,40740,256
2022-02-21,70057,70043,Blue,0,49833,50759,926
2022-08-25,70048,70050,Blue,1,86884,86943,59
2022-02-21,70052,70060,Blue,1,83658,84014,356
2022-08-28,70046,70056,Blue,1,61218,61724,506
2022-06-24,70057,70039,Blue,0,56806,57787,981
2022-07-05,70050,70052,Blue,1,58337,58450,113
2022-01-28,70038,70054,Blue,1,21868,22691,823
2022-02-07,70044,70048,Blue,1,23050,23269,219
2022-04-10,70055,70041,Blue,0,59423,60196,773
2022-04-22,70050,70052,Blue,1,68268,68394,126
2022-09-29,70038,70042,Blue,1,50890,51019,129
2022-02-09,70047,70045,Blue,0,70634,70731,97
2022-08-02,70047,70045,Blue,0,33283,33381,98
2022-10-24,70059,70047,Blue,0,43258,43904,646
2022-01-24,70049,70045,Blue,0,38661,38851,190
2022-11-12,70046,70058,Blue,1,20292,20979,687
2022-08-10,70040,70052,Blue,1,85758,86369,611
2022-12-18,70059,70055,Blue,0,61048,61194,146
2022-03-30,70051,70047,Blue,0,40820,41019,199
2022-06-15,70053,70041,Blue,0,47415,48160,745
2022-03-10,70038,70060,Blue,1,56526,57803,1277
2022-12-17,70051,70045,Blue,0,77599,77940,341
2022-10-11,70042,70048,Blue,1,26711,27023,312
2022-08-22,70042,70060,Blue,1,50044,51074,1030
2022-06-06,70047,70043,Blue,0,36934,37211,277
2022-12-18,70050,70060,Blue,1,82921,83459,538
2022-08-16,70042,70060,Blue,1,89235,90196,961
2022-03-03,70059,70049,Blue,0,58993,59528,535
2022-04-28,70055,70049,Blue,0,57253,57531,278
2022-06-06,70038,70046,Blue,1,30554,30918,364
2022-02-09,70038,70050,Blue,1,49833,50370,537
2022-01-04,70049,70039,Blue,0,47119,47594,475
2022-10-10,70048,70056,Blue,1,29649,30037,388
2022-12-10,70044,70048,Blue,1,69824,70063,239
2022-03-01,70059,70053,Blue,0,60709,60995,286
2022-12-23,70041,70039,Blue,0,24339,24371,32
2022-07-18,70040,70054,Blue,1,62514,63277,763
2022-01-18,70047,70838,Blue,0,84602,85070,468
2022-12-29,70053,70838,Blue,0,29205,30067,862
2022-09-12,70053,70049,Blue,0,24987,25188,201
2022-07-11,70042,70048,Blue,1,43308,43662,354
2022-02-28,70055,70039,Blue,0,58871,59652,781
2022-11-13,70053,70043,Blue,0,31911,32480,569
2022-10-04,70053,70039,Blue,0,58007,58738,731
2022-11-04,70057,70047,Blue,0,51167,51649,482
2022-06-28,70042,70050,Blue,1,29138,29616,478
2022-02-05,70047,70838,Blue,0,39106,39632,526
2022-03-06,70048,70050,Blue,1,76904,76962,58
2022-11-02,70052,70056,Blue,1,68143,68284,141
2022-04-02,70051,70043,Blue,0,46353,46836,483
2022-02-19,70040,70046,Blue,1,32423,32692,269
2022-07-02,70041,70838,Blue,0,40523,40649,126
2022-07-16,70057,70049,Blue,0,35251,35637,386
2022-10-06,70038,70042,Blue,1,53972,54069,97
2022-01-09,70048,70060,Blue,1,73885,74519,634
2022-08-06,70044,70056,Blue,1,34188,34853,665
2022-12-26,70040,70052,Blue,1,72682,73344,662
2022-01-17,70040,70052,Blue,1,56747,57399,652
2022-03-14,70038,70052,Blue,1,57139,57877,738
2022-01-07,70044,70056,Blue,1,63369,64077,708
2022-08-18,70044,70058,Blue,1,31038,31833,795
2022-03-24,70043,70041,Blue,0,57486,57514,28
2022-06-05,70040,70042,Blue,1,76584,76620,36
2022-06-17,70039,70838,Blue,0,64614,64649,35
2022-03-17,70046,70054,Blue,1,63299,63766,467
2022-11-09,70048,70054,Blue,1,35067,35441,374
2022-06-17,70055,70053,Blue,0,28357,28410,53
2022-10-22,70044,70052,Blue,1,76943,77434,491
2022-12-15,70038,70060,Blue,1,27314,28462,1148
2022-06-23,70052,70060,Blue,1,29533,30031,498
2022-01-08,70059,70043,Blue,0,51388,52320,932
2022-12-27,70055,70053,Blue,0,21506,21552,46
2022-10-17,70055,70041,Blue,0,67276,67989,713
2022-04-13,70051,70041,Blue,0,70335,70925,590
2022-12-07,70050,70054,Blue,1,34208,34426,218
2022-08-28,70059,70039,Blue,0,81555,82547,992
2022-04-18,70045,70041,Blue,0,59144,59311,167
2022-11-29,70055,70049,Blue,0,64155,64423,268
2022-10-08,70050,70054,Blue,1,64825,65045,220
2022-09-19,70053,70051,Blue,0,30076,30132,56
2022-01-09,70059,70047,Blue,0,53296,53814,518
2022-07-07,70057,70055,Blue,0,57814,57882,68
2022-04-14,70049,70045,Blue,0,39838,40093,255
2022-03-21,70055,70047,Blue,0,65168,65531,363
2022-02-22,70047,70838,Blue,0,56020,56577,557
2022-02-28,70049,70838,Blue,0,50934,51582,648
2022-12-13,70056,70058,Blue,1,30502,30575,73
2022-06-19,70053,70049,Blue,0,59280,59483,203
2022-03-03,70042,70052,Blue,1,28306,28868,562
2022-02-25,70049,70047,Blue,0,40665,40724,59
2022-02-04,70042,70060,Blue,1,57762,58902,1140
2022-09-20,70048,70054,Blue,1,21901,22202,301
2022-09-01,70038,70060,Blue,1,68000,69163,1163
2022-03-23,70042,70052,Blue,1,33804,34690,886
2022-06-16,70059,70039,Blue,0,60157,61303,1146
2022-02-15,70042,70060,Blue,1,73121,74076,955
2022-04-16,70056,70060,Blue,1,49508,49691,183
2022-07-15,70055,70838,Blue,0,69265,70206,941
2022-09-27,70038,70060,Blue,1,76774,77866,1092
2022-08-09,70053,70041,Blue,0,65222,65909,687
2022-11-27,70054,70056,Blue,1,70186,70235,49
2022-12-09,70046,70060,Blue,1,25565,26263,698
2022-02-02,70054,70056,Blue,1,31074,31121,47
2022-01-14,70059,70053,Blue,0,55686,55933,247
2022-06-16,70051,70039,Blue,0,20625,21350,725
2022-09-26,70038,70050,Blue,1,26987,27545,558
2022-03-25,70053,70041,Blue,0,44276,44967,691
2022-02-26,70046,70054,Blue,1,37051,37507,456
2022-08-28,70055,70041,Blue,0,58333,59059,726
2022-10-05,70059,70047,Blue,0,77644,78260,616
2022-01-04,70051,70045,Blue,0,54970,55307,337
2022-02-19,70052,70058,Blue,1,39559,39787,228
2022-02-25,70055,70039,Blue,0,70746,71531,785
2022-04-02,70038,70042,Blue,1,75011,75105,94
2022-09-18,70057,70053,Blue,0,63756,63919,163
2022-03-12,70044,70056,Blue,1,30922,31590,668
2022-05-01,70052,70058,Blue,1,32483,32747,264
2022-03-01,70045,70043,Blue,0,30788,30891,103
2022-12-24,70046,70058,Blue,1,61372,61989,617
2022-11-21,70048,70056,Blue,1,47199,47633,434
2022-02-09,70057,70051,Blue,0,33045,33355,310
2022-04-16,70051,70045,Blue,0,20558,20972,414
2022-03-10,70046,70050,Blue,1,25864,26056,192
2022-08-29,70047,70838,Blue,0,55900,56431,531
2022-01-14,70059,70039,Blue,0,63201,64210,1009
2022-01-14,70055,70051,Blue,0,57664,57812,148
2022-06-19,70040,70046,Blue,1,33207,33487,280
2022-10-04,70050,70058,Blue,1,29645,30092,447
2022-07-25,70046,70060,Blue,1,32713,33451,738
2022-04-01,70053,70043,Blue,0,88347,88900,553
2022-03-07,70038,70052,Blue,1,23354,24040,686
2022-12-17,70043,70838,Blue,0,23715,23917,202
2022-05-11,70052,70058,Blue,1,59261,59508,247
2022-01-01,70053,70051,Blue,0,66509,66554,45
2022-11-14,70059,70838,Blue,0,32554,33635,1081
2022-02-12,70048,70052,Blue,1,84293,84502,209
2022-08-28,70055,70049,Blue,0,76698,76992,294
2022-04-11,70044,70058,Blue,1,63075,63867,792
2022-11-22,70045,70039,Blue,0,35087,35365,278
2022-09-06,70040,70046,Blue,1,51475,51744,269
2022-07-09,70059,70041,Blue,0,62714,63694,980
2022-12-08,70051,70047,Blue,0,32125,32339,214
2022-01-19,70038,70046,Blue,1,43508,43817,309
2022-08-24,70051,70838,Blue,0,33867,34684,817
2022-02-09,70046,70052,Blue,1,27338,27667,329
2022-02-28,70053,70039,Blue,0,87763,88457,694
2022-09-28,70039,70838,Blue,0,26859,26895,36
2022-02-19,70040,70054,Blue,1,42684,43386,702
2022-12-03,70043,70838,Blue,0,45878,46067,189
2022-09-01,70050,70058,Blue,1,54630,55088,458
2022-08-18,70038,70042,Blue,1,55629,55767,138
2022-01-17,70053,70051,Blue,0,37779,37837,58
2022-07-20,70038,70050,Blue,1,40241,40882,641
2022-08-13,70053,70838,Blue,0,47323,48173,850
2022-03-15,70052,70060,Blue,1,30448,30946,498
2022-09-14,70042,70058,Blue,1,65010,65932,922
2022-09-01,70059,70057,Blue,0,62468,62502,34
2022-04-14,70046,70048,Blue,1,31644,31731,87
2022-12-16,70055,70047,Blue,0,33696,34052,356
2022-09-28,70056,70060,Blue,1,74570,74740,170
2022-11-24,70054,70060,Blue,1,64818,65090,272
2022-06-18,70053,70049,Blue,0,29532,29726,194
2022-01-16,70040,70050,Blue,1,54855,55425,570
2022-09-03,70059,70045,Blue,0,32489,33186,697
2022-08-03,70051,70047,Blue,0,56081,56280,199
2022-08-29,70047,70838,Blue,0,83654,84116,462
2022-05-31,70038,70040,Blue,1,30076,30094,18
2022-04-07,70055,70051,Blue,0,29883,30037,154
2022-09-26,70042,70044,Blue,1,47935,47964,29
2022-11-19,70043,70041,Blue,0,49084,49113,29
2022-11-11,70044,70054,Blue,1,69170,69737,567
2022-12-22,70057,70049,Blue,0,54022,54389,367
2022-02-03,70040,70046,Blue,1,48725,48971,246
2022-03-26,70059,70051,Blue,0,56265,56591,326
2022-03-25,70057,70051,Blue,0,64214,64460,246
2022-11-25,70040,70050,Blue,1,30772,31258,486
2022-03-08,70046,70060,Blue,1,42909,43743,834
2022-09-24,70057,70053,Blue,0,66029,66202,173
2022-01-27,70055,70047,Blue,0,84812,85193,381
2022-12-16,70057,70047,Blue,0,85047,85555,508
2022-01-25,70038,70056,Blue,1,65286,66271,985
2022-11-24,70059,70057,Blue,0,74898,74932,34
2022-01-03,70039,70838,Blue,0,25098,25199,101
2022-03-02,70050,70054,Blue,1,62098,62291,193
2022-11-30,70051,70047,Blue,0,53936,54146,210
2022-03-17,70059,70039,Blue,0,20239,21273,1034
2022-03-24,70041,70039,Blue,0,19483,19519,36
2022-02-04,70048,70056,Blue,1,57430,57888,458
2022-04-19,70038,70042,Blue,1,44277,44413,136
2022-08-09,70051,70043,Blue,0,22971,23466,495
2022-03-09,70040,70044,Blue,1,21913,22012,99
2022-10-03,70053,70043,Blue,0,76725,77324,599
2022-11-18,70038,70048,Blue,1,37752,38215,463
2022-07-26,70057,70053,Blue,0,73407,73559,152
2022-07-20,70042,70048,Blue,1,29160,29458,298
2022-12-18,70048,70056,Blue,1,61423,61851,428
2022-12-13,70048,70056,Blue,1,40348,40763,415
2022-03-15,70038,70054,Blue,1,25616,26367,751
2022-04-28,70053,70051,Blue,0,27037,27090,53
2022-01-25,70048,70056,Blue,1,25601,26013,412
2022-05-29,70049,70047,Blue,0,81460,81514,54
2022-08-23,70044,70054,Blue,1,60157,60731,574
2022-03-29,70059,70053,Blue,0,28158,28404,246
2022-03-15,70050,70054,Blue,1,46093,46299,206
2022-03-01,70042,70054,Blue,1,87335,88088,753
2022-02-14,70046,70054,Blue,1,83684,84171,487
2022-12-01,70044,70046,Blue,1,87588,87694,106
2022-11-13,70042,70054,Blue,1,64689,65375,686
2022-12-30,70059,70045,Blue,0,37757,38514,757
2022-12-22,70059,70053,Blue,0,29779,29994,215
2022-11-15,70048,70052,Blue,1,27812,28029,217
2022-07-09,70050,70052,Blue,1,69235,69350,115
2022-04-20,70046,70054,Blue,1,22180,22601,421
2022-12-06,70046,70056,Blue,1,27152,27666,514
2022-11-04,70047,70039,Blue,0,47581,48052,471
2022-07-01,70053,70049,Blue,0,37186,37433,247
2022-09-20,70059,70057,Blue,0,55095,55130,35
2022-07-19,70047,70838,Blue,0,50564,51127,563
2022-09-27,70046,70060,Blue,1,45731,46483,752
2022-09-22,70046,70050,Blue,1,32903,33092,189
2022-10-28,70057,70047,Blue,0,84273,84889,616
2022-02-05,70042,70050,Blue,1,63832,64226,394
2022-01-01,70042,70056,Blue,1,41776,42481,705
2022-01-05,70040,70048,Blue,1,34157,34517,360
2022-03-23,70046,70060,Blue,1,44637,45479,842
2022-11-18,70057,70043,Blue,0,70769,71529,760
2022-07-12,70053,70043,Blue,0,29186,29840,654
2022-09-10,70055,70838,Blue,0,65609,66531,922
2022-10-27,70057,70838,Blue,0,40176,41238,1062
2022-05-20,70047,70838,Blue,0,59922,60558,636
2022-02-17,70038,70048,Blue,1,54075,54616,541
2022-03-21,70044,70054,Blue,1,31372,31999,627
2022-12-30,70047,70043,Blue,0,20683,20925,242
2022-01-09,70045,70041,Blue,0,33170,33315,145
2022-06-13,70057,70055,Blue,0,19254,19327,73
2022-01-02,70054,70058,Blue,1,84639,84817,178
2022-03-15,70044,70058,Blue,1,68167,68971,804
2022-06-09,70055,70838,Blue,0,37238,38261,1023
2022-04-06,70041,70039,Blue,0,37343,37378,35
2022-02-23,70050,70054,Blue,1,40733,40940,207
2022-07-18,70054,70058,Blue,1,77602,77759,157
2022-07-14,70050,70054,Blue,1,88754,88961,207
2022-04-09,70057,70055,Blue,0,28240,28316,76
2022-11-21,70044,70058,Blue,1,30464,31230,766
2022-12-20,70051,70045,Blue,0,76651,76988,337
2022-09-11,70043,70041,Blue,0,52578,52613,35
2022-03-17,70049,70041,Blue,0,23908,24373,465
2022-03-10,70055,70043,Blue,0,23877,24603,726
2022-01-27,70042,70044,Blue,1,82982,83012,30
2022-07-07,70041,70039,Blue,0,33763,33799,36
2022-08-19,70044,70052,Blue,1,64276,64790,514
2022-05-16,70059,70049,Blue,0,64003,64506,503
2022-04-18,70038,70040,Blue,1,81451,81467,16
2022-01-13,70038,70058,Blue,1,69910,70942,1032
2022-04-14,70050,70054,Blue,1,68014,68224,210
2022-12-06,70038,70040,Blue,1,38875,38891,16
2022-04-21,70057,70041,Blue,0,33035,33988,953
2022-05-12,70050,70060,Blue,1,29069,29580,511
2022-10-09,70044,70046,Blue,1,40589,40698,109
2022-11-26,70045,70039,Blue,0,57553,57819,266
2022-03-17,70057,70051,Blue,0,26728,26967,239
2022-06-01,70049,70041,Blue,0,51319,51894,575
2022-12-25,70055,70045,Blue,0,56012,56502,490
2022-07-17,70040,70052,Blue,1,26181,26781,600
2022-07-19,70040,70046,Blue,1,48727,48972,245
2022-08-20,70052,70056,Blue,1,73152,73306,154
2022-03-23,70053,70051,Blue,0,61960,62011,51
2022-09-23,70051,70041,Blue,0,73160,73749,589
2022-01-19,70040,70050,Blue,1,24975,25608,633
2022-12-02,70051,70045,Blue,0,20302,20639,337
2022-01-28,70056,70060,Blue,1,34147,34431,284
2022-03-16,70047,70838,Blue,0,54154,54648,494
2022-03-23,70042,70056,Blue,1,61490,62258,768
2022-08-21,70051,70045,Blue,0,71033,71372,339
2022-01-28,70056,70058,Blue,1,79095,79176,81
2022-05-19,70044,70052,Blue,1,59955,60558,603
2022-03-11,70049,70041,Blue,0,20754,21183,429
2022-08-22,70042,70060,Blue,1,51223,52247,1024
2022-04-20,70040,70044,Blue,1,48739,48858,119
2022-10-01,70048,70054,Blue,1,38800,39142,342
2022-01-07,70042,70060,Blue,1,27395,28535,1140
2022-03-17,70059,70053,Blue,0,37516,37757,241
2022-09-06,70049,70043,Blue,0,71961,72294,333
2022-03-29,70045,70041,Blue,0,52616,52784,168
2022-10-28,70038,70050,Blue,1,68958,69519,561
2022-12-23,70040,70044,Blue,1,24532,24633,101
2022-01-25,70040,70052,Blue,1,29412,30078,666
2022-01-10,70042,70046,Blue,1,68374,68590,216
2022-06-10,70056,70058,Blue,1,65264,65477,213
2022-07-22,70040,70054,Blue,1,63274,64020,746
2022-10-07,70041,70039,Blue,0,31975,32009,34
2022-09-22,70052,70060,Blue,1,51623,51983,360
2022-09-26,70050,70052,Blue,1,82581,82690,109
2022-03-23,70040,70052,Blue,1,28525,29191,666
2022-07-04,70042,70050,Blue,1,53260,53706,446
2022-10-03,70046,70058,Blue,1,40821,41454,633
2022-01-20,70038,70042,Blue,1,32347,32432,85
2022-02-23,70048,70058,Blue,1,50225,50697,472
2022-05-18,70045,70041,Blue,0,65793,66034,241
2022-04-18,70044,70058,Blue,1,23874,24696,822
2022-02-06,70046,70058,Blue,1,59492,60086,594
2022-11-23,70053,70045,Blue,0,29893,30341,448
2022-10-20,70044,70056,Blue,1,54775,55482,707
2022-03-10,70053,70043,Blue,0,79706,80325,619
2022-08-25,70046,70048,Blue,1,37130,37209,79
2022-12-05,70049,70047,Blue,0,37566,37624,58
2022-07-26,70038,70050,Blue,1,59182,59865,683
2022-03-22,70045,70043,Blue,0,86507,86607,100
2022-08-11,70038,70046,Blue,1,25232,25531,299
2022-09-22,70042,70058,Blue,1,65542,66416,874
2022-02-11,70059,70057,Blue,0,42692,42729,37
2022-11-10,70049,70043,Blue,0,42103,42462,359
2022-12-27,70048,70060,Blue,1,36505,37105,600
2022-09-01,70048,70054,Blue,1,75730,76032,302
2022-07-17,70046,70048,Blue,1,41386,41473,87
2022-10-04,70047,70043,Blue,0,25777,26043,266
2022-03-13,70055,70045,Blue,0,36376,36908,532
2022-11-01,70059,70049,Blue,0,70723,71180,457
2022-06-11,70046,70054,Blue,1,47368,47782,414
2022-07-18,70042,70044,Blue,1,34095,34123,28
2022-01-03,70050,70054,Blue,1,65499,65724,225
2022-04-14,70044,70052,Blue,1,51015,51538,523
2022-09-29,70041,70838,Blue,0,33263,33380,117
2022-07-23,70047,70041,Blue,0,42785,43145,360
2022-08-22,70059,70049,Blue,0,19981,20460,479
2022-04-01,70040,70054,Blue,1,69293,70079,786
2022-07-19,70050,70060,Blue,1,28864,29409,545
2022-02-04,70038,70044,Blue,1,79861,80081,220
2022-09-20,70058,70060,Blue,1,54019,54077,58
2022-04-19,70038,70056,Blue,1,82048,83009,961
2022-05-06,70052,70056,Blue,1,43616,43768,152
2022-09-22,70053,70049,Blue,0,27044,27258,214
2022-08-29,70059,70043,Blue,0,67093,67912,819
2022-08-16,70057,70041,Blue,0,48730,49739,1009
2022-01-31,70043,70041,Blue,0,70978,71011,33
2022-01-29,70038,70056,Blue,1,64471,67304,2833
2022-02-13,70042,70046,Blue,1,29726,29901,175
2022-10-09,70058,70060,Blue,1,36638,36707,69
2022-06-16,70047,70039,Blue,0,51285,51786,501
2022-08-24,70052,70054,Blue,1,56415,56475,60
2022-07-18,70055,70039,Blue,0,59963,60857,894
2022-11-26,70059,70039,Blue,0,38955,39924,969
2022-12-29,70042,70046,Blue,1,77859,78042,183
2022-02-18,70057,70049,Blue,0,62094,62539,445
2022-08-28,70055,70039,Blue,0,65359,66189,830
2022-02-06,70055,70039,Blue,0,40337,41229,892
2022-02-02,70051,70049,Blue,0,27371,27474,103
2022-01-22,70044,70050,Blue,1,27691,28019,328
2022-12-21,70057,70838,Blue,0,59798,60846,1048
2022-11-28,70055,70838,Blue,0,65181,66095,914
2022-09-18,70038,70052,Blue,1,37026,37750,724
2022-01-24,70040,70056,Blue,1,35175,36171,996
2022-01-15,70050,70058,Blue,1,79900,80312,412
2022-03-19,70053,70049,Blue,0,61367,61578,211
2022-06-13,70040,70044,Blue,1,46445,46549,104
2022-08-09,70049,70045,Blue,0,67188,67412,224
2022-12-25,70046,70050,Blue,1,61742,61945,203
2022-09-17,70038,70046,Blue,1,78610,78947,337
2022-04-02,70048,70052,Blue,1,36085,36288,203
2022-07-11,70055,70039,Blue,0,73518,74279,761
2022-02-28,70059,70047,Blue,0,28177,28896,719
2022-12-16,70040,70054,Blue,1,87616,88370,754
2022-08-27,70050,70058,Blue,1,44827,45228,401
2022-01-27,70053,70051,Blue,0,26767,26827,60
2022-06-17,70042,70058,Blue,1,84405,85287,882
2022-07-15,70048,70060,Blue,1,80389,81566,1177
2022-12-22,70049,70043,Blue,0,43932,44271,339
2022-08-11,70058,70060,Blue,1,83067,83137,70
2022-08-13,70040,70054,Blue,1,83021,83844,823
2022-01-29,70054,70056,Blue,1,41921,42107,186
2022-11-01,70059,70057,Blue,0,59298,59333,35
2022-03-17,70053,70049,Blue,0,70773,70960,187
2022-02-28,70046,70050,Blue,1,72863,73062,199
2022-02-13,70051,70045,Blue,0,66618,66954,336
2022-06-19,70044,70058,Blue,1,69650,70565,915
2022-09-06,70038,70048,Blue,1,43147,43662,515
2022-10-31,70038,70058,Blue,1,31933,32920,987
2022-04-19,70050,70054,Blue,1,31016,31221,205
2022-08-22,70047,70838,Blue,0,53405,54006,601
2022-12-06,70046,70052,Blue,1,28574,28919,345
2022-12-31,70047,70043,Blue,0,28207,28442,235
2022-11-09,70049,70039,Blue,0,20072,20648,576
2022-10-10,70042,70046,Blue,1,27966,28149,183
2022-05-13,70057,70051,Blue,0,88318,88571,253
2022-03-24,70044,70058,Blue,1,29846,30638,792
2022-11-06,70057,70047,Blue,0,78995,79493,498
2022-04-27,70057,70049,Blue,0,40612,41040,428
2022-04-02,70042,70060,Blue,1,75700,76725,1025
2022-02-09,70053,70039,Blue,0,51497,52372,875
2022-10-09,70046,70048,Blue,1,68744,68825,81
2022-04-02,70058,70060,Blue,1,44182,44245,63
2022-12-30,70051,70045,Blue,0,56020,56370,350
2022-03-10,70048,70060,Blue,1,62426,63129,703
2022-10-17,70040,70042,Blue,1,51383,51419,36
2022-03-11,70055,70039,Blue,0,22368,23304,936
2022-12-16,70042,70044,Blue,1,35142,35170,28
2022-07-23,70044,70048,Blue,1,78031,78282,251
2022-03-10,70052,70054,Blue,1,38329,38387,58
2022-08-04,70055,70049,Blue,0,60499,60790,291
2022-01-10,70044,70048,Blue,1,75408,75687,279
2022-05-20,70049,70041,Blue,0,60090,60636,546
2022-02-26,70045,70041,Blue,0,55973,56160,187
2022-01-23,70048,70056,Blue,1,26879,27269,390
2022-03-29,70054,70056,Blue,1,67627,67673,46
2022-06-11,70042,70060,Blue,1,82337,83581,1244
2022-08-28,70051,70045,Blue,0,40518,40855,337
2022-03-29,70053,70051,Blue,0,22566,22628,62
2022-03-20,70055,70043,Blue,0,56079,56794,715
2022-07-24,70055,70047,Blue,0,72920,73294,374
2022-11-09,70042,70054,Blue,1,90658,91347,689
2022-03-22,70040,70052,Blue,1,57815,58508,693
2022-02-22,70046,70050,Blue,1,62925,63110,185
2022-10-17,70048,70050,Blue,1,61380,61436,56
2022-11-20,70045,70039,Blue,0,46356,46575,219
2022-12-16,70049,70047,Blue,0,33999,34052,53
2022-01-16,70051,70047,Blue,0,66094,66289,195
2022-02-18,70059,70055,Blue,0,73753,73892,139
2022-08-09,70046,70050,Blue,1,62614,62800,186
2022-02-10,70050,70054,Blue,1,29443,29661,218
2022-12-10,70039,70838,Blue,0,61070,61104,34
2022-08-12,70048,70060,Blue,1,64586,65289,703
2022-09-29,70053,70041,Blue,0,28330,29094,764
2022-03-10,70047,70838,Blue,0,54214,54866,652
2022-03-19,70051,70045,Blue,0,34462,34799,337
2022-05-18,70040,70050,Blue,1,36605,37934,1329
2022-09-21,70038,70040,Blue,1,34886,34901,15
2022-12-16,70059,70053,Blue,0,30978,31200,222
2022-03-03,70043,70039,Blue,0,33579,33690,111
2022-05-23,70040,70044,Blue,1,83483,83624,141
2022-06-14,70043,70041,Blue,0,44871,44902,31
2022-09-20,70047,70041,Blue,0,44350,44687,337
2022-02-10,70049,70047,Blue,0,39809,39867,58
2022-10-01,70038,70056,Blue,1,58272,59165,893
2022-03-23,70048,70054,Blue,1,58892,59350,458
2022-06-17,70040,70042,Blue,1,33040,33070,30
2022-03-05,70051,70049,Blue,0,80248,80353,105
2022-03-23,70057,70041,Blue,0,74441,75335,894
2022-12-24,70043,70041,Blue,0,38354,38384,30
2022-02-10,70042,70052,Blue,1,20607,21191,584
2022-04-20,70040,70054,Blue,1,28544,29307,763
2022-07-08,70059,70838,Blue,0,24253,25440,1187
2022-04-03,70055,70049,Blue,0,52949,53233,284
2022-04-09,70055,70047,Blue,0,85031,85389,358
2022-02-15,70047,70041,Blue,0,74989,75400,411
2022-02-11,70049,70043,Blue,0,53058,53393,335
2022-03-19,70053,70047,Blue,0,51660,51955,295
2022-08-24,70051,70047,Blue,0,39422,39729,307
2022-11-11,70044,70054,Blue,1,40696,41290,594
2022-11-05,70059,70045,Blue,0,50297,51064,767
2022-03-06,70044,70050,Blue,1,41883,42257,374
2022-10-09,70055,70051,Blue,0,79907,80048,141
2022-12-27,70058,70060,Blue,1,55670,55734,64
2022-11-18,70051,70039,Blue,0,70604,71365,761
2022-06-16,70055,70041,Blue,0,48898,49673,775
2022-02-16,70038,70050,Blue,1,62864,63518,654
2022-11-23,70046,70060,Blue,1,28149,28941,792
2022-02-07,70054,70056,Blue,1,25380,25429,49
2022-02-11,70053,70039,Blue,0,75153,75953,800
2022-08-09,70041,70838,Blue,0,47375,47503,128
2022-01-26,70059,70838,Blue,0,34153,35413,1260
2022-09-12,70057,70049,Blue,0,23099,23503,404
2022-01-03,70051,70045,Blue,0,48013,48340,327
2022-04-05,70044,70046,Blue,1,21732,21832,100
2022-10-28,70055,70051,Blue,0,69860,70005,145
2022-02-03,70059,70049,Blue,0,76678,77390,712
2022-08-09,70040,70060,Blue,1,53006,54048,1042
2022-01-07,70052,70060,Blue,1,49423,49795,372
2022-04-19,70047,70838,Blue,0,52161,52652,491
2022-09-17,70059,70039,Blue,0,33559,34549,990
2022-08-19,70042,70060,Blue,1,50465,51657,1192
2022-10-03,70057,70053,Blue,0,78811,78967,156
2022-07-31,70055,70043,Blue,0,51874,52648,774
2022-06-10,70045,70039,Blue,0,32570,32883,313
2022-07-05,70055,70049,Blue,0,64876,65164,288
2022-12-20,70054,70060,Blue,1,73578,73842,264
2022-09-29,70059,70055,Blue,0,77669,77812,143
2022-10-05,70046,70048,Blue,1,72035,72132,97
2022-09-03,70042,70052,Blue,1,71917,72512,595
2022-10-23,70057,70041,Blue,0,23151,23974,823
2022-04-12,70040,70060,Blue,1,85448,86423,975
2022-03-17,70038,70042,Blue,1,83132,83232,100
2022-08-12,70053,70838,Blue,0,27898,28809,911
2022-04-10,70053,70043,Blue,0,66523,67123,600
2022-12-20,70038,70058,Blue,1,87734,88757,1023
2022-09-06,70048,70054,Blue,1,23652,23944,292
2022-10-05,70048,70060,Blue,1,68248,68957,709
2022-09-01,70042,70056,Blue,1,64052,64833,781
2022-07-11,70048,70052,Blue,1,56177,56383,206
2022-10-16,70049,70039,Blue,0,52705,53228,523
2022-12-15,70045,70838,Blue,0,37831,38173,342
2022-05-21,70044,70048,Blue,1,23292,23615,323
2022-01-04,70057,70041,Blue,0,80267,81238,971
2022-10-04,70041,70039,Blue,0,36488,36520,32
2022-07-03,70059,70053,Blue,0,86415,86643,228
2022-01-18,70059,70049,Blue,0,65596,66077,481
2022-01-05,70054,70058,Blue,1,23628,23824,196
2022-09-26,70059,70055,Blue,0,78829,78971,142
2022-11-08,70051,70041,Blue,0,69409,69966,557
2022-06-29,70059,70057,Blue,0,76933,76968,35
2022-03-11,70044,70058,Blue,1,67547,68346,799
2022-01-06,70056,70060,Blue,1,54609,55160,551
2022-07-30,70056,70058,Blue,1,51671,51742,71
2022-07-15,70043,70838,Blue,0,32401,32631,230
2022-04-09,70053,70041,Blue,0,38171,38908,737
2022-12-22,70059,70051,Blue,0,62355,62700,345
2022-02-11,70038,70056,Blue,1,36203,37218,1015
2022-09-09,70043,70039,Blue,0,73709,73812,103
2022-11-05,70044,70058,Blue,1,40117,40872,755
2022-06-23,70042,70054,Blue,1,23123,23811,688
2022-04-04,70045,70838,Blue,0,74083,74420,337
2022-04-22,70046,70060,Blue,1,64762,65560,798
2022-09-08,70049,70838,Blue,0,49353,49937,584
2022-09-15,70056,70058,Blue,1,36692,36769,77
2022-04-19,70056,70060,Blue,1,59677,59868,191
2022-01-09,70047,70838,Blue,0,28449,28938,489
2022-07-14,70045,70838,Blue,0,65473,65904,431
2022-11-30,70053,70049,Blue,0,73600,73880,280
2022-04-04,70054,70060,Blue,1,67851,68165,314
2022-12-07,70052,70058,Blue,1,53337,53596,259
2022-06-13,70054,70056,Blue,1,30564,30612,48
2022-09-14,70040,70056,Blue,1,84344,85209,865
2022-10-13,70059,70041,Blue,0,34350,35299,949
2022-09-08,70044,70056,Blue,1,39082,39784,702
2022-08-16,70057,70049,Blue,0,54181,54571,390
2022-02-16,70056,70058,Blue,1,34573,34649,76
2022-02-21,70044,70048,Blue,1,32573,32827,254
2022-10-07,70059,70049,Blue,0,59986,60454,468
2022-01-07,70040,70052,Blue,1,27644,28339,695
2022-12-24,70055,70053,Blue,0,70994,71040,46
2022-02-25,70054,70056,Blue,1,47334,47380,46
2022-04-20,70049,70039,Blue,0,63488,64066,578
2022-10-12,70049,70043,Blue,0,79515,79865,350
2022-12-29,70046,70054,Blue,1,78887,79336,449
2022-03-20,70046,70058,Blue,1,79463,80136,673
2022-06-20,70047,70039,Blue,0,68747,69179,432
2022-06-15,70051,70043,Blue,0,64495,64999,504
2022-07-07,70059,70055,Blue,0,78479,78621,142
2022-01-20,70044,70060,Blue,1,65174,66126,952
2022-08-22,70042,70050,Blue,1,77042,77452,410
2022-03-14,70040,70042,Blue,1,33314,33344,30
2022-04-24,70045,70838,Blue,0,63816,64159,343
2022-03-23,70051,70047,Blue,0,44721,44925,204
2022-01-03,70057,70045,Blue,0,76686,77332,646
2022-10-10,70045,70043,Blue,0,51734,51826,92
2022-08-29,70042,70046,Blue,1,41030,41194,164
2022-07-16,70053,70838,Blue,0,68384,69261,877
2022-11-21,70056,70058,Blue,1,59281,59350,69
2022-01-18,70038,70056,Blue,1,59832,60745,913
2022-02-09,70043,70039,Blue,0,36799,36914,115
2022-11-07,70051,70039,Blue,0,37692,38480,788
2022-07-14,70043,70041,Blue,0,51324,51351,27
2022-07-20,70047,70041,Blue,0,29496,29851,355
2022-10-28,70050,70058,Blue,1,76973,77604,631
2022-04-07,70051,70045,Blue,0,88435,88764,329
2022-07-13,70050,70056,Blue,1,55604,55898,294
2022-03-24,70053,70051,Blue,0,63994,64078,84
2022-10-05,70044,70054,Blue,1,32136,32711,575
2022-10-10,70038,70052,Blue,1,61804,62558,754
2022-10-17,70052,70058,Blue,1,34336,34660,324
2022-01-14,70052,70060,Blue,1,20775,21135,360
2022-06-18,70044,70050,Blue,1,35810,36360,550
2022-11-17,70055,70047,Blue,0,43828,44199,371
2022-04-13,70042,70058,Blue,1,77690,78648,958
2022-11-03,70042,70044,Blue,1,75336,75367,31
2022-02-27,70043,70039,Blue,0,53644,53758,114
2022-02-04,70050,70058,Blue,1,21862,22301,439
2022-01-27,70043,70039,Blue,0,45864,45973,109
2022-12-17,70051,70043,Blue,0,47991,48473,482
2022-10-29,70038,70044,Blue,1,56656,56846,190
2022-11-17,70041,70838,Blue,0,34049,34195,146
2022-04-22,70051,70039,Blue,0,36835,37518,683
2022-10-15,70050,70060,Blue,1,74506,75079,573
2022-12-31,70059,70838,Blue,0,24142,25314,1172
2022-05-21,70053,70039,Blue,0,63231,64036,805
2022-01-26,70040,70046,Blue,1,89231,89462,231
2022-07-12,70055,70039,Blue,0,20656,21617,961
2022-03-01,70057,70053,Blue,0,20319,20489,170
2022-02-18,70050,70058,Blue,1,35994,36559,565
2022-09-12,70054,70058,Blue,1,52911,53098,187
2022-10-11,70043,70041,Blue,0,69605,69633,28
2022-02-23,70053,70047,Blue,0,25446,25773,327
2022-10-19,70042,70046,Blue,1,51512,51686,174
2022-01-08,70048,70054,Blue,1,56632,56945,313
2022-05-20,70046,70056,Blue,1,27064,27612,548
2022-10-08,70042,70044,Blue,1,80746,80776,30
2022-01-27,70053,70051,Blue,0,55714,55773,59
2022-03-13,70038,70050,Blue,1,56948,57532,584
2022-12-19,70059,70043,Blue,0,26676,27932,1256
2022-02-13,70053,70043,Blue,0,48160,48708,548
2022-02-09,70049,70045,Blue,0,58617,58802,185
2022-08-05,70046,70050,Blue,1,80104,80289,185
2022-03-21,70047,70838,Blue,0,33264,33808,544
2022-12-28,70052,70060,Blue,1,66838,67191,353
2022-01-12,70053,70838,Blue,0,31179,32376,1197
2022-05-23,70042,70046,Blue,1,67206,67432,226
2022-06-20,70047,70838,Blue,0,31562,32083,521
2022-03-06,70045,70039,Blue,0,29271,29508,237
2022-03-31,70046,70052,Blue,1,57283,57639,356
2022-07-16,70048,70056,Blue,1,57286,57681,395
2022-09-12,70041,70039,Blue,0,52412,52443,31
2022-01-22,70042,70050,Blue,1,29290,29752,462
2022-01-04,70042,70060,Blue,1,63620,64760,1140
2022-08-12,70043,70838,Blue,0,52940,53140,200
2022-02-22,70046,70060,Blue,1,60813,61607,794
2022-01-03,70038,70052,Blue,1,35655,36497,842
2022-08-26,70044,70054,Blue,1,28959,29555,596
2022-09-04,70057,70041,Blue,0,79646,80539,893
2022-11-17,70044,70058,Blue,1,68212,68992,780
2022-08-02,70050,70054,Blue,1,62110,62382,272
2022-02-18,70040,70052,Blue,1,87800,88443,643
2022-09-24,70042,70046,Blue,1,89254,89453,199
2022-02-25,70053,70047,Blue,0,74031,74338,307
2022-02-10,70047,70043,Blue,0,19018,19322,304
2022-01-12,70046,70060,Blue,1,70341,71025,684
2022-10-02,70053,70039,Blue,0,81913,82753,840
2022-02-01,70050,70052,Blue,1,46499,46676,177
2022-04-24,70048,70058,Blue,1,80881,81396,515
2022-10-25,70053,70041,Blue,0,75161,75829,668
2022-07-10,70043,70838,Blue,0,34923,35134,211
2022-11-25,70049,70045,Blue,0,32703,32891,188
2022-02-10,70059,70057,Blue,0,85753,85789,36
2022-03-04,70040,70050,Blue,1,63576,64121,545
2022-06-22,70040,70052,Blue,1,71604,72373,769
2022-11-18,70044,70048,Blue,1,70723,70972,249
2022-08-05,70040,70058,Blue,1,50295,51210,915
2022-02-02,70059,70045,Blue,0,60499,61240,741
2022-01-26,70038,70046,Blue,1,42510,42836,326
2022-07-16,70055,70838,Blue,0,71000,71913,913
2022-09-02,70042,70050,Blue,1,33344,33771,427
2022-08-01,70049,70039,Blue,0,33589,34141,552
2022-05-19,70057,70049,Blue,0,43302,43733,431
2022-01-12,70040,70054,Blue,1,32995,33817,822
2022-02-23,70054,70056,Blue,1,49592,49639,47
2022-04-01,70050,70058,Blue,1,65878,66343,465
2022-10-19,70039,70838,Blue,0,73902,73935,33
2022-08-06,70057,70055,Blue,0,58477,58546,69
2022-03-30,70055,70043,Blue,0,61878,62550,672
2022-12-26,70041,70039,Blue,0,88306,88340,34
2022-09-09,70050,70056,Blue,1,85263,85571,308
2022-04-05,70059,70041,Blue,0,43207,44118,911
2022-06-30,70038,70058,Blue,1,55438,56563,1125
2022-01-25,70054,70056,Blue,1,34070,34116,46
2022-05-04,70057,70047,Blue,0,61539,62137,598
2022-03-22,70047,70838,Blue,0,42127,42607,480
2022-11-22,70046,70050,Blue,1,65558,65732,174
2022-06-13,70057,70041,Blue,0,44449,45387,938
2022-03-18,70044,70052,Blue,1,53282,53742,460
2022-01-18,70048,70058,Blue,1,68194,68816,622
2022-04-18,70040,70058,Blue,1,27907,28824,917
2022-04-29,70059,70053,Blue,0,27626,27860,234
2022-03-08,70046,70054,Blue,1,84617,85045,428
2022-01-09,70052,70056,Blue,1,69075,69206,131
2022-06-09,70038,70040,Blue,1,72580,72594,14
2022-09-22,70053,70041,Blue,0,28783,29557,774
2022-09-13,70053,70049,Blue,0,59848,60029,181
2022-12-21,70044,70060,Blue,1,64340,65258,918
2022-04-22,70041,70039,Blue,0,34087,34121,34
2022-11-03,70047,70838,Blue,0,81925,82395,470
2022-07-17,70050,70056,Blue,1,55952,56254,302
2022-10-25,70059,70039,Blue,0,41203,42279,1076
2022-02-10,70038,70044,Blue,1,23046,23222,176
2022-12-18,70044,70048,Blue,1,30252,30479,227
2022-12-02,70042,70044,Blue,1,31635,31664,29
2022-07-06,70038,70046,Blue,1,24004,24337,333
2022-05-13,70051,70047,Blue,0,24266,24487,221
2022-02-05,70044,70046,Blue,1,75737,75838,101
2022-02-21,70054,70058,Blue,1,40854,41013,159
2022-10-28,70057,70041,Blue,0,24517,25420,903
2022-11-05,70046,70052,Blue,1,33802,34120,318
2022-10-23,70040,70048,Blue,1,62451,62884,433
2022-01-19,70051,70047,Blue,0,58834,59054,220
2022-05-20,70059,70055,Blue,0,73216,73365,149
2022-11-15,70047,70043,Blue,0,44242,44483,241
2022-09-18,70055,70838,Blue,0,86594,87552,958
2022-11-13,70059,70053,Blue,0,65717,65951,234
2022-01-09,70042,70048,Blue,1,34025,34304,279
2022-02-16,70038,70042,Blue,1,35354,35471,117
2022-08-17,70040,70060,Blue,1,67469,68600,1131
2022-11-19,70044,70056,Blue,1,22558,23237,679
2022-03-04,70058,70060,Blue,1,54941,55145,204
2022-02-15,70038,70048,Blue,1,53875,54363,488
2022-05-26,70038,70052,Blue,1,36554,37417,863
2022-01-07,70038,70050,Blue,1,52752,53358,606
2022-03-17,70038,70058,Blue,1,66199,67382,1183
2022-09-26,70055,70053,Blue,0,64257,64303,46
2022-09-28,70047,70041,Blue,0,81821,82156,335
2022-07-12,70047,70838,Blue,0,67311,67842,531
2022-04-21,70052,70060,Blue,1,41648,42003,355
2022-12-15,70047,70041,Blue,0,73955,74307,352
2022-08-05,70051,70039,Blue,0,26301,26974,673
2022-06-11,70050,70058,Blue,1,77291,77706,415
2022-12-30,70055,70043,Blue,0,57313,57957,644
2022-06-13,70059,70039,Blue,0,60493,61575,1082
2022-04-02,70053,70838,Blue,0,35427,36355,928
2022-10-28,70046,70052,Blue,1,67757,68122,365
2022-02-01,70053,70039,Blue,0,80304,80971,667
2022-10-13,70042,70044,Blue,1,44166,44196,30
2022-09-24,70038,70050,Blue,1,37212,37758,546
2022-01-10,70059,70057,Blue,0,59294,59330,36
2022-10-26,70044,70058,Blue,1,58373,59262,889
2022-07-21,70047,70039,Blue,0,57352,57758,406
2022-05-20,70047,70039,Blue,0,76629,77136,507
2022-04-13,70049,70039,Blue,0,67671,68172,501
2022-01-14,70050,70058,Blue,1,29158,29545,387
2022-09-11,70042,70056,Blue,1,44432,45199,767
2022-02-22,70055,70043,Blue,0,72244,72955,711
2022-12-13,70044,70054,Blue,1,60463,61123,660
2022-02-17,70038,70054,Blue,1,25651,26488,837
2022-07-18,70053,70039,Blue,0,59441,60257,816
2022-12-11,70050,70052,Blue,1,67812,67931,119
2022-02-01,70049,70039,Blue,0,58942,59479,537
2022-02-15,70053,70041,Blue,0,74630,75400,770
2022-11-21,70055,70043,Blue,0,30223,30951,728
2022-07-09,70057,70055,Blue,0,81582,81651,69
2022-01-31,70055,70047,Blue,0,54087,54463,376
2022-01-04,70053,70043,Blue,0,78602,79208,606
2022-12-12,70051,70838,Blue,0,75327,76062,735
2022-11-29,70051,70045,Blue,0,84591,84919,328
2022-03-07,70052,70060,Blue,1,70655,71048,393
2022-12-19,70038,70060,Blue,1,47105,48279,1174
2022-04-21,70038,70044,Blue,1,70520,70689,169
2022-02-17,70057,70838,Blue,0,88216,89801,1585
2022-02-11,70054,70056,Blue,1,69421,69468,47
2022-09-30,70043,70838,Blue,0,25801,26020,219
2022-06-03,70049,70039,Blue,0,65235,65811,576
2022-06-25,70046,70060,Blue,1,72608,73369,761
2022-07-20,70051,70838,Blue,0,64162,64918,756
2022-09-06,70058,70060,Blue,1,27888,27956,68
2022-11-04,70059,70043,Blue,0,55636,56512,876
2022-09-22,70051,70043,Blue,0,46312,46772,460
2022-03-16,70055,70049,Blue,0,24905,25194,289
2022-02-10,70056,70060,Blue,1,89578,89760,182
2022-11-30,70059,70057,Blue,0,57845,57883,38
2022-01-01,70057,70053,Blue,0,53370,53524,154
2022-01-03,70051,70049,Blue,0,79300,79403,103
2022-12-02,70038,70044,Blue,1,66148,66314,166
2022-01-15,70057,70051,Blue,0,31470,31718,248
2022-03-04,70040,70052,Blue,1,34515,35252,737
2022-05-19,70040,70052,Blue,1,86269,87004,735
2022-02-18,70059,70057,Blue,0,78918,78953,35
2022-10-12,70044,70046,Blue,1,80825,80929,104
2022-04-01,70053,70838,Blue,0,65863,66761,898
2022-04-13,70046,70056,Blue,1,59353,59867,514
2022-10-22,70038,70056,Blue,1,26313,27385,1072
2022-08-31,70038,70048,Blue,1,85704,86237,533
2022-07-03,70053,70039,Blue,0,73031,73776,745
2022-08-29,70048,70052,Blue,1,37750,37966,216
2022-03-23,70040,70044,Blue,1,54610,54719,109
2022-03-18,70040,70048,Blue,1,33616,34020,404
2022-09-11,70054,70060,Blue,1,74543,74826,283
2022-12-05,70044,70050,Blue,1,25696,26025,329
2022-08-24,70048,70054,Blue,1,34585,34948,363
2022-09-13,70047,70041,Blue,0,31914,32235,321
2022-11-09,70047,70045,Blue,0,75942,76024,82
2022-07-01,70038,70052,Blue,1,68582,69378,796
2022-08-11,70045,70838,Blue,0,19269,19685,416
2022-03-26,70049,70039,Blue,0,27580,28096,516
2022-09-08,70059,70049,Blue,0,56665,57132,467
2022-11-22,70051,70041,Blue,0,41389,41935,546
2022-01-26,70046,70056,Blue,1,22211,22750,539
2022-06-11,70040,70048,Blue,1,81456,81866,410
2022-12-15,70045,70039,Blue,0,20819,21073,254
2022-11-18,70044,70052,Blue,1,35500,35989,489
2022-12-06,70038,70054,Blue,1,64279,65099,820
2022-06-09,70051,70039,Blue,0,56373,57100,727
2022-03-09,70057,70053,Blue,0,24045,24207,162
2022-02-13,70038,70060,Blue,1,62896,64041,1145
2022-01-10,70059,70047,Blue,0,32905,33506,601
2022-03-12,70052,70058,Blue,1,50914,51156,242
2022-01-18,70044,70054,Blue,1,37693,38333,640
2022-10-14,70056,70058,Blue,1,37665,37741,76
2022-11-24,70048,70050,Blue,1,74181,74239,58
2022-11-09,70045,70838,Blue,0,79937,80237,300
2022-07-29,70052,70058,Blue,1,24342,24617,275
2022-10-16,70053,70838,Blue,0,82485,83287,802
2022-09-14,70047,70838,Blue,0,55732,56241,509
2022-01-03,70051,70049,Blue,0,71021,71129,108
2022-06-14,70047,70041,Blue,0,38234,38626,392
2022-10-16,70040,70056,Blue,1,76994,77911,917
2022-12-12,70046,70060,Blue,1,83809,84541,732
2022-04-06,70055,70838,Blue,0,34349,35402,1053
2022-04-23,70053,70838,Blue,0,41963,42847,884
2022-07-28,70038,70052,Blue,1,73146,73844,698
2022-07-05,70039,70838,Blue,0,22706,22744,38
2022-08-23,70053,70049,Blue,0,32870,33081,211
2022-05-09,70059,70057,Blue,0,36319,36356,37
2022-04-22,70059,70047,Blue,0,32694,33318,624
2022-07-14,70055,70051,Blue,0,65255,65392,137
2022-11-30,70050,70058,Blue,1,63069,63527,458
2022-03-10,70059,70057,Blue,0,54197,54231,34
2022-03-12,70057,70039,Blue,0,22894,23819,925
2022-09-25,70048,70058,Blue,1,30488,30980,492
2022-02-20,70042,70046,Blue,1,28581,28748,167
2022-12-21,70059,70047,Blue,0,86839,87436,597
2022-06-06,70042,70048,Blue,1,34540,34933,393
2022-10-09,70044,70046,Blue,1,51798,51899,101
2022-10-02,70051,70838,Blue,0,42495,43316,821
2022-06-28,70047,70041,Blue,0,62916,63267,351
2022-02-16,70046,70054,Blue,1,56907,57470,563
2022-01-26,70057,70041,Blue,0,29134,30124,990
2022-08-20,70059,70051,Blue,0,34094,34429,335
2022-04-15,70057,70053,Blue,0,27055,27213,158
2022-09-18,70053,70043,Blue,0,69208,69859,651
2022-08-20,70056,70060,Blue,1,23225,23403,178
2022-10-27,70050,70060,Blue,1,76437,76974,537
2022-06-21,70042,70058,Blue,1,83331,84264,933
2022-07-30,70055,70047,Blue,0,65603,65968,365
2022-03-22,70055,70838,Blue,0,38993,39995,1002
2022-11-25,70044,70048,Blue,1,37952,38168,216
2022-03-10,70045,70041,Blue,0,75663,75840,177
2022-07-26,70044,70052,Blue,1,39375,39993,618
2022-02-08,70050,70060,Blue,1,40498,40991,493
2022-01-09,70052,70060,Blue,1,86263,86612,349
2022-11-04,70053,70047,Blue,0,28235,28529,294
2022-11-14,70049,70838,Blue,0,59323,59961,638
2022-12-16,70040,70060,Blue,1,53977,55006,1029
2022-10-07,70053,70047,Blue,0,28357,28668,311
2022-07-06,70046,70056,Blue,1,69370,69911,541
2022-09-07,70048,70052,Blue,1,21917,22130,213
2022-12-22,70038,70058,Blue,1,78835,79982,1147
2022-07-28,70052,70060,Blue,1,54507,54872,365
2022-08-11,70059,70039,Blue,0,72257,73290,1033
2022-03-20,70042,70046,Blue,1,27817,27985,168
2022-09-03,70059,70045,Blue,0,57309,58018,709
2022-06-16,70051,70049,Blue,0,58815,58917,102
2022-06-28,70050,70060,Blue,1,38255,38779,524
2022-11-26,70051,70049,Blue,0,84383,84488,105
2022-10-20,70040,70054,Blue,1,67090,67915,825
2022-03-28,70038,70054,Blue,1,63137,63959,822
2022-07-18,70057,70049,Blue,0,75454,75845,391
2022-02-21,70046,70048,Blue,1,69423,69509,86
2022-03-29,70051,70049,Blue,0,58142,58245,103
2022-01-23,70038,70046,Blue,1,35472,35801,329
2022-01-03,70043,70041,Blue,0,82110,82139,29
2022-12-16,70046,70054,Blue,1,47008,47431,423
2022-07-17,70052,70056,Blue,1,60453,60610,157
2022-07-18,70053,70043,Blue,0,27948,28593,645
2022-03-16,70053,70051,Blue,0,73489,73553,64
2022-06-11,70050,70054,Blue,1,35162,35393,231
2022-04-09,70055,70053,Blue,0,35892,35937,45
2022-07-16,70053,70047,Blue,0,52231,52515,284
2022-07-21,70049,70047,Blue,0,49495,49548,53
2022-09-17,70052,70054,Blue,1,34738,34788,50
2022-08-03,70040,70060,Blue,1,30731,31719,988
2022-11-18,70049,70045,Blue,0,43960,44257,297
2022-08-21,70055,70043,Blue,0,50777,51457,680
2022-12-31,70048,70058,Blue,1,67882,68424,542
2022-01-06,70055,70049,Blue,0,42302,42665,363
2022-04-14,70046,70048,Blue,1,91211,91320,109
2022-09-22,70040,70048,Blue,1,48733,49102,369
2022-04-22,70040,70044,Blue,1,89230,89339,109
2022-01-27,70044,70054,Blue,1,61849,62417,568
2022-07-25,70048,70054,Blue,1,69453,69832,379
2022-06-20,70038,70060,Blue,1,73675,74740,1065
2022-02-26,70043,70838,Blue,0,43105,43308,203
2022-02-12,70049,70043,Blue,0,61642,61995,353
2022-11-07,70046,70048,Blue,1,48977,49057,80
2022-12-01,70059,70051,Blue,0,78141,78449,308
2022-03-18,70046,70054,Blue,1,56635,57047,412
2022-01-03,70059,70049,Blue,0,59415,59929,514
2022-03-05,70054,70056,Blue,1,43384,43431,47
2022-01-04,70051,70043,Blue,0,25599,26156,557
2022-04-06,70044,70056,Blue,1,81672,82309,637
2022-02-11,70049,70039,Blue,0,73115,73633,518
2022-08-03,70045,70041,Blue,0,35253,35475,222
2022-01-10,70059,70049,Blue,0,34547,35073,526
2022-10-16,70044,70054,Blue,1,60981,61574,593
2022-12-11,70047,70041,Blue,0,22131,22494,363
2022-04-20,70048,70052,Blue,1,85463,85671,208
2022-02-16,70056,70058,Blue,1,54704,54776,72
2022-01-08,70045,70041,Blue,0,87302,87462,160
2022-06-23,70052,70058,Blue,1,37037,37382,345
2022-08-28,70054,70060,Blue,1,74130,74405,275
2022-02-24,70058,70060,Blue,1,58652,58763,111
2022-11-07,70038,70058,Blue,1,49874,51035,1161
2022-04-18,70051,70045,Blue,0,24308,24671,363
2022-04-12,70051,70041,Blue,0,88461,89025,564
2022-02-15,70048,70060,Blue,1,26236,26880,644
2022-08-01,70042,70058,Blue,1,57814,58773,959
2022-04-14,70045,70043,Blue,0,20200,20286,86
2022-07-06,70050,70052,Blue,1,61142,61262,120
2022-06-25,70057,70053,Blue,0,26098,26248,150
2022-10-06,70053,70041,Blue,0,29153,29860,707
2022-03-05,70042,70048,Blue,1,47124,47466,342
2022-03-09,70041,70039,Blue,0,21247,21276,29
2022-05-21,70051,70045,Blue,0,62021,62413,392
2022-06-22,70051,70043,Blue,0,43817,44371,554
2022-01-08,70053,70049,Blue,0,86824,87024,200
2022-11-23,70047,70039,Blue,0,64092,64478,386
2022-01-14,70044,70050,Blue,1,50483,50816,333
2022-06-30,70059,70045,Blue,0,41863,42828,965
2022-02-02,70042,70050,Blue,1,31604,32027,423
2022-08-22,70043,70039,Blue,0,56356,56475,119
2022-06-25,70038,70042,Blue,1,33427,33517,90
2022-04-04,70042,70056,Blue,1,70667,71412,745
2022-11-07,70059,70053,Blue,0,69134,69357,223
2022-08-15,70055,70041,Blue,0,27379,28083,704
2022-09-13,70051,70039,Blue,0,43584,44215,631
2022-04-15,70055,70043,Blue,0,58285,58991,706
2022-09-19,70055,70051,Blue,0,43896,44042,146
2022-08-12,70046,70052,Blue,1,47006,47319,313
2022-08-04,70055,70041,Blue,0,80425,81112,687
2022-03-01,70040,70042,Blue,1,45366,45396,30
2022-01-08,70049,70838,Blue,0,28132,28728,596
2022-01-14,70053,70045,Blue,0,22378,22820,442
2022-04-21,70042,70058,Blue,1,64509,65486,977
2022-05-27,70045,70041,Blue,0,78992,79186,194
2022-11-12,70049,70838,Blue,0,61523,62246,723
2022-12-16,70057,70039,Blue,0,45825,46890,1065
2022-09-15,70042,70046,Blue,1,21929,22096,167
2022-03-09,70055,70053,Blue,0,25055,25126,71
2022-07-08,70045,70043,Blue,0,54811,54922,111
2022-10-05,70048,70050,Blue,1,64794,64853,59
2022-07-26,70049,70045,Blue,0,86994,87198,204
2022-06-16,70038,70056,Blue,1,37870,38897,1027
2022-01-15,70052,70056,Blue,1,44967,45098,131
2022-02-16,70057,70838,Blue,0,32443,33450,1007
2022-09-15,70046,70054,Blue,1,56989,57458,469
2022-12-28,70059,70043,Blue,0,87441,88279,838
2022-01-03,70053,70049,Blue,0,78026,78206,180
2022-03-15,70045,70838,Blue,0,63951,64307,356
2022-04-15,70046,70054,Blue,1,28823,29278,455
2022-06-17,70051,70043,Blue,0,70879,71378,499
2022-10-12,70046,70052,Blue,1,87709,88012,303
2022-12-05,70045,70043,Blue,0,63672,63769,97
2022-03-05,70053,70051,Blue,0,56499,56548,49
2022-03-16,70038,70042,Blue,1,56880,57020,140
2022-03-21,70053,70051,Blue,0,64968,65028,60
2022-12-04,70056,70058,Blue,1,73558,73648,90
2022-04-17,70044,70058,Blue,1,76650,77446,796
2022-08-29,70056,70060,Blue,1,41425,41616,191
2022-06-13,70059,70049,Blue,0,84015,84471,456
2022-01-22,70045,70043,Blue,0,28434,28592,158
2022-05-20,70042,70056,Blue,1,44945,45816,871
2022-12-16,70042,70060,Blue,1,38800,39789,989
2022-11-28,70042,70052,Blue,1,90675,91199,524
2022-07-22,70055,70838,Blue,0,86970,87856,886
2022-04-22,70053,70041,Blue,0,28917,29723,806
2022-03-28,70050,70056,Blue,1,35013,35297,284
2022-04-16,70040,70060,Blue,1,78681,79800,1119
2022-08-25,70043,70838,Blue,0,27063,27343,280
2022-03-08,70052,70054,Blue,1,56083,56131,48
2022-12-12,70046,70060,Blue,1,70539,71455,916
2022-10-09,70044,70054,Blue,1,60433,61114,681
2022-12-21,70059,70045,Blue,0,28763,29514,751
2022-02-13,70044,70058,Blue,1,49082,49904,822
2022-09-15,70053,70047,Blue,0,57986,58272,286
2022-03-30,70049,70047,Blue,0,79435,79490,55
2022-09-03,70057,70055,Blue,0,75893,75962,69
2022-12-25,70042,70044,Blue,1,83859,83888,29
2022-07-31,70053,70039,Blue,0,82505,83263,758
2022-10-25,70038,70056,Blue,1,89949,91600,1651
2022-08-06,70040,70056,Blue,1,81504,82377,873
2022-03-12,70038,70040,Blue,1,29653,29672,19
2022-02-23,70049,70838,Blue,0,29586,30219,633
2022-08-31,70055,70838,Blue,0,49565,50513,948
2022-12-01,70049,70047,Blue,0,22436,22510,74
2022-09-21,70055,70053,Blue,0,51671,51716,45
2022-12-10,70040,70058,Blue,1,43763,44704,941
2022-08-23,70052,70054,Blue,1,29704,29778,74
2022-07-18,70057,70043,Blue,0,61012,61796,784
2022-08-01,70053,70051,Blue,0,65271,65321,50
2022-07-15,70057,70049,Blue,0,49671,50081,410
2022-03-20,70050,70060,Blue,1,72086,72813,727
2022-12-04,70051,70041,Blue,0,58263,58919,656
2022-07-02,70038,70042,Blue,1,42073,42170,97
2022-07-10,70040,70042,Blue,1,31634,31666,32
2022-11-07,70053,70051,Blue,0,80619,80670,51
2022-12-31,70042,70054,Blue,1,72730,73409,679
2022-06-29,70053,70043,Blue,0,46688,47343,655
2022-01-27,70048,70056,Blue,1,39216,39733,517
2022-04-11,70046,70052,Blue,1,31566,31916,350
2022-07-01,70042,70054,Blue,1,79209,80148,939
2022-04-07,70042,70046,Blue,1,52888,53056,168
2022-09-27,70051,70041,Blue,0,18874,19552,678
2022-12-18,70052,70060,Blue,1,55083,55473,390
2022-11-18,70040,70044,Blue,1,90954,91378,424
2022-02-23,70044,70046,Blue,1,55075,55182,107
2022-05-21,70054,70056,Blue,1,42962,43008,46
2022-01-19,70054,70058,Blue,1,47428,47582,154
2022-06-23,70040,70042,Blue,1,29480,29516,36
2022-09-11,70055,70049,Blue,0,45558,45854,296
2022-04-13,70043,70838,Blue,0,67768,67970,202
2022-02-20,70046,70054,Blue,1,64348,64806,458
2022-05-23,70048,70052,Blue,1,29216,29578,362
2022-09-24,70042,70048,Blue,1,50870,51202,332
2022-02-15,70052,70054,Blue,1,30716,30775,59
2022-06-10,70038,70040,Blue,1,57161,57177,16
2022-01-28,70042,70054,Blue,1,71586,72269,683
2022-04-11,70050,70054,Blue,1,38073,38336,263
2022-02-23,70042,70056,Blue,1,30131,30917,786
2022-02-13,70047,70045,Blue,0,79340,79429,89
2022-12-23,70055,70051,Blue,0,75841,76026,185
2022-07-25,70045,70838,Blue,0,55148,55500,352
2022-01-26,70046,70060,Blue,1,39451,40379,928
2022-07-23,70056,70058,Blue,1,38207,38277,70
2022-02-07,70059,70043,Blue,0,78906,79761,855
2022-03-11,70047,70045,Blue,0,82912,83009,97
2022-02-15,70051,70043,Blue,0,33621,34217,596
2022-09-25,70057,70047,Blue,0,35630,36155,525
2022-09-19,70049,70043,Blue,0,21621,21997,376
2022-10-26,70053,70047,Blue,0,46560,46896,336
2022-05-18,70057,70047,Blue,0,28559,29084,525
2022-01-24,70045,70838,Blue,0,71726,72110,384
2022-04-04,70044,70054,Blue,1,37598,38193,595
2022-08-11,70045,70039,Blue,0,35809,36098,289
2022-03-02,70055,70053,Blue,0,62467,62516,49
2022-07-04,70042,70050,Blue,1,62233,62687,454
2022-05-18,70038,70056,Blue,1,34776,36106,1330
2022-02-01,70055,70045,Blue,0,32552,33082,530
2022-05-25,70038,70042,Blue,1,34932,35019,87
2022-10-27,70042,70060,Blue,1,41110,42067,957
2022-03-17,70052,70058,Blue,1,47140,47378,238
2022-12-29,70042,70054,Blue,1,56860,57539,679
2022-06-28,70059,70047,Blue,0,49937,50486,549
2022-10-03,70051,70041,Blue,0,57288,57876,588
2022-08-24,70042,70044,Blue,1,86773,86804,31
2022-06-10,70044,70050,Blue,1,25672,26050,378
2022-11-01,70045,70043,Blue,0,74021,74110,89
2022-06-17,70057,70055,Blue,0,37744,37826,82
2022-12-21,70049,70045,Blue,0,60260,60453,193
2022-08-28,70052,70060,Blue,1,88069,88444,375
2022-09-02,70049,70041,Blue,0,28268,28665,397
2022-08-13,70057,70041,Blue,0,67651,68473,822
2022-01-21,70051,70041,Blue,0,74718,75272,554
2022-10-27,70042,70056,Blue,1,33350,34157,807
2022-01-14,70051,70039,Blue,0,36190,36795,605
2022-11-09,70050,70058,Blue,1,46814,47227,413
2022-06-12,70057,70041,Blue,0,37610,38499,889
2022-07-05,70038,70052,Blue,1,72116,72880,764
2022-03-31,70044,70054,Blue,1,51004,51642,638
2022-07-11,70038,70048,Blue,1,48957,49508,551
2022-08-22,70048,70056,Blue,1,81646,82052,406
2022-12-13,70044,70050,Blue,1,35074,35414,340
2022-01-26,70038,70044,Blue,1,84915,85105,190
2022-11-30,70048,70056,Blue,1,68205,68627,422
2022-06-16,70051,70041,Blue,0,54107,54709,602
2022-01-10,70040,70042,Blue,1,45578,45617,39
2022-07-13,70049,70045,Blue,0,65249,65455,206
2022-03-28,70042,70058,Blue,1,42124,43040,916
2022-02-26,70048,70050,Blue,1,52841,52899,58
2022-08-05,70059,70053,Blue,0,67806,68032,226
2022-01-17,70038,70052,Blue,1,81374,82136,762
2022-06-29,70052,70056,Blue,1,85717,85873,156
2022-10-02,70059,70041,Blue,0,67348,68256,908
2022-11-09,70044,70046,Blue,1,21510,21620,110
2022-11-05,70049,70838,Blue,0,25335,25984,649
2022-10-03,70049,70045,Blue,0,61364,61553,189
2022-01-20,70055,70053,Blue,0,53304,53401,97
2022-08-03,70056,70060,Blue,1,23115,23280,165
2022-12-14,70042,70054,Blue,1,73804,74411,607
2022-10-12,70049,70043,Blue,0,33232,33610,378
2022-07-05,70051,70838,Blue,0,62242,63015,773
2022-06-23,70059,70057,Blue,0,75917,75955,38
2022-10-23,70053,70039,Blue,0,24091,24800,709
2022-05-23,70048,70052,Blue,1,58995,59268,273
2022-11-13,70049,70041,Blue,0,73247,73650,403
2022-06-02,70043,70838,Blue,0,68292,68478,186
2022-07-22,70040,70060,Blue,1,78768,79851,1083
2022-08-20,70055,70053,Blue,0,59119,59163,44
2022-09-24,70053,70047,Blue,0,53277,53564,287
2022-07-23,70053,70041,Blue,0,37065,37778,713
2022-12-22,70059,70045,Blue,0,41059,41784,725
2022-02-28,70038,70046,Blue,1,57431,57780,349
2022-04-10,70050,70058,Blue,1,25225,25632,407
2022-02-19,70044,70046,Blue,1,58534,58636,102
2022-03-31,70038,70054,Blue,1,71415,72279,864
2022-03-09,70050,70052,Blue,1,77105,77218,113
2022-10-02,70049,70045,Blue,0,38051,38254,203
2022-01-26,70040,70042,Blue,1,64412,64442,30
2022-09-01,70049,70047,Blue,0,64494,64553,59
2022-02-14,70050,70054,Blue,1,23637,23862,225
2022-07-24,70039,70838,Blue,0,58152,58185,33
2022-02-15,70059,70043,Blue,0,53598,54480,882
2022-02-10,70038,70042,Blue,1,42974,43067,93
2022-12-15,70054,70056,Blue,1,49262,49309,47
2022-01-04,70053,70838,Blue,0,58971,59766,795
2022-07-17,70050,70054,Blue,1,50116,50366,250
2022-09-13,70059,70047,Blue,0,46815,47385,570
2022-10-31,70046,70048,Blue,1,73115,73196,81
2022-12-29,70051,70039,Blue,0,66900,67501,601
2022-02-09,70059,70051,Blue,0,78906,79241,335
2022-06-28,70038,70060,Blue,1,66734,68173,1439
2022-02-11,70046,70060,Blue,1,84643,85321,678
2022-01-26,70045,70043,Blue,0,52590,52734,144
2022-10-03,70045,70041,Blue,0,61146,61360,214
2022-01-06,70048,70060,Blue,1,48890,49505,615
2022-05-20,70059,70049,Blue,0,20590,21054,464
2022-09-22,70051,70045,Blue,0,25519,25922,403
2022-03-30,70042,70054,Blue,1,57915,58973,1058
2022-02-07,70038,70044,Blue,1,29058,29273,215
2022-04-30,70052,70054,Blue,1,79717,79762,45
2022-01-15,70046,70048,Blue,1,31099,31180,81
2022-12-30,70053,70047,Blue,0,72388,72673,285
2022-07-30,70054,70060,Blue,1,72125,72383,258
2022-01-16,70055,70049,Blue,0,55103,55395,292
2022-09-22,70051,70049,Blue,0,47722,47823,101
2022-07-05,70042,70056,Blue,1,61547,62362,815
2022-12-05,70059,70049,Blue,0,44712,45194,482
2022-03-08,70052,70060,Blue,1,56686,57155,469
2022-01-10,70044,70060,Blue,1,68787,69782,995
2022-02-10,70042,70048,Blue,1,81774,82164,390
2022-10-04,70047,70039,Blue,0,20210,20675,465
2022-10-21,70042,70048,Blue,1,52280,52603,323
2022-06-23,70054,70058,Blue,1,30328,30476,148
2022-11-16,70051,70045,Blue,0,36627,36982,355
2022-02-03,70051,70047,Blue,0,30448,30658,210
2022-06-19,70057,70053,Blue,0,52330,52485,155
2022-07-22,70053,70041,Blue,0,71252,71960,708
2022-06-11,70051,70047,Blue,0,73984,74176,192
2022-07-10,70059,70045,Blue,0,37514,38268,754
2022-09-11,70045,70838,Blue,0,76264,76611,347
2022-04-22,70052,70056,Blue,1,46520,46658,138
2022-04-02,70038,70060,Blue,1,30188,31277,1089
2022-05-07,70053,70047,Blue,0,87277,87570,293
2022-01-11,70044,70056,Blue,1,51799,52573,774
2022-04-28,70052,70058,Blue,1,63267,63511,244
2022-12-23,70038,70058,Blue,1,48397,49565,1168
2022-11-04,70052,70056,Blue,1,45362,45504,142
2022-05-18,70051,70049,Blue,0,63609,63759,150
2022-10-07,70050,70056,Blue,1,70900,71218,318
2022-01-17,70040,70058,Blue,1,31962,32952,990
2022-04-13,70054,70060,Blue,1,59820,60119,299
2022-09-22,70040,70058,Blue,1,25905,26864,959
2022-12-09,70038,70052,Blue,1,28993,29661,668
2022-12-23,70040,70060,Blue,1,52822,53942,1120
2022-08-19,70058,70060,Blue,1,40895,40966,71
2022-09-21,70051,70045,Blue,0,34760,35170,410
2022-02-12,70059,70039,Blue,0,28686,29761,1075
2022-01-29,70053,70051,Blue,0,72708,72856,148
2022-12-31,70044,70054,Blue,1,74761,75347,586
2022-06-13,70058,70060,Blue,1,68737,68810,73
2022-11-12,70048,70060,Blue,1,73321,73884,563
2022-03-18,70053,70045,Blue,0,43505,43920,415
2022-04-18,70045,70039,Blue,0,59144,59392,248
2022-01-24,70051,70047,Blue,0,30655,30845,190
2022-08-31,70057,70838,Blue,0,44367,45347,980
2022-10-06,70059,70053,Blue,0,43341,43580,239
2022-11-13,70057,70039,Blue,0,79697,80571,874
2022-04-06,70057,70041,Blue,0,54278,55176,898
2022-05-21,70059,70047,Blue,0,20175,20758,583
2022-11-20,70051,70049,Blue,0,68780,68883,103
2022-05-18,70047,70045,Blue,0,21285,21493,208
2022-10-26,70040,70050,Blue,1,70117,71346,1229
2022-03-10,70043,70838,Blue,0,38573,38795,222
2022-10-10,70040,70048,Blue,1,76816,77206,390
2022-07-09,70043,70838,Blue,0,71227,71433,206
2022-11-08,70046,70052,Blue,1,89508,89839,331
2022-04-07,70051,70047,Blue,0,59092,59317,225
2022-03-04,70056,70058,Blue,1,89351,89430,79
2022-02-25,70057,70055,Blue,0,63562,63635,73
2022-04-19,70043,70041,Blue,0,40520,40552,32
2022-02-19,70052,70058,Blue,1,63947,64262,315
2022-05-15,70051,70047,Blue,0,21892,22096,204
2022-03-30,70056,70060,Blue,1,49658,49842,184
2022-04-16,70042,70044,Blue,1,37898,37928,30
2022-01-27,70042,70054,Blue,1,35965,36905,940
2022-01-21,70050,70058,Blue,1,30222,30662,440
2022-03-05,70040,70046,Blue,1,36724,36973,249
2022-12-30,70053,70043,Blue,0,33487,34064,577
2022-04-23,70049,70041,Blue,0,28663,29131,468
2022-06-23,70056,70060,Blue,1,23302,23504,202
2022-09-13,70045,70041,Blue,0,61348,61532,184
2022-12-20,70053,70045,Blue,0,47028,47447,419
2022-11-15,70051,70049,Blue,0,24213,24314,101
2022-11-12,70057,70838,Blue,0,30938,31948,1010
2022-06-12,70044,70050,Blue,1,82576,82952,376
2022-08-24,70046,70050,Blue,1,42919,43114,195
2022-01-24,70040,70050,Blue,1,24657,25317,660
2022-10-29,70042,70058,Blue,1,72991,73914,923
2022-02-03,70053,70047,Blue,0,46394,46750,356
2022-04-18,70045,70043,Blue,0,44978,45077,99
2022-03-25,70042,70046,Blue,1,77573,77743,170
2022-06-23,70042,70056,Blue,1,71544,72446,902
2022-04-06,70043,70838,Blue,0,62638,62842,204
2022-08-17,70042,70058,Blue,1,40713,41594,881
2022-12-07,70042,70060,Blue,1,57238,58252,1014
2022-02-13,70057,70051,Blue,0,34430,34863,433
2022-05-11,70050,70058,Blue,1,42019,42405,386
2022-02-02,70048,70052,Blue,1,27134,27353,219
2022-06-10,70040,70052,Blue,1,26723,27416,693
2022-09-16,70047,70838,Blue,0,89042,89642,600
2022-03-21,70040,70042,Blue,1,54382,54416,34
2022-08-21,70040,70044,Blue,1,86537,86644,107
2022-01-12,70053,70043,Blue,0,36471,37034,563
2022-07-10,70046,70058,Blue,1,60183,60860,677
2022-07-04,70042,70048,Blue,1,53937,54322,385
2022-06-20,70057,70043,Blue,0,39628,40539,911
2022-12-23,70053,70039,Blue,0,31046,31836,790
2022-02-23,70053,70049,Blue,0,52408,52605,197
2022-04-10,70040,70046,Blue,1,64044,64314,270
2022-11-01,70047,70041,Blue,0,87348,87654,306
2022-09-29,70053,70049,Blue,0,84464,84680,216
2022-11-22,70044,70056,Blue,1,29207,29890,683
2022-01-22,70049,70039,Blue,0,74548,75037,489
2022-09-28,70059,70051,Blue,0,49394,49720,326
2022-05-29,70040,70048,Blue,1,53780,54241,461
2022-06-15,70059,70055,Blue,0,61701,61867,166
2022-08-10,70038,70058,Blue,1,75885,76932,1047
2022-10-09,70042,70052,Blue,1,46279,46802,523
2022-06-24,70038,70050,Blue,1,52960,53613,653
2022-07-09,70040,70044,Blue,1,71849,71977,128
2022-03-02,70053,70045,Blue,0,78590,79086,496
2022-05-13,70057,70049,Blue,0,28116,28519,403
2022-04-04,70039,70838,Blue,0,89447,89487,40
2022-11-14,70053,70045,Blue,0,49675,50123,448
2022-07-18,70058,70060,Blue,1,63775,64022,247
2022-02-23,70055,70045,Blue,0,62474,63054,580
2022-04-05,70038,70040,Blue,1,59529,59547,18
2022-01-05,70038,70060,Blue,1,74703,75858,1155
2022-10-21,70059,70045,Blue,0,82884,83620,736
2022-05-16,70057,70047,Blue,0,19734,20253,519
2022-11-25,70038,70052,Blue,1,73152,73859,707
2022-12-02,70053,70043,Blue,0,80094,80670,576
2022-07-04,70038,70050,Blue,1,67337,67954,617
2022-03-25,70047,70045,Blue,0,73950,74037,87
2022-12-26,70050,70056,Blue,1,83010,83320,310
2022-02-05,70046,70048,Blue,1,56586,56662,76
2022-11-08,70044,70056,Blue,1,73470,74123,653
2022-01-24,70041,70838,Blue,0,58786,58935,149
2022-08-22,70059,70047,Blue,0,52093,52700,607
2022-08-25,70050,70058,Blue,1,20515,20925,410
2022-01-20,70059,70049,Blue,0,84006,84461,455
2022-04-29,70049,70047,Blue,0,59089,59130,41
2022-01-20,70040,70060,Blue,1,38873,40107,1234
2022-08-26,70038,70058,Blue,1,26065,27078,1013
2022-01-13,70040,70046,Blue,1,61529,61854,325
2022-03-18,70045,70838,Blue,0,61500,61959,459
2022-10-18,70046,70052,Blue,1,54289,54634,345
2022-03-09,70043,70039,Blue,0,72428,72529,101
2022-09-02,70049,70041,Blue,0,65338,65750,412
2022-11-30,70050,70060,Blue,1,51372,51934,562
2022-12-10,70054,70060,Blue,1,27916,28177,261
2022-05-18,70040,70050,Blue,1,60607,61236,629
2022-11-08,70056,70060,Blue,1,68399,68612,213
2022-09-16,70048,70058,Blue,1,20456,21001,545
2022-07-02,70040,70048,Blue,1,20070,20489,419
2022-04-11,70057,70053,Blue,0,72149,72299,150
2022-10-19,70053,70041,Blue,0,82309,82938,629
2022-12-22,70043,70838,Blue,0,62156,62445,289
2022-02-02,70044,70056,Blue,1,76163,76910,747
2022-12-19,70050,70054,Blue,1,34375,34575,200
2022-07-09,70040,70044,Blue,1,38900,39023,123
2022-09-12,70044,70056,Blue,1,33409,34129,720
2022-11-08,70042,70054,Blue,1,73387,74042,655
2022-12-30,70048,70060,Blue,1,31459,32089,630
2022-11-25,70057,70838,Blue,0,31466,32457,991
2022-11-12,70052,70054,Blue,1,53644,53698,54
2022-02-15,70059,70039,Blue,0,65297,66501,1204
2022-10-20,70051,70049,Blue,0,45835,45937,102
2022-06-30,70049,70039,Blue,0,80179,80723,544
2022-02-23,70039,70838,Blue,0,65703,65738,35
2022-11-30,70055,70039,Blue,0,63887,64758,871
2022-02-26,70048,70058,Blue,1,60400,60908,508
2022-10-20,70045,70041,Blue,0,38190,38358,168
2022-05-06,70057,70051,Blue,0,19049,19321,272
2022-04-10,70038,70040,Blue,1,41006,41023,17
2022-05-15,70053,70047,Blue,0,61483,61798,315
2022-08-27,70059,70057,Blue,0,33015,33051,36
2022-03-01,70046,70048,Blue,1,23135,23217,82
2022-02-18,70040,70052,Blue,1,20462,21145,683
2022-08-07,70059,70043,Blue,0,59776,60610,834
2022-02-05,70055,70039,Blue,0,64516,65365,849
2022-03-15,70055,70041,Blue,0,44586,45350,764
2022-11-06,70057,70838,Blue,0,71179,72200,1021
2022-04-21,70055,70838,Blue,0,19758,20705,947
2022-09-19,70057,70041,Blue,0,35968,36869,901
2022-11-20,70045,70043,Blue,0,83724,83815,91
2022-02-06,70049,70838,Blue,0,23637,24300,663
2022-06-14,70053,70838,Blue,0,61672,62500,828
2022-09-27,70046,70048,Blue,1,39995,40071,76
2022-12-04,70044,70046,Blue,1,87520,87630,110
2022-07-26,70049,70838,Blue,0,26257,26900,643
2022-01-26,70059,70838,Blue,0,53594,55452,1858
2022-09-16,70042,70058,Blue,1,66042,67223,1181
2022-01-28,70044,70046,Blue,1,27462,27578,116
2022-06-19,70057,70047,Blue,0,77686,78164,478
2022-02-17,70045,70838,Blue,0,70749,71108,359
2022-11-13,70038,70040,Blue,1,37697,37713,16
2022-03-28,70043,70041,Blue,0,64082,64112,30
2022-10-17,70059,70049,Blue,0,37472,37952,480
2022-04-15,70042,70044,Blue,1,66891,66922,31
2022-05-04,70057,70053,Blue,0,64251,64397,146
2022-03-29,70051,70043,Blue,0,57526,58055,529
2022-10-12,70053,70051,Blue,0,84533,84597,64
2022-05-28,70040,70048,Blue,1,87358,87839,481
2022-09-01,70051,70043,Blue,0,86886,87347,461
2022-04-08,70038,70040,Blue,1,63439,63455,16
2022-04-08,70040,70058,Blue,1,88402,89327,925
2022-06-29,70046,70054,Blue,1,50910,51435,525
2022-03-05,70046,70052,Blue,1,26029,26402,373
2022-10-19,70038,70058,Blue,1,26224,27265,1041
2022-04-04,70052,70058,Blue,1,52966,53206,240
2022-04-09,70055,70039,Blue,0,40254,41168,914
2022-09-21,70051,70838,Blue,0,72588,73316,728
2022-05-20,70038,70042,Blue,1,31189,31299,110
2022-05-20,70055,70053,Blue,0,35421,35468,47
2022-04-15,70055,70039,Blue,0,87667,88552,885
2022-03-27,70038,70044,Blue,1,62905,63085,180
2022-10-17,70059,70043,Blue,0,61156,61933,777
2022-12-03,70059,70057,Blue,0,29322,29357,35
2022-10-20,70053,70051,Blue,0,78930,78987,57
2022-06-10,70057,70055,Blue,0,86977,87046,69
2022-07-20,70059,70047,Blue,0,23839,24399,560
2022-06-12,70055,70053,Blue,0,31062,31109,47
2022-12-04,70054,70058,Blue,1,57889,58058,169
2022-11-08,70046,70058,Blue,1,21535,22171,636
2022-05-31,70044,70046,Blue,1,65368,65488,120
2022-09-23,70055,70039,Blue,0,77116,77914,798
2022-02-12,70042,70046,Blue,1,57888,58072,184
2022-09-11,70039,70838,Blue,0,74409,74442,33
2022-10-31,70059,70043,Blue,0,44229,45127,898
2022-10-07,70040,70060,Blue,1,79653,80705,1052
2022-11-12,70050,70058,Blue,1,67398,67809,411
2022-10-31,70046,70056,Blue,1,24490,24980,490
2022-08-16,70057,70047,Blue,0,42959,43493,534
2022-07-21,70042,70046,Blue,1,81477,81665,188
2022-02-18,70040,70056,Blue,1,80953,81790,837
2022-08-13,70050,70054,Blue,1,54572,54783,211
2022-03-02,70038,70050,Blue,1,63236,63844,608
2022-10-14,70052,70060,Blue,1,64025,64391,366
2022-08-06,70055,70039,Blue,0,72085,72888,803
2022-12-01,70043,70041,Blue,0,47855,47882,27
2022-11-21,70039,70838,Blue,0,44201,44235,34
2022-04-21,70044,70060,Blue,1,24756,25709,953
2022-03-15,70048,70050,Blue,1,39842,39906,64
2022-06-27,70042,70054,Blue,1,33995,34751,756
2022-07-22,70045,70043,Blue,0,60961,61051,90
2022-04-08,70045,70039,Blue,0,62123,62365,242
2022-07-29,70051,70049,Blue,0,41990,42092,102
2022-09-12,70057,70053,Blue,0,82829,82980,151
2022-10-08,70046,70048,Blue,1,42451,42529,78
2022-02-18,70040,70052,Blue,1,22828,23521,693
2022-11-13,70047,70041,Blue,0,72779,73090,311
2022-03-18,70042,70050,Blue,1,57277,57694,417
2022-12-03,70048,70054,Blue,1,24110,24436,326
2022-09-06,70039,70838,Blue,0,27558,27596,38
2022-02-19,70059,70049,Blue,0,56243,56787,544
2022-09-03,70043,70041,Blue,0,76008,76036,28
2022-07-20,70048,70050,Blue,1,27920,27983,63
2022-06-10,70038,70056,Blue,1,69478,70624,1146
2022-11-04,70040,70058,Blue,1,72701,73709,1008
2022-10-19,70053,70051,Blue,0,45131,45193,62
2022-04-18,70059,70045,Blue,0,67523,68177,654
2022-02-13,70040,70058,Blue,1,63505,64485,980
2022-09-22,70056,70058,Blue,1,48686,48763,77
2022-03-16,70057,70051,Blue,0,48755,48995,240
2022-03-24,70042,70052,Blue,1,66738,67350,612
2022-08-11,70038,70058,Blue,1,28584,29562,978
2022-08-31,70042,70050,Blue,1,63405,63800,395
2022-01-09,70045,70039,Blue,0,67598,67863,265
2022-05-19,70048,70060,Blue,1,86785,87428,643
2022-01-27,70040,70044,Blue,1,35434,35565,131
2022-06-23,70046,70050,Blue,1,72447,72667,220
2022-01-08,70048,70056,Blue,1,23573,23974,401
2022-01-15,70059,70057,Blue,0,85691,85727,36
2022-03-07,70048,70060,Blue,1,61171,61920,749
2022-11-18,70038,70044,Blue,1,65828,66008,180
2022-02-08,70051,70049,Blue,0,68269,68377,108
2022-01-09,70059,70047,Blue,0,51673,52279,606
2022-11-19,70048,70054,Blue,1,86029,86318,289
2022-03-28,70059,70045,Blue,0,24259,25017,758
2022-12-13,70057,70055,Blue,0,40359,40429,70
2022-07-16,70059,70047,Blue,0,87379,87922,543
2022-01-28,70051,70045,Blue,0,30667,31027,360
2022-01-26,70059,70057,Blue,0,84017,84052,35
2022-03-20,70059,70047,Blue,0,71113,71648,535
2022-04-24,70055,70043,Blue,0,79944,80591,647
2022-04-23,70057,70041,Blue,0,42277,43194,917
2022-03-02,70059,70053,Blue,0,87504,87765,261
2022-10-04,70051,70043,Blue,0,44832,45370,538
2022-03-25,70038,70048,Blue,1,46940,47432,492
2022-03-22,70059,70047,Blue,0,84012,84533,521
2022-12-09,70043,70838,Blue,0,30749,30979,230
2022-07-08,70057,70043,Blue,0,44802,45600,798
2022-06-23,70056,70060,Blue,1,78961,79139,178
2022-05-18,70042,70048,Blue,1,25344,25842,498
2022-02-16,70050,70056,Blue,1,79777,80130,353
2022-04-23,70054,70058,Blue,1,26559,26716,157
2022-07-18,70046,70058,Blue,1,58923,59587,664
2022-11-25,70040,70042,Blue,1,52750,52779,29
2022-02-08,70059,70051,Blue,0,70509,70858,349
2022-10-30,70044,70048,Blue,1,56137,56377,240
2022-03-23,70052,70054,Blue,1,25329,25385,56
2022-02-19,70038,70060,Blue,1,50181,51322,1141
2022-09-28,70047,70045,Blue,0,61503,61598,95
2022-02-18,70044,70056,Blue,1,74850,75496,646
2022-09-09,70057,70838,Blue,0,22382,23463,1081
2022-10-09,70051,70041,Blue,0,74349,74892,543
2022-12-26,70044,70050,Blue,1,78244,78587,343
2022-01-15,70053,70051,Blue,0,60145,60205,60
2022-11-02,70057,70049,Blue,0,56267,56690,423
2022-03-30,70045,70039,Blue,0,78634,78883,249
2022-03-13,70047,70039,Blue,0,39461,39888,427
2022-11-04,70057,70045,Blue,0,58938,59557,619
2022-03-11,70040,70048,Blue,1,33916,34325,409
2022-01-09,70052,70056,Blue,1,33842,33979,137
2022-10-04,70051,70039,Blue,0,68042,68678,636
2022-07-06,70051,70043,Blue,0,46749,47293,544
2022-02-03,70046,70050,Blue,1,47359,47549,190
2022-04-01,70038,70052,Blue,1,44235,45010,775
2022-02-24,70039,70838,Blue,0,60836,60929,93
2022-07-25,70045,70043,Blue,0,21579,21682,103
2022-12-29,70053,70045,Blue,0,49018,49438,420
2022-12-19,70042,70058,Blue,1,38496,39540,1044
2022-12-20,70057,70055,Blue,0,27223,27292,69
2022-12-10,70059,70053,Blue,0,40595,40823,228
2022-01-05,70051,70045,Blue,0,66684,67015,331
2022-10-12,70058,70060,Blue,1,74213,74275,62
2022-12-15,70044,70054,Blue,1,25966,26570,604
2022-01-06,70059,70043,Blue,0,63197,64016,819
2022-06-08,70040,70052,Blue,1,68802,70282,1480
2022-02-19,70047,70041,Blue,0,21483,21835,352
2022-03-03,70042,70056,Blue,1,79910,80684,774
2022-07-20,70051,70039,Blue,0,71094,72158,1064
2022-04-05,70056,70060,Blue,1,60234,60414,180
2022-01-04,70053,70838,Blue,0,67424,68257,833
2022-03-24,70059,70049,Blue,0,45496,45993,497
2022-09-22,70038,70044,Blue,1,78332,78510,178
2022-04-21,70049,70047,Blue,0,62229,62285,56
2022-12-06,70045,70043,Blue,0,27610,27713,103
2022-03-13,70053,70049,Blue,0,24103,24302,199
2022-10-04,70049,70039,Blue,0,59800,60304,504
2022-06-24,70052,70056,Blue,1,70287,70445,158
2022-11-28,70044,70050,Blue,1,29208,29552,344
2022-12-02,70050,70058,Blue,1,46320,46731,411
2022-02-10,70055,70051,Blue,0,60679,60851,172
2022-04-16,70048,70056,Blue,1,36080,36453,373
2022-01-05,70044,70058,Blue,1,59814,60620,806
2022-09-21,70057,70055,Blue,0,23922,23990,68
2022-10-29,70057,70051,Blue,0,82409,82641,232
2022-07-29,70053,70838,Blue,0,46875,47767,892
2022-04-13,70057,70055,Blue,0,33343,33411,68
2022-04-24,70059,70049,Blue,0,86456,86914,458
2022-07-24,70057,70838,Blue,0,36941,38045,1104
2022-04-04,70057,70051,Blue,0,45569,45804,235
2022-04-04,70059,70053,Blue,0,57488,57727,239
2022-10-18,70053,70039,Blue,0,37739,38490,751
2022-04-17,70051,70045,Blue,0,68764,69100,336
2022-10-07,70057,70045,Blue,0,60062,60697,635
2022-05-31,70049,70039,Blue,0,35346,36122,776
2022-07-20,70051,70043,Blue,0,64162,64648,486
2022-09-02,70040,70044,Blue,1,71010,71117,107
2022-10-21,70044,70060,Blue,1,39005,39913,908
2022-06-17,70048,70056,Blue,1,83322,83719,397
2022-08-09,70049,70047,Blue,0,34427,34478,51
2022-01-24,70042,70050,Blue,1,47085,47510,425
2022-10-06,70046,70054,Blue,1,56412,56845,433
2022-07-30,70042,70058,Blue,1,79411,80276,865
2022-04-06,70040,70054,Blue,1,23410,24202,792
2022-06-24,70053,70041,Blue,0,42410,43077,667
2022-07-18,70057,70838,Blue,0,59447,60556,1109
2022-06-22,70040,70046,Blue,1,21181,21483,302
2022-09-20,70040,70054,Blue,1,62774,63524,750
2022-04-16,70055,70039,Blue,0,42927,43809,882
2022-05-25,70049,70041,Blue,0,26030,26741,711
2022-03-11,70038,70042,Blue,1,90138,90692,554
2022-01-28,70047,70838,Blue,0,81838,82348,510
2022-08-25,70040,70056,Blue,1,70095,70897,802
2022-01-25,70040,70058,Blue,1,28574,29526,952
2022-11-24,70043,70041,Blue,0,61762,61790,28
2022-09-14,70057,70053,Blue,0,67172,67323,151
2022-03-25,70048,70054,Blue,1,31966,32314,348
2022-03-02,70047,70043,Blue,0,83429,83675,246
2022-07-03,70052,70056,Blue,1,71483,71642,159
2022-05-18,70046,70052,Blue,1,67099,67515,416
2022-06-16,70039,70838,Blue,0,77180,77217,37
2022-06-22,70057,70039,Blue,0,52053,52985,932
2022-04-17,70055,70043,Blue,0,58874,59552,678
2022-01-22,70044,70056,Blue,1,25837,26627,790
2022-08-24,70044,70050,Blue,1,57448,57811,363
2022-05-21,70047,70838,Blue,0,33083,33639,556
2022-09-16,70048,70054,Blue,1,82449,82737,288
2022-03-15,70044,70050,Blue,1,64233,64602,369
2022-04-10,70042,70060,Blue,1,73318,74293,975
2022-10-01,70049,70047,Blue,0,53513,53574,61
2022-03-13,70044,70054,Blue,1,83252,83900,648
2022-07-13,70041,70039,Blue,0,77477,77515,38
2022-08-30,70046,70060,Blue,1,37109,37845,736
2022-10-25,70057,70051,Blue,0,27298,27555,257
2022-09-04,70048,70054,Blue,1,59619,59909,290
2022-12-08,70044,70056,Blue,1,61960,62653,693
2022-10-25,70042,70054,Blue,1,40077,40789,712
2022-03-04,70056,70060,Blue,1,31272,31438,166
2022-10-31,70042,70046,Blue,1,24267,24447,180
2022-08-25,70050,70052,Blue,1,51990,52105,115
2022-11-23,70040,70044,Blue,1,74777,74886,109
2022-04-14,70051,70039,Blue,0,44704,45455,751
2022-04-15,70055,70051,Blue,0,62779,62917,138
2022-12-08,70051,70043,Blue,0,44070,44573,503
2022-12-24,70048,70052,Blue,1,76572,76782,210
2022-11-18,70038,70052,Blue,1,68538,69323,785
2022-09-15,70054,70056,Blue,1,25823,25877,54
2022-01-25,70040,70056,Blue,1,57490,58250,760
2022-10-13,70055,70051,Blue,0,61546,61685,139
2022-06-29,70040,70042,Blue,1,45322,45358,36
2022-02-09,70053,70051,Blue,0,31730,31781,51
2022-04-03,70050,70052,Blue,1,51608,51724,116
2022-08-19,70057,70047,Blue,0,73899,74383,484
2022-12-31,70056,70058,Blue,1,20770,20845,75
2022-01-19,70046,70056,Blue,1,70276,70817,541
2022-03-03,70059,70045,Blue,0,25217,26051,834
2022-02-22,70038,70040,Blue,1,24242,24260,18
2022-04-21,70059,70049,Blue,0,76048,76543,495
2022-10-12,70051,70047,Blue,0,45495,45683,188
2022-08-21,70059,70057,Blue,0,21490,21533,43
2022-03-17,70042,70056,Blue,1,33083,33778,695
2022-01-26,70048,70056,Blue,1,24822,25262,440
2022-01-24,70042,70056,Blue,1,60918,61675,757
2022-05-24,70049,70838,Blue,0,37366,38111,745
2022-06-29,70057,70043,Blue,0,38802,39663,861
2022-01-25,70053,70047,Blue,0,50524,50825,301
2022-03-09,70042,70058,Blue,1,31293,32141,848
2022-06-06,70045,70838,Blue,0,33076,33497,421
2022-09-24,70059,70055,Blue,0,66522,66671,149
2022-11-26,70040,70048,Blue,1,70219,70626,407
2022-07-14,70041,70039,Blue,0,30889,30923,34
2022-01-10,70049,70047,Blue,0,56866,56931,65
2022-10-05,70042,70046,Blue,1,35413,35582,169
2022-10-20,70044,70058,Blue,1,48872,49727,855
2022-12-28,70046,70052,Blue,1,74332,74635,303
2022-08-31,70041,70838,Blue,0,31404,31598,194
2022-05-11,70059,70049,Blue,0,66080,66600,520
2022-05-21,70044,70050,Blue,1,65785,66169,384
2022-02-16,70057,70039,Blue,0,58481,59544,1063
2022-02-14,70050,70058,Blue,1,41394,41771,377
2022-12-02,70048,70056,Blue,1,22747,23210,463
2022-02-03,70050,70056,Blue,1,56327,56617,290
2022-10-21,70053,70051,Blue,0,27880,27938,58
2022-10-11,70040,70048,Blue,1,45176,45554,378
2022-05-19,70059,70041,Blue,0,69082,70209,1127
2022-01-04,70050,70052,Blue,1,82308,82422,114
2022-07-03,70043,70039,Blue,0,52736,52860,124
2022-01-11,70059,70045,Blue,0,27253,27939,686
2022-11-15,70038,70052,Blue,1,23967,24674,707
2022-02-08,70047,70838,Blue,0,34817,35441,624
2022-10-18,70038,70056,Blue,1,40867,41922,1055
2022-01-15,70048,70056,Blue,1,86145,86542,397
2022-01-25,70057,70838,Blue,0,55768,56836,1068
2022-12-05,70046,70054,Blue,1,64757,65213,456
2022-08-14,70055,70051,Blue,0,24806,24951,145
2022-11-09,70038,70060,Blue,1,63794,64970,1176
2022-02-13,70059,70049,Blue,0,28033,28509,476
2022-07-22,70050,70052,Blue,1,27061,27187,126
2022-12-30,70040,70046,Blue,1,80183,80458,275
2022-06-24,70042,70048,Blue,1,44211,44552,341
2022-09-11,70038,70056,Blue,1,73175,74059,884
2022-12-14,70044,70054,Blue,1,31413,32051,638
2022-02-03,70044,70052,Blue,1,78756,79365,609
2022-11-08,70046,70056,Blue,1,49701,50226,525
2022-01-21,70042,70060,Blue,1,71564,72736,1172
2022-01-07,70047,70039,Blue,0,85268,85653,385
2022-01-07,70047,70043,Blue,0,19924,20204,280
2022-04-04,70058,70060,Blue,1,47373,47432,59
2022-02-01,70057,70043,Blue,0,61477,62317,840
2022-05-27,70038,70052,Blue,1,68967,69902,935
2022-03-04,70042,70050,Blue,1,52977,53443,466
2022-01-29,70043,70041,Blue,0,19611,19645,34
2022-09-23,70053,70039,Blue,0,22452,23379,927
2022-10-23,70038,70044,Blue,1,87315,87494,179
2022-11-15,70051,70049,Blue,0,29585,29695,110
2022-07-23,70059,70049,Blue,0,43290,43741,451
2022-11-17,70051,70838,Blue,0,29457,30294,837
2022-07-04,70055,70838,Blue,0,24984,25937,953
2022-01-31,70053,70045,Blue,0,79741,80207,466
2022-03-15,70040,70048,Blue,1,21227,21613,386
2022-01-29,70042,70054,Blue,1,75276,77218,1942
2022-04-12,70048,70058,Blue,1,62818,63293,475
2022-04-21,70040,70046,Blue,1,76394,76659,265
2022-06-08,70047,70045,Blue,0,67215,67323,108
2022-02-12,70044,70060,Blue,1,63937,64810,873
2022-08-15,70049,70045,Blue,0,29003,29226,223
2022-04-21,70044,70048,Blue,1,35292,35534,242
2022-12-06,70045,70041,Blue,0,26536,26694,158
2022-10-24,70057,70838,Blue,0,68200,69275,1075
2022-10-25,70040,70048,Blue,1,68596,68974,378
2022-09-19,70046,70060,Blue,1,68673,69471,798
2022-09-15,70053,70051,Blue,0,64426,64494,68
2022-03-12,70040,70052,Blue,1,82247,82923,676
2022-11-02,70042,70050,Blue,1,82196,82795,599
2022-07-18,70055,70047,Blue,0,52894,53272,378
2022-02-12,70045,70838,Blue,0,69925,70277,352
2022-12-14,70044,70048,Blue,1,86772,87013,241
2022-08-06,70042,70060,Blue,1,47650,48626,976
2022-02-17,70043,70838,Blue,0,20205,20427,222
2022-01-06,70054,70056,Blue,1,25391,25438,47
2022-05-24,70049,70838,Blue,0,86637,87313,676
2022-11-22,70055,70049,Blue,0,78970,79242,272
2022-12-01,70051,70041,Blue,0,55767,56369,602
2022-03-28,70045,70043,Blue,0,24250,24346,96
2022-08-05,70057,70055,Blue,0,28107,28176,69
2022-11-05,70039,70838,Blue,0,61131,61171,40
2022-04-19,70057,70041,Blue,0,30645,31595,950
2022-09-28,70041,70039,Blue,0,56805,56835,30
2022-01-11,70055,70039,Blue,0,47865,48721,856
2022-07-13,70040,70048,Blue,1,25443,25879,436
2022-12-28,70057,70047,Blue,0,51002,51475,473
2022-03-02,70049,70039,Blue,0,63429,63922,493
2022-10-22,70059,70039,Blue,0,63254,64280,1026
2022-08-30,70059,70047,Blue,0,53778,54343,565
2022-12-23,70040,70048,Blue,1,79716,80148,432
2022-06-26,70057,70043,Blue,0,83074,83859,785
2022-06-09,70038,70044,Blue,1,78139,78326,187
2022-04-24,70049,70047,Blue,0,63543,63601,58
2022-02-03,70047,70838,Blue,0,48321,48921,600
2022-04-06,70059,70838,Blue,0,29653,30898,1245
2022-07-18,70042,70044,Blue,1,78495,78529,34
2022-12-12,70050,70058,Blue,1,54500,54918,418
2022-04-30,70056,70060,Blue,1,77452,77622,170
2022-02-12,70055,70049,Blue,0,61814,62101,287
2022-09-28,70044,70048,Blue,1,64817,65035,218
2022-11-25,70051,70049,Blue,0,52880,52984,104
2022-03-17,70055,70051,Blue,0,27745,27888,143
2022-01-19,70042,70056,Blue,1,23002,23951,949
2022-09-29,70055,70049,Blue,0,85928,86206,278
2022-12-11,70053,70041,Blue,0,63294,63931,637
2022-10-31,70046,70054,Blue,1,33645,34096,451
2022-10-31,70040,70058,Blue,1,32839,33830,991
2022-09-12,70055,70051,Blue,0,63618,63762,144
2022-06-27,70048,70058,Blue,1,21650,22172,522
2022-12-06,70038,70050,Blue,1,63336,63931,595
2022-05-02,70049,70047,Blue,0,50005,50085,80
2022-01-25,70042,70046,Blue,1,75329,75499,170
2022-09-03,70042,70058,Blue,1,71458,72354,896
2022-11-09,70057,70053,Blue,0,29677,29844,167
2022-03-01,70046,70056,Blue,1,33014,33525,511
2022-07-19,70040,70054,Blue,1,25694,26423,729
2022-02-20,70050,70054,Blue,1,68356,68550,194
2022-09-04,70052,70060,Blue,1,37137,37477,340
2022-03-20,70055,70041,Blue,0,47083,47831,748
2022-07-31,70047,70041,Blue,0,73887,74224,337
2022-08-19,70038,70044,Blue,1,24034,24204,170
2022-02-20,70042,70050,Blue,1,53876,54290,414
2022-12-28,70048,70052,Blue,1,29500,29702,202
2022-12-28,70053,70041,Blue,0,62310,62963,653
2022-12-02,70047,70039,Blue,0,75496,75893,397
2022-10-17,70049,70041,Blue,0,57216,57648,432
2022-04-18,70049,70047,Blue,0,41670,41728,58
2022-01-08,70040,70056,Blue,1,69139,69975,836
2022-03-28,70057,70055,Blue,0,52591,52663,72
2022-04-24,70046,70058,Blue,1,76766,77394,628
2022-01-28,70048,70060,Blue,1,74568,75283,715
2022-07-03,70052,70056,Blue,1,78806,78974,168
2022-02-06,70044,70046,Blue,1,54281,54390,109
2022-04-02,70053,70039,Blue,0,70553,71297,744
2022-07-08,70038,70054,Blue,1,68946,69806,860
2022-08-25,70046,70060,Blue,1,68331,69042,711
2022-10-30,70040,70044,Blue,1,74283,74397,114
2022-04-29,70057,70055,Blue,0,72094,72163,69
2022-12-26,70055,70047,Blue,0,76688,77089,401
2022-11-07,70051,70838,Blue,0,42098,42886,788
2022-02-18,70057,70043,Blue,0,73825,74647,822
2022-07-01,70044,70060,Blue,1,63056,64254,1198
2022-12-04,70059,70043,Blue,0,86427,87223,796
2022-04-16,70053,70051,Blue,0,36517,36572,55
2022-10-20,70043,70838,Blue,0,88732,88943,211
2022-12-16,70049,70838,Blue,0,63947,64616,669
2022-11-19,70038,70054,Blue,1,77294,78138,844
2022-12-28,70057,70049,Blue,0,51330,51707,377
2022-03-30,70046,70050,Blue,1,35711,35887,176
2022-02-23,70051,70045,Blue,0,66284,66634,350
2022-03-18,70050,70054,Blue,1,54946,55159,213
2022-05-23,70049,70838,Blue,0,20436,21207,771
2022-03-13,70044,70058,Blue,1,38534,39247,713
2022-12-10,70040,70052,Blue,1,50782,51435,653
2022-12-23,70038,70056,Blue,1,83408,84410,1002
2022-06-14,70053,70045,Blue,0,71816,72250,434
2022-03-29,70049,70039,Blue,0,65795,66306,511
2022-01-29,70040,70042,Blue,1,28639,28673,34
2022-06-10,70054,70056,Blue,1,67331,67432,101
2022-04-07,70057,70041,Blue,0,24030,24911,881
2022-02-17,70059,70051,Blue,0,84005,84325,320
2022-11-24,70057,70045,Blue,0,59849,60473,624
2022-09-24,70055,70041,Blue,0,43447,44230,783
2022-02-12,70057,70049,Blue,0,69257,69665,408
2022-12-19,70055,70045,Blue,0,85031,85534,503
2022-12-29,70040,70056,Blue,1,34039,34922,883
2022-02-23,70046,70060,Blue,1,66381,67283,902
2022-03-12,70055,70053,Blue,0,57521,57567,46
2022-12-18,70059,70047,Blue,0,46814,47395,581
2022-05-19,70046,70048,Blue,1,81552,81702,150
2022-07-21,70050,70060,Blue,1,32477,32986,509
2022-01-07,70059,70838,Blue,0,45496,46629,1133
2022-07-16,70059,70057,Blue,0,41657,41691,34
2022-09-12,70042,70050,Blue,1,43687,44102,415
2022-09-07,70057,70047,Blue,0,60885,61401,516
2022-01-04,70044,70046,Blue,1,62475,62590,115
2022-02-18,70046,70048,Blue,1,52541,52616,75
2022-08-26,70038,70058,Blue,1,38864,39919,1055
2022-12-18,70057,70043,Blue,0,24686,25428,742
2022-05-27,70042,70046,Blue,1,87190,87400,210
2022-04-15,70040,70046,Blue,1,33398,33643,245
2022-04-25,70050,70052,Blue,1,42288,42412,124
2022-11-01,70038,70050,Blue,1,57559,58195,636
2022-09-30,70044,70056,Blue,1,80401,81099,698
2022-09-09,70050,70056,Blue,1,28711,29019,308
2022-12-29,70059,70053,Blue,0,79426,79654,228
2022-02-02,70049,70047,Blue,0,85177,85233,56
2022-07-26,70059,70045,Blue,0,67070,67721,651
2022-12-14,70055,70049,Blue,0,71414,71701,287
2022-05-31,70038,70052,Blue,1,67038,67887,849
2022-12-28,70038,70044,Blue,1,81975,82169,194
2022-03-01,70045,70838,Blue,0,88325,88667,342
2022-11-29,70044,70052,Blue,1,28018,28525,507
2022-11-24,70055,70045,Blue,0,43640,44126,486
2022-08-25,70044,70048,Blue,1,37665,37923,258
2022-02-04,70051,70045,Blue,0,28055,28470,415
2022-04-22,70045,70039,Blue,0,81949,82201,252
2022-12-17,70040,70048,Blue,1,58892,59312,420
2022-12-13,70038,70050,Blue,1,63803,64462,659
2022-09-30,70053,70045,Blue,0,53853,54325,472
2022-05-03,70053,70049,Blue,0,27082,27296,214
2022-09-07,70059,70057,Blue,0,45256,45292,36
2022-09-24,70040,70056,Blue,1,55659,56479,820
2022-04-22,70057,70041,Blue,0,75564,76365,801
2022-02-19,70042,70046,Blue,1,52034,52214,180
2022-12-07,70050,70056,Blue,1,67712,68024,312
2022-08-24,70059,70051,Blue,0,46464,46797,333
2022-06-10,70058,70060,Blue,1,57255,57554,299
2022-10-07,70052,70054,Blue,1,58363,58424,61
2022-02-03,70047,70045,Blue,0,30706,30809,103
2022-01-20,70050,70056,Blue,1,87144,87447,303
2022-08-07,70054,70058,Blue,1,38506,38663,157
2022-02-12,70038,70050,Blue,1,61645,62262,617
2022-02-18,70047,70043,Blue,0,55675,55951,276
2022-01-22,70038,70056,Blue,1,39912,40829,917
2022-07-22,70038,70052,Blue,1,23255,23992,737
2022-12-05,70038,70048,Blue,1,75803,76262,459
2022-04-23,70038,70058,Blue,1,62052,63141,1089
2022-12-13,70044,70054,Blue,1,51703,52371,668
2022-04-20,70058,70060,Blue,1,22793,23102,309
2022-06-09,70057,70051,Blue,0,80130,80371,241
2022-07-08,70054,70058,Blue,1,63089,63248,159
2022-11-02,70043,70838,Blue,0,65313,65508,195
2022-12-05,70055,70045,Blue,0,47483,48005,522
2022-08-27,70057,70047,Blue,0,51456,51961,505
2022-10-03,70044,70058,Blue,1,46904,47647,743
2022-11-30,70047,70838,Blue,0,75392,75889,497
2022-10-09,70048,70052,Blue,1,74187,74389,202
2022-12-31,70050,70058,Blue,1,52956,53365,409
2022-11-23,70049,70041,Blue,0,33072,33500,428
2022-12-15,70057,70043,Blue,0,19613,20482,869
2022-06-02,70048,70052,Blue,1,22932,23288,356
2022-12-10,70047,70045,Blue,0,68181,68280,99
2022-02-01,70057,70053,Blue,0,38206,38395,189
2022-09-02,70041,70039,Blue,0,75938,75967,29
2022-08-29,70040,70054,Blue,1,53424,54176,752
2022-10-19,70042,70046,Blue,1,83512,83695,183
2022-08-01,70046,70060,Blue,1,38196,38987,791
2022-05-27,70049,70039,Blue,0,37079,37664,585
2022-06-11,70051,70045,Blue,0,58286,58618,332
2022-12-16,70048,70054,Blue,1,80067,80373,306
2022-07-23,70054,70060,Blue,1,81788,82112,324
2022-12-12,70059,70043,Blue,0,70699,71516,817
2022-10-15,70040,70054,Blue,1,56803,57578,775
2022-06-05,70042,70050,Blue,1,59398,59877,479
2022-05-03,70058,70060,Blue,1,24522,24582,60
2022-01-06,70042,70052,Blue,1,51792,52361,569
2022-07-05,70050,70052,Blue,1,67827,67937,110
2022-06-19,70048,70054,Blue,1,61823,62117,294
2022-09-03,70048,70058,Blue,1,83586,84100,514
2022-05-31,70040,70052,Blue,1,82347,83136,789
2022-07-08,70053,70838,Blue,0,48102,48918,816
2022-07-26,70040,70042,Blue,1,56747,56781,34
2022-08-28,70042,70048,Blue,1,28609,28927,318
2022-12-26,70057,70053,Blue,0,77672,77823,151
2022-09-27,70057,70043,Blue,0,46985,47829,844
2022-11-26,70046,70050,Blue,1,56476,56643,167
2022-07-27,70051,70045,Blue,0,58098,58426,328
2022-04-10,70042,70058,Blue,1,32490,33385,895
2022-03-08,70040,70044,Blue,1,65927,66082,155
2022-01-20,70038,70048,Blue,1,86534,87011,477
2022-12-26,70040,70060,Blue,1,72133,73174,1041
2022-02-20,70059,70057,Blue,0,63564,63601,37
2022-04-06,70059,70049,Blue,0,58875,59373,498
2022-02-03,70038,70044,Blue,1,32086,32272,186
2022-04-15,70044,70054,Blue,1,80566,81135,569
2022-11-22,70045,70838,Blue,0,23709,24092,383
2022-03-24,70038,70040,Blue,1,42409,42426,17
2022-01-10,70059,70051,Blue,0,82872,83170,298
2022-07-07,70042,70060,Blue,1,36988,38175,1187
2022-10-18,70049,70041,Blue,0,39834,40326,492
2022-03-01,70038,70046,Blue,1,66918,67263,345
2022-02-12,70050,70056,Blue,1,56732,57034,302
2022-03-23,70055,70053,Blue,0,61567,61612,45
2022-07-23,70058,70060,Blue,1,71513,71574,61
2022-04-10,70042,70054,Blue,1,63060,63790,730
2022-08-31,70042,70050,Blue,1,84245,84717,472
2022-05-18,70053,70838,Blue,0,25496,26544,1048
2022-04-15,70055,70039,Blue,0,76238,77553,1315
2022-09-11,70041,70838,Blue,0,82554,82667,113
2022-01-20,70055,70053,Blue,0,24759,24835,76
2022-04-19,70047,70045,Blue,0,62926,63040,114
2022-03-13,70038,70056,Blue,1,72076,73036,960
2022-10-26,70041,70838,Blue,0,57681,57803,122
2022-04-15,70047,70838,Blue,0,50356,50837,481
2022-09-24,70041,70039,Blue,0,35131,35169,38
2022-06-23,70047,70045,Blue,0,79027,79127,100
2022-09-27,70038,70048,Blue,1,72635,73091,456
2022-04-07,70057,70053,Blue,0,33024,33176,152
2022-03-11,70049,70039,Blue,0,73773,74314,541
2022-06-08,70040,70044,Blue,1,71328,71453,125
2022-12-28,70051,70045,Blue,0,49114,49449,335
2022-03-17,70055,70051,Blue,0,84794,84928,134
2022-11-25,70041,70039,Blue,0,19446,19484,38
2022-08-02,70051,70047,Blue,0,47186,47391,205
2022-03-06,70050,70054,Blue,1,88813,89019,206
2022-11-14,70046,70050,Blue,1,58542,58726,184
2022-11-02,70038,70060,Blue,1,74192,75309,1117
2022-01-15,70044,70048,Blue,1,71879,72145,266
2022-10-31,70047,70838,Blue,0,73964,74593,629
2022-02-02,70055,70051,Blue,0,64617,64833,216
2022-02-21,70040,70044,Blue,1,68058,68177,119
2022-08-30,70052,70060,Blue,1,78579,78914,335
2022-06-10,70055,70838,Blue,0,33543,34530,987
2022-05-20,70055,70051,Blue,0,59191,59332,141
2022-12-15,70038,70050,Blue,1,41074,41606,532
2022-07-21,70047,70039,Blue,0,64276,64692,416
2022-03-28,70047,70043,Blue,0,79000,79249,249
2022-08-31,70050,70054,Blue,1,47495,47699,204
2022-07-14,70042,70054,Blue,1,52728,53452,724
2022-02-16,70054,70056,Blue,1,37544,37590,46
2022-02-04,70046,70048,Blue,1,86621,86700,79
2022-12-05,70040,70056,Blue,1,48747,49583,836
2022-03-10,70059,70041,Blue,0,67156,68069,913
2022-08-04,70055,70051,Blue,0,66442,66575,133
2022-07-21,70047,70043,Blue,0,33356,33632,276
2022-12-15,70056,70058,Blue,1,25212,25287,75
2022-11-27,70040,70048,Blue,1,43712,44103,391
2022-09-16,70052,70054,Blue,1,74353,74409,56
2022-06-20,70038,70044,Blue,1,57858,58053,195
2022-04-16,70038,70054,Blue,1,56200,57093,893
2022-06-26,70051,70041,Blue,0,61839,62443,604
2022-02-09,70044,70046,Blue,1,23897,24016,119
2022-06-13,70046,70060,Blue,1,77243,77945,702
2022-10-11,70045,70043,Blue,0,66727,66818,91
2022-03-21,70045,70039,Blue,0,69266,69499,233
2022-02-04,70044,70050,Blue,1,22183,22579,396
2022-08-08,70042,70054,Blue,1,32499,33174,675
2022-06-10,70040,70052,Blue,1,56079,56764,685
2022-11-02,70041,70838,Blue,0,20781,20921,140
2022-11-03,70054,70056,Blue,1,39650,39707,57
2022-12-02,70043,70039,Blue,0,28885,28996,111
2022-03-31,70047,70041,Blue,0,22307,22670,363
2022-12-20,70050,70060,Blue,1,28524,29088,564
2022-12-14,70040,70056,Blue,1,73227,74066,839
2022-03-02,70038,70050,Blue,1,64857,65514,657
2022-07-07,70045,70838,Blue,0,44432,44846,414
2022-01-09,70047,70039,Blue,0,70116,70522,406
2022-12-18,70052,70058,Blue,1,85382,85639,257
2022-06-27,70038,70046,Blue,1,34999,35343,344
2022-11-12,70046,70052,Blue,1,84270,84672,402
2022-12-22,70040,70048,Blue,1,25028,25416,388
2022-10-07,70057,70041,Blue,0,52046,52890,844
2022-09-03,70044,70054,Blue,1,53082,53660,578
2022-02-23,70048,70054,Blue,1,66127,66451,324
2022-08-02,70048,70054,Blue,1,31265,31671,406
2022-10-01,70057,70049,Blue,0,59018,59515,497
2022-12-09,70053,70041,Blue,0,22887,23623,736
2022-11-07,70057,70055,Blue,0,83200,83270,70
2022-04-10,70053,70043,Blue,0,21802,22523,721
2022-11-03,70059,70043,Blue,0,71235,72068,833
2022-03-19,70043,70039,Blue,0,45322,45437,115
2022-06-26,70042,70046,Blue,1,59905,60110,205
2022-12-22,70040,70048,Blue,1,59093,59510,417
2022-03-20,70055,70039,Blue,0,75081,75979,898
2022-11-26,70042,70056,Blue,1,48702,49402,700
2022-12-09,70043,70838,Blue,0,48147,48333,186
2022-02-01,70051,70838,Blue,0,63885,64653,768
2022-01-07,70048,70054,Blue,1,34654,35065,411
2022-08-22,70045,70041,Blue,0,62029,62217,188
2022-05-19,70059,70045,Blue,0,67927,68714,787
2022-12-23,70042,70052,Blue,1,68372,68947,575
2022-02-13,70045,70043,Blue,0,37015,37135,120
2022-07-08,70051,70838,Blue,0,73741,74497,756
2022-11-03,70053,70039,Blue,0,52812,53589,777
2022-06-13,70059,70057,Blue,0,31162,31215,53
2022-03-03,70042,70048,Blue,1,57269,57559,290
2022-08-23,70052,70058,Blue,1,75640,75912,272
2022-06-29,70048,70058,Blue,1,83194,83738,544
2022-07-02,70057,70043,Blue,0,39571,40379,808
2022-03-28,70040,70048,Blue,1,21923,22360,437
2022-02-08,70047,70043,Blue,0,72663,72903,240
2022-09-27,70057,70041,Blue,0,28141,29059,918
2022-01-06,70056,70058,Blue,1,26594,26666,72
2022-01-31,70046,70050,Blue,1,29624,29827,203
2022-08-30,70051,70049,Blue,0,55716,55818,102
2022-12-21,70052,70060,Blue,1,23145,23524,379
2022-06-10,70049,70043,Blue,0,38242,38661,419
2022-12-09,70055,70045,Blue,0,47008,47507,499
2022-12-16,70048,70054,Blue,1,25096,25424,328
2022-10-27,70045,70838,Blue,0,55012,55389,377
2022-07-28,70043,70838,Blue,0,61678,61882,204
2022-08-12,70038,70040,Blue,1,88253,88267,14
2022-03-09,70038,70058,Blue,1,50298,51493,1195
2022-12-13,70044,70050,Blue,1,73822,74130,308
2022-03-15,70046,70060,Blue,1,88380,89170,790
2022-03-28,70044,70046,Blue,1,66623,66723,100
2022-06-11,70038,70052,Blue,1,73939,74659,720
2022-08-29,70038,70054,Blue,1,31608,32439,831
2022-11-24,70042,70060,Blue,1,61392,62360,968
2022-02-19,70051,70045,Blue,0,42642,42985,343
2022-09-03,70048,70058,Blue,1,84786,85310,524
2022-01-20,70055,70043,Blue,0,87089,87834,745
2022-09-03,70057,70051,Blue,0,30932,31166,234
2022-04-07,70057,70055,Blue,0,65978,66049,71
2022-11-21,70048,70060,Blue,1,65324,65915,591
2022-11-28,70048,70058,Blue,1,59273,59816,543
2022-06-07,70045,70041,Blue,0,72381,72548,167
2022-01-20,70054,70058,Blue,1,46836,47012,176
2022-02-03,70038,70048,Blue,1,54911,55372,461
2022-11-25,70040,70046,Blue,1,37400,37662,262
2022-01-08,70040,70054,Blue,1,23711,24428,717
2022-04-12,70057,70039,Blue,0,27638,28610,972
2022-08-13,70046,70048,Blue,1,82595,82678,83
2022-09-24,70051,70047,Blue,0,21231,21455,224
2022-01-06,70042,70054,Blue,1,27395,28057,662
2022-03-17,70055,70039,Blue,0,38300,39128,828
2022-09-09,70059,70057,Blue,0,35354,35390,36
2022-07-24,70038,70050,Blue,1,69370,69973,603
2022-10-27,70044,70048,Blue,1,85216,85472,256
2022-08-24,70045,70838,Blue,0,64107,64452,345
2022-09-18,70059,70041,Blue,0,76515,77516,1001
2022-01-05,70049,70045,Blue,0,76538,76738,200
2022-08-22,70051,70045,Blue,0,25059,25404,345
2022-10-30,70040,70060,Blue,1,79155,80210,1055
2022-10-25,70045,70043,Blue,0,68874,68961,87
2022-02-25,70043,70838,Blue,0,65683,65879,196
2022-07-31,70049,70039,Blue,0,69469,69965,496
2022-04-02,70046,70054,Blue,1,25398,25866,468
2022-10-24,70049,70047,Blue,0,82469,82525,56
2022-04-14,70056,70060,Blue,1,48537,48717,180
2022-03-09,70046,70056,Blue,1,61730,62243,513
2022-11-16,70054,70056,Blue,1,53795,53842,47
2022-06-14,70051,70039,Blue,0,25857,26579,722
2022-04-14,70048,70058,Blue,1,25041,25595,554
2022-12-09,70044,70052,Blue,1,44310,44891,581
2022-12-12,70045,70039,Blue,0,70903,71129,226
2022-01-10,70057,70045,Blue,0,55883,56694,811
2022-02-22,70043,70838,Blue,0,20401,20657,256
2022-03-31,70043,70041,Blue,0,65932,65961,29
2022-11-28,70038,70058,Blue,1,78901,79915,1014
2022-12-29,70049,70039,Blue,0,34615,35143,528
2022-10-26,70038,70054,Blue,1,46296,47168,872
2022-08-09,70044,70054,Blue,1,24140,24707,567
2022-02-15,70048,70054,Blue,1,46903,47196,293
2022-10-30,70051,70043,Blue,0,22678,23200,522
2022-04-22,70051,70045,Blue,0,62961,63313,352
2022-12-22,70047,70043,Blue,0,81804,82065,261
2022-06-16,70059,70043,Blue,0,68153,68989,836
2022-09-08,70059,70041,Blue,0,75453,76387,934
2022-02-18,70047,70039,Blue,0,26732,27186,454
2022-10-26,70055,70838,Blue,0,25298,26371,1073
2022-08-20,70057,70053,Blue,0,74681,74831,150
2022-07-26,70038,70042,Blue,1,46157,46260,103
2022-02-19,70043,70041,Blue,0,55626,55654,28
2022-03-09,70044,70054,Blue,1,33431,33967,536
2022-02-17,70049,70045,Blue,0,50330,50553,223
2022-11-16,70056,70060,Blue,1,38293,38464,171
2022-02-10,70044,70048,Blue,1,79366,79597,231
2022-09-23,70045,70039,Blue,0,67864,68183,319
2022-09-06,70038,70056,Blue,1,29428,30315,887
2022-10-20,70051,70049,Blue,0,51354,51455,101
2022-09-08,70040,70042,Blue,1,54982,55015,33
2022-08-23,70049,70043,Blue,0,51662,52032,370
2022-07-16,70055,70838,Blue,0,62360,63327,967
2022-02-08,70044,70052,Blue,1,64830,65298,468
2022-03-31,70046,70050,Blue,1,43004,43205,201
2022-08-17,70055,70047,Blue,0,67760,68116,356
2022-09-02,70049,70047,Blue,0,39618,39673,55
2022-08-17,70057,70041,Blue,0,67654,68473,819
2022-07-15,70042,70048,Blue,1,62850,63158,308
2022-09-28,70054,70056,Blue,1,79756,79804,48
2022-07-09,70059,70045,Blue,0,27076,27775,699
2022-07-07,70051,70045,Blue,0,82080,82417,337
2022-07-07,70053,70051,Blue,0,74561,74620,59
2022-03-24,70053,70039,Blue,0,27255,28064,809
2022-06-25,70047,70045,Blue,0,71263,71368,105
2022-05-06,70052,70054,Blue,1,79153,79208,55
2022-02-21,70049,70045,Blue,0,64875,65081,206
2022-10-10,70038,70040,Blue,1,79524,79538,14
2022-03-25,70038,70056,Blue,1,66735,67794,1059
2022-01-04,70042,70058,Blue,1,61177,61992,815
2022-10-06,70051,70041,Blue,0,54132,54686,554
2022-12-28,70055,70838,Blue,0,33520,34409,889
2022-08-08,70046,70054,Blue,1,80019,80425,406
2022-10-27,70040,70054,Blue,1,63233,64044,811
2022-03-28,70053,70049,Blue,0,74010,74221,211
2022-06-22,70038,70044,Blue,1,53725,53911,186
2022-02-01,70041,70039,Blue,0,56980,57010,30
2022-04-10,70050,70058,Blue,1,52178,52609,431
2022-06-10,70038,70050,Blue,1,40721,41361,640
2022-07-26,70052,70058,Blue,1,29694,29964,270
2022-04-16,70050,70054,Blue,1,30810,31005,195
2022-09-28,70051,70039,Blue,0,35290,36063,773
2022-07-25,70043,70041,Blue,0,66646,66682,36
2022-01-26,70045,70043,Blue,0,25155,25260,105
2022-08-29,70055,70838,Blue,0,69320,70169,849
2022-08-21,70042,70048,Blue,1,69524,69847,323
2022-08-05,70052,70054,Blue,1,37373,37436,63
2022-12-05,70057,70053,Blue,0,33872,34023,151
2022-12-09,70059,70047,Blue,0,64995,65557,562
2022-12-19,70053,70047,Blue,0,19427,19741,314
2022-11-08,70055,70047,Blue,0,54555,54915,360
2022-03-10,70042,70052,Blue,1,28076,28685,609
2022-02-09,70051,70047,Blue,0,29803,30020,217
2022-02-23,70054,70060,Blue,1,79233,79525,292
2022-05-14,70051,70049,Blue,0,67608,67712,104
2022-03-10,70058,70060,Blue,1,78462,78532,70
2022-12-28,70045,70039,Blue,0,26919,27170,251
2022-07-22,70044,70048,Blue,1,60857,61126,269
2022-10-01,70040,70044,Blue,1,64832,64938,106
2022-11-04,70043,70041,Blue,0,61954,61982,28
2022-08-12,70040,70054,Blue,1,51868,52651,783
2022-07-10,70038,70052,Blue,1,67746,68527,781
2022-10-10,70042,70046,Blue,1,27028,27189,161
2022-02-02,70048,70060,Blue,1,67555,68184,629
2022-12-25,70053,70045,Blue,0,24943,25370,427
2022-11-09,70042,70046,Blue,1,51193,51367,174
2022-11-22,70044,70052,Blue,1,71242,71772,530
2022-06-09,70044,70050,Blue,1,55291,55686,395
2022-12-03,70040,70056,Blue,1,69138,69940,802
2022-02-20,70049,70039,Blue,0,59751,60283,532
2022-06-09,70048,70058,Blue,1,33501,34010,509
2022-08-01,70049,70045,Blue,0,32749,32960,211
2022-07-22,70038,70060,Blue,1,65935,67347,1412
2022-08-06,70043,70838,Blue,0,64764,64959,195
2022-08-28,70038,70056,Blue,1,89107,90071,964
2022-06-24,70049,70041,Blue,0,55074,55563,489
2022-01-05,70046,70060,Blue,1,73857,74547,690
2022-07-12,70040,70046,Blue,1,64297,64595,298
2022-07-07,70057,70045,Blue,0,62299,62927,628
2022-03-09,70057,70049,Blue,0,40497,40948,451
2022-06-03,70047,70039,Blue,0,75302,75721,419
2022-01-04,70049,70838,Blue,0,55555,56213,658
2022-04-14,70057,70043,Blue,0,81274,82081,807
2022-09-12,70059,70053,Blue,0,26357,26642,285
2022-10-04,70046,70060,Blue,1,63174,63934,760
2022-05-25,70043,70838,Blue,0,26712,26945,233
2022-08-20,70046,70054,Blue,1,51659,52092,433
2022-03-05,70058,70060,Blue,1,76051,76134,83
2022-01-24,70051,70838,Blue,0,62070,62819,749
2022-08-09,70059,70041,Blue,0,42250,43266,1016
2022-10-20,70053,70049,Blue,0,34589,34810,221
2022-08-09,70059,70041,Blue,0,41600,42613,1013
2022-01-05,70038,70050,Blue,1,42966,43469,503
2022-06-12,70038,70056,Blue,1,33132,33953,821
2022-02-19,70038,70050,Blue,1,75552,76112,560
2022-03-16,70056,70060,Blue,1,53494,53693,199
2022-05-19,70053,70039,Blue,0,21611,22551,940
2022-07-03,70040,70046,Blue,1,83056,83344,288
2022-02-28,70044,70050,Blue,1,42666,43044,378
2022-12-24,70043,70838,Blue,0,24723,24917,194
2022-01-08,70038,70052,Blue,1,38351,39148,797
2022-04-15,70049,70045,Blue,0,29079,29334,255
2022-06-25,70045,70838,Blue,0,83792,84185,393
2022-01-24,70051,70039,Blue,0,61760,62400,640
2022-02-21,70042,70060,Blue,1,53034,54001,967
2022-04-02,70040,70058,Blue,1,35664,36592,928
2022-05-19,70038,70046,Blue,1,71969,72333,364
2022-12-31,70057,70043,Blue,0,52553,53306,753
2022-10-25,70038,70046,Blue,1,52032,52340,308
2022-11-10,70057,70838,Blue,0,25501,26641,1140
2022-08-20,70050,70052,Blue,1,32436,32543,107
2022-01-12,70057,70051,Blue,0,63881,64110,229
2022-02-11,70038,70048,Blue,1,57512,58012,500
2022-01-07,70048,70050,Blue,1,71885,71941,56
2022-08-04,70055,70053,Blue,0,20616,20663,47
2022-06-19,70038,70056,Blue,1,79095,80047,952
2022-08-12,70059,70045,Blue,0,37642,38462,820
2022-09-12,70051,70047,Blue,0,83786,83974,188
2022-08-04,70059,70045,Blue,0,63437,64135,698
2022-10-28,70049,70838,Blue,0,62375,63017,642
2022-04-01,70042,70056,Blue,1,64835,65616,781
2022-03-22,70046,70052,Blue,1,60775,61105,330
2022-07-02,70046,70052,Blue,1,81791,82132,341
2022-08-09,70053,70045,Blue,0,45072,45517,445
2022-09-11,70049,70041,Blue,0,58667,59086,419
2022-05-19,70042,70054,Blue,1,76101,76871,770
2022-02-04,70043,70041,Blue,0,61118,61147,29
2022-10-18,70047,70039,Blue,0,70287,70709,422
2022-06-04,70047,70041,Blue,0,55634,56036,402
2022-07-07,70038,70054,Blue,1,26252,27115,863
2022-11-21,70043,70838,Blue,0,77919,78117,198
2022-02-16,70050,70054,Blue,1,22552,22748,196
2022-08-20,70051,70838,Blue,0,73346,74119,773
2022-08-06,70048,70056,Blue,1,30223,30606,383
2022-02-21,70044,70056,Blue,1,22581,23268,687
2022-04-07,70051,70049,Blue,0,59949,60052,103
2022-01-03,70044,70048,Blue,1,70716,70946,230
2022-07-04,70055,70039,Blue,0,28328,29194,866
2022-02-24,70042,70048,Blue,1,77563,77864,301
2022-03-31,70040,70048,Blue,1,54885,55311,426
2022-08-19,70046,70058,Blue,1,52551,53237,686
2022-02-12,70046,70056,Blue,1,46228,46728,500
2022-09-13,70057,70047,Blue,0,27291,27828,537
2022-11-27,70053,70838,Blue,0,67602,68358,756
2022-03-01,70057,70043,Blue,0,61984,62738,754
2022-07-27,70048,70050,Blue,1,34703,34766,63
2022-08-16,70059,70053,Blue,0,70215,70446,231
2022-06-06,70046,70048,Blue,1,58045,58142,97
2022-10-12,70045,70041,Blue,0,70928,71087,159
2022-03-29,70053,70049,Blue,0,28736,28944,208
2022-09-03,70046,70050,Blue,1,82555,82737,182
2022-08-18,70048,70058,Blue,1,25132,25704,572
2022-08-04,70049,70041,Blue,0,51484,51924,440
2022-11-28,70059,70838,Blue,0,75916,77060,1144
2022-09-30,70049,70041,Blue,0,31518,31982,464
2022-05-20,70039,70838,Blue,0,62929,62968,39
2022-04-10,70057,70051,Blue,0,37594,37851,257
2022-08-20,70043,70039,Blue,0,70091,70195,104
2022-04-30,70057,70051,Blue,0,45094,45341,247
2022-08-07,70041,70838,Blue,0,63317,63438,121
2022-11-05,70040,70058,Blue,1,49161,50544,1383
2022-07-06,70038,70050,Blue,1,46680,47308,628
2022-06-17,70057,70049,Blue,0,47203,47623,420
2022-02-06,70046,70052,Blue,1,61111,61472,361
2022-09-24,70059,70838,Blue,0,57329,58413,1084
2022-01-28,70040,70044,Blue,1,68645,68758,113
2022-06-14,70041,70838,Blue,0,56102,56212,110
2022-01-24,70049,70043,Blue,0,51437,51883,446
2022-01-25,70050,70054,Blue,1,25018,25239,221
2022-11-10,70051,70045,Blue,0,43941,44282,341
2022-07-11,70042,70048,Blue,1,65138,65480,342
2022-07-25,70046,70048,Blue,1,89446,89522,76
2022-01-05,70057,70053,Blue,0,73826,73971,145
2022-03-19,70044,70058,Blue,1,28777,29535,758
2022-03-18,70038,70040,Blue,1,86535,86551,16
2022-02-11,70045,70041,Blue,0,32881,33084,203
2022-10-04,70059,70055,Blue,0,43320,43465,145
2022-11-09,70048,70054,Blue,1,62554,62895,341
2022-02-14,70048,70056,Blue,1,33417,33781,364
2022-08-10,70058,70060,Blue,1,68573,68640,67
2022-06-17,70052,70058,Blue,1,83574,83834,260
2022-03-14,70042,70044,Blue,1,60604,60634,30
2022-09-23,70045,70043,Blue,0,28714,28833,119
2022-02-11,70038,70042,Blue,1,46420,46521,101
2022-09-25,70054,70060,Blue,1,82547,82825,278
2022-02-15,70059,70043,Blue,0,54818,55834,1016
2022-03-14,70055,70039,Blue,0,31647,32413,766
2022-04-03,70059,70043,Blue,0,84733,85682,949
2022-06-12,70046,70050,Blue,1,54148,54333,185
2022-05-13,70053,70047,Blue,0,52149,52676,527
2022-04-07,70059,70049,Blue,0,76038,76562,524
2022-09-12,70048,70050,Blue,1,74378,74449,71
2022-02-09,70038,70050,Blue,1,29969,30530,561
2022-12-01,70052,70056,Blue,1,49388,49526,138
2022-10-04,70038,70050,Blue,1,67940,68493,553
2022-04-22,70055,70039,Blue,0,52684,53545,861
2022-03-18,70042,70048,Blue,1,84406,84719,313
2022-04-12,70040,70060,Blue,1,70990,72013,1023
2022-06-17,70057,70045,Blue,0,36500,37194,694
2022-11-30,70048,70050,Blue,1,75819,75877,58
2022-04-01,70041,70039,Blue,0,19917,19951,34
2022-08-30,70038,70046,Blue,1,75816,76164,348
2022-11-27,70053,70043,Blue,0,62730,63420,690
2022-11-21,70043,70838,Blue,0,88999,89581,582
2022-01-04,70046,70058,Blue,1,71258,71824,566
2022-12-20,70045,70039,Blue,0,36757,37012,255
2022-10-12,70053,70047,Blue,0,47098,47394,296
2022-07-20,70044,70048,Blue,1,22406,22640,234
2022-08-19,70059,70047,Blue,0,33078,33667,589
2022-03-05,70049,70045,Blue,0,78322,78514,192
2022-10-01,70048,70054,Blue,1,32859,33143,284
2022-06-12,70040,70060,Blue,1,41706,42687,981
2022-01-23,70053,70041,Blue,0,75163,75812,649
2022-09-12,70044,70048,Blue,1,87551,87761,210
2022-04-21,70053,70051,Blue,0,64376,64441,65
2022-02-17,70042,70060,Blue,1,39351,40326,975
2022-07-13,70050,70058,Blue,1,61244,61657,413
2022-10-30,70053,70039,Blue,0,53052,53859,807
2022-12-21,70049,70041,Blue,0,60260,60678,418
2022-06-27,70049,70047,Blue,0,70413,70471,58
2022-08-01,70050,70054,Blue,1,66770,66975,205
2022-07-05,70044,70056,Blue,1,39120,39868,748
2022-07-08,70045,70043,Blue,0,49138,49252,114
2022-01-13,70038,70054,Blue,1,60427,61411,984
2022-11-30,70047,70041,Blue,0,25330,25675,345
2022-01-25,70058,70060,Blue,1,53942,54080,138
2022-06-25,70053,70041,Blue,0,60712,61429,717
2022-01-12,70040,70050,Blue,1,53104,53589,485
2022-09-14,70038,70050,Blue,1,27142,27725,583
2022-06-18,70051,70047,Blue,0,65825,66020,195
2022-10-18,70041,70838,Blue,0,43965,44084,119
2022-01-24,70044,70058,Blue,1,67864,68788,924
2022-05-06,70058,70060,Blue,1,55776,55835,59
2022-03-24,70053,70043,Blue,0,19147,19978,831
2022-09-11,70042,70044,Blue,1,63578,63609,31
2022-11-23,70053,70049,Blue,0,35511,35743,232
2022-07-10,70059,70043,Blue,0,65365,66247,882
2022-09-20,70042,70050,Blue,1,52572,53009,437
2022-04-03,70044,70056,Blue,1,58259,58924,665
2022-07-26,70053,70047,Blue,0,49831,50129,298
2022-08-01,70042,70048,Blue,1,32486,32780,294
2022-05-18,70046,70052,Blue,1,38016,38469,453
2022-03-09,70057,70045,Blue,0,25239,25932,693
2022-07-03,70059,70057,Blue,0,66815,66850,35
2022-01-11,70038,70056,Blue,1,64067,64911,844
2022-07-11,70045,70039,Blue,0,82197,82475,278
2022-01-22,70059,70045,Blue,0,45978,46684,706
2022-08-16,70052,70060,Blue,1,82060,82471,411
2022-12-22,70041,70039,Blue,0,56015,56049,34
2022-05-18,70038,70060,Blue,1,61049,62363,1314
2022-01-19,70053,70041,Blue,0,74004,74654,650
2022-06-12,70038,70054,Blue,1,89115,90015,900
2022-09-23,70046,70048,Blue,1,69332,69401,69
2022-04-24,70038,70040,Blue,1,49927,49943,16
2022-07-16,70059,70045,Blue,0,79096,79827,731
2022-08-17,70046,70048,Blue,1,57746,57833,87
2022-02-03,70048,70050,Blue,1,42875,42947,72
2022-02-03,70040,70042,Blue,1,47032,47065,33
2022-07-18,70047,70041,Blue,0,28273,28674,401
2022-02-14,70053,70838,Blue,0,41850,42665,815
2022-11-19,70055,70045,Blue,0,53722,54272,550
2022-01-18,70044,70046,Blue,1,35725,35948,223
2022-09-12,70040,70054,Blue,1,70101,70835,734
2022-02-15,70042,70056,Blue,1,36882,37596,714
2022-01-14,70039,70838,Blue,0,77837,77877,40
2022-04-21,70038,70052,Blue,1,70520,71232,712
2022-04-02,70059,70045,Blue,0,58936,59668,732
2022-11-13,70042,70048,Blue,1,46829,47128,299
2022-04-02,70042,70060,Blue,1,26402,27410,1008
2022-05-31,70048,70050,Blue,1,82223,82308,85
2022-11-10,70044,70060,Blue,1,79117,80046,929
2022-12-30,70045,70041,Blue,0,24854,25030,176
2022-03-19,70043,70041,Blue,0,89175,89202,27
2022-10-29,70038,70042,Blue,1,51775,51872,97
2022-07-04,70038,70044,Blue,1,21040,21224,184
2022-07-30,70051,70045,Blue,0,72244,72580,336
2022-01-12,70044,70050,Blue,1,61254,61608,354
2022-04-11,70043,70838,Blue,0,41572,41797,225
2022-08-08,70038,70052,Blue,1,38833,39557,724
2022-01-01,70047,70838,Blue,0,57732,58200,468
2022-04-10,70044,70056,Blue,1,23430,24181,751
2022-06-12,70052,70058,Blue,1,28421,28662,241
2022-07-06,70038,70042,Blue,1,80073,80172,99
2022-11-24,70045,70039,Blue,0,89049,89621,572
2022-03-16,70042,70048,Blue,1,85580,85876,296
2022-07-19,70059,70057,Blue,0,24708,24743,35
2022-08-10,70055,70049,Blue,0,52703,52985,282
2022-03-21,70050,70054,Blue,1,52539,52761,222
2022-07-23,70057,70047,Blue,0,30940,31451,511
2022-09-09,70047,70041,Blue,0,71985,72299,314
2022-04-14,70049,70039,Blue,0,49208,49737,529
2022-06-13,70049,70043,Blue,0,43719,44108,389
2022-07-20,70057,70055,Blue,0,33574,33643,69
2022-01-14,70048,70058,Blue,1,29803,30266,463
2022-03-20,70042,70044,Blue,1,65249,65276,27
2022-08-12,70059,70043,Blue,0,41623,42551,928
2022-02-27,70048,70056,Blue,1,58570,58956,386
2022-05-08,70058,70060,Blue,1,63791,63852,61
2022-06-21,70055,70045,Blue,0,57973,58492,519
2022-12-14,70042,70044,Blue,1,79147,79178,31
2022-08-26,70048,70060,Blue,1,58708,59344,636
2022-01-23,70046,70048,Blue,1,76780,76865,85
2022-08-22,70047,70043,Blue,0,52170,52404,234
2022-08-02,70053,70039,Blue,0,79605,80329,724
2022-01-05,70042,70056,Blue,1,56149,56881,732
2022-09-11,70042,70052,Blue,1,47358,47902,544
2022-04-08,70048,70054,Blue,1,75341,75645,304
2022-05-23,70042,70048,Blue,1,67725,68127,402
2022-02-02,70057,70047,Blue,0,79523,79965,442
2022-07-04,70048,70056,Blue,1,74107,74503,396
2022-01-05,70055,70838,Blue,0,70698,71515,817
2022-12-29,70042,70060,Blue,1,34114,35151,1037
2022-01-20,70057,70047,Blue,0,25539,26068,529
2022-09-02,70044,70060,Blue,1,52043,52934,891
2022-09-21,70045,70838,Blue,0,63983,64292,309
2022-12-31,70038,70060,Blue,1,64277,65485,1208
2022-12-23,70055,70043,Blue,0,19404,20160,756
2022-04-02,70052,70058,Blue,1,24413,24656,243
2022-02-02,70047,70039,Blue,0,21256,21732,476
2022-12-20,70042,70054,Blue,1,60145,60857,712
2022-02-11,70059,70049,Blue,0,65892,66385,493
2022-07-12,70038,70060,Blue,1,53936,55212,1276
2022-11-08,70054,70060,Blue,1,57453,57804,351
2022-11-04,70059,70838,Blue,0,60004,61122,1118
2022-01-13,70055,70047,Blue,0,63965,64340,375
2022-12-30,70041,70039,Blue,0,62721,62754,33
2022-03-28,70046,70050,Blue,1,25492,25663,171
2022-08-01,70038,70042,Blue,1,42973,43069,96
2022-02-11,70059,70039,Blue,0,69084,70125,1041
2022-05-03,70050,70058,Blue,1,38494,38986,492
2022-04-19,70042,70058,Blue,1,50460,51430,970
2022-09-18,70038,70042,Blue,1,87311,87403,92
2022-07-12,70047,70041,Blue,0,28213,28546,333
2022-04-30,70057,70049,Blue,0,28891,29286,395
2022-02-05,70059,70051,Blue,0,70806,71152,346
2022-01-16,70042,70056,Blue,1,51685,52509,824
2022-12-02,70049,70838,Blue,0,70711,71293,582
2022-12-12,70059,70053,Blue,0,44222,44454,232
2022-03-17,70040,70042,Blue,1,45841,45871,30
2022-06-15,70042,70046,Blue,1,78261,78444,183
2022-10-12,70040,70050,Blue,1,80642,81169,527
2022-05-19,70043,70039,Blue,0,29257,29365,108
2022-02-24,70059,70041,Blue,0,26955,27948,993
2022-08-31,70048,70058,Blue,1,84819,85374,555
2022-12-04,70055,70039,Blue,0,64298,65329,1031
2022-03-15,70049,70043,Blue,0,71033,71412,379
2022-02-16,70058,70060,Blue,1,46363,46444,81
2022-01-12,70055,70053,Blue,0,43618,43721,103
2022-01-01,70038,70050,Blue,1,68981,69596,615
2022-07-10,70038,70060,Blue,1,36255,37459,1204
2022-10-04,70046,70054,Blue,1,27901,28361,460
2022-09-28,70051,70039,Blue,0,86893,87560,667
2022-04-01,70057,70055,Blue,0,75682,75752,70
2022-07-21,70050,70052,Blue,1,35575,35700,125
2022-03-11,70038,70056,Blue,1,58844,59696,852
2022-07-11,70049,70045,Blue,0,61058,61259,201
2022-12-21,70050,70052,Blue,1,76381,76504,123
2022-04-16,70045,70043,Blue,0,53849,53954,105
2022-07-31,70057,70041,Blue,0,60393,61271,878
2022-11-01,70056,70058,Blue,1,39649,39732,83
2022-10-14,70049,70045,Blue,0,71185,71379,194
2022-02-10,70049,70045,Blue,0,45462,45640,178
2022-03-24,70038,70054,Blue,1,75195,76011,816
2022-08-30,70040,70046,Blue,1,67392,67652,260
2022-01-19,70040,70052,Blue,1,43152,43896,744
2022-06-25,70044,70046,Blue,1,31477,31597,120
2022-01-13,70047,70045,Blue,0,53907,54028,121
2022-01-31,70057,70045,Blue,0,65814,66485,671
2022-06-23,70038,70048,Blue,1,47244,47821,577
2022-02-04,70044,70058,Blue,1,82213,83017,804
2022-07-28,70055,70053,Blue,0,56639,56687,48
2022-05-21,70042,70048,Blue,1,64013,64376,363
2022-02-23,70040,70042,Blue,1,32407,32439,32
2022-11-18,70041,70838,Blue,0,60804,60929,125
2022-03-21,70039,70838,Blue,0,79927,79961,34
2022-07-03,70040,70052,Blue,1,27752,28419,667
2022-11-30,70044,70052,Blue,1,76446,76963,517
2022-07-11,70051,70041,Blue,0,54904,55512,608
2022-09-07,70059,70047,Blue,0,85748,86302,554
2022-11-22,70053,70043,Blue,0,43853,44474,621
2022-03-01,70046,70058,Blue,1,43312,43928,616
2022-07-07,70045,70043,Blue,0,63935,64054,119
2022-08-04,70051,70039,Blue,0,44579,45275,696
2022-02-18,70038,70058,Blue,1,71033,72062,1029
2022-09-07,70051,70047,Blue,0,76272,76464,192
2022-08-26,70048,70054,Blue,1,33875,34204,329
2022-07-23,70045,70039,Blue,0,64859,65140,281
2022-07-11,70052,70060,Blue,1,29324,29701,377
2022-12-29,70042,70050,Blue,1,64724,65146,422
2022-01-04,70051,70045,Blue,0,34554,34899,345
2022-04-20,70048,70054,Blue,1,29517,29820,303
2022-01-25,70050,70056,Blue,1,47534,47821,287
2022-06-17,70042,70060,Blue,1,76071,77228,1157
2022-01-25,70043,70039,Blue,0,65705,65829,124
2022-09-18,70043,70039,Blue,0,23248,23359,111
2022-04-22,70042,70056,Blue,1,23490,24265,775
2022-06-22,70041,70039,Blue,0,41034,41075,41
2022-07-12,70056,70058,Blue,1,38463,38599,136
2022-08-07,70058,70060,Blue,1,66079,66143,64
2022-03-23,70059,70047,Blue,0,30861,31473,612
2022-08-30,70038,70044,Blue,1,75816,76005,189
2022-04-22,70057,70043,Blue,0,21437,22360,923
2022-02-08,70049,70043,Blue,0,61271,61685,414
2022-04-20,70041,70039,Blue,0,34046,34081,35
2022-06-12,70053,70051,Blue,0,42547,42603,56
2022-02-16,70047,70838,Blue,0,43823,44318,495
2022-12-03,70046,70056,Blue,1,85051,85588,537
2022-06-25,70051,70043,Blue,0,47985,48529,544
2022-03-26,70052,70058,Blue,1,49918,50168,250
2022-06-22,70052,70058,Blue,1,33197,33468,271
2022-03-08,70049,70041,Blue,0,45485,45888,403
2022-07-16,70044,70060,Blue,1,72103,73028,925
2022-09-20,70049,70043,Blue,0,31958,32337,379
2022-01-29,70046,70060,Blue,1,32019,33233,1214
2022-02-14,70040,70050,Blue,1,48154,48635,481
2022-03-29,70053,70041,Blue,0,62868,63629,761
2022-11-18,70040,70050,Blue,1,53430,53940,510
2022-10-30,70057,70039,Blue,0,55528,56406,878
2022-08-23,70053,70045,Blue,0,22868,23571,703
2022-10-24,70058,70060,Blue,1,58195,58267,72
2022-06-22,70038,70044,Blue,1,38221,38405,184
2022-10-02,70057,70041,Blue,0,42208,43138,930
2022-09-29,70042,70044,Blue,1,63425,63464,39
2022-09-30,70058,70060,Blue,1,77601,77668,67
2022-01-05,70047,70041,Blue,0,25787,26182,395
2022-12-30,70055,70041,Blue,0,70923,71637,714
2022-07-06,70042,70060,Blue,1,68617,69710,1093
2022-12-27,70044,70050,Blue,1,24561,24886,325
2022-01-05,70057,70055,Blue,0,32953,33020,67
2022-05-17,70051,70047,Blue,0,50487,50699,212
2022-01-05,70040,70050,Blue,1,79319,79814,495
2022-04-20,70053,70043,Blue,0,22316,22976,660
2022-09-25,70057,70838,Blue,0,69032,70039,1007
2022-03-25,70047,70039,Blue,0,51877,52290,413
2022-07-30,70059,70047,Blue,0,45442,45984,542
2022-07-29,70053,70041,Blue,0,49178,49868,690
2022-10-27,70049,70039,Blue,0,56717,57282,565
2022-02-13,70042,70058,Blue,1,57110,57976,866
2022-07-11,70038,70044,Blue,1,61801,62021,220
2022-06-08,70038,70052,Blue,1,86406,87254,848
2022-04-14,70055,70045,Blue,0,68657,69220,563
2022-02-22,70042,70044,Blue,1,52922,52948,26
2022-09-28,70049,70047,Blue,0,43159,43218,59
2022-11-12,70046,70054,Blue,1,75372,75798,426
2022-01-15,70040,70056,Blue,1,33563,34389,826
2022-07-18,70052,70056,Blue,1,54884,55037,153
2022-03-05,70044,70056,Blue,1,39578,40192,614
2022-09-29,70049,70039,Blue,0,85507,86006,499
2022-07-29,70051,70838,Blue,0,21197,21958,761
2022-07-26,70055,70838,Blue,0,61098,61991,893
2022-09-22,70046,70054,Blue,1,23670,24118,448
2022-05-23,70047,70043,Blue,0,59955,60313,358
2022-11-07,70038,70058,Blue,1,74706,75659,953
2022-07-05,70059,70051,Blue,0,27917,28261,344
2022-02-15,70050,70056,Blue,1,75804,76077,273
2022-01-28,70051,70043,Blue,0,46536,47072,536
2022-07-30,70057,70043,Blue,0,58476,59242,766
2022-10-23,70057,70838,Blue,0,58773,59862,1089
2022-02-25,70054,70056,Blue,1,63846,63896,50
2022-09-20,70040,70042,Blue,1,80669,80699,30
2022-09-27,70054,70056,Blue,1,76075,76121,46
2022-04-14,70057,70039,Blue,0,28837,29953,1116
2022-01-03,70059,70043,Blue,0,29056,29954,898
2022-02-27,70047,70838,Blue,0,58797,59297,500
2022-03-31,70042,70046,Blue,1,67481,67671,190
2022-07-18,70042,70058,Blue,1,21920,22705,785
2022-02-25,70057,70049,Blue,0,23493,23893,400
2022-07-10,70059,70039,Blue,0,66795,67867,1072
2022-01-15,70049,70039,Blue,0,57841,59156,1315
2022-08-27,70038,70040,Blue,1,22334,22351,17
2022-06-26,70041,70838,Blue,0,44604,44728,124
2022-02-21,70052,70060,Blue,1,46661,47019,358
2022-12-17,70051,70838,Blue,0,32882,33601,719
2022-10-23,70054,70058,Blue,1,52968,53128,160
2022-03-27,70053,70045,Blue,0,80054,80497,443
2022-03-21,70057,70041,Blue,0,56368,57327,959
2022-08-15,70057,70838,Blue,0,74973,76039,1066
2022-03-31,70038,70056,Blue,1,84846,85791,945
2022-08-09,70044,70054,Blue,1,58995,59622,627
2022-07-24,70051,70045,Blue,0,56338,56678,340
2022-11-22,70040,70060,Blue,1,61933,62963,1030
2022-11-23,70059,70055,Blue,0,46287,46478,191
2022-02-07,70051,70045,Blue,0,23468,23839,371
2022-05-09,70054,70060,Blue,1,43086,43372,286
2022-11-16,70038,70058,Blue,1,49755,50787,1032
2022-02-22,70057,70045,Blue,0,23309,23944,635
2022-09-18,70041,70039,Blue,0,72059,72093,34
2022-03-21,70040,70056,Blue,1,69969,70762,793
2022-02-12,70051,70049,Blue,0,84370,84477,107
2022-09-25,70044,70060,Blue,1,84864,85841,977
2022-08-20,70052,70056,Blue,1,75781,75944,163
2022-02-22,70046,70058,Blue,1,41745,42409,664
2022-04-16,70059,70055,Blue,0,52461,52606,145
2022-04-09,70057,70045,Blue,0,78509,79147,638
2022-06-23,70040,70052,Blue,1,61430,62160,730
2022-01-09,70041,70838,Blue,0,41085,41208,123
2022-03-06,70040,70060,Blue,1,73223,74252,1029
2022-10-13,70057,70049,Blue,0,32749,33145,396
2022-02-13,70041,70838,Blue,0,45216,45351,135
2022-10-15,70053,70051,Blue,0,28947,28998,51
2022-04-07,70041,70039,Blue,0,70106,70139,33
2022-06-19,70044,70048,Blue,1,51778,52013,235
2022-07-27,70044,70050,Blue,1,30052,30404,352
2022-01-25,70053,70051,Blue,0,29689,29747,58
2022-04-18,70057,70051,Blue,0,35925,36192,267
2022-11-02,70045,70039,Blue,0,78870,79111,241
2022-02-07,70046,70060,Blue,1,37809,38621,812
2022-02-12,70051,70041,Blue,0,43113,43701,588
2022-07-30,70045,70838,Blue,0,57774,58157,383
2022-02-08,70046,70054,Blue,1,35839,36291,452
2022-11-14,70046,70054,Blue,1,71421,71867,446
2022-09-09,70057,70051,Blue,0,63166,63407,241
2022-12-15,70057,70045,Blue,0,32189,32882,693
2022-09-04,70044,70058,Blue,1,26143,26942,799
2022-07-11,70050,70052,Blue,1,48859,48990,131
2022-01-11,70059,70045,Blue,0,30258,31036,778
2022-08-13,70055,70053,Blue,0,33242,33293,51
2022-11-23,70044,70060,Blue,1,66107,66985,878
2022-12-03,70040,70042,Blue,1,83014,83047,33
2022-02-09,70041,70039,Blue,0,66724,66771,47
2022-04-23,70046,70052,Blue,1,56044,56438,394
2022-11-24,70038,70040,Blue,1,57487,57505,18
2022-09-09,70050,70052,Blue,1,28099,28216,117
2022-08-17,70057,70838,Blue,0,31364,32650,1286
2022-02-02,70043,70838,Blue,0,64676,64869,193
2022-07-21,70056,70058,Blue,1,35947,36022,75
2022-01-21,70042,70050,Blue,1,43212,43638,426
2022-08-09,70059,70041,Blue,0,36923,38043,1120
2022-01-27,70046,70056,Blue,1,86397,86915,518
2022-04-20,70040,70052,Blue,1,31506,32133,627
2022-02-25,70050,70054,Blue,1,41461,41821,360
2022-05-31,70041,70039,Blue,0,63571,63605,34
2022-03-25,70042,70044,Blue,1,55526,55558,32
2022-10-12,70046,70060,Blue,1,51319,52068,749
2022-10-13,70047,70039,Blue,0,72398,72792,394
2022-01-29,70050,70060,Blue,1,39414,40535,1121
2022-04-22,70044,70052,Blue,1,52156,52682,526
2022-03-02,70054,70058,Blue,1,30342,30502,160
2022-05-17,70052,70060,Blue,1,69476,69916,440
2022-02-05,70040,70048,Blue,1,50785,51167,382
2022-02-15,70055,70838,Blue,0,72248,73100,852
2022-09-23,70057,70051,Blue,0,27701,27969,268
2022-03-28,70044,70048,Blue,1,56474,56727,253
2022-12-13,70040,70056,Blue,1,26577,27443,866
2022-12-22,70054,70056,Blue,1,57095,57142,47
2022-11-10,70040,70052,Blue,1,71729,72404,675
2022-04-05,70059,70051,Blue,0,62294,62642,348
2022-01-24,70059,70045,Blue,0,20599,21411,812
2022-07-12,70045,70039,Blue,0,53807,54116,309
2022-09-25,70055,70051,Blue,0,45905,46057,152
2022-01-07,70051,70043,Blue,0,55527,56025,498
2022-10-18,70048,70050,Blue,1,74711,74767,56
2022-12-14,70049,70838,Blue,0,40510,41091,581
2022-01-10,70049,70041,Blue,0,80569,80994,425
2022-03-21,70056,70058,Blue,1,66783,66860,77
2022-03-28,70055,70043,Blue,0,54086,54796,710
2022-08-25,70055,70051,Blue,0,63878,64020,142
2022-10-25,70046,70050,Blue,1,27426,27614,188
2022-01-11,70057,70039,Blue,0,21062,22112,1050
2022-12-27,70047,70043,Blue,0,76845,77077,232
2022-12-29,70040,70050,Blue,1,46350,46840,490
2022-11-25,70047,70041,Blue,0,63032,63370,338
2022-12-22,70044,70056,Blue,1,61666,62337,671
2022-12-21,70042,70044,Blue,1,78457,78491,34
2022-07-31,70040,70050,Blue,1,72677,73191,514
2022-03-24,70042,70060,Blue,1,35529,36639,1110
2022-01-26,70051,70039,Blue,0,67617,68258,641
2022-12-20,70048,70056,Blue,1,58611,59171,560
2022-08-30,70059,70838,Blue,0,29322,30528,1206
2022-03-09,70048,70052,Blue,1,29558,29771,213
2022-11-13,70051,70043,Blue,0,39198,39699,501
2022-07-02,70056,70060,Blue,1,49543,49721,178
2022-10-12,70040,70048,Blue,1,75420,75815,395
2022-04-14,70059,70055,Blue,0,58089,58230,141
2022-09-22,70038,70058,Blue,1,74209,75248,1039
2022-03-04,70051,70838,Blue,0,64476,65204,728
2022-11-23,70044,70048,Blue,1,56569,56810,241
2022-08-11,70047,70041,Blue,0,39228,39563,335
2022-01-27,70044,70060,Blue,1,80531,81485,954
2022-02-17,70040,70046,Blue,1,58168,58418,250
2022-01-06,70059,70041,Blue,0,56899,57834,935
2022-11-09,70054,70058,Blue,1,28233,28392,159
2022-07-12,70050,70054,Blue,1,34827,35042,215
2022-03-15,70044,70060,Blue,1,43708,44664,956
2022-04-01,70047,70043,Blue,0,78943,79183,240
2022-08-13,70044,70056,Blue,1,77942,78795,853
2022-11-16,70042,70058,Blue,1,42565,43431,866
2022-07-03,70042,70048,Blue,1,70060,70459,399
2022-03-24,70042,70048,Blue,1,35889,36229,340
2022-02-12,70048,70052,Blue,1,78655,78873,218
2022-02-09,70040,70044,Blue,1,25810,25912,102
2022-03-27,70052,70054,Blue,1,37016,37066,50
2022-06-27,70054,70056,Blue,1,37593,37687,94
2022-04-22,70055,70051,Blue,0,59199,59341,142
2022-08-24,70047,70045,Blue,0,80858,80951,93
2022-07-23,70059,70053,Blue,0,34637,34867,230
2022-07-30,70045,70041,Blue,0,42955,43154,199
2022-01-22,70055,70049,Blue,0,40745,41027,282
2022-06-19,70055,70043,Blue,0,38374,39079,705
2022-01-08,70038,70058,Blue,1,41045,42063,1018
2022-11-11,70050,70052,Blue,1,86614,86730,116
2022-11-14,70041,70039,Blue,0,33181,33213,32
2022-05-04,70050,70052,Blue,1,32949,33054,105
2022-12-26,70057,70047,Blue,0,66334,66812,478
2022-06-29,70055,70051,Blue,0,62501,62641,140
2022-03-29,70050,70054,Blue,1,25730,25927,197
2022-02-05,70049,70838,Blue,0,72973,73544,571
2022-05-21,70042,70048,Blue,1,76541,76937,396
2022-03-11,70048,70050,Blue,1,69075,69133,58
2022-08-15,70048,70050,Blue,1,29546,29600,54
2022-07-12,70058,70060,Blue,1,63348,63451,103
2022-10-05,70059,70053,Blue,0,20835,21061,226
2022-12-17,70038,70042,Blue,1,48026,48123,97
2022-12-22,70051,70043,Blue,0,51968,52435,467
2022-11-03,70042,70054,Blue,1,44359,45017,658
2022-09-15,70057,70051,Blue,0,60387,60629,242
2022-07-12,70045,70039,Blue,0,80180,80433,253
2022-04-21,70046,70048,Blue,1,64525,64615,90
2022-06-25,70053,70051,Blue,0,74083,74140,57
2022-03-22,70059,70039,Blue,0,65294,66331,1037
2022-02-27,70048,70060,Blue,1,65594,66213,619
2022-05-13,70056,70058,Blue,1,34865,34946,81
2022-12-29,70054,70056,Blue,1,68882,68929,47
2022-08-31,70059,70047,Blue,0,47834,48423,589
2022-08-05,70045,70838,Blue,0,27751,28216,465
2022-12-20,70044,70052,Blue,1,54202,54692,490
2022-12-10,70040,70060,Blue,1,26358,27951,1593
2022-12-08,70046,70054,Blue,1,63358,63803,445
2022-08-19,70038,70044,Blue,1,41292,41494,202
2022-11-01,70053,70047,Blue,0,35179,35512,333
2022-03-30,70055,70039,Blue,0,28647,29523,876
2022-02-17,70048,70052,Blue,1,52923,53164,241
2022-01-19,70047,70043,Blue,0,56594,56846,252
2022-12-16,70044,70056,Blue,1,60373,61048,675
2022-11-10,70046,70054,Blue,1,56044,56483,439
2022-08-03,70045,70041,Blue,0,54841,55030,189
2022-03-30,70048,70058,Blue,1,23578,24146,568
2022-05-19,70055,70043,Blue,0,38294,39126,832
2022-09-16,70059,70039,Blue,0,81194,82281,1087
2022-08-08,70047,70043,Blue,0,43632,43890,258
2022-10-07,70047,70045,Blue,0,24477,24568,91
2022-01-13,70055,70838,Blue,0,57669,58598,929
2022-07-19,70040,70058,Blue,1,88270,89139,869
2022-04-12,70053,70039,Blue,0,68728,69409,681
2022-06-24,70047,70838,Blue,0,53130,53772,642
2022-10-03,70038,70050,Blue,1,88255,88793,538
2022-10-24,70057,70051,Blue,0,78574,78822,248
2022-06-27,70047,70045,Blue,0,46485,46593,108
2022-03-28,70046,70058,Blue,1,39471,40191,720
2022-12-07,70042,70046,Blue,1,25349,25514,165
2022-10-06,70038,70052,Blue,1,38440,39299,859
2022-07-08,70045,70838,Blue,0,71449,71841,392
2022-03-28,70057,70051,Blue,0,78976,79209,233
2022-06-11,70047,70045,Blue,0,73092,73186,94
2022-04-09,70045,70039,Blue,0,53734,54024,290
2022-07-09,70038,70060,Blue,1,49104,50269,1165
2022-11-28,70042,70050,Blue,1,89246,89617,371
2022-01-12,70042,70060,Blue,1,49362,50319,957
2022-04-08,70055,70053,Blue,0,64867,64912,45
2022-08-31,70040,70042,Blue,1,24121,24151,30
2022-12-02,70053,70043,Blue,0,59587,60184,597
2022-07-22,70048,70050,Blue,1,74158,74217,59
2022-02-25,70046,70058,Blue,1,33051,35727,2676
2022-07-09,70049,70041,Blue,0,73452,73915,463
2022-11-07,70040,70060,Blue,1,25575,26941,1366
2022-08-22,70040,70056,Blue,1,24605,25471,866
2022-02-15,70042,70048,Blue,1,64219,64582,363
2022-12-10,70043,70041,Blue,0,40436,40468,32
2022-08-01,70045,70043,Blue,0,65447,65559,112
2022-10-09,70047,70041,Blue,0,49561,49906,345
2022-12-18,70038,70042,Blue,1,63425,63525,100
2022-12-26,70044,70060,Blue,1,88443,89348,905
2022-10-07,70046,70060,Blue,1,26315,27070,755
2022-02-10,70055,70049,Blue,0,86475,86772,297
2022-02-13,70041,70838,Blue,0,46423,46565,142
2022-12-23,70047,70043,Blue,0,39108,39354,246
2022-03-19,70051,70041,Blue,0,47428,48008,580
2022-06-12,70044,70056,Blue,1,24791,25498,707
2022-05-25,70045,70838,Blue,0,82594,82945,351
2022-05-18,70042,70054,Blue,1,66807,67644,837
2022-01-04,70046,70050,Blue,1,28867,29046,179
2022-09-07,70038,70058,Blue,1,26128,27119,991
2022-11-26,70050,70058,Blue,1,42620,43017,397
2022-05-27,70044,70050,Blue,1,38826,39216,390
2022-02-23,70049,70045,Blue,0,63688,63873,185
2022-10-06,70053,70838,Blue,0,70487,71334,847
2022-10-28,70054,70060,Blue,1,73547,73819,272
2022-08-07,70053,70041,Blue,0,58988,59662,674
2022-11-30,70057,70838,Blue,0,38185,39276,1091
2022-12-31,70049,70047,Blue,0,78570,78629,59
2022-08-30,70059,70053,Blue,0,41055,41349,294
2022-07-02,70042,70060,Blue,1,56844,57821,977
2022-12-21,70046,70060,Blue,1,56448,57229,781
2022-08-16,70040,70052,Blue,1,26550,27214,664
2022-04-30,70059,70049,Blue,0,61817,62265,448
2022-12-23,70057,70049,Blue,0,31817,32338,521
2022-08-19,70038,70046,Blue,1,53896,54272,376
2022-03-28,70042,70060,Blue,1,25284,26282,998
2022-10-24,70051,70043,Blue,0,56029,56513,484
2022-09-15,70038,70050,Blue,1,84907,85528,621
2022-12-29,70055,70049,Blue,0,31959,32244,285
2022-12-21,70059,70049,Blue,0,33536,33993,457
2022-10-01,70059,70053,Blue,0,28694,28911,217
2022-11-09,70044,70060,Blue,1,25780,26691,911
2022-08-20,70048,70058,Blue,1,38852,39345,493
2022-11-28,70050,70056,Blue,1,30214,30515,301
2022-11-01,70046,70060,Blue,1,45935,46678,743
2022-02-18,70041,70838,Blue,0,58724,58844,120
2022-06-19,70055,70051,Blue,0,37712,37853,141
2022-04-07,70050,70060,Blue,1,74621,75222,601
2022-08-23,70040,70046,Blue,1,61792,62104,312
2022-07-26,70044,70048,Blue,1,64376,64639,263
2022-10-02,70047,70045,Blue,0,45776,45883,107
2022-10-16,70057,70051,Blue,0,32489,32713,224
2022-06-27,70057,70047,Blue,0,32124,32739,615
2022-07-12,70047,70039,Blue,0,27584,28091,507
2022-11-21,70059,70049,Blue,0,30027,30529,502
2022-02-26,70053,70045,Blue,0,43013,43417,404
2022-07-08,70052,70060,Blue,1,51967,52356,389
2022-11-21,70047,70838,Blue,0,35691,36203,512
2022-01-31,70053,70043,Blue,0,57767,58373,606
2022-10-17,70038,70058,Blue,1,46825,47790,965
2022-03-05,70043,70041,Blue,0,51777,51807,30
2022-01-18,70054,70056,Blue,1,26408,26456,48
2022-06-09,70043,70041,Blue,0,52783,52813,30
2022-08-24,70044,70052,Blue,1,25100,25586,486
2022-09-12,70054,70058,Blue,1,29128,29281,153
2022-06-24,70057,70049,Blue,0,73321,73697,376
2022-04-11,70038,70044,Blue,1,62827,63024,197
2022-02-03,70042,70050,Blue,1,62746,63280,534
2022-04-15,70053,70838,Blue,0,29035,29971,936
2022-03-06,70038,70040,Blue,1,75306,75322,16
2022-03-13,70044,70054,Blue,1,51746,52316,570
2022-01-13,70038,70054,Blue,1,54608,55492,884
2022-06-04,70049,70838,Blue,0,27951,28605,654
2022-11-17,70049,70047,Blue,0,69665,69719,54
2022-11-10,70057,70041,Blue,0,23793,24665,872
2022-08-19,70057,70053,Blue,0,51687,51839,152
2022-03-10,70053,70051,Blue,0,26384,26449,65
2022-07-25,70045,70043,Blue,0,30121,30220,99
2022-03-30,70052,70058,Blue,1,87291,87543,252
2022-03-06,70057,70838,Blue,0,74428,75388,960
2022-01-27,70039,70838,Blue,0,33376,33416,40
2022-10-08,70059,70047,Blue,0,30321,30901,580
2022-11-04,70050,70060,Blue,1,53218,53785,567
2022-01-25,70055,70838,Blue,0,55256,56276,1020
2022-06-22,70046,70054,Blue,1,63901,64395,494
2022-03-31,70057,70055,Blue,0,33653,33722,69
2022-07-02,70042,70054,Blue,1,47468,48181,713
2022-06-10,70051,70039,Blue,0,24064,24809,745
2022-10-25,70040,70056,Blue,1,43121,44055,934
2022-03-28,70039,70838,Blue,0,46607,46636,29
2022-11-18,70045,70838,Blue,0,87302,87632,330
2022-06-15,70040,70054,Blue,1,62629,63457,828
2022-09-02,70057,70049,Blue,0,71006,71400,394
2022-09-11,70045,70043,Blue,0,68590,68677,87
2022-09-20,70057,70039,Blue,0,69204,70125,921
2022-04-07,70046,70052,Blue,1,62923,63270,347
2022-11-08,70038,70056,Blue,1,43593,44563,970
2022-03-10,70038,70050,Blue,1,45489,46036,547
2022-06-16,70052,70058,Blue,1,25158,25425,267
2022-06-17,70040,70042,Blue,1,42750,42782,32
2022-04-14,70052,70058,Blue,1,62748,63009,261
2022-03-07,70042,70060,Blue,1,56416,57570,1154
2022-01-24,70046,70054,Blue,1,30728,31201,473
2022-01-24,70048,70060,Blue,1,32831,33778,947
2022-02-27,70040,70054,Blue,1,76463,77240,777
2022-06-24,70046,70054,Blue,1,22923,23385,462
2022-07-08,70051,70049,Blue,0,70394,70497,103
2022-01-31,70047,70838,Blue,0,66363,66934,571
2022-12-12,70057,70045,Blue,0,46896,47546,650
2022-08-17,70059,70057,Blue,0,70214,70250,36
2022-03-09,70059,70057,Blue,0,60194,60233,39
2022-09-17,70055,70051,Blue,0,41818,41964,146
2022-02-03,70057,70049,Blue,0,80710,81303,593
2022-08-28,70051,70043,Blue,0,77390,77856,466
2022-06-10,70048,70050,Blue,1,44150,44211,61
2022-03-06,70049,70041,Blue,0,82107,82516,409
2022-11-27,70038,70040,Blue,1,36257,36270,13
2022-11-24,70055,70047,Blue,0,44418,44797,379
2022-11-28,70050,70054,Blue,1,86247,86444,197
2022-10-01,70049,70047,Blue,0,42209,42275,66
2022-08-07,70042,70060,Blue,1,57140,58097,957
2022-09-17,70051,70039,Blue,0,36078,36731,653
2022-02-20,70049,70043,Blue,0,85094,85472,378
2022-12-18,70040,70048,Blue,1,43698,44067,369
2022-07-10,70040,70060,Blue,1,39869,40992,1123
2022-07-20,70047,70043,Blue,0,53270,53542,272
2022-12-10,70048,70056,Blue,1,46302,46669,367
2022-03-18,70046,70054,Blue,1,49047,49492,445
2022-09-30,70040,70048,Blue,1,62368,62840,472
2022-01-17,70043,70041,Blue,0,30215,30244,29
2022-08-08,70038,70048,Blue,1,48673,49127,454
2022-07-22,70053,70049,Blue,0,36205,36412,207
2022-12-28,70045,70838,Blue,0,22943,23298,355
2022-10-16,70057,70049,Blue,0,23926,24383,457
2022-10-08,70059,70045,Blue,0,84871,85534,663
2022-02-15,70048,70054,Blue,1,39758,40085,327
2022-01-14,70044,70056,Blue,1,70111,70805,694
2022-12-07,70051,70039,Blue,0,66465,67043,578
2022-11-10,70051,70049,Blue,0,80844,80947,103
2022-04-20,70043,70041,Blue,0,24853,24883,30
2022-02-24,70040,70050,Blue,1,53305,54007,702
2022-05-19,70046,70048,Blue,1,47418,47536,118
2022-08-27,70040,70048,Blue,1,45926,46331,405
2022-09-17,70045,70043,Blue,0,63048,63144,96
2022-10-25,70044,70050,Blue,1,68728,69067,339
2022-12-01,70051,70041,Blue,0,22289,22923,634
2022-07-09,70057,70039,Blue,0,54706,55778,1072
2022-12-02,70038,70060,Blue,1,50507,51661,1154
2022-09-04,70047,70043,Blue,0,38201,38487,286
2022-09-08,70050,70060,Blue,1,46411,46943,532
2022-09-07,70039,70838,Blue,0,69157,69189,32
2022-08-31,70051,70045,Blue,0,86877,87207,330
2022-07-10,70057,70039,Blue,0,52442,53413,971
2022-04-17,70046,70052,Blue,1,58461,58831,370
2022-04-04,70059,70838,Blue,0,28772,30002,1230
2022-10-18,70050,70056,Blue,1,21825,22142,317
2022-11-22,70048,70060,Blue,1,49211,49835,624
2022-05-18,70038,70050,Blue,1,30286,30959,673
2022-01-07,70055,70043,Blue,0,30759,31522,763
2022-06-12,70052,70058,Blue,1,56712,56957,245
2022-10-16,70045,70041,Blue,0,51366,51562,196
2022-07-05,70056,70058,Blue,1,30288,30371,83
2022-11-19,70047,70043,Blue,0,21460,21722,262
2022-08-26,70038,70056,Blue,1,56488,57417,929
2022-01-24,70051,70049,Blue,0,25541,25647,106
2022-12-13,70049,70838,Blue,0,70166,70711,545
2022-12-12,70044,70058,Blue,1,71251,72104,853
2022-07-06,70057,70047,Blue,0,38692,39257,565
2022-06-25,70055,70838,Blue,0,29448,30425,977
2022-09-30,70049,70043,Blue,0,39004,39380,376
2022-06-18,70057,70041,Blue,0,35803,36757,954
2022-12-12,70049,70043,Blue,0,87844,88183,339
2022-02-23,70050,70052,Blue,1,53824,53936,112
2022-07-22,70055,70051,Blue,0,68028,68176,148
2022-02-24,70057,70045,Blue,0,44443,45147,704
2022-06-19,70059,70055,Blue,0,68656,68786,130
2022-07-25,70053,70041,Blue,0,51991,52650,659
2022-08-06,70053,70045,Blue,0,59781,60242,461
2022-11-08,70046,70048,Blue,1,75556,75640,84
2022-09-22,70053,70043,Blue,0,24526,25266,740
2022-11-23,70051,70045,Blue,0,63856,64188,332
2022-05-04,70057,70049,Blue,0,84690,85050,360
2022-01-21,70053,70047,Blue,0,63245,63532,287
2022-09-23,70052,70058,Blue,1,84276,84529,253
2022-02-25,70053,70043,Blue,0,62926,63552,626
2022-11-25,70051,70039,Blue,0,37319,37973,654
2022-02-22,70040,70050,Blue,1,53108,53569,461
2022-03-03,70047,70041,Blue,0,77770,78095,325
2022-07-31,70051,70039,Blue,0,84952,85565,613
2022-12-11,70051,70039,Blue,0,35147,35770,623
2022-08-05,70047,70043,Blue,0,28619,28856,237
2022-12-01,70040,70050,Blue,1,23748,24250,502
2022-09-22,70038,70040,Blue,1,80121,80139,18
2022-12-06,70059,70838,Blue,0,45260,46444,1184
2022-04-21,70051,70838,Blue,0,66297,67105,808
2022-07-07,70038,70044,Blue,1,52768,52953,185
2022-02-09,70050,70054,Blue,1,76892,77104,212
2022-11-02,70057,70043,Blue,0,34960,35863,903
2022-03-30,70046,70054,Blue,1,28836,29303,467
2022-11-04,70040,70046,Blue,1,46471,46851,380
2022-01-31,70057,70051,Blue,0,59069,59356,287
2022-12-28,70038,70058,Blue,1,64761,65754,993
2022-06-21,70050,70052,Blue,1,68428,68546,118
2022-07-19,70055,70045,Blue,0,53256,53799,543
2022-02-17,70057,70051,Blue,0,23963,24210,247
2022-03-27,70057,70053,Blue,0,62009,62161,152
2022-07-18,70053,70047,Blue,0,32916,33236,320
2022-10-09,70044,70046,Blue,1,43162,43262,100
2022-07-27,70053,70039,Blue,0,60070,60795,725
2022-04-18,70059,70057,Blue,0,62418,62454,36
2022-11-22,70053,70047,Blue,0,54345,54645,300
2022-04-15,70040,70044,Blue,1,38802,38932,130
2022-08-27,70044,70054,Blue,1,36346,36940,594
2022-01-04,70048,70060,Blue,1,63018,63737,719
2022-06-22,70044,70050,Blue,1,30881,31227,346
2022-08-05,70045,70043,Blue,0,22650,22754,104
2022-05-20,70040,70044,Blue,1,70714,70833,119
2022-06-10,70054,70058,Blue,1,74907,75057,150
2022-04-20,70059,70045,Blue,0,51193,51973,780
2022-07-09,70048,70052,Blue,1,77176,77390,214
2022-01-12,70050,70058,Blue,1,54288,54700,412
2022-03-18,70046,70058,Blue,1,65011,65657,646
2022-08-29,70052,70054,Blue,1,81940,81998,58
2022-01-20,70059,70039,Blue,0,22054,23264,1210
2022-01-01,70047,70041,Blue,0,55554,55903,349
2022-07-11,70059,70055,Blue,0,24009,24161,152
2022-02-16,70053,70045,Blue,0,58381,58891,510
2022-07-04,70059,70047,Blue,0,60495,61040,545
2022-08-02,70057,70055,Blue,0,60934,61002,68
2022-03-24,70059,70051,Blue,0,79459,79853,394
2022-08-24,70042,70056,Blue,1,58445,59258,813
2022-02-12,70038,70040,Blue,1,53414,53437,23
2022-03-02,70053,70043,Blue,0,62278,62883,605
2022-08-15,70055,70039,Blue,0,48660,49545,885
2022-09-26,70047,70045,Blue,0,21056,21153,97
2022-02-23,70046,70050,Blue,1,75678,75882,204
2022-11-04,70055,70053,Blue,0,23042,23111,69
2022-08-27,70043,70039,Blue,0,30665,30768,103
2022-08-04,70052,70060,Blue,1,77519,77898,379
2022-08-29,70049,70043,Blue,0,28182,28575,393
2022-08-10,70057,70055,Blue,0,44412,44479,67
2022-04-27,70055,70053,Blue,0,68775,68821,46
2022-03-21,70057,70039,Blue,0,28859,29865,1006
2022-10-13,70055,70043,Blue,0,20391,21206,815
2022-09-14,70040,70052,Blue,1,52396,53030,634
2022-02-27,70038,70048,Blue,1,33915,34382,467
2022-06-16,70040,70056,Blue,1,82725,83617,892
2022-11-10,70042,70046,Blue,1,59249,59423,174
2022-04-23,70050,70054,Blue,1,41038,41220,182
2022-09-28,70053,70049,Blue,0,42453,42695,242
2022-07-27,70048,70052,Blue,1,31425,31689,264
2022-09-20,70042,70058,Blue,1,75542,76425,883
2022-08-08,70045,70838,Blue,0,28047,28443,396
2022-07-07,70038,70056,Blue,1,24025,24978,953
2022-10-31,70046,70052,Blue,1,27510,27817,307
2022-10-19,70042,70052,Blue,1,34674,35200,526
2022-03-21,70059,70041,Blue,0,28163,29125,962
2022-07-29,70052,70058,Blue,1,89227,89503,276
2022-07-26,70045,70838,Blue,0,65819,66222,403
2022-10-09,70050,70056,Blue,1,46228,46574,346
2022-10-06,70042,70050,Blue,1,84608,85024,416
2022-06-29,70057,70043,Blue,0,55318,56140,822
2022-04-08,70049,70047,Blue,0,28353,28407,54
2022-04-12,70040,70054,Blue,1,69488,70400,912
2022-09-21,70053,70039,Blue,0,86818,87553,735
2022-02-09,70042,70052,Blue,1,33393,33934,541
2022-01-05,70043,70838,Blue,0,86548,86718,170
2022-12-28,70049,70039,Blue,0,63869,64361,492
2022-01-19,70059,70043,Blue,0,26663,27648,985
2022-08-12,70057,70041,Blue,0,68310,69182,872
2022-11-15,70041,70838,Blue,0,53091,53212,121
2022-10-23,70052,70060,Blue,1,33869,34195,326
2022-06-11,70044,70058,Blue,1,24536,25359,823
2022-03-04,70053,70041,Blue,0,86027,86654,627
2022-04-01,70049,70045,Blue,0,80524,80702,178
2022-10-18,70050,70052,Blue,1,37051,37167,116
2022-04-13,70051,70045,Blue,0,65352,65668,316
2022-05-17,70055,70047,Blue,0,29101,29499,398
2022-06-02,70044,70048,Blue,1,59158,59470,312
2022-12-18,70057,70041,Blue,0,87415,88259,844
2022-12-16,70053,70051,Blue,0,30058,30114,56
2022-04-27,70055,70053,Blue,0,79466,79511,45
2022-09-19,70048,70056,Blue,1,56462,56835,373
2022-09-24,70038,70050,Blue,1,50712,51304,592
2022-10-09,70051,70047,Blue,0,57415,57611,196
2022-07-25,70057,70055,Blue,0,65742,65811,69
2022-07-01,70057,70053,Blue,0,28123,28289,166
2022-06-09,70048,70054,Blue,1,27290,27673,383
2022-09-16,70040,70054,Blue,1,45623,46311,688
2022-08-20,70044,70050,Blue,1,40795,41151,356
2022-03-10,70038,70058,Blue,1,36727,37669,942
2022-09-01,70059,70838,Blue,0,66012,67166,1154
2022-07-09,70049,70838,Blue,0,74067,74686,619
2022-12-20,70055,70838,Blue,0,28296,29244,948
2022-03-01,70038,70048,Blue,1,76989,77501,512
2022-06-23,70053,70045,Blue,0,26192,26649,457
2022-12-27,70038,70048,Blue,1,87733,88168,435
2022-07-01,70049,70043,Blue,0,77034,77430,396
2022-10-11,70052,70058,Blue,1,84074,84324,250
2022-07-10,70045,70043,Blue,0,77794,77930,136
2022-04-06,70056,70060,Blue,1,55810,56131,321
2022-09-26,70046,70056,Blue,1,28964,29464,500
2022-03-31,70044,70048,Blue,1,85656,85916,260
2022-10-31,70052,70058,Blue,1,28191,28439,248
2022-09-27,70043,70041,Blue,0,31485,31513,28
2022-03-16,70047,70041,Blue,0,25761,26112,351
2022-07-27,70038,70044,Blue,1,44358,44607,249
2022-04-27,70054,70060,Blue,1,51848,52105,257
2022-11-07,70059,70053,Blue,0,59813,60208,395
2022-02-11,70057,70053,Blue,0,42148,42294,146
2022-04-15,70046,70052,Blue,1,34671,35047,376
2022-08-13,70059,70053,Blue,0,52474,52730,256
2022-02-10,70057,70039,Blue,0,57278,58300,1022
2022-06-09,70042,70058,Blue,1,20554,21575,1021
2022-01-27,70042,70050,Blue,1,78223,78775,552
2022-08-31,70045,70041,Blue,0,29190,29371,181
2022-02-05,70053,70051,Blue,0,60849,60907,58
2022-07-22,70052,70058,Blue,1,70787,71031,244
2022-06-14,70053,70043,Blue,0,23417,24089,672
2022-08-17,70043,70838,Blue,0,40600,40974,374
2022-08-12,70057,70041,Blue,0,51586,52459,873
2022-03-30,70051,70047,Blue,0,62978,63192,214
2022-02-25,70045,70039,Blue,0,52332,52581,249
2022-12-03,70051,70041,Blue,0,22115,22714,599
2022-11-03,70040,70044,Blue,1,34554,34670,116
2022-06-21,70042,70048,Blue,1,29541,29933,392
2022-02-25,70038,70042,Blue,1,86124,86229,105
2022-01-27,70053,70051,Blue,0,66199,66254,55
2022-07-31,70040,70058,Blue,1,61893,63072,1179
2022-04-08,70043,70039,Blue,0,31819,31944,125
2022-07-05,70041,70039,Blue,0,21802,21837,35
2022-09-15,70045,70039,Blue,0,64959,65261,302
2022-03-28,70055,70043,Blue,0,61901,62568,667
2022-04-13,70044,70056,Blue,1,57690,58386,696
2022-02-10,70051,70043,Blue,0,28224,28710,486
2022-08-23,70048,70050,Blue,1,55749,55818,69
2022-10-06,70043,70041,Blue,0,51380,51410,30
2022-01-03,70048,70056,Blue,1,80828,81234,406
2022-12-23,70057,70053,Blue,0,73316,73494,178
2022-02-15,70049,70041,Blue,0,38146,38706,560
2022-06-29,70046,70058,Blue,1,76143,76806,663
2022-05-16,70057,70055,Blue,0,76911,76987,76
2022-02-24,70038,70048,Blue,1,72974,73467,493
2022-10-06,70043,70039,Blue,0,31521,31650,129
2022-06-27,70053,70838,Blue,0,67081,68206,1125
2022-12-05,70048,70058,Blue,1,46666,47182,516
2022-03-07,70038,70060,Blue,1,29058,30171,1113
2022-10-16,70042,70044,Blue,1,65220,65253,33
2022-03-09,70056,70060,Blue,1,36742,36948,206
2022-09-29,70051,70043,Blue,0,31479,32048,569
2022-10-13,70038,70052,Blue,1,60406,61184,778
2022-07-25,70057,70045,Blue,0,41527,42123,596
2022-03-03,70049,70045,Blue,0,54961,55144,183
2022-12-15,70042,70060,Blue,1,78553,79521,968
2022-10-18,70046,70054,Blue,1,78676,79110,434
2022-07-24,70057,70041,Blue,0,52850,53680,830
2022-07-14,70044,70046,Blue,1,28078,28222,144
2022-09-16,70046,70050,Blue,1,62794,63006,212
2022-01-12,70051,70041,Blue,0,31545,32245,700
2022-09-03,70038,70050,Blue,1,21808,22377,569
2022-11-11,70056,70060,Blue,1,56915,57142,227
2022-11-29,70051,70047,Blue,0,77730,77923,193
2022-02-15,70042,70048,Blue,1,27388,27714,326
2022-12-24,70038,70060,Blue,1,33429,34506,1077
2022-01-10,70042,70058,Blue,1,66305,67206,901
2022-09-10,70045,70043,Blue,0,44071,44175,104
2022-11-27,70044,70052,Blue,1,80585,81101,516
2022-11-03,70038,70046,Blue,1,19898,20232,334
2022-10-31,70057,70047,Blue,0,45809,46277,468
2022-09-25,70053,70051,Blue,0,27214,27266,52
2022-03-14,70047,70838,Blue,0,53123,53603,480
2022-02-28,70051,70043,Blue,0,56951,57418,467
2022-11-29,70042,70058,Blue,1,64008,64897,889
2022-11-18,70038,70054,Blue,1,87496,88396,900
2022-04-03,70045,70041,Blue,0,66443,66601,158
2022-12-31,70046,70058,Blue,1,24653,25282,629
2022-03-29,70040,70056,Blue,1,87249,88088,839
2022-01-04,70046,70048,Blue,1,43306,43377,71
2022-09-28,70040,70048,Blue,1,27837,28210,373
2022-08-25,70057,70055,Blue,0,81266,81334,68
2022-04-04,70038,70046,Blue,1,71964,72288,324
2022-03-17,70038,70054,Blue,1,66517,67433,916
2022-01-28,70050,70052,Blue,1,35912,36030,118
2022-10-12,70042,70046,Blue,1,67547,67738,191
2022-02-22,70038,70050,Blue,1,68284,68845,561
2022-07-22,70048,70056,Blue,1,26967,27370,403
2022-12-17,70050,70056,Blue,1,45370,45653,283
2022-08-16,70057,70051,Blue,0,34426,34682,256
2022-12-13,70055,70049,Blue,0,72434,72760,326
2022-11-29,70040,70042,Blue,1,30308,30340,32
2022-06-12,70053,70045,Blue,0,47629,48084,455
2022-03-09,70057,70051,Blue,0,59064,59317,253
2022-03-08,70053,70043,Blue,0,33900,34564,664
2022-06-27,70048,70056,Blue,1,46714,47110,396
2022-03-08,70059,70049,Blue,0,31156,31682,526
2022-12-03,70057,70039,Blue,0,40117,41639,1522
2022-01-17,70042,70046,Blue,1,65979,66193,214
2022-12-18,70053,70039,Blue,0,54114,54881,767
2022-03-05,70056,70060,Blue,1,90140,90327,187
2022-12-21,70047,70045,Blue,0,34474,34592,118
2022-01-03,70048,70058,Blue,1,39606,40161,555
2022-08-05,70050,70052,Blue,1,36007,36193,186
2022-01-13,70059,70043,Blue,0,26663,27633,970
2022-01-23,70042,70046,Blue,1,50079,50260,181
2022-02-17,70057,70053,Blue,0,55500,55671,171
2022-04-06,70044,70058,Blue,1,61851,62646,795
2022-01-06,70053,70041,Blue,0,66178,66810,632
2022-10-27,70047,70838,Blue,0,26482,27023,541
2022-10-27,70048,70056,Blue,1,22661,23051,390
2022-11-15,70040,70050,Blue,1,43080,43603,523
2022-11-16,70042,70052,Blue,1,28309,28899,590
2022-11-06,70053,70047,Blue,0,25359,25652,293
2022-10-16,70044,70050,Blue,1,81258,81586,328
2022-07-08,70046,70054,Blue,1,52537,53002,465
2022-02-09,70038,70046,Blue,1,66136,66525,389
2022-09-19,70059,70043,Blue,0,77614,78446,832
2022-06-19,70057,70838,Blue,0,68015,69157,1142
2022-09-16,70053,70041,Blue,0,71507,72160,653
2022-08-23,70046,70056,Blue,1,48235,48759,524
2022-07-22,70038,70044,Blue,1,75938,76129,191
2022-07-24,70042,70050,Blue,1,50657,51091,434
2022-02-11,70047,70043,Blue,0,19499,19769,270
2022-01-20,70038,70058,Blue,1,26955,27949,994
2022-09-16,70059,70045,Blue,0,43156,43893,737
2022-06-27,70059,70055,Blue,0,62173,62324,151
2022-10-04,70044,70052,Blue,1,62593,63136,543
2022-01-07,70050,70060,Blue,1,48794,49339,545
2022-11-10,70048,70052,Blue,1,72589,72791,202
2022-10-31,70038,70048,Blue,1,66443,66923,480
2022-08-02,70057,70043,Blue,0,23066,23813,747
2022-04-18,70040,70060,Blue,1,78692,79809,1117
2022-12-29,70038,70060,Blue,1,59236,60397,1161
2022-09-07,70057,70053,Blue,0,82750,82899,149
2022-01-19,70059,70041,Blue,0,78906,79792,886
2022-03-20,70049,70039,Blue,0,60283,60777,494
2022-11-09,70057,70838,Blue,0,50021,51034,1013
2022-06-17,70040,70054,Blue,1,60832,61670,838
2022-09-23,70046,70056,Blue,1,87084,87607,523
2022-06-08,70041,70838,Blue,0,47233,47353,120
2022-03-22,70053,70838,Blue,0,67083,67944,861
2022-06-21,70053,70047,Blue,0,60869,61172,303
2022-04-02,70056,70058,Blue,1,55997,56071,74
2022-02-13,70056,70058,Blue,1,74636,74710,74
2022-08-26,70055,70039,Blue,0,38671,39492,821
2022-07-30,70053,70041,Blue,0,52737,53426,689
2022-01-03,70042,70060,Blue,1,30064,31084,1020
2022-12-10,70051,70049,Blue,0,75471,75576,105
2022-07-06,70045,70041,Blue,0,76365,76575,210
2022-02-24,70045,70043,Blue,0,88274,88374,100
2022-09-01,70055,70049,Blue,0,58209,58492,283
2022-07-30,70057,70049,Blue,0,74680,75056,376
2022-09-24,70044,70052,Blue,1,41763,42255,492
2022-02-01,70044,70052,Blue,1,26146,26671,525
2022-02-25,70048,70050,Blue,1,22086,22153,67
2022-04-07,70046,70056,Blue,1,60627,61197,570
2022-12-01,70059,70051,Blue,0,26394,26769,375
2022-02-08,70057,70041,Blue,0,48756,49648,892
2022-02-18,70055,70039,Blue,0,39443,40401,958
2022-01-14,70040,70056,Blue,1,32775,33640,865
2022-12-22,70059,70039,Blue,0,54810,55845,1035
2022-12-25,70048,70054,Blue,1,58570,58877,307
2022-08-17,70059,70039,Blue,0,21983,23352,1369
2022-04-03,70045,70043,Blue,0,67027,67135,108
2022-10-28,70046,70048,Blue,1,28333,28414,81
2022-06-10,70057,70053,Blue,0,34242,34400,158
2022-01-08,70040,70044,Blue,1,82242,82353,111
2022-12-23,70048,70052,Blue,1,33935,34187,252
2022-09-22,70049,70838,Blue,0,20193,20915,722
2022-01-24,70053,70838,Blue,0,72897,73725,828
2022-12-10,70042,70046,Blue,1,70300,70483,183
2022-07-04,70049,70047,Blue,0,36208,36262,54
2022-03-17,70040,70046,Blue,1,65685,66005,320
2022-10-25,70054,70056,Blue,1,61009,61056,47
2022-05-17,70054,70056,Blue,1,39631,39677,46
2022-02-03,70038,70046,Blue,1,53046,53350,304
2022-06-23,70050,70060,Blue,1,57029,57550,521
2022-09-12,70038,70042,Blue,1,63349,63481,132
2022-02-01,70053,70043,Blue,0,52372,52992,620
2022-04-09,70042,70046,Blue,1,36827,37013,186
2022-10-18,70055,70043,Blue,0,36560,37264,704
2022-06-02,70050,70052,Blue,1,89826,90071,245
2022-06-11,70040,70048,Blue,1,78779,79239,460
2022-10-08,70055,70041,Blue,0,77389,78127,738
2022-03-19,70038,70044,Blue,1,33979,34153,174
2022-12-29,70042,70050,Blue,1,26916,27395,479
2022-12-13,70051,70039,Blue,0,58660,59302,642
2022-08-05,70053,70041,Blue,0,48216,48884,668
2022-08-07,70046,70054,Blue,1,48195,48620,425
2022-12-11,70059,70045,Blue,0,25438,26128,690
2022-09-16,70040,70042,Blue,1,53130,53165,35
2022-01-14,70050,70060,Blue,1,22247,23013,766
2022-03-04,70040,70056,Blue,1,23795,24708,913
2022-11-18,70057,70043,Blue,0,70292,71209,917
2022-12-19,70039,70838,Blue,0,57008,57043,35
2022-08-17,70052,70054,Blue,1,40754,40833,79
2022-07-10,70049,70838,Blue,0,74844,75483,639
2022-07-27,70046,70050,Blue,1,54499,54697,198
2022-12-27,70040,70060,Blue,1,32836,33899,1063
2022-12-19,70059,70053,Blue,0,31362,31584,222
2022-05-13,70057,70055,Blue,0,54144,54212,68
2022-06-10,70048,70052,Blue,1,60919,61251,332
2022-09-02,70053,70045,Blue,0,63458,63873,415
2022-04-06,70052,70060,Blue,1,21166,21554,388
2022-06-26,70059,70049,Blue,0,76516,76995,479
2022-02-07,70053,70039,Blue,0,76327,77084,757
2022-08-04,70044,70060,Blue,1,65988,66903,915
2022-12-28,70057,70055,Blue,0,56669,56740,71
2022-03-09,70055,70047,Blue,0,44019,44455,436
2022-07-01,70057,70055,Blue,0,61685,61754,69
2022-03-31,70042,70046,Blue,1,35928,36115,187
2022-03-31,70049,70043,Blue,0,69589,69926,337
2022-04-09,70055,70047,Blue,0,47230,47623,393
2022-08-22,70057,70049,Blue,0,41239,41643,404
2022-07-22,70044,70052,Blue,1,59128,59665,537
2022-02-19,70046,70056,Blue,1,23384,23934,550
2022-11-03,70057,70045,Blue,0,51583,52501,918
2022-02-12,70042,70060,Blue,1,28202,29064,862
2022-04-17,70038,70042,Blue,1,54255,54367,112
2022-04-05,70042,70056,Blue,1,57271,58015,744
2022-04-16,70040,70046,Blue,1,49756,50029,273
2022-12-29,70040,70056,Blue,1,20946,21728,782
2022-01-27,70059,70047,Blue,0,32657,33239,582
2022-07-25,70041,70838,Blue,0,64573,64691,118
2022-04-21,70040,70050,Blue,1,33000,33471,471
2022-07-10,70046,70060,Blue,1,66699,67503,804
2022-11-28,70045,70039,Blue,0,78220,78461,241
2022-12-14,70051,70049,Blue,0,30128,30262,134
2022-12-12,70049,70043,Blue,0,40227,40540,313
2022-02-28,70047,70838,Blue,0,61703,62227,524
2022-04-09,70052,70058,Blue,1,42763,43007,244
2022-12-19,70046,70054,Blue,1,32386,32823,437
2022-01-14,70054,70056,Blue,1,79054,79107,53
2022-03-17,70057,70045,Blue,0,77266,77866,600
2022-07-07,70057,70043,Blue,0,23086,23956,870
2022-04-07,70046,70048,Blue,1,34528,34646,118
2022-03-11,70040,70058,Blue,1,51768,52741,973
2022-11-17,70042,70050,Blue,1,34632,35015,383
2022-03-10,70040,70050,Blue,1,89220,89665,445
2022-10-22,70048,70052,Blue,1,68556,68760,204
2022-07-11,70042,70052,Blue,1,52931,53604,673
2022-06-10,70051,70041,Blue,0,83836,84436,600
2022-08-12,70040,70044,Blue,1,25338,25450,112
2022-08-28,70053,70838,Blue,0,73004,73849,845
2022-09-24,70038,70050,Blue,1,76637,77210,573
2022-10-02,70053,70047,Blue,0,72451,72761,310
2022-04-20,70042,70058,Blue,1,87981,88910,929
2022-09-17,70059,70043,Blue,0,74062,75030,968
2022-09-21,70038,70058,Blue,1,31964,32933,969
2022-03-04,70058,70060,Blue,1,24428,24494,66
2022-11-30,70045,70041,Blue,0,77797,77965,168
2022-10-17,70047,70045,Blue,0,56358,56451,93
2022-04-07,70047,70838,Blue,0,24029,24577,548
2022-07-27,70059,70838,Blue,0,58757,59894,1137
2022-01-21,70042,70050,Blue,1,63783,64231,448
2022-07-10,70047,70838,Blue,0,47934,48455,521
2022-02-09,70047,70043,Blue,0,63539,63818,279
2022-10-25,70052,70060,Blue,1,70282,70652,370
2022-09-17,70053,70047,Blue,0,31673,31974,301
2022-03-03,70059,70055,Blue,0,31755,31896,141
2022-09-22,70055,70039,Blue,0,65714,66668,954
2022-12-14,70051,70039,Blue,0,84670,85356,686
2022-02-20,70047,70041,Blue,0,64211,64613,402
2022-08-24,70040,70052,Blue,1,51826,52483,657
2022-02-10,70053,70051,Blue,0,56580,56643,63
2022-07-12,70042,70046,Blue,1,23088,23271,183
2022-04-13,70052,70054,Blue,1,30380,30438,58
2022-09-22,70038,70060,Blue,1,64419,65576,1157
2022-09-25,70042,70054,Blue,1,72197,72821,624
2022-02-04,70045,70041,Blue,0,76869,77082,213
2022-02-19,70051,70045,Blue,0,33964,34319,355
2022-12-27,70049,70041,Blue,0,54653,55115,462
2022-11-04,70049,70045,Blue,0,29475,29666,191
2022-08-20,70046,70054,Blue,1,87787,88224,437
2022-11-02,70038,70040,Blue,1,42750,42764,14
2022-11-02,70044,70046,Blue,1,48311,48420,109
2022-05-21,70043,70041,Blue,0,37318,37356,38
2022-12-26,70040,70060,Blue,1,61414,62489,1075
2022-06-15,70051,70045,Blue,0,63588,63913,325
2022-10-04,70042,70056,Blue,1,63976,64746,770
2022-01-01,70055,70039,Blue,0,71983,72813,830
2022-01-18,70042,70056,Blue,1,83930,84699,769
2022-04-05,70055,70043,Blue,0,67329,67965,636
2022-07-20,70059,70041,Blue,0,87403,88355,952
2022-08-09,70045,70838,Blue,0,59345,59715,370
2022-04-05,70057,70055,Blue,0,30329,30397,68
2022-03-10,70038,70046,Blue,1,39014,39362,348
2022-05-10,70052,70060,Blue,1,87660,88064,404
2022-09-27,70053,70047,Blue,0,68350,68646,296
2022-04-03,70049,70047,Blue,0,76502,76562,60
2022-07-13,70050,70056,Blue,1,24241,24558,317
2022-08-03,70049,70047,Blue,0,73852,73908,56
2022-09-29,70057,70838,Blue,0,55177,56304,1127
2022-09-10,70048,70054,Blue,1,53375,53660,285
2022-11-06,70046,70052,Blue,1,74893,75193,300
2022-09-16,70045,70838,Blue,0,27617,28003,386
2022-02-25,70051,70043,Blue,0,33619,34610,991
2022-08-25,70059,70057,Blue,0,24263,24302,39
2022-10-07,70048,70050,Blue,1,86285,86342,57
2022-06-16,70047,70043,Blue,0,57022,57324,302
2022-03-14,70057,70045,Blue,0,19938,20534,596
2022-11-02,70038,70058,Blue,1,56564,57658,1094
2022-02-09,70053,70043,Blue,0,22431,23076,645
2022-12-23,70047,70039,Blue,0,23989,24371,382
2022-02-22,70046,70060,Blue,1,58753,59531,778
2022-03-20,70057,70039,Blue,0,52041,52986,945
2022-01-07,70053,70047,Blue,0,58694,59020,326
2022-12-13,70040,70044,Blue,1,38533,38665,132
2022-03-29,70051,70039,Blue,0,74163,74870,707
2022-07-27,70049,70039,Blue,0,60848,61400,552
2022-01-20,70040,70042,Blue,1,49818,49854,36
2022-03-03,70049,70045,Blue,0,76553,76745,192
2022-02-07,70050,70054,Blue,1,74731,74961,230
2022-12-15,70043,70039,Blue,0,70093,70194,101
2022-07-23,70040,70052,Blue,1,77892,78541,649
2022-07-31,70040,70060,Blue,1,23082,24229,1147
2022-07-24,70044,70046,Blue,1,49656,49762,106
2022-07-13,70041,70039,Blue,0,61719,61755,36
2022-09-22,70059,70838,Blue,0,22154,23384,1230
2022-04-10,70053,70045,Blue,0,50849,51277,428
2022-07-04,70039,70838,Blue,0,54118,54171,53
2022-03-28,70057,70045,Blue,0,26441,27245,804
2022-08-28,70046,70052,Blue,1,61743,62087,344
2022-04-03,70042,70056,Blue,1,60919,61666,747
2022-01-13,70053,70041,Blue,0,25759,26462,703
2022-11-03,70052,70060,Blue,1,40729,41091,362
2022-12-12,70049,70838,Blue,0,28167,28828,661
2022-07-09,70038,70052,Blue,1,52327,53092,765
2022-08-05,70050,70058,Blue,1,40458,40893,435
2022-09-11,70051,70047,Blue,0,56347,56540,193
2022-09-18,70040,70054,Blue,1,78014,78746,732
2022-03-04,70038,70056,Blue,1,89166,90092,926
2022-10-26,70043,70838,Blue,0,25739,25949,210
2022-04-07,70057,70045,Blue,0,64166,64770,604
2022-04-14,70056,70058,Blue,1,88737,88815,78
2022-10-31,70051,70039,Blue,0,73484,74169,685
2022-11-15,70057,70047,Blue,0,53161,53652,491
2022-08-20,70057,70039,Blue,0,31464,32381,917
2022-08-10,70053,70043,Blue,0,29581,30195,614
2022-02-27,70038,70060,Blue,1,46756,47981,1225
2022-12-14,70040,70058,Blue,1,83645,84629,984
2022-04-09,70040,70060,Blue,1,68055,69072,1017
2022-08-29,70050,70060,Blue,1,58236,58775,539
2022-03-29,70046,70050,Blue,1,57245,57450,205
2022-10-09,70051,70043,Blue,0,45010,45489,479
2022-10-18,70042,70054,Blue,1,28724,29337,613
2022-08-16,70059,70045,Blue,0,30585,31390,805
2022-10-30,70043,70039,Blue,0,54239,54359,120
2022-11-09,70052,70060,Blue,1,62632,63015,383
2022-09-28,70048,70060,Blue,1,56336,57124,788
2022-08-05,70057,70051,Blue,0,45407,45658,251
2022-02-04,70049,70043,Blue,0,51617,51970,353
2022-10-18,70048,70060,Blue,1,51362,51956,594
2022-05-18,70038,70058,Blue,1,54776,55983,1207
2022-09-12,70047,70838,Blue,0,76617,77124,507
2022-01-03,70044,70056,Blue,1,65444,66148,704
2022-11-09,70051,70043,Blue,0,42406,42919,513
2022-07-01,70047,70041,Blue,0,64898,65266,368
2022-03-22,70039,70838,Blue,0,54905,54938,33
2022-08-01,70040,70050,Blue,1,82707,83408,701
2022-03-30,70038,70046,Blue,1,70509,70878,369
2022-02-16,70038,70050,Blue,1,26352,26947,595
2022-07-12,70044,70056,Blue,1,58327,59060,733
2022-06-28,70038,70050,Blue,1,52451,53095,644
2022-06-18,70051,70045,Blue,0,54520,54879,359
2022-07-28,70056,70058,Blue,1,58822,58892,70
2022-05-14,70055,70047,Blue,0,33825,34220,395
2022-08-12,70059,70049,Blue,0,72798,73268,470
2022-12-23,70040,70056,Blue,1,37527,38440,913
2022-01-04,70046,70048,Blue,1,26431,26511,80
2022-02-10,70040,70054,Blue,1,73121,73924,803
2022-06-21,70038,70050,Blue,1,21301,21950,649
2022-09-27,70042,70050,Blue,1,49946,50312,366
2022-07-11,70040,70060,Blue,1,57489,58644,1155
2022-11-14,70055,70047,Blue,0,66218,66595,377
2022-10-22,70052,70060,Blue,1,88124,88508,384
2022-12-31,70041,70039,Blue,0,78317,78345,28
2022-08-16,70055,70051,Blue,0,61513,61653,140
2022-12-20,70057,70039,Blue,0,59218,60148,930
2022-04-04,70057,70838,Blue,0,22112,23244,1132
2022-09-20,70057,70051,Blue,0,23087,23362,275
2022-03-04,70044,70046,Blue,1,71669,71776,107
2022-10-27,70055,70041,Blue,0,63612,64359,747
2022-08-02,70044,70050,Blue,1,55143,55480,337
2022-03-10,70038,70048,Blue,1,25057,25570,513
2022-10-04,70044,70054,Blue,1,63575,64188,613
2022-09-30,70047,70039,Blue,0,63048,63478,430
2022-06-18,70042,70056,Blue,1,71934,72730,796
2022-03-07,70042,70046,Blue,1,80488,80656,168
2022-02-10,70050,70052,Blue,1,67937,68068,131
2022-10-12,70050,70056,Blue,1,52390,52688,298
2022-06-07,70042,70044,Blue,1,87835,87884,49
2022-05-20,70053,70039,Blue,0,52447,53345,898
2022-02-15,70048,70058,Blue,1,75217,75723,506
2022-03-09,70057,70055,Blue,0,33938,34006,68
2022-08-18,70048,70058,Blue,1,28762,29284,522
2022-10-20,70059,70057,Blue,0,23847,23881,34
2022-09-14,70038,70056,Blue,1,33613,34552,939
2022-12-24,70038,70044,Blue,1,27053,27335,282
2022-12-25,70058,70060,Blue,1,37980,38054,74
2022-02-01,70048,70056,Blue,1,43092,43579,487
2022-08-16,70046,70058,Blue,1,30403,31028,625
2022-06-17,70057,70045,Blue,0,65085,65679,594
2022-01-25,70041,70838,Blue,0,66413,66553,140
2022-02-12,70045,70039,Blue,0,54873,55173,300
2022-08-31,70041,70039,Blue,0,21380,21417,37
2022-11-19,70055,70047,Blue,0,25005,25381,376
2022-02-20,70055,70043,Blue,0,35744,36449,705
2022-02-17,70040,70056,Blue,1,53468,54371,903
2022-07-24,70049,70041,Blue,0,42632,43070,438
2022-10-15,70042,70044,Blue,1,53065,53094,29
2022-07-03,70051,70049,Blue,0,85015,85119,104
2022-04-05,70042,70056,Blue,1,61194,62035,841
2022-05-03,70059,70049,Blue,0,54741,55235,494
2022-01-27,70038,70060,Blue,1,20995,22515,1520
2022-08-12,70038,70052,Blue,1,33192,33960,768
2022-06-21,70052,70056,Blue,1,44485,44638,153
2022-09-17,70044,70058,Blue,1,59576,60346,770
2022-02-14,70040,70046,Blue,1,85457,85696,239
2022-11-19,70047,70041,Blue,0,35757,36061,304
2022-08-01,70055,70043,Blue,0,23611,24341,730
2022-05-04,70055,70051,Blue,0,40699,40846,147
2022-12-05,70046,70052,Blue,1,71958,72253,295
2022-05-30,70049,70045,Blue,0,89179,89511,332
2022-07-06,70038,70050,Blue,1,72721,73389,668
2022-04-06,70053,70043,Blue,0,58854,59506,652
2022-04-20,70053,70051,Blue,0,62269,62323,54
2022-01-25,70053,70039,Blue,0,30334,31245,911
2022-02-03,70055,70043,Blue,0,52306,53041,735
2022-08-30,70055,70047,Blue,0,24437,24813,376
2022-07-15,70057,70045,Blue,0,52939,53587,648
2022-01-11,70049,70043,Blue,0,64643,65001,358
2022-08-12,70053,70838,Blue,0,40614,41459,845
2022-10-26,70050,70056,Blue,1,27999,28298,299
2022-04-22,70038,70046,Blue,1,20654,20985,331
2022-12-03,70048,70052,Blue,1,70085,70313,228
2022-11-12,70046,70056,Blue,1,45659,46136,477
2022-03-05,70051,70049,Blue,0,18825,18933,108
2022-12-03,70038,70056,Blue,1,42464,43391,927
2022-03-17,70042,70046,Blue,1,84999,85168,169
2022-12-22,70056,70060,Blue,1,30459,30641,182
2022-04-21,70043,70041,Blue,0,51351,51382,31
2022-10-27,70055,70041,Blue,0,45475,46269,794
2022-08-09,70046,70048,Blue,1,32727,32813,86
2022-08-26,70055,70041,Blue,0,59535,60357,822
2022-01-19,70053,70043,Blue,0,74653,75275,622
2022-04-23,70046,70050,Blue,1,73261,73463,202
2022-02-14,70044,70052,Blue,1,51853,52328,475
2022-06-17,70046,70054,Blue,1,37162,37871,709
2022-06-14,70050,70060,Blue,1,63831,64375,544
2022-01-13,70052,70058,Blue,1,69714,69974,260
2022-10-15,70040,70060,Blue,1,31979,33115,1136
2022-11-25,70053,70047,Blue,0,65256,65536,280
2022-08-08,70042,70056,Blue,1,35113,35896,783
2022-09-30,70040,70060,Blue,1,26129,27206,1077
2022-09-09,70052,70060,Blue,1,25415,25829,414
2022-02-02,70040,70056,Blue,1,29119,29934,815
2022-06-04,70043,70838,Blue,0,82418,82605,187
2022-11-28,70048,70050,Blue,1,23383,23439,56
2022-06-21,70056,70058,Blue,1,28287,28360,73
2022-06-23,70046,70048,Blue,1,86194,86297,103
2022-06-16,70038,70056,Blue,1,52526,53561,1035
2022-04-21,70055,70043,Blue,0,39996,40806,810
2022-06-15,70054,70058,Blue,1,56018,56174,156
2022-08-14,70053,70047,Blue,0,47075,47355,280
2022-03-21,70057,70053,Blue,0,23448,23609,161
2022-03-27,70042,70050,Blue,1,37174,37594,420
2022-09-09,70052,70056,Blue,1,80131,80326,195
2022-04-02,70059,70055,Blue,0,79094,79239,145
2022-11-24,70049,70045,Blue,0,72156,72350,194
2022-10-05,70045,70039,Blue,0,35144,35419,275
2022-02-09,70041,70838,Blue,0,65049,65159,110
2022-01-03,70041,70039,Blue,0,37317,37348,31
2022-09-30,70049,70047,Blue,0,54720,54776,56
2022-03-27,70055,70039,Blue,0,83964,84720,756
2022-02-09,70049,70043,Blue,0,30717,31134,417
2022-01-13,70041,70838,Blue,0,59488,59617,129
2022-03-05,70054,70056,Blue,1,55910,55956,46
2022-03-17,70044,70060,Blue,1,44393,45396,1003
2022-01-17,70046,70056,Blue,1,74840,75347,507
2022-06-16,70040,70054,Blue,1,52813,53600,787
2022-01-24,70055,70051,Blue,0,84207,84372,165
2022-09-19,70046,70058,Blue,1,88620,89353,733
2022-04-10,70054,70056,Blue,1,65382,65429,47
2022-10-14,70046,70054,Blue,1,22134,22550,416
2022-09-28,70054,70056,Blue,1,34126,34174,48
2022-03-24,70044,70052,Blue,1,70987,71477,490
2022-12-01,70038,70056,Blue,1,28152,29046,894
2022-08-06,70046,70054,Blue,1,52730,53159,429
2022-10-07,70042,70054,Blue,1,21319,21979,660
2022-12-19,70042,70054,Blue,1,55163,55810,647
2022-06-17,70050,70052,Blue,1,53396,53523,127
2022-01-06,70051,70043,Blue,0,54285,54766,481
2022-09-27,70044,70056,Blue,1,70719,71358,639
2022-01-19,70046,70050,Blue,1,81211,81396,185
2022-03-21,70044,70046,Blue,1,56446,56558,112
2022-03-15,70040,70044,Blue,1,29323,29421,98
2022-05-25,70043,70838,Blue,0,67264,67455,191
2022-10-31,70047,70043,Blue,0,47442,47692,250
2022-02-12,70048,70056,Blue,1,72799,73174,375
2022-03-11,70053,70043,Blue,0,68169,68793,624
2022-07-10,70047,70045,Blue,0,56120,56228,108
2022-12-26,70040,70058,Blue,1,39728,40652,924
2022-01-18,70038,70060,Blue,1,21051,22330,1279
2022-12-07,70040,70052,Blue,1,35359,35964,605
2022-12-03,70045,70041,Blue,0,67868,68037,169
2022-03-14,70057,70047,Blue,0,21762,22284,522
2022-09-07,70052,70060,Blue,1,25703,26062,359
2022-01-14,70057,70041,Blue,0,85821,86654,833
2022-06-02,70042,70044,Blue,1,36096,36130,34
2022-01-31,70050,70056,Blue,1,36470,36840,370
2022-12-14,70051,70041,Blue,0,67937,68501,564
2022-06-16,70040,70042,Blue,1,63809,63840,31
2022-10-06,70046,70048,Blue,1,80733,80819,86
2022-11-07,70046,70048,Blue,1,30313,30389,76
2022-03-30,70042,70046,Blue,1,75966,76164,198
2022-01-03,70044,70046,Blue,1,29528,29629,101
2022-03-08,70049,70047,Blue,0,27495,27551,56
2022-05-24,70044,70048,Blue,1,24057,24321,264
2022-10-05,70045,70043,Blue,0,62502,62595,93
2022-07-06,70048,70060,Blue,1,69005,69710,705
2022-02-18,70055,70049,Blue,0,63370,63659,289
2022-01-03,70040,70056,Blue,1,68513,69280,767
2022-07-28,70047,70043,Blue,0,55184,55479,295
2022-06-16,70042,70060,Blue,1,50738,51735,997
2022-03-05,70049,70041,Blue,0,67021,67495,474
2022-01-03,70047,70838,Blue,0,27236,27734,498
2022-03-16,70054,70060,Blue,1,76069,76347,278
2022-01-08,70051,70049,Blue,0,56595,56699,104
2022-11-01,70040,70060,Blue,1,46178,47274,1096
2022-10-04,70059,70053,Blue,0,28461,28733,272
2022-09-09,70057,70055,Blue,0,19617,19689,72
2022-03-09,70049,70043,Blue,0,43241,43625,384
2022-08-11,70043,70039,Blue,0,53505,53615,110
2022-07-24,70050,70058,Blue,1,51644,52035,391
2022-08-27,70059,70057,Blue,0,22812,22848,36
2022-02-10,70042,70056,Blue,1,40291,41039,748
2022-02-06,70055,70043,Blue,0,28697,29372,675
2022-07-03,70057,70838,Blue,0,45503,46554,1051
2022-12-17,70040,70042,Blue,1,64276,64308,32
2022-07-03,70046,70056,Blue,1,71389,71938,549
2022-07-01,70038,70056,Blue,1,58906,59877,971
2022-08-04,70040,70056,Blue,1,70621,71506,885
2022-12-05,70053,70051,Blue,0,75159,75221,62
2022-07-29,70055,70047,Blue,0,79290,79654,364
2022-06-19,70040,70046,Blue,1,91122,91545,423
2022-10-14,70055,70838,Blue,0,57166,58099,933
2022-11-29,70042,70054,Blue,1,85842,86502,660
2022-01-04,70059,70047,Blue,0,57793,58337,544
2022-01-23,70040,70048,Blue,1,34058,34432,374
2022-11-27,70049,70045,Blue,0,33541,33733,192
2022-04-13,70045,70039,Blue,0,35051,35328,277
2022-01-28,70059,70047,Blue,0,49221,49803,582
2022-07-05,70047,70045,Blue,0,32760,32873,113
2022-01-28,70042,70058,Blue,1,85547,86386,839
2022-06-29,70042,70052,Blue,1,59107,59723,616
2022-02-08,70052,70060,Blue,1,79515,79894,379
2022-03-04,70042,70056,Blue,1,22421,23202,781
2022-03-23,70055,70043,Blue,0,40594,41408,814
2022-01-22,70059,70057,Blue,0,86527,86562,35
2022-12-05,70049,70045,Blue,0,80978,81175,197
2022-12-08,70057,70045,Blue,0,38269,38901,632
2022-03-01,70048,70058,Blue,1,72996,73592,596
2022-10-25,70038,70060,Blue,1,64977,66265,1288
2022-05-02,70059,70049,Blue,0,44721,45169,448
2022-10-09,70059,70051,Blue,0,65726,66042,316
2022-02-09,70053,70051,Blue,0,76907,76965,58
2022-01-07,70041,70838,Blue,0,63008,63133,125
2022-11-05,70055,70039,Blue,0,65685,66503,818
2022-02-14,70057,70838,Blue,0,28247,29407,1160
2022-08-06,70053,70047,Blue,0,37069,37485,416
2022-09-25,70057,70051,Blue,0,45805,46057,252
2022-05-28,70047,70045,Blue,0,68815,68914,99
2022-10-09,70038,70040,Blue,1,26109,26133,24
2022-10-16,70055,70049,Blue,0,39675,39952,277
2022-10-06,70040,70052,Blue,1,52132,52757,625
2022-07-08,70048,70054,Blue,1,54697,55009,312
2022-02-23,70044,70060,Blue,1,38135,39057,922
2022-06-23,70055,70047,Blue,0,42935,43377,442
2022-09-28,70038,70054,Blue,1,52876,53633,757
2022-01-13,70047,70041,Blue,0,28211,28579,368
2022-11-24,70038,70048,Blue,1,83714,84150,436
2022-08-03,70042,70056,Blue,1,30448,31263,815
2022-03-16,70038,70050,Blue,1,62228,62818,590
2022-02-01,70053,70051,Blue,0,68221,68274,53
2022-11-30,70055,70838,Blue,0,66651,67538,887
2022-05-12,70050,70054,Blue,1,30656,30863,207
2022-04-05,70038,70044,Blue,1,55026,55294,268
2022-05-29,70038,70044,Blue,1,23120,23313,193
2022-12-13,70056,70058,Blue,1,35389,35466,77
2022-12-29,70053,70047,Blue,0,76673,76964,291
2022-05-20,70045,70043,Blue,0,66467,66635,168
2022-07-13,70059,70049,Blue,0,52940,53411,471
2022-01-04,70040,70056,Blue,1,65000,65832,832
2022-07-09,70052,70054,Blue,1,74695,74753,58
2022-12-10,70046,70054,Blue,1,33798,34235,437
2022-01-25,70044,70050,Blue,1,73324,73689,365
2022-02-22,70043,70041,Blue,0,79309,79337,28
2022-02-13,70053,70041,Blue,0,56285,56964,679
2022-11-08,70056,70060,Blue,1,58219,58402,183
2022-07-30,70057,70838,Blue,0,51993,53016,1023
2022-03-07,70046,70048,Blue,1,64704,64806,102
2022-12-21,70049,70041,Blue,0,57685,58100,415
2022-08-28,70057,70047,Blue,0,72271,72748,477
2022-06-09,70045,70043,Blue,0,40145,40292,147
2022-12-30,70053,70039,Blue,0,59972,60677,705
2022-09-17,70045,70041,Blue,0,79214,79424,210
2022-04-18,70051,70041,Blue,0,59401,59975,574
2022-02-21,70055,70053,Blue,0,21032,21126,94
2022-12-17,70059,70051,Blue,0,37317,37651,334
2022-07-20,70053,70049,Blue,0,47213,47411,198
2022-10-13,70046,70052,Blue,1,45687,46023,336
2022-09-19,70057,70047,Blue,0,36993,37565,572
2022-08-18,70040,70058,Blue,1,85021,86119,1098
2022-09-16,70042,70050,Blue,1,32154,32571,417
2022-07-25,70047,70838,Blue,0,81109,81614,505
2022-02-11,70059,70047,Blue,0,53594,54118,524
2022-02-09,70042,70046,Blue,1,29796,29971,175
2022-08-27,70047,70043,Blue,0,62255,62499,244
2022-01-24,70052,70054,Blue,1,89476,89538,62
2022-09-12,70046,70048,Blue,1,52773,52852,79
2022-03-01,70051,70047,Blue,0,29802,29999,197
2022-09-05,70047,70043,Blue,0,41452,41676,224
2022-02-10,70052,70054,Blue,1,75591,75651,60
2022-02-05,70057,70053,Blue,0,43356,43516,160
2022-10-24,70044,70052,Blue,1,80844,81311,467
2022-12-15,70053,70045,Blue,0,58493,58955,462
2022-10-05,70038,70060,Blue,1,67696,68957,1261
2022-03-10,70052,70054,Blue,1,27210,27264,54
2022-12-04,70048,70056,Blue,1,72596,72963,367
2022-02-25,70042,70048,Blue,1,26561,26874,313
2022-02-05,70055,70043,Blue,0,88442,89310,868
2022-10-19,70051,70049,Blue,0,63213,63314,101
2022-02-01,70057,70043,Blue,0,32445,33248,803
2022-12-18,70057,70049,Blue,0,26265,26675,410
2022-10-04,70057,70053,Blue,0,25185,25342,157
2022-02-24,70055,70045,Blue,0,59846,60470,624
2022-03-19,70055,70049,Blue,0,52659,52946,287
2022-07-20,70059,70041,Blue,0,67000,67964,964
2022-01-24,70052,70056,Blue,1,43710,43847,137
2022-02-10,70059,70838,Blue,0,56588,57721,1133
2022-03-14,70049,70047,Blue,0,83411,83476,65
2022-09-23,70042,70052,Blue,1,57960,58582,622
2022-11-10,70046,70052,Blue,1,73980,74292,312
2022-12-21,70059,70055,Blue,0,21027,21169,142
2022-12-05,70055,70041,Blue,0,38671,39407,736
2022-09-03,70057,70045,Blue,0,59581,60211,630
2022-11-01,70044,70046,Blue,1,61511,61619,108
2022-12-03,70046,70052,Blue,1,41552,41933,381
2022-12-21,70044,70060,Blue,1,68974,69887,913
2022-04-21,70055,70047,Blue,0,80242,80616,374
2022-11-23,70052,70058,Blue,1,43997,44251,254
2022-01-24,70059,70049,Blue,0,37521,38017,496
2022-05-18,70041,70838,Blue,0,83438,83555,117
2022-06-09,70055,70049,Blue,0,31971,32268,297
2022-04-15,70048,70050,Blue,1,82771,82830,59
2022-02-23,70038,70052,Blue,1,27983,28735,752
2022-05-01,70057,70051,Blue,0,52316,52572,256
2022-04-09,70040,70054,Blue,1,57799,58546,747
2022-07-12,70050,70058,Blue,1,28672,29133,461
2022-08-07,70038,70042,Blue,1,54255,54361,106
2022-12-23,70038,70056,Blue,1,21330,22290,960
2022-03-01,70045,70043,Blue,0,86555,86656,101
2022-11-25,70048,70050,Blue,1,56199,56255,56
2022-12-13,70055,70041,Blue,0,88314,89015,701
2022-02-13,70055,70043,Blue,0,68601,69298,697
2022-05-18,70048,70058,Blue,1,79027,79564,537
2022-09-18,70040,70060,Blue,1,37085,38134,1049
2022-08-18,70054,70056,Blue,1,63472,63519,47
2022-01-22,70042,70044,Blue,1,49848,49877,29
2022-11-27,70042,70052,Blue,1,51706,52283,577
2022-11-23,70045,70041,Blue,0,31595,31774,179
2022-12-30,70040,70048,Blue,1,19872,20275,403
2022-04-16,70040,70052,Blue,1,27009,27673,664
2022-07-18,70040,70042,Blue,1,81530,81567,37
2022-05-04,70050,70060,Blue,1,67609,68103,494
2022-12-24,70050,70060,Blue,1,62178,62696,518
2022-02-24,70059,70039,Blue,0,66799,67778,979
2022-06-13,70044,70046,Blue,1,48955,49062,107
2022-12-03,70053,70838,Blue,0,37084,37923,839
2022-04-20,70051,70045,Blue,0,26151,26564,413
2022-09-05,70044,70056,Blue,1,50294,51003,709
2022-11-10,70052,70058,Blue,1,51855,52114,259
2022-07-08,70050,70060,Blue,1,81933,82436,503
2022-01-09,70049,70041,Blue,0,47304,47690,386
2022-02-14,70042,70060,Blue,1,82231,83149,918
2022-10-13,70059,70055,Blue,0,30564,30714,150
2022-11-14,70055,70047,Blue,0,64213,64574,361
2022-07-04,70038,70044,Blue,1,81333,81518,185
2022-01-11,70038,70056,Blue,1,20962,21990,1028
2022-01-13,70040,70048,Blue,1,64092,64472,380
2022-02-07,70041,70039,Blue,0,58303,58337,34
2022-11-21,70048,70050,Blue,1,23359,23421,62
2022-04-23,70057,70041,Blue,0,65487,66325,838
2022-01-07,70038,70048,Blue,1,71953,72374,421
2022-11-07,70046,70058,Blue,1,85379,86025,646
2022-03-03,70057,70838,Blue,0,27642,28676,1034
2022-05-21,70044,70056,Blue,1,53162,53926,764
2022-08-03,70055,70043,Blue,0,75572,76385,813
2022-12-18,70042,70052,Blue,1,34874,35437,563
2022-09-15,70051,70039,Blue,0,26372,27152,780
2022-11-30,70057,70838,Blue,0,37530,38520,990
2022-09-08,70042,70048,Blue,1,55253,55565,312
2022-08-01,70038,70058,Blue,1,73146,74227,1081
2022-11-08,70059,70055,Blue,0,72797,72937,140
2022-12-01,70044,70048,Blue,1,49958,50175,217
2022-08-25,70040,70042,Blue,1,67143,67173,30
2022-12-07,70040,70048,Blue,1,78950,79331,381
2022-10-10,70042,70052,Blue,1,53005,53535,530
2022-09-16,70041,70838,Blue,0,69700,69827,127
2022-04-14,70055,70045,Blue,0,29870,30574,704
2022-04-19,70048,70050,Blue,1,68167,68226,59
2022-06-15,70057,70053,Blue,0,67601,67754,153
2022-09-19,70048,70060,Blue,1,24062,24830,768
2022-02-02,70038,70044,Blue,1,86554,86744,190
2022-01-16,70058,70060,Blue,1,79678,79749,71
2022-10-13,70040,70044,Blue,1,38975,39078,103
2022-08-25,70057,70047,Blue,0,79494,79977,483
2022-04-06,70059,70045,Blue,0,32563,33294,731
2022-09-03,70040,70046,Blue,1,60504,60791,287
2022-08-18,70047,70039,Blue,0,28048,28555,507
2022-02-19,70048,70058,Blue,1,88742,89242,500
2022-04-12,70045,70838,Blue,0,84178,84474,296
2022-04-24,70045,70043,Blue,0,30017,30112,95
2022-07-14,70046,70060,Blue,1,43771,44684,913
2022-01-14,70057,70047,Blue,0,19907,20477,570
2022-02-12,70044,70050,Blue,1,32034,32358,324
2022-11-22,70057,70045,Blue,0,55720,56351,631
2022-06-19,70040,70056,Blue,1,53784,54693,909
2022-03-30,70041,70838,Blue,0,71998,72141,143
2022-02-22,70057,70055,Blue,0,23728,23798,70
2022-11-15,70055,70043,Blue,0,22070,22855,785
2022-07-16,70043,70041,Blue,0,65797,65827,30
2022-07-29,70055,70051,Blue,0,65887,66029,142
2022-06-24,70057,70041,Blue,0,54298,55166,868
2022-11-23,70053,70041,Blue,0,45635,46294,659
2022-07-07,70051,70039,Blue,0,65313,66002,689
2022-08-03,70054,70058,Blue,1,54835,54992,157
2022-03-20,70053,70838,Blue,0,82477,83280,803
2022-04-03,70048,70056,Blue,1,47781,48176,395
2022-09-05,70051,70039,Blue,0,57975,58924,949
2022-11-12,70044,70056,Blue,1,52566,53209,643
2022-10-24,70046,70056,Blue,1,67017,67520,503
2022-07-21,70046,70050,Blue,1,88226,88413,187
2022-04-12,70059,70041,Blue,0,64695,65644,949
2022-04-07,70044,70048,Blue,1,45505,45768,263
2022-06-22,70053,70838,Blue,0,77317,78179,862
2022-05-19,70050,70052,Blue,1,68307,68424,117
2022-11-18,70055,70043,Blue,0,71969,72679,710
2022-07-28,70053,70051,Blue,0,44997,45063,66
2022-09-16,70057,70041,Blue,0,69757,70634,877
2022-01-19,70047,70041,Blue,0,23415,23780,365
2022-10-15,70038,70058,Blue,1,19877,20928,1051
2022-11-06,70052,70058,Blue,1,27141,27388,247
2022-02-04,70050,70052,Blue,1,62152,62262,110
2022-08-24,70056,70058,Blue,1,72745,72816,71
2022-06-20,70054,70060,Blue,1,39555,39837,282
2022-01-06,70053,70041,Blue,0,86565,87177,612
2022-06-15,70059,70039,Blue,0,85746,86756,1010
2022-04-14,70040,70060,Blue,1,65985,67028,1043
2022-08-16,70043,70838,Blue,0,63375,63565,190
2022-08-16,70038,70048,Blue,1,73155,73641,486
2022-04-13,70038,70044,Blue,1,53047,53205,158
2022-02-23,70059,70047,Blue,0,27258,27791,533
2022-05-30,70038,70050,Blue,1,59122,59816,694
2022-03-27,70049,70039,Blue,0,67310,67835,525
2022-09-23,70054,70056,Blue,1,39817,39865,48
2022-02-21,70053,70043,Blue,0,32206,32823,617
2022-07-05,70055,70045,Blue,0,46786,47326,540
2022-07-14,70055,70041,Blue,0,72700,73544,844
2022-03-22,70059,70051,Blue,0,66795,67142,347
2022-08-01,70043,70838,Blue,0,54693,54880,187
2022-03-09,70055,70039,Blue,0,37199,38283,1084
2022-04-20,70059,70057,Blue,0,78314,78349,35
2022-10-10,70055,70053,Blue,0,24023,24067,44
2022-08-23,70053,70049,Blue,0,58504,58707,203
2022-06-24,70057,70055,Blue,0,81475,81544,69
2022-02-26,70059,70055,Blue,0,41661,41806,145
2022-11-13,70043,70039,Blue,0,53138,53249,111
2022-07-27,70059,70043,Blue,0,58217,59075,858
2022-04-02,70057,70047,Blue,0,27156,27639,483
2022-10-21,70057,70041,Blue,0,24841,25736,895
2022-01-27,70050,70058,Blue,1,76396,76805,409
2022-02-26,70053,70838,Blue,0,85162,86176,1014
2022-02-18,70048,70054,Blue,1,25308,25601,293
2022-01-18,70043,70041,Blue,0,32565,32594,29
2022-06-19,70045,70041,Blue,0,55718,55922,204
2022-12-27,70055,70041,Blue,0,21219,22017,798
2022-11-22,70042,70046,Blue,1,42587,42755,168
2022-07-26,70046,70060,Blue,1,59099,59979,880
2022-03-06,70038,70042,Blue,1,74785,74874,89
2022-04-05,70042,70060,Blue,1,28290,29299,1009
2022-01-21,70047,70041,Blue,0,38786,39145,359
2022-06-09,70042,70058,Blue,1,57247,58559,1312
2022-09-30,70057,70041,Blue,0,38556,39466,910
2022-10-23,70040,70050,Blue,1,68879,69333,454
2022-11-11,70044,70060,Blue,1,65344,66300,956
2022-09-16,70047,70045,Blue,0,31167,31258,91
2022-08-16,70038,70054,Blue,1,23207,24018,811
2022-02-09,70045,70041,Blue,0,28326,28519,193
2022-10-13,70040,70056,Blue,1,46160,47029,869
2022-01-11,70051,70049,Blue,0,64157,64263,106
2022-03-17,70057,70039,Blue,0,36456,37452,996
2022-01-28,70043,70039,Blue,0,74659,74762,103
2022-08-01,70052,70054,Blue,1,34001,34082,81
2022-07-08,70048,70056,Blue,1,28470,28894,424
2022-08-23,70059,70045,Blue,0,43679,44471,792
2022-08-01,70055,70053,Blue,0,46996,47043,47
2022-04-10,70048,70056,Blue,1,79030,79413,383
2022-05-12,70059,70055,Blue,0,57265,57409,144
2022-04-01,70042,70056,Blue,1,57574,58318,744
2022-09-22,70047,70041,Blue,0,41236,41584,348
2022-01-14,70043,70838,Blue,0,23689,23939,250
2022-01-18,70045,70043,Blue,0,29490,29686,196
2022-04-08,70049,70045,Blue,0,72558,72737,179
2022-10-08,70043,70838,Blue,0,38789,38962,173
2022-11-24,70041,70039,Blue,0,81215,81249,34
2022-11-23,70055,70043,Blue,0,50151,50827,676
2022-09-23,70054,70058,Blue,1,35549,35698,149
2022-12-04,70051,70045,Blue,0,75851,76313,462
2022-04-18,70038,70060,Blue,1,23363,24585,1222
2022-10-05,70040,70056,Blue,1,50889,51794,905
2022-11-01,70038,70050,Blue,1,34942,35481,539
2022-09-06,70055,70051,Blue,0,81618,81766,148
2022-11-07,70053,70045,Blue,0,86932,87354,422
2022-08-16,70051,70043,Blue,0,23784,24311,527
2022-09-15,70059,70057,Blue,0,57218,57254,36
2022-09-29,70042,70052,Blue,1,64741,65268,527
2022-01-26,70040,70042,Blue,1,21921,21955,34
2022-08-28,70041,70039,Blue,0,51622,51651,29
2022-08-04,70054,70056,Blue,1,69917,69964,47
2022-09-08,70049,70047,Blue,0,72875,72939,64
2022-04-15,70045,70043,Blue,0,46365,46470,105
2022-03-01,70045,70041,Blue,0,57646,57826,180
2022-08-22,70044,70054,Blue,1,46399,47016,617
2022-11-20,70050,70054,Blue,1,53201,53399,198
2022-02-17,70059,70053,Blue,0,62895,63154,259
2022-07-09,70044,70054,Blue,1,58007,58626,619
2022-03-14,70054,70060,Blue,1,79460,79733,273
2022-04-16,70049,70041,Blue,0,49172,49691,519
2022-07-27,70051,70838,Blue,0,64835,65584,749
2022-11-25,70040,70056,Blue,1,76813,77604,791
2022-11-13,70046,70052,Blue,1,56237,56561,324
2022-09-12,70055,70041,Blue,0,63618,64355,737
2022-09-09,70038,70060,Blue,1,42801,43993,1192
2022-02-19,70042,70054,Blue,1,42264,42912,648
2022-08-04,70055,70051,Blue,0,24892,25039,147
2022-04-22,70056,70060,Blue,1,88600,88770,170
2022-07-11,70038,70056,Blue,1,89107,90002,895
2022-04-21,70053,70045,Blue,0,86602,87107,505
2022-03-14,70049,70047,Blue,0,87373,87429,56
2022-11-04,70046,70058,Blue,1,32985,33758,773
2022-08-06,70042,70044,Blue,1,67611,67638,27
2022-12-15,70052,70058,Blue,1,57861,58126,265
2022-04-07,70051,70039,Blue,0,79273,79902,629
2022-07-22,70044,70048,Blue,1,34853,35105,252
2022-01-17,70046,70058,Blue,1,30098,30722,624
2022-10-29,70046,70056,Blue,1,57051,57560,509
2022-09-23,70050,70054,Blue,1,35237,35512,275
2022-01-19,70053,70838,Blue,0,64380,65236,856
2022-09-02,70059,70049,Blue,0,27209,27674,465
2022-07-07,70040,70058,Blue,1,60900,61855,955
2022-02-14,70042,70048,Blue,1,44823,45117,294
2022-04-24,70053,70045,Blue,0,39125,39580,455
2022-01-06,70038,70052,Blue,1,83112,83859,747
2022-04-07,70051,70838,Blue,0,45941,46712,771
2022-10-17,70053,70039,Blue,0,67841,68540,699
2022-03-18,70038,70044,Blue,1,29187,29381,194
2022-12-24,70047,70041,Blue,0,88869,89217,348
2022-01-16,70059,70039,Blue,0,40164,41197,1033
2022-06-02,70044,70050,Blue,1,59158,59578,420
2022-11-14,70055,70043,Blue,0,52720,53401,681
2022-03-13,70051,70049,Blue,0,44453,44556,103
2022-09-15,70051,70838,Blue,0,61694,62434,740
2022-10-17,70059,70041,Blue,0,28899,30002,1103
2022-04-29,70057,70047,Blue,0,58612,59130,518
2022-02-25,70038,70054,Blue,1,51193,51958,765
2022-03-07,70051,70043,Blue,0,31275,31802,527
2022-12-13,70040,70044,Blue,1,25299,25402,103
2022-04-23,70056,70060,Blue,1,56098,56276,178
2022-03-09,70044,70056,Blue,1,35322,36068,746
2022-02-11,70041,70838,Blue,0,86161,86281,120
2022-11-08,70059,70041,Blue,0,48371,49265,894
2022-05-18,70049,70041,Blue,0,28377,29013,636
2022-07-20,70055,70053,Blue,0,33686,33734,48
2022-09-04,70050,70052,Blue,1,56496,56604,108
2022-03-11,70046,70054,Blue,1,65599,66012,413
2022-12-06,70043,70039,Blue,0,41621,41728,107
2022-04-02,70049,70045,Blue,0,86174,86355,181
2022-01-02,70049,70039,Blue,0,71615,72063,448
2022-08-19,70044,70046,Blue,1,43785,43887,102
2022-03-11,70057,70051,Blue,0,39874,40132,258
2022-12-23,70038,70056,Blue,1,32080,32959,879
2022-11-14,70055,70041,Blue,0,56571,57338,767
2022-10-09,70053,70049,Blue,0,28013,28274,261
2022-02-27,70048,70060,Blue,1,63436,64048,612
2022-01-29,70054,70058,Blue,1,46976,47207,231
2022-07-28,70047,70045,Blue,0,58525,58629,104
2022-02-15,70038,70046,Blue,1,51261,51599,338
2022-06-29,70052,70054,Blue,1,64857,64914,57
2022-04-15,70045,70838,Blue,0,20258,20644,386
2022-12-13,70050,70058,Blue,1,33798,34215,417
2022-04-11,70040,70046,Blue,1,30911,31189,278
2022-05-08,70059,70049,Blue,0,27611,28155,544
2022-09-02,70038,70056,Blue,1,27364,28217,853
2022-10-19,70055,70041,Blue,0,27807,28561,754
2022-09-30,70042,70056,Blue,1,31761,32557,796
2022-07-14,70045,70039,Blue,0,30594,30923,329
2022-04-06,70050,70052,Blue,1,24572,24696,124
2022-01-13,70038,70046,Blue,1,57434,57818,384
2022-06-29,70055,70053,Blue,0,51100,51145,45
2022-03-30,70046,70048,Blue,1,30638,30727,89
2022-01-05,70038,70060,Blue,1,40160,41341,1181
2022-01-01,70055,70041,Blue,0,78818,79603,785
2022-06-12,70052,70056,Blue,1,48564,48701,137
2022-11-18,70052,70056,Blue,1,59673,59812,139
2022-03-04,70056,70058,Blue,1,33599,33680,81
2022-01-14,70040,70046,Blue,1,89219,89484,265
2022-01-26,70053,70047,Blue,0,66165,66445,280
2022-06-13,70049,70045,Blue,0,27180,27412,232
2022-09-14,70047,70039,Blue,0,19066,19515,449
2022-02-07,70044,70046,Blue,1,74347,74453,106
2022-06-23,70039,70838,Blue,0,31303,31338,35
2022-11-08,70055,70045,Blue,0,32288,32798,510
2022-03-07,70053,70041,Blue,0,31712,32351,639
2022-12-12,70048,70060,Blue,1,41396,42101,705
2022-04-08,70053,70047,Blue,0,32649,32954,305
2022-04-03,70038,70048,Blue,1,56946,57392,446
2022-04-18,70052,70056,Blue,1,28381,28529,148
2022-03-31,70059,70838,Blue,0,35841,37044,1203
2022-04-06,70042,70054,Blue,1,64730,65441,711
2022-12-30,70040,70060,Blue,1,28096,29166,1070
2022-04-18,70040,70050,Blue,1,23709,24245,536
2022-03-02,70059,70041,Blue,0,79453,80322,869
2022-09-10,70044,70056,Blue,1,25182,26201,1019
2022-04-10,70057,70047,Blue,0,51753,52277,524
2022-04-09,70057,70055,Blue,0,58481,58550,69
2022-01-21,70040,70048,Blue,1,33553,33947,394
2022-06-09,70042,70050,Blue,1,81043,81527,484
2022-04-14,70052,70054,Blue,1,64143,64187,44
2022-04-07,70052,70054,Blue,1,24368,24421,53
2022-06-21,70038,70054,Blue,1,24960,25884,924
2022-01-25,70054,70060,Blue,1,61281,61686,405
2022-04-16,70055,70047,Blue,0,67758,68155,397
2022-08-27,70053,70041,Blue,0,64599,65273,674
2022-04-16,70055,70838,Blue,0,67758,68758,1000
2022-06-11,70038,70056,Blue,1,33974,34877,903
2022-12-19,70041,70838,Blue,0,53824,53960,136
2022-02-20,70042,70044,Blue,1,67358,67390,32
2022-12-22,70040,70048,Blue,1,75010,75404,394
2022-12-14,70052,70058,Blue,1,49417,49666,249
2022-07-22,70044,70060,Blue,1,24389,25369,980
2022-08-05,70042,70054,Blue,1,80665,81352,687
2022-03-04,70056,70058,Blue,1,22107,22182,75
2022-11-11,70043,70041,Blue,0,39674,39710,36
2022-03-05,70044,70052,Blue,1,58527,59028,501
2022-09-08,70057,70043,Blue,0,66983,67840,857
2022-04-07,70044,70060,Blue,1,59812,60707,895
2022-01-24,70049,70045,Blue,0,72064,72256,192
2022-07-29,70057,70043,Blue,0,47925,48754,829
2022-09-16,70042,70046,Blue,1,70221,70410,189
2022-11-21,70046,70058,Blue,1,33484,34135,651
2022-12-31,70044,70050,Blue,1,87057,87391,334
2022-11-17,70053,70045,Blue,0,29177,29664,487
2022-08-12,70042,70054,Blue,1,67188,67873,685
2022-11-01,70046,70052,Blue,1,36761,37105,344
2022-11-14,70042,70060,Blue,1,72785,73766,981
2022-03-12,70041,70838,Blue,0,52413,52542,129
2022-03-16,70049,70039,Blue,0,46035,46551,516
2022-10-20,70044,70048,Blue,1,38116,38333,217
2022-12-10,70059,70047,Blue,0,38425,38990,565
2022-01-31,70055,70041,Blue,0,30241,31360,1119
2022-08-18,70046,70052,Blue,1,33255,33623,368
2022-04-22,70040,70042,Blue,1,32450,32482,32
2022-09-14,70044,70054,Blue,1,55661,56235,574
2022-10-17,70042,70058,Blue,1,55723,56668,945
2022-12-16,70059,70047,Blue,0,32656,33257,601
2022-10-03,70055,70039,Blue,0,44970,45809,839
2022-02-25,70059,70053,Blue,0,67520,67761,241
2022-03-16,70040,70052,Blue,1,82081,82745,664
2022-07-07,70038,70048,Blue,1,22018,22558,540
2022-08-20,70057,70043,Blue,0,56860,57622,762
2022-04-01,70059,70039,Blue,0,56596,57548,952
2022-11-08,70046,70050,Blue,1,31873,32063,190
2022-01-12,70057,70041,Blue,0,22493,23347,854
2022-01-12,70047,70039,Blue,0,84138,84547,409
2022-08-05,70059,70838,Blue,0,64861,65947,1086
2022-02-14,70042,70060,Blue,1,67775,68737,962
2022-07-09,70053,70041,Blue,0,54331,55047,716
2022-05-18,70057,70047,Blue,0,31527,32017,490
2022-12-15,70053,70041,Blue,0,53921,54579,658
2022-04-23,70049,70838,Blue,0,78346,78972,626
2022-01-05,70039,70838,Blue,0,34026,34081,55
2022-03-31,70048,70058,Blue,1,26254,26743,489
2022-12-02,70038,70050,Blue,1,26471,27018,547
2022-09-02,70040,70054,Blue,1,68055,68794,739
2022-10-12,70051,70838,Blue,0,28856,29692,836
2022-01-24,70059,70045,Blue,0,72615,73308,693
2022-03-04,70044,70050,Blue,1,25665,26098,433
2022-12-13,70059,70053,Blue,0,64995,65230,235
2022-02-11,70052,70056,Blue,1,44954,45102,148
2022-10-03,70046,70058,Blue,1,43618,44231,613
2022-10-11,70057,70051,Blue,0,28964,29233,269
2022-01-25,70040,70054,Blue,1,69075,69848,773
2022-12-21,70041,70039,Blue,0,44630,44661,31
2022-10-01,70040,70048,Blue,1,74570,74950,380
2022-07-15,70038,70058,Blue,1,65043,66118,1075
2022-10-30,70040,70048,Blue,1,66748,67168,420
2022-12-31,70059,70043,Blue,0,80122,80965,843
2022-06-16,70039,70838,Blue,0,55301,55438,137
2022-04-15,70048,70060,Blue,1,45290,45955,665
2022-10-31,70038,70048,Blue,1,56499,56997,498
2022-11-25,70058,70060,Blue,1,51260,51319,59
2022-03-15,70044,70060,Blue,1,87472,88578,1106
2022-07-07,70048,70054,Blue,1,42621,42942,321
2022-02-17,70049,70047,Blue,0,80651,80710,59
2022-02-01,70038,70048,Blue,1,75893,76388,495
2022-08-12,70038,70046,Blue,1,51391,51727,336
2022-11-09,70040,70046,Blue,1,68545,68792,247
2022-09-02,70059,70043,Blue,0,39623,40501,878
2022-06-25,70049,70043,Blue,0,67368,67833,465
2022-10-09,70055,70053,Blue,0,55106,55151,45
2022-01-22,70048,70050,Blue,1,44797,44856,59
2022-09-13,70057,70051,Blue,0,82282,82519,237
2022-03-10,70044,70058,Blue,1,61006,61822,816
2022-01-19,70040,70046,Blue,1,51964,52222,258
2022-07-02,70042,70058,Blue,1,51460,52306,846
2022-09-14,70046,70058,Blue,1,21774,22429,655
2022-10-06,70044,70060,Blue,1,34365,35407,1042
2022-01-19,70048,70050,Blue,1,38212,38270,58
2022-11-12,70040,70060,Blue,1,48065,49122,1057
2022-09-08,70055,70043,Blue,0,44904,45576,672
2022-04-14,70048,70056,Blue,1,91370,91771,401
2022-08-14,70044,70050,Blue,1,53931,54267,336
2022-03-10,70045,70838,Blue,0,35996,36308,312
2022-03-24,70046,70060,Blue,1,23122,23939,817
2022-02-07,70050,70054,Blue,1,29144,29365,221
2022-06-15,70057,70043,Blue,0,38738,39572,834
2022-04-08,70050,70052,Blue,1,30877,30990,113
2022-08-06,70038,70058,Blue,1,33970,34961,991
2022-08-20,70044,70056,Blue,1,75835,76514,679
2022-04-16,70051,70045,Blue,0,31261,31652,391
2022-10-24,70048,70052,Blue,1,61687,61888,201
2022-08-27,70042,70052,Blue,1,70304,70913,609
2022-06-26,70051,70039,Blue,0,39261,39944,683
2022-04-12,70040,70058,Blue,1,24018,25152,1134
2022-10-31,70038,70042,Blue,1,21457,21550,93
2022-11-23,70048,70060,Blue,1,49369,49968,599
2022-09-03,70038,70046,Blue,1,42606,42913,307
2022-06-13,70040,70050,Blue,1,69009,69538,529
2022-03-02,70038,70046,Blue,1,71414,71742,328
2022-02-14,70049,70047,Blue,0,46035,46099,64
2022-09-12,70040,70056,Blue,1,64661,65520,859
2022-07-25,70042,70052,Blue,1,35471,36076,605
2022-04-04,70055,70039,Blue,0,28640,29541,901
2022-08-26,70059,70049,Blue,0,24675,25149,474
2022-09-21,70055,70041,Blue,0,52388,53114,726
2022-10-19,70044,70060,Blue,1,56740,57793,1053
2022-02-25,70059,70051,Blue,0,20974,21355,381
2022-07-14,70040,70046,Blue,1,57086,57436,350
2022-02-28,70053,70039,Blue,0,62860,63598,738
2022-09-20,70051,70039,Blue,0,25922,26739,817
2022-09-14,70051,70049,Blue,0,31388,31488,100
2022-10-14,70050,70056,Blue,1,73768,74066,298
2022-07-25,70057,70053,Blue,0,34494,34646,152
2022-10-06,70044,70046,Blue,1,66872,66975,103
2022-01-12,70042,70056,Blue,1,86676,87436,760
2022-08-06,70040,70056,Blue,1,23703,24508,805
2022-06-21,70044,70058,Blue,1,74538,75398,860
2022-08-26,70059,70049,Blue,0,53053,53549,496
2022-06-23,70048,70052,Blue,1,74250,74462,212
2022-10-23,70055,70838,Blue,0,39677,40591,914
2022-12-09,70046,70052,Blue,1,43375,43827,452
2022-06-22,70047,70045,Blue,0,77654,77757,103
2022-09-02,70057,70041,Blue,0,76596,77449,853
2022-03-27,70048,70056,Blue,1,38794,39150,356
2022-01-28,70058,70060,Blue,1,30697,30774,77
2022-01-27,70040,70060,Blue,1,32719,34096,1377
2022-09-07,70041,70838,Blue,0,24064,24202,138
2022-01-07,70046,70058,Blue,1,61722,62335,613
2022-10-24,70052,70058,Blue,1,26044,26299,255
2022-06-18,70044,70050,Blue,1,49981,50454,473
2022-11-05,70047,70039,Blue,0,31487,31900,413
2022-12-03,70059,70041,Blue,0,29322,30283,961
2022-06-24,70057,70051,Blue,0,20029,20273,244
2022-02-08,70038,70042,Blue,1,58629,58744,115
2022-07-10,70047,70045,Blue,0,30731,30822,91
2022-10-31,70055,70043,Blue,0,57925,58600,675
2022-01-25,70055,70045,Blue,0,58295,58872,577
2022-01-27,70052,70060,Blue,1,62099,62521,422
2022-01-14,70047,70039,Blue,0,26762,27167,405
2022-10-14,70053,70049,Blue,0,34177,34360,183
2022-06-25,70052,70056,Blue,1,39736,39885,149
2022-07-17,70046,70058,Blue,1,85025,85760,735
2022-05-06,70052,70058,Blue,1,56535,56779,244
2022-08-20,70059,70045,Blue,0,48140,48862,722
2022-07-27,70048,70058,Blue,1,20416,20943,527
2022-11-19,70056,70060,Blue,1,22097,22297,200
2022-10-25,70040,70048,Blue,1,36871,37270,399
2022-02-02,70049,70043,Blue,0,62537,62939,402
2022-06-19,70040,70044,Blue,1,55397,55515,118
2022-09-13,70038,70044,Blue,1,52346,52550,204
2022-07-11,70040,70046,Blue,1,70478,70763,285
2022-03-10,70038,70044,Blue,1,59838,60034,196
2022-04-21,70038,70048,Blue,1,84932,85428,496
2022-12-12,70059,70039,Blue,0,55644,56713,1069
2022-04-22,70040,70046,Blue,1,22203,22442,239
2022-11-21,70042,70046,Blue,1,33607,33788,181
2022-12-29,70059,70039,Blue,0,63491,64478,987
2022-06-02,70038,70052,Blue,1,27196,28110,914
2022-08-26,70040,70060,Blue,1,77143,78175,1032
2022-03-22,70040,70056,Blue,1,44291,45231,940
2022-12-27,70049,70838,Blue,0,27484,28081,597
2022-02-06,70043,70041,Blue,0,77976,78006,30
2022-01-14,70044,70050,Blue,1,84555,84987,432
2022-06-26,70042,70052,Blue,1,72821,73491,670
2022-07-03,70038,70044,Blue,1,60732,60928,196
2022-08-10,70049,70045,Blue,0,28996,29209,213
2022-02-02,70047,70041,Blue,0,69695,70077,382
2022-02-11,70040,70056,Blue,1,31532,32434,902
2022-01-15,70042,70044,Blue,1,37900,37930,30
2022-04-15,70042,70056,Blue,1,43693,44473,780
2022-11-20,70051,70838,Blue,0,74743,75408,665
2022-03-03,70042,70044,Blue,1,54685,54717,32
2022-02-13,70042,70060,Blue,1,31847,32848,1001
2022-06-09,70048,70054,Blue,1,74555,74864,309
2022-01-15,70039,70838,Blue,0,88571,88606,35
2022-10-27,70049,70838,Blue,0,38706,39371,665
2022-04-07,70053,70047,Blue,0,63468,63744,276
2022-04-14,70056,70058,Blue,1,66798,66868,70
2022-05-30,70038,70048,Blue,1,33907,34505,598
2022-06-21,70049,70043,Blue,0,82037,82410,373
2022-10-20,70053,70049,Blue,0,27405,27592,187
2022-06-07,70040,70044,Blue,1,79880,79988,108
2022-09-23,70042,70048,Blue,1,43037,43360,323
2022-03-02,70055,70045,Blue,0,84812,85327,515
2022-01-28,70059,70041,Blue,0,27853,28770,917
2022-02-19,70040,70060,Blue,1,69130,70176,1046
2022-12-17,70050,70054,Blue,1,41784,42110,326
2022-07-30,70050,70054,Blue,1,62150,62402,252
2022-12-21,70040,70042,Blue,1,48200,48235,35
2022-12-19,70050,70060,Blue,1,72268,72992,724
2022-02-28,70038,70056,Blue,1,65528,66466,938
2022-04-21,70045,70041,Blue,0,27561,27747,186
2022-04-23,70040,70056,Blue,1,27561,28338,777
2022-04-21,70042,70050,Blue,1,30402,30845,443
2022-06-03,70038,70052,Blue,1,66558,67356,798
2022-09-07,70052,70058,Blue,1,25703,25957,254
2022-05-15,70053,70049,Blue,0,80647,80851,204
2022-10-29,70045,70043,Blue,0,50517,50602,85
2022-01-13,70040,70058,Blue,1,56559,57694,1135
2022-12-05,70051,70838,Blue,0,22533,23265,732
2022-01-03,70049,70043,Blue,0,44854,45175,321
2022-07-21,70038,70042,Blue,1,49223,49315,92
2022-08-16,70057,70039,Blue,0,20012,20980,968
2022-07-09,70059,70047,Blue,0,74080,74629,549
2022-03-20,70046,70048,Blue,1,69847,69943,96
2022-03-14,70057,70039,Blue,0,46166,47115,949
2022-07-29,70038,70052,Blue,1,73039,73773,734
2022-01-28,70044,70058,Blue,1,27040,27897,857
2022-10-13,70044,70060,Blue,1,70342,71267,925
2022-06-10,70040,70044,Blue,1,62075,62208,133
2022-03-18,70051,70045,Blue,0,52923,53270,347
2022-02-17,70040,70046,Blue,1,39659,39900,241
2022-06-15,70058,70060,Blue,1,63131,63358,227
2022-07-02,70058,70060,Blue,1,69112,69177,65
2022-02-28,70059,70049,Blue,0,61997,62456,459
2022-03-29,70044,70052,Blue,1,64564,65069,505
2022-08-22,70053,70838,Blue,0,43972,44866,894
2022-03-01,70050,70054,Blue,1,71120,71330,210
2022-12-18,70053,70039,Blue,0,48133,48820,687
2022-04-18,70057,70041,Blue,0,23132,23929,797
2022-07-09,70048,70056,Blue,1,38285,38715,430
2022-09-10,70045,70041,Blue,0,49998,50175,177
2022-03-02,70051,70041,Blue,0,77605,78174,569
2022-08-12,70053,70051,Blue,0,26242,26295,53
2022-03-14,70056,70060,Blue,1,32504,32763,259
2022-06-19,70046,70058,Blue,1,53427,54143,716
2022-08-11,70059,70055,Blue,0,34405,34555,150
2022-07-22,70042,70046,Blue,1,70757,70935,178
2022-04-16,70059,70047,Blue,0,58938,59535,597
2022-10-23,70059,70047,Blue,0,23833,24371,538
2022-06-19,70038,70060,Blue,1,47240,48401,1161
2022-10-13,70048,70060,Blue,1,62049,62680,631
2022-02-11,70049,70041,Blue,0,57093,57516,423
2022-07-01,70040,70054,Blue,1,64024,64976,952
2022-11-29,70059,70045,Blue,0,26662,27391,729
2022-02-28,70052,70056,Blue,1,63012,63144,132
2022-12-16,70040,70060,Blue,1,19995,21126,1131
2022-04-15,70044,70056,Blue,1,66421,67140,719
2022-08-16,70040,70056,Blue,1,73697,74516,819
2022-06-21,70044,70058,Blue,1,65327,66160,833
2022-07-08,70043,70039,Blue,0,89293,89780,487
2022-07-25,70038,70052,Blue,1,71095,71794,699
2022-02-26,70042,70054,Blue,1,67603,68259,656
2022-01-17,70047,70041,Blue,0,51996,52359,363
2022-11-20,70057,70041,Blue,0,58265,59070,805
2022-04-02,70059,70045,Blue,0,21487,22135,648
2022-08-03,70040,70052,Blue,1,58525,59176,651
2022-10-09,70055,70043,Blue,0,21702,22386,684
2022-07-21,70058,70060,Blue,1,27554,27627,73
2022-12-23,70038,70058,Blue,1,70474,71639,1165
2022-12-01,70059,70047,Blue,0,66413,66959,546
2022-03-10,70046,70050,Blue,1,27220,27439,219
2022-01-12,70059,70053,Blue,0,59899,60156,257
2022-01-18,70040,70054,Blue,1,53791,54571,780
2022-02-22,70055,70053,Blue,0,33144,33231,87
2022-09-26,70045,70041,Blue,0,54304,54474,170
2022-06-06,70040,70048,Blue,1,21582,22008,426
2022-12-10,70059,70039,Blue,0,27630,28714,1084
2022-01-17,70053,70039,Blue,0,37204,37991,787
2022-09-11,70048,70054,Blue,1,30478,30775,297
2022-02-24,70047,70039,Blue,0,54467,54982,515
2022-09-06,70057,70041,Blue,0,28118,29035,917
2022-10-05,70059,70045,Blue,0,30570,31307,737
2022-08-12,70040,70042,Blue,1,27879,27915,36
2022-04-03,70057,70051,Blue,0,79066,79308,242
2022-10-01,70039,70838,Blue,0,46622,46655,33
2022-08-16,70054,70056,Blue,1,36722,36770,48
2022-12-17,70038,70042,Blue,1,24311,24422,111
2022-06-23,70041,70838,Blue,0,70254,70410,156
2022-09-30,70038,70046,Blue,1,25661,26008,347
2022-02-26,70040,70044,Blue,1,76187,76306,119
2022-09-25,70057,70055,Blue,0,63708,63779,71
2022-12-15,70059,70838,Blue,0,84035,85208,1173
2022-06-10,70051,70043,Blue,0,30290,30854,564
2022-03-15,70046,70060,Blue,1,81400,82246,846
2022-08-04,70047,70838,Blue,0,65057,65514,457
2022-12-30,70042,70054,Blue,1,57520,58262,742
2022-03-28,70044,70056,Blue,1,31500,32231,731
2022-01-21,70045,70039,Blue,0,31447,31832,385
2022-01-28,70049,70039,Blue,0,61574,62083,509
2022-11-20,70045,70838,Blue,0,46356,46651,295
2022-07-07,70040,70058,Blue,1,50630,51814,1184
2022-07-26,70054,70060,Blue,1,72468,72736,268
2022-11-01,70059,70041,Blue,0,23899,24944,1045
2022-09-23,70057,70045,Blue,0,26027,26743,716
2022-03-10,70045,70043,Blue,0,24510,24603,93
2022-03-17,70047,70041,Blue,0,39922,40266,344
2022-11-15,70055,70053,Blue,0,48568,48613,45
2022-04-28,70053,70051,Blue,0,27915,27975,60
2022-09-29,70049,70047,Blue,0,63557,63616,59
2022-02-26,70053,70045,Blue,0,33338,33787,449
2022-06-22,70053,70043,Blue,0,38814,39442,628
2022-10-12,70044,70060,Blue,1,65748,66668,920
2022-09-21,70038,70052,Blue,1,39654,40368,714
2022-06-24,70042,70044,Blue,1,54209,54239,30
2022-12-02,70053,70047,Blue,0,74722,75054,332
2022-07-02,70048,70058,Blue,1,38825,39328,503
2022-04-08,70038,70042,Blue,1,45893,45995,102
2022-03-26,70050,70052,Blue,1,73400,73570,170
2022-04-17,70049,70047,Blue,0,86088,86144,56
2022-02-14,70059,70047,Blue,0,21012,21564,552
2022-06-17,70053,70043,Blue,0,32036,32690,654
2022-11-03,70051,70838,Blue,0,34692,35454,762
2022-02-13,70044,70048,Blue,1,83940,84165,225
2022-08-18,70041,70838,Blue,0,54315,54451,136
2022-12-14,70059,70041,Blue,0,30142,31162,1020
2022-05-11,70050,70054,Blue,1,59101,59317,216
2022-06-27,70046,70052,Blue,1,85094,85469,375
2022-09-05,70048,70050,Blue,1,70920,70975,55
2022-04-25,70059,70049,Blue,0,21496,22000,504
2022-11-29,70043,70039,Blue,0,46157,46262,105
2022-04-03,70045,70039,Blue,0,72539,72779,240
2022-02-26,70059,70838,Blue,0,55153,56324,1171
2022-04-28,70057,70051,Blue,0,52002,52265,263
2022-02-14,70059,70039,Blue,0,57203,58200,997
2022-12-07,70038,70044,Blue,1,44538,44710,172
2022-11-21,70040,70042,Blue,1,62350,62380,30
2022-08-13,70055,70053,Blue,0,38592,38654,62
2022-12-19,70038,70046,Blue,1,36676,37049,373
2022-08-22,70053,70045,Blue,0,32089,32533,444
2022-12-02,70046,70056,Blue,1,25158,25646,488
2022-10-17,70055,70043,Blue,0,20598,21239,641
2022-03-11,70055,70039,Blue,0,52718,53563,845
2022-02-11,70053,70045,Blue,0,42328,42747,419
2022-05-18,70049,70039,Blue,0,83504,84191,687
2022-10-24,70042,70060,Blue,1,65262,66241,979
2022-12-08,70046,70056,Blue,1,76990,77470,480
2022-03-06,70052,70060,Blue,1,47576,47972,396
2022-10-20,70040,70050,Blue,1,63331,63819,488
2022-04-07,70059,70041,Blue,0,63797,64659,862
2022-10-17,70057,70041,Blue,0,44129,45073,944
2022-04-13,70057,70041,Blue,0,62673,63540,867
2022-11-21,70049,70045,Blue,0,72595,72786,191
2022-07-01,70059,70053,Blue,0,58126,58354,228
2022-06-21,70040,70056,Blue,1,51136,52104,968
2022-12-31,70055,70051,Blue,0,69483,69616,133
2022-05-30,70043,70039,Blue,0,77011,77108,97
2022-02-11,70040,70058,Blue,1,86215,87314,1099
2022-01-27,70040,70050,Blue,1,60223,60728,505
2022-04-13,70059,70043,Blue,0,66148,67045,897
2022-06-26,70042,70060,Blue,1,59466,60640,1174
2022-02-28,70044,70052,Blue,1,38146,38654,508
2022-12-08,70041,70838,Blue,0,58190,58318,128
2022-03-07,70047,70045,Blue,0,60551,60672,121
2022-01-02,70038,70042,Blue,1,58075,58178,103
2022-07-03,70044,70060,Blue,1,72293,73230,937
2022-12-26,70059,70043,Blue,0,53839,54760,921
2022-03-07,70044,70048,Blue,1,84539,84811,272
2022-07-14,70057,70043,Blue,0,64408,65293,885
2022-10-24,70057,70051,Blue,0,53618,53873,255
2022-09-02,70059,70043,Blue,0,32009,33320,1311
2022-09-30,70050,70060,Blue,1,58206,58741,535
2022-02-16,70049,70041,Blue,0,59840,60294,454
2022-06-14,70045,70043,Blue,0,52849,52955,106
2022-08-01,70040,70048,Blue,1,60753,61134,381
2022-12-21,70040,70058,Blue,1,56118,57122,1004
2022-06-29,70046,70060,Blue,1,32579,33438,859
2022-04-11,70042,70060,Blue,1,61805,62812,1007
2022-09-06,70045,70039,Blue,0,49253,49524,271
2022-09-29,70042,70058,Blue,1,73326,74181,855
2022-04-15,70047,70039,Blue,0,58152,58587,435
2022-03-12,70049,70047,Blue,0,29187,29241,54
2022-07-08,70046,70060,Blue,1,81713,82436,723
2022-10-29,70041,70039,Blue,0,41593,41629,36
2022-10-15,70057,70041,Blue,0,41749,42706,957
2022-03-19,70042,70048,Blue,1,55739,56069,330
2022-04-21,70043,70039,Blue,0,77013,77130,117
2022-10-13,70042,70060,Blue,1,32966,34040,1074
2022-09-17,70040,70058,Blue,1,21078,21998,920
2022-04-22,70047,70043,Blue,0,74969,75239,270
2022-04-07,70059,70051,Blue,0,26653,26964,311
2022-09-08,70041,70838,Blue,0,35812,35931,119
2022-07-22,70057,70051,Blue,0,38559,38811,252
2022-11-20,70040,70056,Blue,1,81748,82611,863
2022-04-14,70038,70042,Blue,1,80927,81034,107
2022-10-21,70052,70060,Blue,1,34004,34358,354
2022-06-30,70038,70060,Blue,1,25097,26376,1279
2022-11-21,70039,70838,Blue,0,27011,27044,33
2022-02-18,70045,70838,Blue,0,24775,25166,391
2022-01-28,70047,70043,Blue,0,58078,58336,258
2022-11-24,70059,70051,Blue,0,76514,76837,323
2022-03-29,70042,70046,Blue,1,22925,23113,188
2022-02-05,70051,70039,Blue,0,82055,82747,692
2022-01-31,70055,70041,Blue,0,56182,56945,763
2022-08-12,70042,70046,Blue,1,71204,71378,174
2022-06-06,70049,70045,Blue,0,80034,80251,217
2022-09-07,70048,70056,Blue,1,27007,27426,419
2022-06-08,70047,70838,Blue,0,75816,76301,485
2022-05-08,70055,70049,Blue,0,40424,40693,269
2022-11-04,70059,70039,Blue,0,57241,58465,1224
2022-01-28,70050,70058,Blue,1,57645,58069,424
2022-09-17,70045,70039,Blue,0,58641,58898,257
2022-10-02,70056,70058,Blue,1,40593,40661,68
2022-11-25,70038,70046,Blue,1,28583,28905,322
2022-07-26,70059,70049,Blue,0,65751,66257,506
2022-04-22,70057,70047,Blue,0,27047,27564,517
2022-09-12,70059,70043,Blue,0,76040,76857,817
2022-01-13,70045,70039,Blue,0,53309,53566,257
2022-01-03,70040,70056,Blue,1,19907,20738,831
2022-06-24,70053,70049,Blue,0,36696,37001,305
2022-03-24,70040,70050,Blue,1,41334,41866,532
2022-02-27,70053,70051,Blue,0,30341,30387,46
2022-03-01,70044,70050,Blue,1,42681,43083,402
2022-11-12,70050,70060,Blue,1,29688,30197,509
2022-12-10,70050,70054,Blue,1,87955,88162,207
2022-07-30,70054,70056,Blue,1,63561,63608,47
2022-01-10,70052,70056,Blue,1,25980,26122,142
2022-01-20,70042,70044,Blue,1,51496,51524,28
2022-01-19,70048,70058,Blue,1,56112,56672,560
2022-11-02,70044,70060,Blue,1,86752,87607,855
2022-08-05,70045,70039,Blue,0,66801,67062,261
2022-10-20,70055,70051,Blue,0,65861,65995,134
2022-06-02,70040,70046,Blue,1,54157,54471,314
2022-07-11,70059,70051,Blue,0,65028,65368,340
2022-07-05,70059,70055,Blue,0,85759,85909,150
2022-12-12,70046,70058,Blue,1,48734,49446,712
2022-02-05,70038,70056,Blue,1,28028,28840,812
2022-09-22,70055,70045,Blue,0,29915,30532,617
2022-08-06,70052,70060,Blue,1,82981,83385,404
2022-10-14,70042,70046,Blue,1,69098,69268,170
2022-02-27,70039,70838,Blue,0,79347,79383,36
2022-09-15,70053,70047,Blue,0,30425,30740,315
2022-06-21,70059,70055,Blue,0,53148,53299,151
2022-06-26,70059,70043,Blue,0,33237,34150,913
2022-07-29,70057,70051,Blue,0,74592,74847,255
2022-02-27,70054,70060,Blue,1,75084,75354,270
2022-08-27,70057,70838,Blue,0,45518,46539,1021
2022-11-01,70055,70051,Blue,0,57394,57540,146
2022-03-28,70049,70043,Blue,0,20375,20709,334
2022-11-01,70048,70060,Blue,1,46655,47274,619
2022-06-13,70059,70045,Blue,0,68495,69196,701
2022-01-12,70042,70052,Blue,1,42822,43379,557
2022-10-25,70038,70046,Blue,1,46728,47040,312
2022-10-30,70057,70043,Blue,0,53920,54721,801
2022-01-26,70049,70838,Blue,0,54980,55704,724
2022-10-04,70055,70047,Blue,0,72975,73335,360
2022-02-10,70048,70052,Blue,1,21473,21678,205
2022-10-07,70041,70039,Blue,0,28188,28220,32
2022-08-03,70047,70039,Blue,0,72407,72793,386
2022-09-14,70050,70060,Blue,1,83244,83780,536
2022-11-02,70038,70050,Blue,1,88206,88779,573
2022-04-10,70053,70041,Blue,0,66523,67196,673
2022-11-19,70053,70045,Blue,0,79368,79793,425
2022-02-11,70038,70060,Blue,1,64542,65691,1149
2022-11-07,70049,70047,Blue,0,20487,20548,61
2022-02-14,70053,70039,Blue,0,86034,86760,726
2022-03-01,70054,70056,Blue,1,50173,50220,47
2022-04-24,70038,70040,Blue,1,73123,73138,15
2022-08-03,70057,70041,Blue,0,87401,88203,802
2022-09-10,70046,70058,Blue,1,28968,29576,608
2022-07-21,70059,70049,Blue,0,70215,70762,547
2022-06-11,70052,70058,Blue,1,55377,55631,254
2022-04-27,70054,70058,Blue,1,78114,78278,164
2022-09-15,70052,70060,Blue,1,37511,37894,383
2022-07-30,70040,70042,Blue,1,52965,53001,36
2022-07-01,70057,70838,Blue,0,63596,64640,1044
2022-11-30,70044,70046,Blue,1,25358,25470,112
2022-05-18,70042,70058,Blue,1,71313,72273,960
2022-04-23,70059,70039,Blue,0,77851,78889,1038
2022-04-24,70046,70054,Blue,1,38724,39141,417
2022-08-01,70055,70039,Blue,0,22916,23748,832
2022-06-30,70059,70057,Blue,0,42400,42450,50
2022-07-23,70055,70045,Blue,0,30502,31024,522
2022-12-22,70050,70054,Blue,1,82556,82783,227
2022-06-29,70059,70053,Blue,0,62731,62950,219
2022-11-02,70040,70048,Blue,1,24088,24464,376
2022-03-22,70055,70041,Blue,0,62386,63255,869
2022-04-20,70043,70039,Blue,0,72920,73021,101
2022-08-19,70057,70053,Blue,0,66631,66787,156
2022-02-12,70049,70041,Blue,0,21381,21835,454
2022-10-08,70050,70052,Blue,1,24218,24332,114
2022-07-11,70055,70049,Blue,0,34124,34422,298
2022-12-28,70039,70838,Blue,0,31646,31685,39
2022-01-03,70040,70050,Blue,1,71723,72184,461
2022-01-25,70040,70046,Blue,1,31856,32148,292
2022-07-20,70040,70058,Blue,1,67749,69279,1530
2022-04-05,70055,70043,Blue,0,23837,24468,631
2022-11-08,70046,70050,Blue,1,59086,59290,204
2022-01-17,70050,70060,Blue,1,69678,70190,512
2022-07-16,70051,70039,Blue,0,18859,19564,705
2022-03-26,70052,70060,Blue,1,35281,35632,351
2022-08-02,70055,70041,Blue,0,52523,53327,804
2022-02-24,70044,70056,Blue,1,82914,83642,728
2022-12-20,70054,70058,Blue,1,32393,32595,202
2022-04-14,70051,70047,Blue,0,51075,51313,238
2022-12-09,70047,70039,Blue,0,23268,23736,468
2022-01-19,70059,70043,Blue,0,66796,67631,835
2022-08-05,70052,70054,Blue,1,80480,80545,65
2022-11-17,70043,70041,Blue,0,36836,36864,28
2022-02-09,70044,70046,Blue,1,63368,63473,105
2022-11-21,70054,70060,Blue,1,35828,36134,306
2022-04-23,70055,70838,Blue,0,38634,39585,951
2022-03-09,70055,70043,Blue,0,76211,76952,741
2022-07-13,70055,70047,Blue,0,24438,24809,371
2022-01-07,70053,70051,Blue,0,72399,72467,68
2022-11-17,70059,70049,Blue,0,39014,39584,570
2022-10-11,70042,70044,Blue,1,34686,34714,28
2022-11-14,70059,70039,Blue,0,29405,30463,1058
2022-04-22,70053,70838,Blue,0,63753,64613,860
2022-09-28,70048,70052,Blue,1,59600,59802,202
2022-12-30,70059,70053,Blue,0,53285,53503,218
2022-03-06,70042,70052,Blue,1,27032,27576,544
2022-05-15,70053,70047,Blue,0,48263,48535,272
2022-07-18,70050,70058,Blue,1,30937,31355,418
2022-04-21,70047,70838,Blue,0,65000,65510,510
2022-08-03,70059,70051,Blue,0,83911,84207,296
2022-06-18,70044,70054,Blue,1,32047,32684,637
2022-12-20,70042,70052,Blue,1,50273,51081,808
2022-01-18,70057,70055,Blue,0,46706,46774,68
2022-07-04,70055,70045,Blue,0,67340,67860,520
2022-03-18,70045,70041,Blue,0,82542,82716,174
2022-11-04,70038,70040,Blue,1,32760,32775,15
2022-03-07,70046,70056,Blue,1,21470,21992,522
2022-03-04,70059,70041,Blue,0,24257,25168,911
2022-07-28,70048,70056,Blue,1,26702,27122,420
2022-08-15,70059,70053,Blue,0,43923,44167,244
2022-08-10,70056,70058,Blue,1,45115,45188,73
2022-11-22,70038,70060,Blue,1,79392,80438,1046
2022-07-29,70039,70838,Blue,0,73521,73552,31
2022-12-09,70057,70051,Blue,0,71863,72114,251
2022-03-08,70055,70039,Blue,0,57082,57978,896
2022-08-24,70059,70055,Blue,0,74129,74269,140
2022-07-01,70038,70048,Blue,1,23987,24473,486
2022-11-04,70053,70047,Blue,0,25657,26007,350
2022-08-27,70044,70060,Blue,1,85833,87050,1217
2022-03-04,70053,70838,Blue,0,58381,59216,835
2022-09-10,70041,70039,Blue,0,76847,76883,36
2022-12-24,70044,70046,Blue,1,33624,33735,111
2022-04-19,70046,70058,Blue,1,34279,34942,663
2022-02-24,70046,70052,Blue,1,84699,85020,321
2022-04-11,70041,70039,Blue,0,31068,31106,38
2022-03-20,70053,70041,Blue,0,55711,56357,646
2022-07-11,70059,70045,Blue,0,52810,53528,718
2022-03-14,70038,70040,Blue,1,61626,61644,18
2022-03-04,70042,70044,Blue,1,51801,51829,28
2022-10-05,70053,70041,Blue,0,60623,61332,709
2022-02-08,70040,70056,Blue,1,82709,83541,832
2022-06-04,70038,70048,Blue,1,74055,74604,549
2022-12-23,70057,70043,Blue,0,60478,61398,920
2022-04-05,70055,70041,Blue,0,29540,30282,742
2022-08-31,70053,70047,Blue,0,21103,21399,296
2022-03-20,70050,70058,Blue,1,56982,57395,413
2022-09-09,70044,70048,Blue,1,83763,84004,241
2022-12-03,70059,70039,Blue,0,84013,85071,1058
2022-07-06,70051,70041,Blue,0,18802,19442,640
2022-02-20,70057,70045,Blue,0,21583,22282,699
2022-08-10,70059,70049,Blue,0,20414,20880,466
2022-06-27,70047,70043,Blue,0,74147,74440,293
2022-10-14,70045,70039,Blue,0,28887,29155,268
2022-02-01,70040,70046,Blue,1,73570,73825,255
2022-10-21,70057,70049,Blue,0,44338,44709,371
2022-08-23,70042,70054,Blue,1,61303,62030,727
2022-10-03,70050,70054,Blue,1,54647,54862,215
2022-07-27,70055,70051,Blue,0,68841,68971,130
2022-09-29,70055,70049,Blue,0,52699,52995,296
2022-06-14,70054,70058,Blue,1,46839,46999,160
2022-12-13,70045,70039,Blue,0,69487,69722,235
2022-05-08,70053,70047,Blue,0,77080,77367,287
2022-02-26,70047,70041,Blue,0,27729,28059,330
2022-01-04,70042,70050,Blue,1,22268,22732,464
2022-09-18,70038,70046,Blue,1,67344,67683,339
2022-07-11,70052,70060,Blue,1,52751,53131,380
2022-10-24,70048,70056,Blue,1,68693,69056,363
2022-07-02,70052,70060,Blue,1,88916,89256,340
2022-06-26,70048,70054,Blue,1,67755,68067,312
2022-12-30,70057,70838,Blue,0,81290,82391,1101
2022-07-08,70059,70838,Blue,0,19936,21037,1101
2022-03-02,70042,70056,Blue,1,65032,65885,853
2022-10-23,70046,70050,Blue,1,34255,34427,172
2022-04-23,70044,70054,Blue,1,65580,66216,636
2022-07-29,70054,70060,Blue,1,74476,74734,258
2022-06-23,70038,70052,Blue,1,47656,48384,728
2022-11-07,70052,70060,Blue,1,78062,78428,366
2022-06-25,70038,70050,Blue,1,74357,74991,634
2022-06-16,70055,70838,Blue,0,88400,89687,1287
2022-08-06,70038,70042,Blue,1,58273,58373,100
2022-07-23,70053,70045,Blue,0,47352,47807,455
2022-01-24,70053,70045,Blue,0,54176,54609,433
2022-09-09,70043,70838,Blue,0,34414,34606,192
2022-12-21,70059,70041,Blue,0,28763,29760,997
2022-06-17,70044,70050,Blue,1,42591,42968,377
2022-01-28,70051,70045,Blue,0,77530,77863,333
2022-02-14,70042,70048,Blue,1,28022,28344,322
2022-06-04,70049,70047,Blue,0,44178,44247,69
2022-12-29,70053,70045,Blue,0,49715,50190,475
2022-12-21,70038,70054,Blue,1,22694,23459,765
2022-08-15,70059,70045,Blue,0,83463,84145,682
2022-02-14,70053,70049,Blue,0,59575,59780,205
2022-08-28,70045,70043,Blue,0,38298,38397,99
2022-03-08,70038,70060,Blue,1,50288,51370,1082
2022-06-14,70048,70052,Blue,1,29827,30036,209
2022-10-14,70046,70058,Blue,1,39864,40537,673
2022-11-12,70057,70838,Blue,0,24216,25253,1037
2022-02-18,70042,70056,Blue,1,77600,78356,756
2022-10-26,70051,70045,Blue,0,85366,85689,323
2022-07-28,70051,70041,Blue,0,33458,34059,601
2022-06-03,70038,70040,Blue,1,26233,26250,17
2022-11-18,70049,70045,Blue,0,50004,50240,236
2022-11-01,70038,70042,Blue,1,62227,62360,133
2022-09-19,70040,70060,Blue,1,54197,55338,1141
2022-11-24,70048,70060,Blue,1,74722,75324,602
2022-08-22,70047,70043,Blue,0,49112,49350,238
2022-01-13,70047,70039,Blue,0,61511,61946,435
2022-09-26,70043,70041,Blue,0,57657,57686,29
2022-05-03,70050,70052,Blue,1,31106,31219,113
2022-10-10,70038,70046,Blue,1,40450,40774,324
2022-04-08,70051,70047,Blue,0,86092,86283,191
2022-07-17,70040,70044,Blue,1,28529,28651,122
2022-11-20,70042,70048,Blue,1,25454,25732,278
2022-08-28,70046,70048,Blue,1,49750,49831,81
2022-04-13,70051,70049,Blue,0,52150,52271,121
2022-08-28,70040,70052,Blue,1,73313,73992,679
2022-09-29,70057,70041,Blue,0,24928,25836,908
2022-10-16,70059,70057,Blue,0,42796,42831,35
2022-03-27,70052,70060,Blue,1,57307,57649,342
2022-08-09,70046,70060,Blue,1,71962,72709,747
2022-06-19,70044,70050,Blue,1,42509,42906,397
2022-12-08,70038,70044,Blue,1,75211,75412,201
2022-10-03,70059,70045,Blue,0,33072,34182,1110
2022-09-22,70050,70060,Blue,1,34250,34768,518
2022-03-17,70056,70060,Blue,1,66394,66864,470
2022-03-11,70038,70058,Blue,1,42440,43491,1051
2022-02-20,70053,70049,Blue,0,56258,56441,183
2022-02-26,70053,70838,Blue,0,61406,62250,844
2022-03-31,70057,70041,Blue,0,31233,32116,883
2022-03-14,70046,70048,Blue,1,63830,63902,72
2022-07-06,70054,70058,Blue,1,64882,65043,161
2022-03-02,70046,70052,Blue,1,33038,33392,354
2022-10-20,70048,70054,Blue,1,48176,48487,311
2022-08-16,70057,70055,Blue,0,57271,57339,68
2022-10-13,70040,70056,Blue,1,50890,51713,823
2022-10-19,70038,70046,Blue,1,22927,23257,330
2022-03-15,70057,70041,Blue,0,41608,42508,900
2022-09-17,70051,70047,Blue,0,62006,62202,196
2022-06-08,70042,70052,Blue,1,28335,29122,787
2022-04-11,70040,70060,Blue,1,74710,75764,1054
2022-09-14,70042,70054,Blue,1,53507,54214,707
2022-03-09,70057,70041,Blue,0,18899,19900,1001
2022-04-04,70046,70056,Blue,1,51184,51732,548
2022-10-11,70049,70039,Blue,0,74320,74809,489
2022-04-07,70059,70838,Blue,0,49754,50922,1168
2022-08-13,70039,70838,Blue,0,36455,36498,43
2022-12-08,70057,70055,Blue,0,40719,40788,69
2022-10-19,70056,70058,Blue,1,63238,63306,68
2022-07-02,70057,70838,Blue,0,66580,67629,1049
2022-11-21,70046,70058,Blue,1,24302,24916,614
2022-09-15,70049,70045,Blue,0,59279,59476,197
2022-03-19,70046,70052,Blue,1,57590,57931,341
2022-03-29,70044,70050,Blue,1,51387,51726,339
2022-06-28,70048,70054,Blue,1,33354,33672,318
2022-12-26,70057,70039,Blue,0,80996,81944,948
2022-03-06,70056,70060,Blue,1,29313,29478,165
2022-06-23,70045,70041,Blue,0,65025,65208,183
2022-12-06,70057,70047,Blue,0,86746,87220,474
2022-03-22,70059,70838,Blue,0,74365,75540,1175
2022-07-09,70048,70058,Blue,1,42624,43104,480
2022-12-16,70046,70058,Blue,1,33638,34290,652
2022-11-13,70051,70043,Blue,0,64972,65416,444
2022-09-06,70052,70056,Blue,1,33336,33477,141
2022-02-03,70042,70052,Blue,1,82480,83027,547
2022-03-01,70039,70838,Blue,0,52325,52413,88
2022-03-04,70038,70058,Blue,1,72973,74021,1048
2022-06-26,70057,70053,Blue,0,69582,69735,153
2022-01-13,70052,70054,Blue,1,47787,47842,55
2022-10-20,70055,70039,Blue,0,38713,39541,828
2022-08-17,70038,70058,Blue,1,23901,24920,1019
2022-06-18,70043,70039,Blue,0,72268,72379,111
2022-04-18,70042,70044,Blue,1,72572,72606,34
2022-02-28,70053,70043,Blue,0,23925,24483,558
2022-07-04,70053,70043,Blue,0,70550,71159,609
2022-08-26,70053,70041,Blue,0,22429,23114,685
2022-03-01,70050,70054,Blue,1,72557,72763,206
2022-07-24,70059,70039,Blue,0,27743,28711,968
2022-12-16,70046,70056,Blue,1,57499,58028,529
2022-09-08,70038,70056,Blue,1,47670,48564,894
2022-04-21,70046,70058,Blue,1,87502,88121,619
2022-04-11,70046,70060,Blue,1,24323,25108,785
2022-08-03,70040,70052,Blue,1,82905,83563,658
2022-11-03,70048,70056,Blue,1,73663,74053,390
2022-11-07,70055,70049,Blue,0,22757,23036,279
2022-07-15,70044,70046,Blue,1,62157,62260,103
2022-10-27,70049,70838,Blue,0,87849,88430,581
2022-10-20,70050,70056,Blue,1,32126,32425,299
2022-12-01,70040,70042,Blue,1,28635,28670,35
2022-01-01,70055,70045,Blue,0,62144,62692,548
2022-04-19,70053,70049,Blue,0,43500,43738,238
2022-07-02,70055,70051,Blue,0,69439,69584,145
2022-06-23,70059,70053,Blue,0,70571,70813,242
2022-05-29,70041,70838,Blue,0,74279,74403,124
2022-08-05,70038,70056,Blue,1,39512,40463,951
2022-07-08,70050,70058,Blue,1,66936,67352,416
2022-04-22,70039,70838,Blue,0,50832,50868,36
2022-09-13,70038,70054,Blue,1,26936,27719,783
2022-12-11,70046,70052,Blue,1,48720,49047,327
2022-08-10,70055,70039,Blue,0,39694,40592,898
2022-02-09,70042,70054,Blue,1,59093,59733,640
2022-06-13,70046,70050,Blue,1,88098,88264,166
2022-10-02,70040,70056,Blue,1,44359,45176,817
2022-06-29,70038,70056,Blue,1,76777,77749,972
2022-09-23,70057,70055,Blue,0,58588,58657,69
2022-10-04,70059,70045,Blue,0,76452,77122,670
2022-10-01,70045,70838,Blue,0,57019,57401,382
2022-07-20,70057,70053,Blue,0,24390,24543,153
2022-07-22,70042,70052,Blue,1,73825,74358,533
2022-07-24,70059,70838,Blue,0,24646,25702,1056
2022-07-29,70044,70060,Blue,1,56544,57498,954
2022-11-24,70057,70045,Blue,0,53909,54723,814
2022-08-22,70041,70039,Blue,0,49877,49918,41
2022-08-23,70057,70055,Blue,0,23107,23177,70
2022-08-18,70038,70042,Blue,1,72413,72508,95
2022-09-03,70038,70058,Blue,1,43213,44183,970
2022-01-05,70043,70041,Blue,0,21175,21204,29
2022-04-11,70056,70060,Blue,1,63789,64043,254
2022-03-24,70057,70045,Blue,0,73361,74029,668
2022-06-17,70049,70039,Blue,0,77183,77696,513
2022-07-22,70059,70057,Blue,0,33084,33121,37
2022-12-06,70049,70045,Blue,0,66131,66343,212
2022-03-23,70049,70047,Blue,0,32719,32772,53
2022-04-30,70051,70047,Blue,0,38247,38574,327
2022-11-13,70040,70044,Blue,1,51071,51195,124
2022-08-09,70047,70043,Blue,0,68196,68440,244
2022-01-20,70046,70050,Blue,1,61987,62179,192
2022-01-09,70057,70055,Blue,0,54997,55067,70
2022-12-24,70042,70052,Blue,1,37907,38485,578
2022-02-23,70042,70056,Blue,1,69129,69901,772
2022-01-12,70059,70041,Blue,0,33794,34693,899
2022-07-12,70059,70047,Blue,0,55107,55682,575
2022-09-06,70054,70058,Blue,1,58946,59108,162
2022-09-06,70047,70039,Blue,0,33714,34137,423
2022-10-13,70055,70039,Blue,0,79047,79894,847
2022-09-22,70040,70042,Blue,1,81409,81444,35
2022-04-08,70059,70047,Blue,0,76037,76600,563
2022-12-31,70046,70052,Blue,1,65926,66269,343
2022-03-16,70057,70838,Blue,0,25897,27006,1109
2022-11-25,70055,70838,Blue,0,80056,80942,886
2022-01-19,70053,70049,Blue,0,29687,29944,257
2022-09-05,70042,70052,Blue,1,81852,82395,543
2022-08-18,70055,70045,Blue,0,49672,50293,621
2022-11-19,70044,70048,Blue,1,65097,65347,250
2022-12-14,70040,70052,Blue,1,41760,42411,651
2022-04-04,70055,70041,Blue,0,21876,22697,821
2022-10-29,70050,70056,Blue,1,68597,69073,476
2022-08-21,70046,70054,Blue,1,51946,52372,426
2022-12-26,70045,70039,Blue,0,26875,27101,226
2022-01-11,70038,70042,Blue,1,48092,48182,90
2022-01-11,70059,70039,Blue,0,39255,40371,1116
2022-11-10,70057,70055,Blue,0,26799,26868,69
2022-01-19,70052,70056,Blue,1,87282,87420,138
2022-11-11,70051,70838,Blue,0,85656,86372,716
2022-11-13,70048,70060,Blue,1,82220,82835,615
2022-01-15,70040,70050,Blue,1,63058,63605,547
2022-06-14,70050,70052,Blue,1,72089,72205,116
2022-05-19,70049,70039,Blue,0,75389,76036,647
2022-04-27,70049,70047,Blue,0,57434,57482,48
2022-02-25,70055,70838,Blue,0,77952,78873,921
2022-02-18,70042,70048,Blue,1,35523,35870,347
2022-01-08,70045,70039,Blue,0,81422,81658,236
2022-01-17,70038,70052,Blue,1,19869,20738,869
2022-12-08,70040,70060,Blue,1,58637,59737,1100
2022-10-20,70045,70838,Blue,0,70680,71028,348
2022-05-14,70054,70058,Blue,1,26886,27038,152
2022-11-30,70040,70042,Blue,1,27366,27402,36
2022-03-10,70038,70040,Blue,1,34445,34466,21
2022-12-14,70044,70046,Blue,1,82909,83012,103
2022-01-31,70046,70050,Blue,1,82079,82270,191
2022-03-03,70053,70043,Blue,0,68782,69421,639
2022-08-25,70042,70048,Blue,1,23254,23567,313
2022-03-08,70057,70041,Blue,0,29147,30104,957
2022-07-01,70050,70058,Blue,1,30118,30536,418
2022-02-15,70038,70044,Blue,1,52447,52635,188
2022-10-15,70042,70046,Blue,1,21171,21350,179
2022-11-11,70042,70052,Blue,1,62501,63092,591
2022-01-26,70045,70043,Blue,0,55631,55742,111
2022-02-21,70038,70060,Blue,1,55608,56808,1200
2022-06-21,70040,70054,Blue,1,51693,52550,857
2022-01-21,70042,70058,Blue,1,51519,52424,905
2022-12-30,70049,70039,Blue,0,81076,81543,467
2022-02-24,70050,70054,Blue,1,62572,62772,200
2022-03-18,70043,70039,Blue,0,80286,80404,118
2022-09-11,70048,70054,Blue,1,74176,74502,326
2022-10-29,70047,70045,Blue,0,53631,53723,92
2022-10-06,70059,70838,Blue,0,70221,71334,1113
2022-03-23,70055,70041,Blue,0,32872,33655,783
2022-08-19,70051,70039,Blue,0,41223,41955,732
2022-11-03,70046,70058,Blue,1,63151,63790,639
2022-09-16,70050,70054,Blue,1,82543,82737,194
2022-09-10,70046,70054,Blue,1,38139,38559,420
2022-01-22,70057,70051,Blue,0,46054,46317,263
2022-03-29,70043,70039,Blue,0,68698,68816,118
2022-04-25,70055,70049,Blue,0,47889,48207,318
2022-04-18,70048,70054,Blue,1,34475,34809,334
2022-10-24,70053,70838,Blue,0,25838,26815,977
2022-04-12,70054,70056,Blue,1,22309,22356,47
2022-01-10,70038,70040,Blue,1,77472,77491,19
2022-08-23,70044,70048,Blue,1,66543,66770,227
2022-02-02,70053,70838,Blue,0,79161,79977,816
2022-07-07,70044,70050,Blue,1,23632,24023,391
2022-01-20,70044,70052,Blue,1,65748,66260,512
2022-01-12,70046,70056,Blue,1,60649,61188,539
2022-04-22,70048,70052,Blue,1,27121,27348,227
2022-10-09,70042,70052,Blue,1,66820,67420,600
2022-04-12,70057,70045,Blue,0,42773,43552,779
2022-04-08,70042,70056,Blue,1,47691,48463,772
2022-02-08,70042,70050,Blue,1,89301,89686,385
2022-11-07,70059,70051,Blue,0,50539,50857,318
2022-12-06,70042,70050,Blue,1,69114,69512,398
2022-06-27,70059,70049,Blue,0,43156,43713,557
2022-10-11,70045,70041,Blue,0,24625,24794,169
2022-09-24,70051,70041,Blue,0,44708,45333,625
2022-08-18,70042,70056,Blue,1,33473,34210,737
2022-11-24,70050,70058,Blue,1,67800,68233,433
2022-02-11,70057,70039,Blue,0,53180,54195,1015
2022-07-17,70059,70039,Blue,0,30854,31821,967
2022-09-13,70040,70046,Blue,1,65635,65888,253
2022-06-02,70049,70047,Blue,0,40365,40430,65
2022-03-25,70057,70043,Blue,0,69587,70367,780
2022-03-07,70040,70052,Blue,1,64398,65057,659
2022-08-04,70051,70039,Blue,0,45090,45782,692
2022-09-07,70039,70838,Blue,0,72291,72328,37
2022-09-16,70044,70056,Blue,1,46399,47105,706
2022-08-05,70049,70838,Blue,0,70085,70737,652
2022-10-28,70058,70060,Blue,1,41010,41103,93
2022-03-19,70050,70058,Blue,1,29674,30070,396
2022-12-12,70055,70041,Blue,0,22763,23522,759
2022-02-07,70053,70049,Blue,0,59273,59509,236
2022-08-07,70051,70039,Blue,0,80705,81404,699
2022-11-28,70048,70056,Blue,1,67412,67789,377
2022-06-15,70040,70046,Blue,1,62313,62684,371
2022-07-22,70050,70058,Blue,1,66939,67366,427
2022-04-01,70055,70047,Blue,0,33807,34227,420
2022-05-24,70049,70047,Blue,0,29942,29996,54
2022-06-16,70041,70039,Blue,0,56981,57012,31
2022-10-29,70038,70058,Blue,1,64334,65390,1056
2022-01-09,70052,70054,Blue,1,71009,71067,58
2022-09-12,70038,70058,Blue,1,49755,50713,958
2022-06-20,70053,70043,Blue,0,58489,59304,815
2022-04-29,70053,70049,Blue,0,84271,84496,225
2022-01-17,70052,70060,Blue,1,75824,76204,380
2022-02-12,70053,70051,Blue,0,32779,32838,59
2022-10-28,70053,70049,Blue,0,19891,20128,237
2022-04-05,70057,70043,Blue,0,73295,74071,776
2022-07-14,70044,70052,Blue,1,60643,61186,543
2022-04-03,70052,70058,Blue,1,53966,54225,259
2022-01-27,70038,70042,Blue,1,42972,43065,93
2022-01-31,70045,70838,Blue,0,56263,56679,416
2022-04-10,70045,70039,Blue,0,69716,69959,243
2022-03-04,70047,70039,Blue,0,31518,31965,447
2022-09-02,70059,70055,Blue,0,57726,57870,144
2022-11-13,70053,70047,Blue,0,84869,85156,287
2022-09-27,70038,70042,Blue,1,32900,32991,91
2022-12-19,70050,70060,Blue,1,77744,78329,585
2022-12-22,70055,70041,Blue,0,36362,37175,813
2022-03-17,70053,70043,Blue,0,64052,64611,559
2022-03-24,70042,70046,Blue,1,69365,69535,170
2022-05-18,70048,70054,Blue,1,48325,48664,339
2022-07-08,70054,70058,Blue,1,63273,63430,157
2022-07-03,70059,70043,Blue,0,32412,33261,849
2022-02-15,70047,70039,Blue,0,77233,77681,448
2022-11-02,70044,70052,Blue,1,42552,43033,481
2022-08-01,70042,70060,Blue,1,27048,28029,981
2022-04-23,70051,70049,Blue,0,52273,52376,103
2022-10-02,70049,70838,Blue,0,47923,48575,652
2022-12-07,70051,70838,Blue,0,32092,32897,805
2022-07-07,70040,70060,Blue,1,80526,81672,1146
2022-01-25,70057,70051,Blue,0,63265,63496,231
2022-09-06,70040,70042,Blue,1,70765,70794,29
2022-03-01,70042,70052,Blue,1,73135,73713,578
2022-08-15,70047,70039,Blue,0,32429,32910,481
2022-10-13,70045,70043,Blue,0,88096,88184,88
2022-10-15,70059,70041,Blue,0,36295,37262,967
2022-09-12,70057,70055,Blue,0,61428,61497,69
2022-02-23,70051,70047,Blue,0,63553,63741,188
2022-01-26,70059,70055,Blue,0,30853,31000,147
2022-07-23,70055,70049,Blue,0,37533,37829,296
2022-08-05,70059,70047,Blue,0,59295,59838,543
2022-10-22,70055,70051,Blue,0,26329,26470,141
2022-03-03,70040,70058,Blue,1,33315,34205,890
2022-08-06,70059,70045,Blue,0,78436,79127,691
2022-08-18,70053,70049,Blue,0,62893,63074,181
2022-01-09,70040,70054,Blue,1,24608,25370,762
2022-03-21,70044,70054,Blue,1,27168,27748,580
2022-08-15,70048,70052,Blue,1,77838,78043,205
2022-02-16,70053,70039,Blue,0,69760,70490,730
2022-02-02,70042,70046,Blue,1,63616,63799,183
2022-12-10,70053,70049,Blue,0,83457,83660,203
2022-09-30,70055,70053,Blue,0,48551,48596,45
2022-06-05,70038,70040,Blue,1,70700,70715,15
2022-05-22,70046,70050,Blue,1,43390,43629,239
2022-09-25,70047,70043,Blue,0,64672,64901,229
2022-03-09,70049,70838,Blue,0,66133,66734,601
2022-03-24,70053,70049,Blue,0,19801,19999,198
2022-07-22,70043,70041,Blue,0,86686,86714,28
2022-09-28,70051,70838,Blue,0,59173,59904,731
2022-03-13,70048,70052,Blue,1,57999,58205,206
2022-03-20,70057,70838,Blue,0,62442,63533,1091
2022-04-01,70043,70041,Blue,0,82626,82655,29
2022-08-08,70042,70046,Blue,1,56830,57010,180
2022-08-21,70053,70043,Blue,0,34242,34844,602
2022-04-04,70044,70060,Blue,1,27803,28773,970
2022-09-28,70038,70056,Blue,1,80071,80907,836
2022-01-14,70042,70050,Blue,1,79902,80361,459
2022-02-21,70051,70045,Blue,0,48012,48369,357
2022-10-14,70049,70041,Blue,0,29412,29848,436
2022-03-16,70055,70043,Blue,0,58560,59283,723
2022-12-09,70049,70045,Blue,0,33696,33890,194
2022-11-29,70059,70039,Blue,0,72254,73189,935
2022-10-17,70057,70047,Blue,0,28184,28712,528
2022-07-02,70059,70051,Blue,0,22159,22485,326
2022-10-09,70049,70045,Blue,0,73846,74051,205
2022-06-11,70040,70044,Blue,1,89192,89306,114
2022-03-01,70055,70051,Blue,0,20773,20904,131
2022-10-17,70051,70047,Blue,0,48337,48530,193
2022-02-23,70055,70838,Blue,0,50419,51358,939
2022-07-01,70043,70838,Blue,0,37362,37555,193
2022-09-01,70047,70041,Blue,0,39524,39948,424
2022-01-23,70048,70050,Blue,1,79094,79158,64
2022-03-17,70055,70838,Blue,0,83656,84531,875
2022-04-13,70055,70838,Blue,0,33452,34420,968
2022-12-16,70050,70058,Blue,1,67589,68006,417
2022-04-08,70042,70060,Blue,1,67797,69017,1220
2022-11-22,70046,70050,Blue,1,55602,55770,168
2022-01-12,70051,70838,Blue,0,58464,59241,777
2022-08-22,70057,70043,Blue,0,46892,47684,792
2022-01-17,70038,70052,Blue,1,35093,35848,755
2022-02-19,70042,70060,Blue,1,64888,65834,946
2022-02-08,70040,70060,Blue,1,68002,69094,1092
2022-07-19,70038,70048,Blue,1,26924,27382,458
2022-03-06,70042,70060,Blue,1,58178,59123,945
2022-03-22,70057,70045,Blue,0,67236,67883,647
2022-10-26,70052,70056,Blue,1,68203,68339,136
2022-11-28,70057,70055,Blue,0,30562,30635,73
2022-02-11,70042,70052,Blue,1,62117,62670,553
2022-11-14,70050,70054,Blue,1,62779,62968,189
2022-10-07,70047,70838,Blue,0,71269,71731,462
2022-09-29,70053,70041,Blue,0,57495,58180,685
2022-09-26,70055,70051,Blue,0,41865,42030,165
2022-02-14,70059,70043,Blue,0,31152,32109,957
2022-11-24,70049,70043,Blue,0,86949,87295,346
2022-12-30,70044,70058,Blue,1,45826,46592,766
2022-06-08,70044,70050,Blue,1,86624,87025,401
2022-09-22,70043,70041,Blue,0,30416,30446,30
2022-12-12,70041,70039,Blue,0,64200,64231,31
2022-04-13,70054,70060,Blue,1,39850,40226,376
2022-04-09,70057,70838,Blue,0,70355,71378,1023
2022-08-02,70049,70043,Blue,0,62211,62573,362
2022-07-07,70045,70043,Blue,0,43037,43144,107
2022-08-02,70047,70043,Blue,0,25800,26090,290
2022-11-02,70038,70048,Blue,1,21453,21893,440
2022-10-18,70055,70049,Blue,0,35087,35397,310
2022-02-19,70053,70047,Blue,0,41394,41672,278
2022-04-20,70048,70052,Blue,1,31729,31940,211
2022-01-31,70042,70046,Blue,1,61471,61648,177
2022-01-04,70046,70056,Blue,1,27999,28546,547
2022-01-28,70041,70838,Blue,0,59687,59848,161
2022-08-31,70059,70053,Blue,0,68660,68893,233
2022-12-25,70042,70058,Blue,1,43764,44608,844
2022-12-19,70040,70048,Blue,1,33136,34247,1111
2022-01-31,70046,70056,Blue,1,68065,68578,513
2022-06-21,70051,70049,Blue,0,73731,73834,103
2022-03-02,70044,70052,Blue,1,20970,21527,557
2022-04-15,70054,70060,Blue,1,28946,29294,348
2022-01-16,70042,70060,Blue,1,28579,29469,890
2022-07-17,70041,70039,Blue,0,74334,74373,39
2022-09-20,70057,70049,Blue,0,77008,77396,388
2022-07-11,70042,70056,Blue,1,84805,85567,762
2022-11-07,70042,70044,Blue,1,35687,35824,137
2022-03-25,70040,70054,Blue,1,68646,69500,854
2022-04-21,70052,70054,Blue,1,22562,22621,59
2022-07-10,70059,70039,Blue,0,57616,58658,1042
2022-02-13,70059,70838,Blue,0,54915,56037,1122
2022-08-20,70038,70054,Blue,1,37273,38126,853
2022-11-30,70057,70051,Blue,0,20015,20272,257
2022-07-16,70051,70049,Blue,0,54455,54558,103
2022-03-21,70059,70838,Blue,0,31763,32838,1075
2022-05-06,70055,70053,Blue,0,74603,74650,47
2022-08-12,70042,70048,Blue,1,31323,31656,333
2022-07-30,70046,70054,Blue,1,62472,62921,449
2022-09-02,70055,70039,Blue,0,24868,25753,885
2022-03-21,70048,70056,Blue,1,69889,70369,480
2022-12-18,70050,70052,Blue,1,56993,57107,114
2022-09-16,70049,70045,Blue,0,29801,30005,204
2022-08-02,70040,70044,Blue,1,32464,32569,105
2022-07-15,70055,70039,Blue,0,29489,30406,917
2022-09-19,70055,70045,Blue,0,24410,24976,566
2022-12-02,70051,70039,Blue,0,88483,89769,1286
2022-04-24,70055,70045,Blue,0,73992,74495,503
2022-03-09,70042,70054,Blue,1,68380,69056,676
2022-01-07,70049,70043,Blue,0,62265,62602,337
2022-10-15,70044,70056,Blue,1,47796,48492,696
2022-09-20,70046,70048,Blue,1,32711,32793,82
2022-06-18,70054,70058,Blue,1,82237,82394,157
2022-03-24,70046,70050,Blue,1,43452,43630,178
2022-03-25,70051,70838,Blue,0,24063,24907,844
2022-07-30,70057,70045,Blue,0,71971,72580,609
2022-08-04,70042,70048,Blue,1,59279,59618,339
2022-10-07,70055,70043,Blue,0,53176,53838,662
2022-07-31,70047,70041,Blue,0,38141,38492,351
2022-09-27,70038,70048,Blue,1,27297,27750,453
2022-06-14,70055,70047,Blue,0,49409,49822,413
2022-04-15,70055,70047,Blue,0,64899,65300,401
2022-02-06,70045,70039,Blue,0,40296,40577,281
2022-08-16,70059,70049,Blue,0,47843,48304,461
2022-03-16,70046,70060,Blue,1,62643,63395,752
2022-11-16,70055,70049,Blue,0,54260,54529,269
2022-12-12,70053,70049,Blue,0,26685,26887,202
2022-05-13,70057,70055,Blue,0,32306,32374,68
2022-11-29,70046,70056,Blue,1,41933,42464,531
2022-04-12,70042,70060,Blue,1,48216,49113,897
2022-01-18,70040,70058,Blue,1,34503,35828,1325
2022-01-03,70053,70041,Blue,0,62425,63337,912
2022-12-15,70038,70060,Blue,1,39865,41111,1246
2022-04-22,70045,70039,Blue,0,40830,41156,326
2022-01-24,70057,70039,Blue,0,65062,65992,930
2022-09-27,70048,70060,Blue,1,75725,76323,598
2022-07-14,70052,70060,Blue,1,63720,64157,437
2022-06-23,70046,70056,Blue,1,23981,24533,552
2022-02-16,70047,70039,Blue,0,23115,23578,463
2022-01-12,70055,70051,Blue,0,59774,59914,140
2022-03-11,70046,70052,Blue,1,25040,25403,363
2022-02-15,70055,70051,Blue,0,57375,57506,131
2022-08-31,70055,70045,Blue,0,20596,21097,501
2022-11-02,70038,70050,Blue,1,70506,71053,547
2022-06-10,70059,70041,Blue,0,82874,83773,899
2022-07-03,70046,70048,Blue,1,91344,91438,94
2022-01-26,70059,70049,Blue,0,42683,43228,545
2022-07-04,70045,70039,Blue,0,64877,65141,264
2022-08-08,70044,70050,Blue,1,65835,66168,333
2022-12-02,70049,70047,Blue,0,64537,64593,56
2022-08-08,70053,70051,Blue,0,42124,42180,56
2022-04-25,70059,70057,Blue,0,24256,24291,35
2022-11-30,70050,70058,Blue,1,73294,73893,599
2022-01-14,70048,70056,Blue,1,52426,52797,371
2022-06-09,70038,70042,Blue,1,70074,70177,103
2022-08-03,70049,70047,Blue,0,69693,69748,55
2022-03-11,70043,70838,Blue,0,40320,40532,212
2022-01-08,70059,70039,Blue,0,80672,81658,986
2022-08-21,70042,70058,Blue,1,56583,57492,909
2022-11-15,70057,70053,Blue,0,72879,73036,157
2022-06-20,70053,70051,Blue,0,58489,58543,54
2022-04-14,70040,70042,Blue,1,21123,21159,36
2022-08-01,70053,70047,Blue,0,61116,61420,304
2022-04-18,70059,70838,Blue,0,88112,89210,1098
2022-06-27,70059,70043,Blue,0,75729,76639,910
2022-09-27,70044,70054,Blue,1,63632,64206,574
2022-10-22,70053,70043,Blue,0,55445,56075,630
2022-02-09,70045,70043,Blue,0,31017,31134,117
2022-10-16,70055,70043,Blue,0,42983,43646,663
2022-12-22,70059,70041,Blue,0,57562,58638,1076
2022-08-06,70044,70050,Blue,1,45546,45874,328
2022-06-30,70050,70054,Blue,1,32200,32432,232
2022-07-28,70049,70043,Blue,0,38998,39389,391
2022-01-04,70042,70050,Blue,1,28005,28439,434
2022-08-30,70055,70049,Blue,0,30753,31027,274
2022-07-18,70040,70060,Blue,1,32751,33889,1138
2022-03-23,70056,70060,Blue,1,21775,22092,317
2022-04-18,70057,70047,Blue,0,62195,62658,463
2022-02-12,70044,70060,Blue,1,75368,76250,882
2022-04-01,70046,70058,Blue,1,50150,50741,591
2022-03-23,70046,70060,Blue,1,36177,37051,874
2022-03-26,70059,70039,Blue,0,49218,50277,1059
2022-07-31,70051,70047,Blue,0,34340,34527,187
2022-03-28,70044,70058,Blue,1,59799,60577,778
2022-12-15,70045,70039,Blue,0,38364,38645,281
2022-02-14,70050,70056,Blue,1,31497,31801,304
2022-09-17,70042,70058,Blue,1,41749,42648,899
2022-10-26,70057,70043,Blue,0,25186,26097,911
2022-01-27,70059,70049,Blue,0,32961,33519,558
2022-07-31,70044,70048,Blue,1,63666,63924,258
2022-06-13,70053,70049,Blue,0,26364,26569,205
2022-08-21,70055,70051,Blue,0,72912,73050,138
2022-01-17,70052,70060,Blue,1,38543,38902,359
2022-06-22,70050,70060,Blue,1,64152,64736,584
2022-05-25,70048,70052,Blue,1,57980,58259,279
2022-09-07,70047,70045,Blue,0,64398,64491,93
2022-09-11,70048,70050,Blue,1,32883,32939,56
2022-10-16,70051,70041,Blue,0,52032,52621,589
2022-10-27,70057,70045,Blue,0,35387,36053,666
2022-10-07,70038,70042,Blue,1,45178,45268,90
2022-02-11,70052,70056,Blue,1,67151,67283,132
2022-09-20,70040,70052,Blue,1,57643,58379,736
2022-01-21,70046,70052,Blue,1,22002,22541,539
2022-07-19,70038,70046,Blue,1,59115,59541,426
2022-03-01,70043,70039,Blue,0,63991,64185,194
2022-06-19,70049,70045,Blue,0,40023,40236,213
2022-08-29,70040,70050,Blue,1,78378,78865,487
2022-12-20,70049,70047,Blue,0,74753,74807,54
2022-06-14,70051,70043,Blue,0,29479,30015,536
2022-03-11,70040,70050,Blue,1,59288,59792,504
2022-07-14,70047,70043,Blue,0,36028,36301,273
2022-11-16,70057,70047,Blue,0,21565,22139,574
2022-10-14,70057,70039,Blue,0,58287,59238,951
2022-11-13,70049,70041,Blue,0,50046,50453,407
2022-08-20,70038,70048,Blue,1,33978,34423,445
2022-09-24,70041,70039,Blue,0,76759,76793,34
2022-08-30,70047,70838,Blue,0,29127,29667,540
2022-07-01,70055,70045,Blue,0,69585,70096,511
2022-06-16,70038,70044,Blue,1,66868,67042,174
2022-11-28,70059,70053,Blue,0,41633,41900,267
2022-08-06,70053,70045,Blue,0,71083,71498,415
2022-08-31,70055,70041,Blue,0,34690,35440,750
2022-07-17,70051,70043,Blue,0,74733,75241,508
2022-09-21,70045,70838,Blue,0,44973,45298,325
2022-03-07,70054,70056,Blue,1,64408,64455,47
2022-04-17,70044,70048,Blue,1,54487,54733,246
2022-08-11,70044,70046,Blue,1,66208,66311,103
2022-10-03,70059,70047,Blue,0,29295,29908,613
2022-12-26,70051,70043,Blue,0,61257,61724,467
2022-10-03,70053,70045,Blue,0,44450,44911,461
2022-02-04,70053,70838,Blue,0,79183,80048,865
2022-04-06,70053,70047,Blue,0,57628,57918,290
2022-05-21,70053,70047,Blue,0,70900,71224,324
2022-12-13,70054,70056,Blue,1,26034,26073,39
2022-06-26,70038,70042,Blue,1,70455,70548,93
2022-04-02,70044,70058,Blue,1,33081,33866,785
2022-11-06,70040,70060,Blue,1,52162,53134,972
2022-09-21,70052,70058,Blue,1,51354,51593,239
2022-10-05,70040,70048,Blue,1,91058,91433,375
2022-11-18,70040,70044,Blue,1,64886,65003,117
2022-01-15,70059,70043,Blue,0,74472,75303,831
2022-01-31,70055,70838,Blue,0,33021,34122,1101
2022-08-05,70050,70052,Blue,1,59974,60092,118
2022-09-01,70040,70050,Blue,1,76399,76908,509
2022-04-13,70038,70056,Blue,1,23054,23943,889
2022-09-07,70055,70043,Blue,0,40402,41134,732
2022-03-05,70055,70051,Blue,0,47782,47910,128
2022-01-27,70056,70058,Blue,1,62540,62612,72
2022-12-07,70057,70047,Blue,0,85891,86355,464
2022-11-02,70055,70045,Blue,0,20128,20697,569
2022-08-04,70055,70045,Blue,0,87489,88103,614
2022-09-19,70059,70047,Blue,0,22237,22820,583
2022-01-26,70047,70045,Blue,0,70645,70743,98
2022-12-02,70055,70838,Blue,0,38292,39248,956
2022-01-06,70050,70056,Blue,1,72020,72314,294
2022-04-29,70050,70058,Blue,1,88524,88901,377
2022-07-24,70051,70049,Blue,0,74447,74552,105
2022-12-11,70055,70838,Blue,0,63196,64081,885
2022-12-29,70046,70060,Blue,1,64360,65135,775
2022-03-02,70043,70838,Blue,0,45889,46086,197
2022-12-22,70038,70048,Blue,1,29834,30321,487
2022-03-04,70043,70041,Blue,0,78640,78670,30
2022-03-19,70057,70838,Blue,0,31530,32596,1066
2022-07-04,70057,70055,Blue,0,31475,31546,71
2022-07-29,70059,70039,Blue,0,79115,80095,980
2022-04-01,70046,70060,Blue,1,64966,65773,807
2022-03-05,70050,70054,Blue,1,30769,30973,204
2022-09-12,70042,70052,Blue,1,22383,22927,544
2022-04-06,70040,70054,Blue,1,53437,54371,934
2022-11-12,70051,70049,Blue,0,24502,24605,103
2022-02-08,70052,70058,Blue,1,34963,35203,240
2022-03-05,70039,70838,Blue,0,60549,60581,32
2022-07-18,70044,70052,Blue,1,62408,62902,494
2022-06-12,70053,70838,Blue,0,65434,66282,848
2022-03-22,70058,70060,Blue,1,70466,70671,205
2022-12-06,70048,70056,Blue,1,80801,81190,389
2022-11-28,70041,70838,Blue,0,86944,87065,121
2022-01-19,70059,70049,Blue,0,55395,55886,491
2022-03-23,70038,70056,Blue,1,46948,47898,950
2022-03-02,70055,70051,Blue,0,76835,77014,179
2022-02-17,70042,70044,Blue,1,35145,35175,30
2022-03-25,70052,70058,Blue,1,64862,65105,243
2022-01-12,70051,70047,Blue,0,71353,71533,180
2022-12-19,70042,70056,Blue,1,83946,84699,753
2022-08-19,70046,70054,Blue,1,61446,61881,435
2022-03-18,70057,70055,Blue,0,31412,31484,72
2022-10-01,70059,70055,Blue,0,81496,81636,140
2022-04-19,70038,70056,Blue,1,89628,91646,2018
2022-11-11,70057,70049,Blue,0,26852,27237,385
2022-09-04,70057,70055,Blue,0,52296,52365,69
2022-11-13,70059,70047,Blue,0,55454,55993,539
2022-04-10,70053,70043,Blue,0,55722,56289,567
2022-04-05,70057,70051,Blue,0,37099,37492,393
2022-06-29,70038,70042,Blue,1,66850,66957,107
2022-01-27,70053,70049,Blue,0,37399,37661,262
2022-10-14,70053,70039,Blue,0,30832,31599,767
2022-12-08,70040,70048,Blue,1,26953,27335,382
2022-12-25,70042,70056,Blue,1,71134,71861,727
2022-06-09,70042,70048,Blue,1,22927,23291,364
2022-10-17,70038,70052,Blue,1,39852,40520,668
2022-03-13,70042,70048,Blue,1,58188,58524,336
2022-12-28,70057,70039,Blue,0,81887,82789,902
2022-08-26,70053,70039,Blue,0,40875,41690,815
2022-12-11,70042,70058,Blue,1,37177,38085,908
2022-05-19,70052,70060,Blue,1,59522,59893,371
2022-10-15,70055,70053,Blue,0,85031,85076,45
2022-02-06,70059,70039,Blue,0,47361,48460,1099
2022-07-03,70059,70039,Blue,0,40817,41919,1102
2022-05-27,70050,70052,Blue,1,73244,73495,251
2022-11-04,70049,70045,Blue,0,82629,82821,192
2022-01-12,70047,70045,Blue,0,85277,85384,107
2022-02-01,70057,70055,Blue,0,28549,28621,72
2022-03-13,70053,70049,Blue,0,81145,81336,191
2022-12-24,70053,70047,Blue,0,85120,85421,301
2022-01-07,70053,70051,Blue,0,31441,31508,67
2022-11-22,70042,70056,Blue,1,35444,36214,770
2022-07-09,70042,70050,Blue,1,41688,42126,438
2022-08-05,70059,70043,Blue,0,57624,58526,902
2022-08-11,70038,70048,Blue,1,21078,21562,484
2022-01-23,70055,70041,Blue,0,76681,77423,742
2022-03-24,70048,70050,Blue,1,31085,31144,59
2022-11-24,70055,70041,Blue,0,85682,86382,700
2022-09-16,70057,70039,Blue,0,33998,34893,895
2022-02-26,70041,70838,Blue,0,50189,50303,114
2022-02-01,70052,70060,Blue,1,53473,53980,507
2022-07-06,70040,70060,Blue,1,77353,78500,1147
2022-12-30,70044,70054,Blue,1,60116,60697,581
2022-04-13,70049,70047,Blue,0,77690,77745,55
2022-04-11,70040,70056,Blue,1,29720,30685,965
2022-02-18,70046,70052,Blue,1,41107,41506,399
2022-03-24,70057,70049,Blue,0,49829,50211,382
2022-12-22,70040,70054,Blue,1,87815,88563,748
2022-01-14,70040,70060,Blue,1,69966,71016,1050
2022-08-23,70041,70838,Blue,0,56754,56902,148
2022-06-10,70053,70045,Blue,0,78081,78512,431
2022-07-12,70059,70039,Blue,0,48855,49930,1075
2022-02-25,70040,70042,Blue,1,76389,76421,32
2022-11-30,70059,70045,Blue,0,82864,83541,677
2022-02-28,70049,70047,Blue,0,50934,51002,68
2022-12-02,70038,70050,Blue,1,36438,37043,605
2022-12-20,70042,70058,Blue,1,69524,70505,981
2022-10-29,70038,70060,Blue,1,38287,39396,1109
2022-07-12,70047,70041,Blue,0,42818,43177,359
2022-04-05,70044,70054,Blue,1,28671,29272,601
2022-02-27,70044,70046,Blue,1,89331,89437,106
2022-02-08,70049,70838,Blue,0,46074,46709,635
2022-11-22,70038,70044,Blue,1,88207,88379,172
2022-01-28,70042,70060,Blue,1,56666,57701,1035
2022-08-24,70044,70058,Blue,1,46493,47352,859
2022-03-19,70043,70041,Blue,0,33398,33425,27
2022-04-08,70047,70838,Blue,0,41598,42186,588
2022-09-20,70041,70838,Blue,0,25283,25402,119
2022-11-23,70053,70838,Blue,0,31544,32368,824
2022-10-24,70052,70054,Blue,1,79814,79862,48
2022-11-22,70054,70056,Blue,1,39174,39222,48
2022-10-27,70055,70049,Blue,0,57953,58229,276
2022-07-01,70057,70047,Blue,0,69025,69554,529
2022-06-19,70053,70049,Blue,0,87593,87785,192
2022-08-11,70053,70049,Blue,0,53811,54018,207
2022-10-01,70053,70049,Blue,0,66781,66987,206
2022-08-06,70044,70052,Blue,1,78836,79348,512
2022-10-18,70042,70052,Blue,1,35911,36474,563
2022-11-17,70048,70050,Blue,1,70574,70639,65
2022-03-18,70049,70045,Blue,0,73107,73302,195
2022-04-17,70059,70055,Blue,0,46357,46496,139
2022-10-30,70044,70048,Blue,1,89389,89626,237
2022-09-19,70051,70045,Blue,0,50914,51315,401
2022-07-28,70053,70838,Blue,0,70477,71314,837
2022-03-15,70057,70838,Blue,0,30656,32177,1521
2022-02-12,70049,70043,Blue,0,47043,47451,408
2022-01-27,70057,70055,Blue,0,55477,55585,108
2022-03-25,70044,70056,Blue,1,81663,82287,624
2022-02-18,70047,70039,Blue,0,33292,33718,426
2022-07-21,70055,70838,Blue,0,26154,27262,1108
2022-08-01,70053,70047,Blue,0,66275,66549,274
2022-05-20,70039,70838,Blue,0,33247,33277,30
2022-03-05,70057,70045,Blue,0,51457,52170,713
2022-08-30,70038,70054,Blue,1,22395,23179,784
2022-06-22,70057,70039,Blue,0,65847,66843,996
2022-03-11,70038,70056,Blue,1,65862,66831,969
2022-12-19,70040,70042,Blue,1,31568,31605,37
2022-02-01,70043,70039,Blue,0,48180,48296,116
2022-02-21,70047,70838,Blue,0,67093,67585,492
2022-04-11,70040,70056,Blue,1,76415,77288,873
2022-09-21,70038,70054,Blue,1,35777,36546,769
2022-07-04,70053,70039,Blue,0,53306,54066,760
2022-10-29,70054,70056,Blue,1,57513,57560,47
2022-12-03,70045,70838,Blue,0,33819,34164,345
2022-03-15,70048,70052,Blue,1,55036,55241,205
2022-12-21,70042,70046,Blue,1,21842,22015,173
2022-06-28,70042,70052,Blue,1,48382,49001,619
2022-06-04,70049,70043,Blue,0,89051,89613,562
2022-09-30,70059,70041,Blue,0,47363,48378,1015
2022-06-22,70048,70050,Blue,1,31672,31729,57
2022-12-13,70053,70045,Blue,0,48649,49166,517
2022-07-29,70053,70039,Blue,0,24971,25778,807
2022-07-12,70043,70039,Blue,0,43148,43263,115
2022-12-29,70053,70051,Blue,0,59078,59138,60
2022-06-10,70048,70054,Blue,1,75311,75629,318
2022-01-12,70049,70041,Blue,0,31425,32027,602
2022-03-30,70046,70056,Blue,1,27032,27551,519
2022-08-05,70043,70838,Blue,0,59703,59898,195
2022-06-20,70038,70044,Blue,1,55457,55632,175
2022-12-17,70044,70052,Blue,1,28800,29286,486
2022-08-13,70046,70048,Blue,1,22733,22810,77
2022-06-27,70038,70040,Blue,1,34301,34321,20
2022-10-05,70055,70051,Blue,0,61515,61658,143
2022-12-27,70046,70048,Blue,1,24526,24608,82
2022-03-10,70044,70054,Blue,1,69670,70349,679
2022-04-15,70057,70045,Blue,0,77258,78051,793
2022-06-23,70038,70050,Blue,1,29683,30258,575
2022-10-04,70059,70041,Blue,0,70077,70950,873
2022-11-28,70041,70838,Blue,0,42660,42788,128
2022-12-27,70040,70046,Blue,1,72802,73077,275
2022-04-12,70053,70045,Blue,0,60154,60601,447
2022-07-04,70038,70048,Blue,1,46980,47464,484
2022-12-31,70048,70060,Blue,1,38770,39382,612
2022-09-12,70055,70045,Blue,0,36125,36724,599
2022-05-30,70041,70838,Blue,0,78537,78669,132
2022-02-15,70040,70050,Blue,1,34824,35375,551
2022-01-25,70057,70049,Blue,0,56370,56785,415
2022-08-26,70041,70838,Blue,0,32445,32573,128
2022-12-26,70040,70052,Blue,1,65118,65750,632
2022-11-28,70057,70053,Blue,0,70299,70450,151
2022-10-26,70048,70054,Blue,1,60817,61109,292
2022-04-21,70054,70056,Blue,1,46620,46666,46
2022-12-17,70053,70041,Blue,0,52243,52905,662
2022-02-19,70045,70043,Blue,0,69421,69551,130
2022-08-05,70054,70058,Blue,1,52030,52186,156
2022-09-04,70042,70050,Blue,1,23180,23609,429
2022-03-26,70048,70054,Blue,1,61552,61965,413
2022-03-21,70046,70052,Blue,1,57810,58217,407
2022-12-12,70038,70052,Blue,1,79959,80625,666
2022-01-21,70044,70056,Blue,1,50996,51703,707
2022-04-02,70057,70039,Blue,0,48747,49716,969
2022-04-01,70059,70838,Blue,0,72435,73688,1253
2022-09-25,70040,70058,Blue,1,67271,68226,955
2022-04-17,70049,70838,Blue,0,24372,25021,649
2022-02-10,70046,70058,Blue,1,25043,25750,707
2022-08-21,70054,70058,Blue,1,65349,65520,171
2022-01-01,70059,70053,Blue,0,68515,68752,237
2022-01-04,70054,70056,Blue,1,43739,43786,47
2022-04-21,70059,70049,Blue,0,48192,48646,454
2022-02-19,70059,70049,Blue,0,71905,72444,539
2022-01-08,70038,70050,Blue,1,82948,83518,570
2022-08-14,70038,70052,Blue,1,54787,55517,730
2022-03-28,70052,70054,Blue,1,40313,40392,79
2022-03-10,70043,70041,Blue,0,76326,76353,27
2022-10-05,70048,70060,Blue,1,75406,75979,573
2022-11-27,70052,70056,Blue,1,59875,60018,143
2022-06-11,70046,70054,Blue,1,40943,41356,413
2022-11-24,70057,70838,Blue,0,47432,48453,1021
2022-12-09,70044,70054,Blue,1,46837,47378,541
2022-03-10,70051,70047,Blue,0,54866,55060,194
2022-10-28,70047,70838,Blue,0,88009,88577,568
2022-08-25,70057,70055,Blue,0,22655,22723,68
2022-02-22,70049,70838,Blue,0,30512,31246,734
2022-07-27,70046,70056,Blue,1,71449,71994,545
2022-09-21,70050,70056,Blue,1,24002,24302,300
2022-10-28,70048,70050,Blue,1,58209,58265,56
2022-10-14,70039,70838,Blue,0,58301,58385,84
2022-02-02,70045,70838,Blue,0,26287,26681,394
2022-09-12,70052,70054,Blue,1,30964,31012,48
2022-06-20,70045,70041,Blue,0,58732,58919,187
2022-10-30,70052,70060,Blue,1,75517,75875,358
2022-07-04,70040,70042,Blue,1,58745,58777,32
2022-06-13,70047,70043,Blue,0,25503,25801,298
2022-06-07,70047,70838,Blue,0,68957,69541,584
2022-10-16,70049,70045,Blue,0,70526,70732,206
2022-06-25,70048,70054,Blue,1,45352,45672,320
2022-07-20,70045,70043,Blue,0,71899,71995,96
2022-10-10,70048,70054,Blue,1,21629,21945,316
2022-04-06,70038,70044,Blue,1,59731,59904,173
2022-04-16,70055,70049,Blue,0,48335,48667,332
2022-09-25,70051,70045,Blue,0,63730,64074,344
2022-09-19,70053,70838,Blue,0,29618,30589,971
2022-08-28,70053,70838,Blue,0,53027,53961,934
2022-02-14,70055,70043,Blue,0,23266,23993,727
2022-05-24,70044,70052,Blue,1,80710,81400,690
2022-02-06,70057,70838,Blue,0,58766,59784,1018
2022-11-16,70041,70039,Blue,0,28720,28753,33
2022-11-09,70044,70046,Blue,1,46869,46976,107
2022-11-18,70053,70045,Blue,0,84534,84980,446
2022-03-05,70047,70041,Blue,0,59557,59863,306
2022-02-21,70050,70052,Blue,1,22960,23084,124
2022-06-18,70049,70047,Blue,0,70758,70812,54
2022-02-12,70040,70048,Blue,1,25714,26091,377
2022-12-06,70044,70054,Blue,1,27613,28199,586
2022-01-04,70043,70838,Blue,0,83725,83904,179
2022-08-20,70041,70039,Blue,0,43318,43360,42
2022-03-15,70047,70045,Blue,0,66771,66880,109
2022-05-25,70046,70048,Blue,1,55951,56060,109
2022-02-19,70040,70056,Blue,1,32957,33764,807
2022-01-19,70052,70058,Blue,1,37066,37345,279
2022-10-21,70059,70838,Blue,0,88126,89777,1651
2022-01-20,70056,70058,Blue,1,86265,86334,69
2022-04-07,70055,70039,Blue,0,29266,30195,929
2022-02-13,70059,70043,Blue,0,70039,70937,898
2022-01-23,70050,70054,Blue,1,62976,63210,234
2022-09-21,70038,70046,Blue,1,45154,45478,324
2022-03-03,70057,70838,Blue,0,58166,59191,1025
2022-07-25,70042,70054,Blue,1,70130,70862,732
2022-07-17,70038,70056,Blue,1,89114,90054,940
2022-01-03,70044,70046,Blue,1,37572,37677,105
2022-06-06,70042,70050,Blue,1,53798,54357,559
2022-03-15,70047,70043,Blue,0,51334,51576,242
2022-09-17,70057,70041,Blue,0,74685,75650,965
2022-03-08,70042,70058,Blue,1,81869,82838,969
2022-02-01,70053,70043,Blue,0,20550,21273,723
2022-11-05,70038,70044,Blue,1,38845,39045,200
2022-11-07,70046,70054,Blue,1,55292,55748,456
2022-12-07,70059,70049,Blue,0,74355,74878,523
2022-12-20,70046,70058,Blue,1,30141,30835,694
2022-12-23,70040,70060,Blue,1,25330,26458,1128
2022-06-20,70040,70042,Blue,1,56417,56452,35
2022-01-20,70038,70042,Blue,1,67072,67190,118
2022-09-23,70053,70039,Blue,0,62268,63001,733
2022-11-01,70046,70056,Blue,1,65552,66130,578
2022-09-29,70038,70060,Blue,1,76163,77349,1186
2022-03-04,70059,70051,Blue,0,40423,40777,354
2022-06-09,70055,70053,Blue,0,25373,25438,65
2022-04-19,70057,70047,Blue,0,33867,34417,550
2022-11-16,70053,70049,Blue,0,40265,40478,213
2022-06-01,70038,70048,Blue,1,26234,26712,478
2022-11-05,70038,70042,Blue,1,29117,29203,86
2022-02-03,70040,70054,Blue,1,61673,62525,852
2022-04-09,70053,70043,Blue,0,43019,43624,605
2022-08-25,70049,70041,Blue,0,54829,55267,438
2022-08-20,70052,70058,Blue,1,44559,44867,308
2022-07-19,70051,70049,Blue,0,70687,70788,101
2022-08-21,70057,70051,Blue,0,34832,35075,243
2022-10-24,70055,70039,Blue,0,49029,49850,821
2022-07-09,70040,70048,Blue,1,45371,45787,416
2022-02-18,70040,70054,Blue,1,67398,68142,744
2022-03-20,70042,70056,Blue,1,53599,54367,768
2022-09-30,70050,70054,Blue,1,63890,64124,234
2022-06-09,70042,70058,Blue,1,25890,26742,852
2022-02-02,70059,70041,Blue,0,26059,27092,1033
2022-04-06,70045,70039,Blue,0,48933,49185,252
2022-01-11,70057,70049,Blue,0,67226,67618,392
2022-10-09,70059,70049,Blue,0,70575,71158,583
2022-01-20,70055,70045,Blue,0,54378,54917,539
2022-07-17,70042,70052,Blue,1,37164,37691,527
2022-11-30,70048,70050,Blue,1,76745,76804,59
2022-10-17,70038,70050,Blue,1,56653,57241,588
2022-11-02,70055,70041,Blue,0,26970,27801,831
2022-02-03,70057,70045,Blue,0,81290,81968,678
2022-03-20,70038,70056,Blue,1,57315,58227,912
2022-07-14,70046,70060,Blue,1,47521,48373,852
2022-10-02,70038,70048,Blue,1,56953,57419,466
2022-08-03,70057,70047,Blue,0,50015,50502,487
2022-09-09,70040,70048,Blue,1,83131,83551,420
2022-08-07,70052,70054,Blue,1,67026,67090,64
2022-06-22,70043,70838,Blue,0,53351,53550,199
2022-08-18,70044,70046,Blue,1,65391,65497,106
2022-05-21,70049,70041,Blue,0,77049,77619,570
2022-05-21,70051,70041,Blue,0,50150,50858,708
2022-12-18,70042,70046,Blue,1,88354,88527,173
2022-05-16,70055,70049,Blue,0,25697,25973,276
2022-01-07,70038,70046,Blue,1,42176,42537,361
2022-02-17,70048,70052,Blue,1,28969,29177,208
2022-04-19,70050,70060,Blue,1,23485,24156,671
2022-04-21,70055,70039,Blue,0,37735,38618,883
2022-09-25,70042,70056,Blue,1,48540,49345,805
2022-06-14,70044,70058,Blue,1,61569,62374,805
2022-03-08,70055,70049,Blue,0,19021,19355,334
2022-07-23,70057,70047,Blue,0,40150,40619,469
2022-08-29,70054,70056,Blue,1,36109,36155,46
2022-06-14,70051,70041,Blue,0,64760,65327,567
2022-04-01,70045,70041,Blue,0,85360,85519,159
2022-10-27,70041,70039,Blue,0,26893,26925,32
2022-06-07,70050,70052,Blue,1,73168,73351,183
2022-09-18,70049,70039,Blue,0,57042,57589,547
2022-03-21,70052,70060,Blue,1,32816,33218,402
2022-04-17,70040,70058,Blue,1,33974,34834,860
2022-01-18,70042,70050,Blue,1,60631,61082,451
2022-04-17,70053,70045,Blue,0,88510,89030,520
2022-11-12,70040,70054,Blue,1,55110,55827,717
2022-08-24,70044,70054,Blue,1,62279,62917,638
2022-11-28,70046,70060,Blue,1,62885,63749,864
2022-11-14,70040,70044,Blue,1,62795,62918,123
2022-08-23,70043,70838,Blue,0,74376,74563,187
2022-09-19,70059,70049,Blue,0,29731,30288,557
2022-10-22,70044,70046,Blue,1,22538,22655,117
2022-04-06,70040,70060,Blue,1,82049,83086,1037
2022-12-12,70051,70045,Blue,0,72043,72385,342
2022-09-20,70051,70047,Blue,0,27580,27800,220
2022-11-12,70040,70056,Blue,1,78987,79840,853
2022-12-06,70059,70039,Blue,0,37461,38562,1101
2022-03-11,70056,70058,Blue,1,77268,77341,73
2022-03-19,70051,70838,Blue,0,66321,67024,703
2022-08-31,70051,70043,Blue,0,22961,23487,526
2022-10-15,70052,70060,Blue,1,40637,41020,383
2022-09-18,70042,70050,Blue,1,32491,32985,494
2022-02-25,70046,70058,Blue,1,24034,24759,725
2022-06-28,70051,70039,Blue,0,43517,44159,642
2022-09-23,70055,70045,Blue,0,35220,35916,696
2022-10-07,70053,70051,Blue,0,38781,38837,56
2022-07-17,70040,70052,Blue,1,53784,54420,636
2022-11-24,70038,70060,Blue,1,31570,32674,1104
2022-10-20,70049,70039,Blue,0,52477,52991,514
2022-12-24,70046,70056,Blue,1,50812,51386,574
2022-03-04,70053,70051,Blue,0,23638,23700,62
2022-11-23,70044,70060,Blue,1,64585,65481,896
2022-11-25,70059,70043,Blue,0,31817,32666,849
2022-10-31,70040,70050,Blue,1,47724,48208,484
2022-06-04,70044,70048,Blue,1,74874,75134,260
2022-02-26,70042,70056,Blue,1,39512,40207,695
2022-04-11,70040,70044,Blue,1,27032,27159,127
2022-01-13,70048,70050,Blue,1,61742,61801,59
2022-01-28,70052,70060,Blue,1,30733,31104,371
2022-05-26,70042,70052,Blue,1,53705,54463,758
2022-02-20,70044,70048,Blue,1,30221,30450,229
2022-09-15,70054,70060,Blue,1,27769,28021,252
2022-07-03,70050,70052,Blue,1,58148,58257,109
2022-11-26,70057,70041,Blue,0,41743,42617,874
2022-11-01,70044,70058,Blue,1,67637,68440,803
2022-06-13,70051,70039,Blue,0,68255,68923,668
2022-09-01,70044,70060,Blue,1,52280,53122,842
2022-02-14,70046,70056,Blue,1,60505,60997,492
2022-11-03,70053,70838,Blue,0,36674,37567,893
2022-09-16,70053,70049,Blue,0,55909,56125,216
2022-08-27,70046,70056,Blue,1,27854,28330,476
2022-07-13,70048,70050,Blue,1,26700,26759,59
2022-10-10,70055,70049,Blue,0,23607,23896,289
2022-08-25,70059,70053,Blue,0,57201,57502,301
2022-08-12,70051,70039,Blue,0,67537,68201,664
2022-11-26,70046,70052,Blue,1,28029,28369,340
2022-11-08,70048,70058,Blue,1,64651,65166,515
2022-06-02,70046,70052,Blue,1,73256,73727,471
2022-02-26,70040,70056,Blue,1,55661,56524,863
2022-10-04,70058,70060,Blue,1,74622,74681,59
2022-06-12,70038,70040,Blue,1,80363,80379,16
2022-07-07,70049,70041,Blue,0,48353,48793,440
2022-01-08,70042,70048,Blue,1,87447,87728,281
2022-03-04,70053,70041,Blue,0,87761,88409,648
2022-02-25,70051,70049,Blue,0,59685,59798,113
2022-02-02,70040,70060,Blue,1,38916,40469,1553
2022-04-06,70055,70051,Blue,0,68063,68191,128
2022-01-18,70047,70043,Blue,0,74523,74742,219
2022-07-29,70045,70043,Blue,0,53224,53337,113
2022-03-10,70049,70041,Blue,0,28683,29105,422
2022-09-17,70055,70051,Blue,0,64006,64214,208
2022-05-08,70050,70056,Blue,1,57308,57621,313
2022-06-21,70045,70039,Blue,0,69065,69363,298
2022-11-14,70059,70838,Blue,0,27497,28708,1211
2022-02-23,70038,70040,Blue,1,54016,54035,19
2022-08-16,70040,70046,Blue,1,22025,22312,287
2022-12-19,70057,70045,Blue,0,85609,86264,655
2022-01-11,70057,70043,Blue,0,52590,53350,760
2022-05-01,70059,70049,Blue,0,59954,60432,478
2022-10-17,70051,70047,Blue,0,69495,69691,196
2022-08-11,70059,70049,Blue,0,54624,55121,497
2022-10-20,70053,70039,Blue,0,39868,40568,700
2022-03-29,70055,70053,Blue,0,34351,34398,47
2022-04-13,70053,70047,Blue,0,28773,29108,335
2022-08-10,70053,70043,Blue,0,25395,26021,626
2022-07-06,70057,70047,Blue,0,20518,21046,528
2022-08-18,70042,70058,Blue,1,61944,62941,997
2022-11-20,70040,70042,Blue,1,62993,63023,30
2022-08-14,70056,70058,Blue,1,38657,38733,76
2022-07-24,70044,70046,Blue,1,53444,53561,117
2022-06-16,70055,70043,Blue,0,21274,22117,843
2022-06-01,70042,70044,Blue,1,44644,44671,27
2022-03-19,70059,70041,Blue,0,29774,30749,975
2022-06-13,70059,70045,Blue,0,76038,76734,696
2022-03-12,70053,70051,Blue,0,83435,83493,58
2022-05-19,70046,70054,Blue,1,26463,26992,529
2022-04-05,70047,70838,Blue,0,74957,75490,533
2022-01-09,70049,70047,Blue,0,38034,38092,58
2022-07-10,70042,70054,Blue,1,30921,31644,723
2022-10-19,70059,70055,Blue,0,21752,21901,149
2022-09-04,70059,70053,Blue,0,80921,81150,229
2022-02-04,70044,70050,Blue,1,33958,34304,346
2022-12-20,70057,70053,Blue,0,63909,64060,151
2022-03-02,70038,70042,Blue,1,60733,60833,100
2022-07-22,70049,70838,Blue,0,27908,28528,620
2022-10-28,70057,70047,Blue,0,33996,34470,474
2022-09-22,70046,70048,Blue,1,45019,45109,90
2022-10-28,70043,70039,Blue,0,65319,65434,115
2022-01-03,70042,70046,Blue,1,37499,37677,178
2022-08-27,70057,70049,Blue,0,36338,36726,388
2022-12-10,70043,70041,Blue,0,70053,70081,28
2022-10-16,70052,70060,Blue,1,39154,39476,322
2022-02-24,70050,70056,Blue,1,68540,68862,322
2022-04-18,70047,70043,Blue,0,57759,57980,221
2022-12-19,70049,70041,Blue,0,72428,72837,409
2022-04-21,70040,70054,Blue,1,68065,68910,845
2022-03-23,70052,70060,Blue,1,51613,51973,360
2022-11-22,70043,70041,Blue,0,61861,61888,27
2022-12-17,70048,70054,Blue,1,51214,51526,312
2022-12-28,70059,70041,Blue,0,35067,36246,1179
2022-11-29,70047,70041,Blue,0,58310,58633,323
2022-11-02,70059,70051,Blue,0,19937,20298,361
2022-03-23,70048,70052,Blue,1,53914,54126,212
2022-12-26,70055,70053,Blue,0,56188,56239,51
2022-03-05,70048,70056,Blue,1,60953,61328,375
2022-03-09,70038,70044,Blue,1,52512,52692,180
2022-11-19,70039,70838,Blue,0,49256,49288,32
2022-05-18,70044,70054,Blue,1,33147,33981,834
2022-04-02,70053,70051,Blue,0,28433,28479,46
2022-01-31,70059,70047,Blue,0,42667,43263,596
2022-03-21,70055,70039,Blue,0,63975,64762,787
2022-04-19,70046,70052,Blue,1,37226,37622,396
2022-04-01,70053,70045,Blue,0,66409,66846,437
2022-12-25,70040,70052,Blue,1,33184,33759,575
2022-09-05,70041,70838,Blue,0,54860,54984,124
2022-07-07,70048,70052,Blue,1,34743,34971,228
2022-06-12,70042,70050,Blue,1,40604,41062,458
2022-09-30,70038,70056,Blue,1,54505,55414,909
2022-07-08,70047,70039,Blue,0,61619,62031,412
2022-02-24,70053,70043,Blue,0,26644,27282,638
2022-12-26,70040,70042,Blue,1,43032,43063,31
2022-03-04,70046,70048,Blue,1,67991,68065,74
2022-03-15,70046,70056,Blue,1,64743,65291,548
2022-04-12,70051,70039,Blue,0,57535,58126,591
2022-12-16,70041,70838,Blue,0,60718,60830,112
2022-12-30,70042,70050,Blue,1,23626,24021,395
2022-10-07,70059,70041,Blue,0,63177,64113,936
2022-06-23,70049,70838,Blue,0,72687,73319,632
2022-03-15,70044,70060,Blue,1,40367,41349,982
2022-04-07,70038,70046,Blue,1,66134,66472,338
2022-09-12,70057,70047,Blue,0,83511,83974,463
2022-01-04,70038,70052,Blue,1,48672,49354,682
2022-07-30,70044,70060,Blue,1,69844,70770,926
2022-12-14,70042,70046,Blue,1,71247,71420,173
2022-01-19,70047,70039,Blue,0,48327,48826,499
2022-03-19,70042,70060,Blue,1,62763,63800,1037
2022-11-16,70055,70838,Blue,0,45319,46293,974
2022-03-01,70040,70042,Blue,1,45872,45911,39
2022-06-09,70048,70058,Blue,1,55620,56297,677
2022-07-27,70040,70048,Blue,1,58246,58660,414
2022-04-05,70059,70057,Blue,0,19233,19271,38
2022-08-07,70055,70838,Blue,0,87504,88509,1005
2022-07-07,70057,70045,Blue,0,31070,31753,683
2022-09-02,70058,70060,Blue,1,42613,42682,69
2022-11-02,70057,70041,Blue,0,70289,71134,845
2022-10-27,70042,70056,Blue,1,64762,65699,937
2022-08-26,70059,70057,Blue,0,30136,30171,35
2022-04-20,70047,70045,Blue,0,33628,33765,137
2022-02-09,70044,70058,Blue,1,30777,31589,812
2022-01-26,70045,70041,Blue,0,72794,72966,172
2022-07-22,70046,70050,Blue,1,65356,65558,202
2022-07-24,70040,70058,Blue,1,35539,36469,930
2022-10-08,70038,70044,Blue,1,65288,65472,184
2022-03-10,70055,70039,Blue,0,67339,68145,806
2022-10-08,70040,70052,Blue,1,53485,54140,655
2022-07-25,70050,70060,Blue,1,30541,31069,528
2022-01-06,70046,70050,Blue,1,64379,64552,173
2022-04-21,70051,70041,Blue,0,22043,22684,641
2022-04-13,70046,70060,Blue,1,24396,25163,767
2022-12-04,70046,70056,Blue,1,69736,70236,500
2022-01-08,70042,70054,Blue,1,71923,72581,658
2022-08-18,70045,70838,Blue,0,47110,47476,366
2022-12-08,70057,70049,Blue,0,29299,29724,425
2022-04-09,70050,70060,Blue,1,47519,48005,486
2022-11-23,70042,70060,Blue,1,39157,40118,961
2022-01-05,70040,70058,Blue,1,59608,60620,1012
2022-12-07,70041,70039,Blue,0,79766,79796,30
2022-07-29,70053,70045,Blue,0,87910,88312,402
2022-08-14,70059,70043,Blue,0,39493,40365,872
2022-09-21,70051,70838,Blue,0,68503,69201,698
2022-10-05,70055,70838,Blue,0,57906,58805,899
2022-08-27,70053,70043,Blue,0,53814,54388,574
2022-04-21,70049,70039,Blue,0,68365,68856,491
2022-11-18,70053,70051,Blue,0,35048,35115,67
2022-08-28,70038,70054,Blue,1,83706,84601,895
2022-08-28,70055,70043,Blue,0,59954,60622,668
2022-01-26,70050,70054,Blue,1,27575,27791,216
2022-02-04,70042,70044,Blue,1,50916,50949,33
2022-06-12,70055,70047,Blue,0,81095,81478,383
2022-01-31,70051,70049,Blue,0,59422,59537,115
2022-09-02,70059,70043,Blue,0,47296,48141,845
2022-11-08,70044,70048,Blue,1,33092,33345,253
2022-05-20,70044,70046,Blue,1,53474,53611,137
2022-04-20,70055,70053,Blue,0,28342,28388,46
2022-05-31,70049,70039,Blue,0,48790,49349,559
2022-01-26,70049,70045,Blue,0,63427,63704,277
2022-08-10,70055,70053,Blue,0,26133,26183,50
2022-08-01,70057,70049,Blue,0,27701,28090,389
2022-12-31,70059,70053,Blue,0,24142,24374,232
2022-07-17,70040,70042,Blue,1,36311,36345,34
2022-08-02,70052,70060,Blue,1,47472,47824,352
2022-01-17,70052,70060,Blue,1,70435,70854,419
2022-09-28,70044,70046,Blue,1,26122,26232,110
2022-09-16,70038,70056,Blue,1,59456,60381,925
2022-08-13,70048,70054,Blue,1,63667,64006,339
2022-01-18,70048,70058,Blue,1,88172,88654,482
2022-09-23,70053,70049,Blue,0,24544,24760,216
2022-09-19,70050,70052,Blue,1,48484,48597,113
2022-07-22,70057,70055,Blue,0,77329,77398,69
2022-11-17,70049,70045,Blue,0,41086,41289,203
2022-07-06,70059,70039,Blue,0,28061,29188,1127
2022-09-30,70042,70050,Blue,1,76960,77367,407
2022-08-25,70059,70047,Blue,0,33494,34061,567
2022-10-04,70055,70045,Blue,0,61527,62033,506
2022-06-11,70044,70060,Blue,1,52617,53568,951
2022-12-30,70042,70056,Blue,1,24843,25619,776
2022-01-03,70053,70043,Blue,0,62425,63050,625
2022-10-31,70057,70041,Blue,0,67654,68478,824
2022-01-01,70051,70045,Blue,0,24264,24626,362
2022-03-02,70040,70044,Blue,1,26720,26842,122
2022-06-02,70045,70039,Blue,0,55606,55919,313
2022-07-20,70059,70047,Blue,0,28041,28606,565
2022-07-28,70048,70050,Blue,1,47657,47714,57
2022-02-09,70055,70041,Blue,0,28669,29532,863
2022-03-03,70041,70039,Blue,0,34636,34673,37
2022-07-16,70047,70838,Blue,0,43901,44400,499
2022-05-03,70056,70060,Blue,1,84688,84871,183
2022-06-20,70042,70046,Blue,1,70383,70582,199
2022-11-15,70044,70048,Blue,1,51011,51262,251
2022-01-23,70042,70054,Blue,1,76545,77240,695
2022-01-24,70044,70048,Blue,1,49978,50214,236
2022-09-18,70046,70056,Blue,1,29626,30162,536
2022-01-19,70046,70056,Blue,1,25763,26247,484
2022-10-14,70051,70838,Blue,0,43605,44349,744
2022-06-24,70042,70052,Blue,1,40676,41608,932
2022-03-09,70049,70047,Blue,0,64972,65043,71
2022-02-09,70046,70058,Blue,1,71368,71966,598
2022-02-22,70044,70054,Blue,1,44418,45054,636
2022-12-29,70058,70060,Blue,1,74516,74582,66
2022-06-11,70056,70060,Blue,1,58858,59045,187
2022-09-24,70049,70041,Blue,0,61577,62044,467
2022-11-12,70048,70054,Blue,1,81898,82197,299
2022-02-02,70040,70046,Blue,1,43549,44015,466
2022-09-05,70038,70048,Blue,1,60206,60673,467
2022-09-21,70057,70049,Blue,0,28961,29373,412
2022-07-18,70048,70054,Blue,1,52339,52674,335
2022-09-28,70050,70056,Blue,1,68572,68880,308
2022-02-08,70046,70060,Blue,1,66257,67061,804
2022-12-24,70039,70838,Blue,0,81712,81742,30
2022-02-22,70046,70048,Blue,1,62641,62743,102
2022-01-20,70043,70039,Blue,0,44808,44924,116
2022-11-08,70055,70838,Blue,0,57460,58393,933
2022-03-09,70059,70057,Blue,0,82874,82910,36
2022-02-28,70059,70041,Blue,0,30558,31631,1073
2022-02-22,70059,70049,Blue,0,40949,41527,578
2022-02-01,70044,70052,Blue,1,64565,65058,493
2022-09-24,70049,70043,Blue,0,43255,43646,391
2022-03-27,70047,70041,Blue,0,33766,34075,309
2022-04-12,70038,70056,Blue,1,26356,27316,960
2022-12-01,70042,70058,Blue,1,75943,76810,867
2022-08-23,70055,70045,Blue,0,21934,22511,577
2022-06-27,70057,70041,Blue,0,51116,51984,868
2022-06-18,70057,70039,Blue,0,45017,46035,1018
2022-04-15,70047,70838,Blue,0,20880,21397,517
2022-12-20,70053,70838,Blue,0,25911,26757,846
2022-01-15,70052,70056,Blue,1,68469,68634,165
2022-11-26,70046,70058,Blue,1,44807,45418,611
2022-04-05,70049,70039,Blue,0,52035,52519,484
2022-10-10,70059,70049,Blue,0,40593,41068,475
2022-01-02,70053,70039,Blue,0,75767,76551,784
2022-12-25,70046,70050,Blue,1,37349,37511,162
2022-11-13,70051,70043,Blue,0,59699,60178,479
2022-09-15,70048,70056,Blue,1,68681,69099,418
2022-11-24,70055,70051,Blue,0,55652,55792,140
2022-12-27,70042,70060,Blue,1,45152,46088,936
2022-02-28,70057,70838,Blue,0,87564,88540,976
2022-08-12,70040,70050,Blue,1,77652,78213,561
2022-12-24,70042,70046,Blue,1,54086,54263,177
2022-06-18,70046,70054,Blue,1,75413,75837,424
2022-12-21,70059,70041,Blue,0,49334,50298,964
2022-02-19,70045,70043,Blue,0,41872,41954,82
2022-09-13,70044,70052,Blue,1,32176,32660,484
2022-06-25,70047,70043,Blue,0,65850,66126,276
2022-03-25,70040,70056,Blue,1,84924,85724,800
2022-03-04,70040,70048,Blue,1,74171,74605,434
2022-07-18,70059,70047,Blue,0,79490,80011,521
2022-06-14,70042,70044,Blue,1,78279,78309,30
2022-09-07,70055,70049,Blue,0,86705,86964,259
2022-09-02,70038,70058,Blue,1,76934,77923,989
2022-01-02,70059,70049,Blue,0,47475,47951,476
2022-01-20,70040,70054,Blue,1,65914,66743,829
2022-12-01,70055,70049,Blue,0,55583,55868,285
2022-12-03,70051,70047,Blue,0,57145,57358,213
2022-04-05,70053,70043,Blue,0,22293,22871,578
2022-01-03,70038,70052,Blue,1,23646,24275,629
2022-08-10,70042,70060,Blue,1,33532,34535,1003
2022-09-13,70058,70060,Blue,1,67243,67327,84
2022-03-14,70040,70052,Blue,1,46454,47078,624
2022-01-22,70049,70039,Blue,0,42751,43302,551
2022-03-27,70042,70058,Blue,1,74380,75293,913
2022-01-24,70057,70043,Blue,0,49823,50711,888
2022-09-01,70044,70048,Blue,1,65941,66161,220
2022-02-11,70050,70052,Blue,1,63863,63973,110
2022-10-27,70054,70060,Blue,1,44512,44783,271
2022-06-21,70051,70039,Blue,0,28490,29169,679
2022-07-18,70059,70045,Blue,0,60656,61396,740
2022-11-09,70057,70053,Blue,0,57282,57436,154
2022-01-02,70048,70060,Blue,1,72517,73082,565
2022-03-01,70059,70039,Blue,0,56004,56954,950
2022-02-24,70039,70838,Blue,0,51968,52008,40
2022-07-03,70048,70050,Blue,1,33651,33711,60
2022-07-22,70042,70060,Blue,1,24616,25661,1045
2022-08-29,70053,70041,Blue,0,23277,24095,818
2022-10-16,70057,70051,Blue,0,87388,87629,241
2022-10-28,70044,70058,Blue,1,46343,47131,788
2022-06-27,70047,70039,Blue,0,29421,29866,445
2022-04-20,70048,70052,Blue,1,57694,57906,212
2022-03-04,70055,70838,Blue,0,19800,20876,1076
2022-10-14,70056,70060,Blue,1,41333,41515,182
2022-06-09,70053,70041,Blue,0,84330,85001,671
2022-10-28,70059,70049,Blue,0,64015,64467,452
2022-02-17,70051,70049,Blue,0,78117,78220,103
2022-06-03,70038,70044,Blue,1,83423,83615,192
2022-01-22,70038,70050,Blue,1,32353,32940,587
2022-03-14,70038,70046,Blue,1,39606,39905,299
2022-01-22,70055,70049,Blue,0,74792,75103,311
2022-12-02,70059,70045,Blue,0,59297,60037,740
2022-05-06,70056,70058,Blue,1,32746,32817,71
2022-01-08,70044,70060,Blue,1,71997,72896,899
2022-06-18,70051,70049,Blue,0,39922,40026,104
2022-05-10,70057,70047,Blue,0,59108,59692,584
2022-02-09,70055,70051,Blue,0,27437,27569,132
2022-05-19,70051,70838,Blue,0,71378,72229,851
2022-03-14,70055,70051,Blue,0,19359,19508,149
2022-01-14,70043,70039,Blue,0,29128,29245,117
2022-10-18,70041,70039,Blue,0,20654,20687,33
2022-01-19,70051,70838,Blue,0,57262,58014,752
2022-07-23,70047,70838,Blue,0,61858,62381,523
2022-02-20,70042,70060,Blue,1,63099,64106,1007
2022-11-30,70046,70060,Blue,1,56891,57657,766
2022-01-06,70047,70838,Blue,0,59658,60117,459
2022-09-04,70038,70040,Blue,1,23771,23785,14
2022-01-15,70042,70052,Blue,1,73781,74353,572
2022-09-03,70044,70052,Blue,1,73637,74134,497
2022-10-31,70042,70054,Blue,1,71248,71952,704
2022-06-17,70038,70058,Blue,1,87738,88765,1027
2022-10-27,70041,70039,Blue,0,39469,39500,31
2022-04-23,70040,70056,Blue,1,64816,65653,837
2022-12-06,70049,70838,Blue,0,23566,24243,677
2022-10-10,70046,70056,Blue,1,88594,89124,530
2022-12-13,70038,70040,Blue,1,24052,24067,15
2022-12-17,70042,70054,Blue,1,35930,36635,705
2022-03-24,70059,70051,Blue,0,59009,59360,351
2022-10-29,70046,70054,Blue,1,27322,27774,452
2022-02-01,70046,70052,Blue,1,56902,57222,320
2022-04-18,70042,70048,Blue,1,28296,28575,279
2022-01-04,70044,70050,Blue,1,40423,40749,326
2022-02-11,70046,70052,Blue,1,46782,47087,305
2022-06-26,70038,70048,Blue,1,23151,23668,517
2022-06-13,70048,70056,Blue,1,73009,73398,389
2022-01-16,70042,70060,Blue,1,83330,84423,1093
2022-02-23,70042,70044,Blue,1,86725,86762,37
2022-03-20,70044,70046,Blue,1,31012,31120,108
2022-03-18,70039,70838,Blue,0,65384,65488,104
2022-01-03,70052,70056,Blue,1,55081,55225,144
2022-01-10,70049,70043,Blue,0,66131,66456,325
2022-03-17,70053,70045,Blue,0,26646,27121,475
2022-10-11,70057,70047,Blue,0,28964,29493,529
2022-07-03,70046,70058,Blue,1,66556,67251,695
2022-01-05,70040,70044,Blue,1,35143,35260,117
2022-08-02,70042,70056,Blue,1,22367,23183,816
2022-06-18,70038,70046,Blue,1,42071,42431,360
2022-11-26,70052,70060,Blue,1,46544,46869,325
2022-11-17,70057,70041,Blue,0,43238,44121,883
2022-11-19,70046,70054,Blue,1,40301,40729,428
2022-04-02,70050,70054,Blue,1,25646,25866,220
2022-03-05,70046,70060,Blue,1,56543,57317,774
2022-03-23,70040,70060,Blue,1,45868,46896,1028
2022-07-26,70056,70058,Blue,1,84653,84729,76
2022-03-13,70054,70058,Blue,1,58908,59067,159
2022-06-09,70050,70054,Blue,1,80987,81195,208
2022-03-16,70057,70043,Blue,0,29738,30561,823
2022-02-04,70050,70060,Blue,1,29639,30470,831
2022-12-21,70046,70048,Blue,1,58611,58679,68
2022-02-17,70059,70055,Blue,0,29660,29811,151
2022-03-09,70048,70058,Blue,1,20554,21121,567
2022-04-13,70044,70058,Blue,1,21743,22609,866
2022-05-18,70051,70039,Blue,0,57882,58665,783
2022-01-14,70038,70060,Blue,1,83173,84335,1162
2022-11-03,70043,70838,Blue,0,62294,62486,192
2022-02-28,70042,70046,Blue,1,34922,35100,178
2022-06-20,70055,70053,Blue,0,78689,78734,45
2022-11-23,70047,70838,Blue,0,20595,21117,522
2022-10-11,70049,70041,Blue,0,69220,69633,413
2022-12-02,70042,70056,Blue,1,41810,42558,748
2022-01-09,70044,70054,Blue,1,63631,64221,590
2022-08-18,70040,70060,Blue,1,75518,76577,1059
2022-06-28,70044,70054,Blue,1,52716,53357,641
2022-02-10,70053,70838,Blue,0,81476,82322,846
2022-12-13,70044,70048,Blue,1,49240,49472,232
2022-12-25,70038,70058,Blue,1,26899,27804,905
2022-08-15,70051,70041,Blue,0,81783,82383,600
2022-06-10,70059,70043,Blue,0,54797,55793,996
2022-01-16,70055,70045,Blue,0,28702,29230,528
2022-07-28,70057,70043,Blue,0,27284,28077,793
2022-03-21,70059,70051,Blue,0,76631,76965,334
2022-09-01,70055,70838,Blue,0,37631,38540,909
2022-09-04,70057,70049,Blue,0,64714,65205,491
2022-01-07,70053,70051,Blue,0,38967,39027,60
2022-10-04,70053,70049,Blue,0,55364,55565,201
2022-11-10,70055,70043,Blue,0,53275,53955,680
2022-01-28,70046,70054,Blue,1,67113,67602,489
2022-07-12,70051,70043,Blue,0,85338,85832,494
2022-08-20,70052,70060,Blue,1,86209,86567,358
2022-10-07,70055,70043,Blue,0,82955,83592,637
2022-03-30,70038,70048,Blue,1,65834,66309,475
2022-10-13,70040,70060,Blue,1,57858,58960,1102
2022-11-19,70049,70043,Blue,0,66035,66358,323
2022-06-29,70038,70060,Blue,1,21373,22558,1185
2022-10-06,70057,70049,Blue,0,71313,71696,383
2022-09-30,70045,70039,Blue,0,30546,30823,277
2022-12-24,70049,70039,Blue,0,44480,44962,482
2022-02-16,70040,70058,Blue,1,32726,33715,989
2022-03-13,70050,70056,Blue,1,66265,66548,283
2022-12-08,70040,70046,Blue,1,49806,50051,245
2022-01-27,70058,70060,Blue,1,45628,45745,117
2022-03-22,70038,70060,Blue,1,50780,51972,1192
2022-11-06,70042,70060,Blue,1,28606,29564,958
2022-11-07,70041,70838,Blue,0,50665,50786,121
2022-07-23,70053,70039,Blue,0,22426,23197,771
2022-08-03,70040,70060,Blue,1,65555,66592,1037
2022-07-03,70044,70050,Blue,1,68541,68939,398
2022-08-23,70059,70051,Blue,0,29246,29590,344
2022-01-24,70059,70051,Blue,0,54496,54794,298
2022-02-21,70049,70043,Blue,0,76324,76704,380
2022-04-21,70050,70058,Blue,1,44129,44567,438
2022-04-12,70059,70057,Blue,0,50731,50766,35
2022-09-01,70038,70048,Blue,1,26936,27390,454
2022-10-12,70047,70043,Blue,0,26692,27188,496
2022-08-17,70057,70045,Blue,0,48166,48946,780
2022-11-11,70051,70838,Blue,0,62263,62999,736
2022-08-25,70040,70052,Blue,1,30325,30951,626
2022-04-02,70042,70054,Blue,1,30332,30968,636
2022-08-07,70040,70060,Blue,1,29288,30338,1050
2022-10-09,70053,70039,Blue,0,62304,63037,733
2022-11-02,70056,70058,Blue,1,52242,52311,69
2022-01-08,70040,70058,Blue,1,64827,65784,957
2022-10-26,70042,70060,Blue,1,70216,71922,1706
2022-07-06,70052,70056,Blue,1,87252,87393,141
2022-03-18,70038,70054,Blue,1,81435,82255,820
2022-06-25,70047,70838,Blue,0,43393,43970,577
2022-12-10,70047,70045,Blue,0,68752,68843,91
2022-12-27,70040,70058,Blue,1,65677,66644,967
2022-09-12,70055,70043,Blue,0,70832,71482,650
2022-09-28,70040,70044,Blue,1,21524,21641,117
2022-06-15,70042,70056,Blue,1,27767,28530,763
2022-07-30,70048,70060,Blue,1,55029,55659,630
2022-11-30,70059,70055,Blue,0,82197,82340,143
2022-09-10,70051,70041,Blue,0,71160,71726,566
2022-01-21,70059,70047,Blue,0,27858,28419,561
2022-08-28,70049,70043,Blue,0,45202,45562,360
2022-02-03,70044,70056,Blue,1,75046,75829,783
2022-11-05,70056,70058,Blue,1,80312,80386,74
2022-04-05,70044,70058,Blue,1,52413,53265,852
2022-01-28,70050,70058,Blue,1,22169,22589,420
2022-03-18,70042,70054,Blue,1,43651,44343,692
2022-12-31,70055,70045,Blue,0,91281,91772,491
2022-09-03,70059,70041,Blue,0,24795,25698,903
2022-07-11,70038,70056,Blue,1,23328,24305,977
2022-11-18,70057,70045,Blue,0,74560,75347,787
2022-01-27,70038,70050,Blue,1,21558,22184,626
2022-03-26,70038,70060,Blue,1,71238,72414,1176
2022-10-23,70040,70046,Blue,1,25388,25626,238
2022-02-07,70038,70044,Blue,1,26348,26512,164
2022-07-01,70048,70054,Blue,1,44642,44974,332
2022-06-27,70057,70051,Blue,0,45019,45258,239
2022-12-17,70052,70056,Blue,1,39748,39875,127
2022-04-19,70053,70047,Blue,0,23143,23468,325
2022-12-19,70053,70045,Blue,0,28203,28650,447
2022-05-17,70051,70047,Blue,0,85844,86116,272
2022-03-01,70046,70048,Blue,1,59874,59965,91
2022-09-23,70038,70040,Blue,1,68306,68320,14
2022-02-13,70038,70054,Blue,1,55337,56237,900
2022-03-19,70050,70060,Blue,1,43227,43740,513
2022-11-26,70040,70056,Blue,1,39420,40171,751
2022-03-30,70042,70050,Blue,1,29213,29627,414
2022-12-31,70038,70046,Blue,1,92329,92643,314
2022-03-18,70040,70054,Blue,1,72506,73323,817
2022-09-30,70059,70057,Blue,0,52264,52299,35
2022-08-30,70042,70052,Blue,1,32068,32672,604
2022-10-21,70048,70058,Blue,1,41452,41943,491
2022-06-15,70043,70838,Blue,0,50231,50433,202
2022-10-15,70053,70045,Blue,0,70549,70987,438
2022-01-03,70048,70050,Blue,1,33141,33200,59
2022-01-17,70057,70045,Blue,0,22903,23600,697
2022-08-31,70057,70049,Blue,0,33598,34040,442
2022-11-16,70057,70051,Blue,0,36028,36287,259
2022-09-18,70053,70043,Blue,0,66092,66764,672
2022-10-03,70052,70056,Blue,1,45970,46114,144
2022-02-07,70059,70041,Blue,0,48194,49104,910
2022-11-02,70040,70058,Blue,1,41936,42975,1039
2022-04-02,70038,70040,Blue,1,35056,35072,16
2022-07-05,70040,70044,Blue,1,30436,30567,131
2022-07-03,70059,70045,Blue,0,41475,42181,706
2022-03-03,70047,70045,Blue,0,43902,44008,106
2022-10-26,70050,70054,Blue,1,32189,32403,214
2022-02-07,70051,70043,Blue,0,65720,66213,493
2022-06-21,70057,70053,Blue,0,76121,76282,161
2022-07-01,70046,70060,Blue,1,79714,80473,759
2022-09-30,70051,70049,Blue,0,33020,33144,124
2022-10-31,70041,70838,Blue,0,55018,55130,112
2022-11-20,70043,70041,Blue,0,27005,27033,28
2022-07-11,70045,70838,Blue,0,24835,25240,405
2022-12-28,70038,70044,Blue,1,52029,52218,189
2022-01-13,70052,70054,Blue,1,54465,54514,49
2022-12-15,70038,70048,Blue,1,85512,86014,502
2022-02-24,70057,70053,Blue,0,86976,87157,181
2022-08-25,70059,70838,Blue,0,76927,77970,1043
2022-01-04,70040,70050,Blue,1,74105,74584,479
2022-05-25,70046,70052,Blue,1,38266,38729,463
2022-04-12,70057,70053,Blue,0,53214,53384,170
2022-02-28,70045,70039,Blue,0,62730,62976,246
2022-08-05,70049,70838,Blue,0,40521,41133,612
2022-03-30,70038,70048,Blue,1,34448,34906,458
2022-11-15,70055,70039,Blue,0,24036,24852,816
2022-12-20,70051,70045,Blue,0,49133,49471,338
2022-12-22,70038,70056,Blue,1,85843,86764,921
2022-02-07,70042,70050,Blue,1,64772,65170,398
2022-02-19,70052,70060,Blue,1,42866,43207,341
2022-04-04,70054,70058,Blue,1,29498,29646,148
2022-12-30,70057,70055,Blue,0,21106,21181,75
2022-04-19,70042,70058,Blue,1,31584,32486,902
2022-09-08,70038,70058,Blue,1,42762,43812,1050
2022-01-14,70049,70045,Blue,0,49184,49376,192
2022-08-03,70051,70045,Blue,0,65892,66205,313
2022-03-11,70040,70058,Blue,1,42133,43195,1062
2022-02-03,70057,70055,Blue,0,46179,46249,70
2022-03-26,70059,70043,Blue,0,35712,36555,843
2022-02-14,70040,70052,Blue,1,40894,41501,607
2022-08-30,70052,70058,Blue,1,77033,77272,239
2022-07-11,70053,70838,Blue,0,72032,72808,776
2022-06-30,70040,70054,Blue,1,43960,44912,952
2022-09-01,70057,70838,Blue,0,64061,65181,1120
2022-01-18,70056,70060,Blue,1,47997,48182,185
2022-07-28,70038,70046,Blue,1,28243,28559,316
2022-09-05,70057,70838,Blue,0,61475,62448,973
2022-05-31,70038,70044,Blue,1,70892,71062,170
2022-09-24,70040,70048,Blue,1,45906,46264,358
2022-03-22,70042,70052,Blue,1,73675,74265,590
2022-03-03,70038,70060,Blue,1,29647,30788,1141
2022-08-16,70046,70054,Blue,1,47837,48289,452
2022-05-23,70045,70039,Blue,0,23130,23409,279
2022-07-31,70038,70058,Blue,1,82332,83362,1030
2022-01-07,70054,70058,Blue,1,24514,24693,179
2022-07-28,70045,70838,Blue,0,26283,26661,378
2022-04-21,70043,70041,Blue,0,33604,33636,32
2022-11-08,70052,70060,Blue,1,69067,69413,346
2022-07-05,70043,70838,Blue,0,53294,53481,187
2022-09-28,70055,70039,Blue,0,74541,75500,959
2022-01-08,70051,70049,Blue,0,84401,84509,108
2022-11-13,70055,70053,Blue,0,65364,65417,53
2022-06-12,70050,70060,Blue,1,34523,35031,508
2022-11-17,70042,70048,Blue,1,74297,74604,307
2022-03-18,70051,70047,Blue,0,35057,35264,207
2022-04-27,70051,70049,Blue,0,86878,86995,117
2022-03-07,70042,70060,Blue,1,38135,39227,1092
2022-07-07,70043,70041,Blue,0,38316,38347,31
2022-03-31,70040,70052,Blue,1,61716,62338,622
2022-02-22,70055,70039,Blue,0,29840,30799,959
2022-10-14,70051,70039,Blue,0,28243,28922,679
2022-04-23,70059,70047,Blue,0,20174,20729,555
2022-01-06,70049,70041,Blue,0,46629,47893,1264
2022-07-05,70057,70055,Blue,0,51803,51876,73
2022-08-12,70056,70060,Blue,1,51815,51993,178
2022-12-28,70048,70056,Blue,1,59059,59448,389
2022-01-31,70040,70054,Blue,1,32274,33272,998
2022-10-13,70040,70048,Blue,1,75286,75679,393
2022-04-12,70059,70838,Blue,0,36435,37569,1134
2022-02-25,70042,70056,Blue,1,21717,22515,798
2022-06-19,70059,70053,Blue,0,51835,52076,241
2022-10-04,70038,70054,Blue,1,67940,68763,823
2022-08-19,70059,70043,Blue,0,21542,22449,907
2022-08-26,70051,70039,Blue,0,21777,22442,665
2022-06-13,70059,70041,Blue,0,48674,49707,1033
2022-04-08,70038,70050,Blue,1,56227,56785,558
2022-03-11,70053,70838,Blue,0,33277,34348,1071
2022-02-18,70055,70041,Blue,0,73930,74715,785
2022-09-08,70040,70058,Blue,1,67004,68028,1024
2022-09-24,70049,70039,Blue,0,54049,54575,526
2022-02-03,70048,70058,Blue,1,29571,30176,605
2022-12-07,70057,70047,Blue,0,28037,28591,554
2022-07-10,70038,70042,Blue,1,44952,45052,100
2022-06-29,70059,70055,Blue,0,46824,46964,140
2022-12-31,70038,70052,Blue,1,79501,80251,750
2022-11-16,70054,70056,Blue,1,86880,86930,50
2022-06-17,70059,70051,Blue,0,84017,84328,311
2022-06-24,70040,70060,Blue,1,39597,41000,1403
2022-08-14,70057,70045,Blue,0,68034,68638,604
2022-08-31,70040,70054,Blue,1,28939,29661,722
2022-12-13,70047,70045,Blue,0,34444,34536,92
2022-10-23,70049,70838,Blue,0,34473,35082,609
2022-07-21,70057,70039,Blue,0,62971,63915,944
2022-01-20,70054,70058,Blue,1,31996,32178,182
2022-06-28,70049,70043,Blue,0,53639,53999,360
2022-03-11,70047,70039,Blue,0,29646,30077,431
2022-05-05,70052,70060,Blue,1,35258,35637,379
2022-01-03,70038,70054,Blue,1,79792,80606,814
2022-09-21,70059,70045,Blue,0,43153,43999,846
2022-02-01,70038,70054,Blue,1,20426,21459,1033
2022-02-08,70051,70041,Blue,0,86114,86674,560
2022-02-19,70059,70838,Blue,0,31410,32594,1184
2022-02-24,70042,70048,Blue,1,56887,57206,319
2022-10-19,70041,70039,Blue,0,28222,28252,30
2022-07-18,70038,70054,Blue,1,63601,64540,939
2022-03-23,70056,70060,Blue,1,28867,29080,213
2022-03-23,70038,70060,Blue,1,51186,52292,1106
2022-11-04,70042,70048,Blue,1,40139,40459,320
2022-03-07,70046,70058,Blue,1,22470,23049,579
2022-02-04,70042,70048,Blue,1,29590,29909,319
2022-12-08,70046,70058,Blue,1,45900,46514,614
2022-12-18,70057,70041,Blue,0,56088,56983,895
2022-03-23,70040,70046,Blue,1,50857,51133,276
2022-11-20,70042,70052,Blue,1,48445,48972,527
2022-06-14,70057,70051,Blue,0,66578,66825,247
2022-12-07,70048,70060,Blue,1,44542,45162,620
2022-09-10,70048,70054,Blue,1,29086,29389,303
2022-03-14,70047,70039,Blue,0,83522,83961,439
2022-07-24,70042,70056,Blue,1,86480,87169,689
2022-03-03,70048,70054,Blue,1,25853,26163,310
2022-10-17,70043,70039,Blue,0,60652,60756,104
2022-09-11,70044,70060,Blue,1,74418,75287,869
2022-12-28,70059,70838,Blue,0,69535,70768,1233
2022-08-26,70049,70838,Blue,0,74260,74873,613
2022-09-18,70038,70056,Blue,1,73220,74153,933
2022-12-06,70051,70047,Blue,0,66765,66990,225
2022-01-16,70040,70050,Blue,1,68959,69564,605
2022-12-23,70048,70054,Blue,1,35133,35488,355
2022-01-09,70055,70043,Blue,0,82394,83050,656
2022-03-15,70047,70041,Blue,0,22329,22722,393
2022-01-05,70057,70047,Blue,0,21770,22314,544
2022-10-18,70048,70060,Blue,1,64576,65395,819
2022-04-19,70046,70054,Blue,1,56133,56560,427
2022-01-29,70046,70050,Blue,1,27718,28062,344
2022-08-14,70055,70053,Blue,0,88402,88448,46
2022-07-24,70038,70050,Blue,1,38384,38944,560
2022-12-02,70053,70051,Blue,0,68916,68965,49
2022-01-16,70051,70045,Blue,0,51491,51830,339
2022-07-15,70038,70052,Blue,1,54979,55686,707
2022-08-20,70050,70058,Blue,1,77896,78337,441
2022-01-10,70047,70039,Blue,0,59913,60333,420
2022-01-23,70046,70058,Blue,1,58479,59107,628
2022-10-12,70048,70058,Blue,1,45450,46020,570
2022-07-17,70046,70048,Blue,1,48636,48713,77
2022-10-26,70048,70058,Blue,1,71288,71818,530
2022-08-11,70053,70047,Blue,0,24989,25342,353
2022-03-06,70059,70053,Blue,0,43453,43699,246
2022-02-24,70040,70054,Blue,1,66226,67010,784
2022-01-15,70038,70054,Blue,1,59580,60488,908
2022-02-09,70041,70039,Blue,0,22771,22806,35
2022-10-17,70044,70046,Blue,1,21537,21648,111
2022-07-23,70045,70039,Blue,0,77275,77539,264
2022-09-25,70055,70047,Blue,0,52954,53380,426
2022-06-14,70042,70054,Blue,1,81749,82522,773
2022-09-23,70055,70039,Blue,0,51321,52190,869
2022-08-26,70050,70056,Blue,1,51294,51641,347
2022-10-14,70049,70838,Blue,0,51070,51665,595
2022-05-11,70049,70047,Blue,0,20208,20242,34
2022-12-19,70049,70838,Blue,0,39513,40460,947
2022-08-21,70038,70050,Blue,1,76390,76972,582
2022-01-22,70051,70049,Blue,0,77671,77775,104
2022-03-23,70055,70838,Blue,0,28032,28941,909
2022-09-04,70046,70056,Blue,1,72984,73494,510
2022-01-25,70046,70054,Blue,1,87472,87886,414
2022-10-20,70038,70052,Blue,1,32330,33048,718
2022-02-20,70040,70060,Blue,1,70526,71588,1062
2022-07-22,70059,70053,Blue,0,22582,22830,248
2022-06-13,70038,70052,Blue,1,75797,76569,772
2022-04-04,70057,70051,Blue,0,60590,60863,273
2022-07-11,70051,70045,Blue,0,54410,54754,344
2022-01-07,70057,70043,Blue,0,37248,38149,901
2022-10-14,70047,70041,Blue,0,22815,23142,327
2022-04-18,70042,70060,Blue,1,71317,72475,1158
2022-10-18,70059,70047,Blue,0,66554,67105,551
2022-01-24,70047,70045,Blue,0,19059,19160,101
2022-03-01,70040,70048,Blue,1,26421,26803,382
2022-07-26,70048,70060,Blue,1,39508,40191,683
2022-07-09,70046,70056,Blue,1,61959,62484,525
2022-08-15,70042,70050,Blue,1,36608,37057,449
2022-10-17,70038,70054,Blue,1,60399,61456,1057
2022-12-20,70040,70042,Blue,1,20671,20706,35
2022-12-20,70038,70042,Blue,1,41294,41399,105
2022-10-03,70043,70838,Blue,0,42022,42212,190
2022-03-02,70053,70047,Blue,0,79710,79982,272
2022-07-18,70059,70053,Blue,0,44714,44955,241
2022-06-19,70047,70039,Blue,0,60732,61192,460
2022-02-28,70040,70054,Blue,1,57521,58271,750
2022-07-04,70038,70052,Blue,1,64972,65730,758
2022-01-06,70050,70052,Blue,1,69141,69280,139
2022-01-24,70046,70056,Blue,1,60839,61359,520
2022-12-14,70042,70058,Blue,1,89267,90138,871
2022-08-25,70051,70838,Blue,0,57007,57737,730
2022-11-06,70052,70060,Blue,1,66350,66690,340
2022-08-27,70038,70056,Blue,1,43686,44541,855
2022-03-09,70057,70838,Blue,0,20713,21888,1175
2022-11-21,70040,70048,Blue,1,86586,86942,356
2022-02-07,70038,70050,Blue,1,67933,68501,568
2022-01-19,70049,70043,Blue,0,33714,34114,400
2022-10-10,70052,70056,Blue,1,54115,54267,152
2022-03-24,70048,70052,Blue,1,38350,38559,209
2022-12-03,70053,70045,Blue,0,59209,59654,445
2022-09-11,70057,70045,Blue,0,36944,37570,626
2022-03-22,70057,70043,Blue,0,21430,22303,873
2022-06-05,70050,70052,Blue,1,36369,36629,260
2022-09-19,70038,70060,Blue,1,42118,43248,1130
2022-02-23,70051,70043,Blue,0,56974,57505,531
2022-12-19,70040,70050,Blue,1,31051,31527,476
2022-09-17,70045,70838,Blue,0,75445,75813,368
2022-11-18,70052,70056,Blue,1,62985,63129,144
2022-08-10,70057,70051,Blue,0,56019,56406,387
2022-11-14,70048,70050,Blue,1,31243,31303,60
2022-03-29,70057,70045,Blue,0,72696,73301,605
2022-05-03,70057,70051,Blue,0,18893,19181,288
2022-05-18,70044,70054,Blue,1,61976,62704,728
2022-11-09,70057,70045,Blue,0,59369,59937,568
2022-08-06,70051,70039,Blue,0,20547,21210,663
2022-12-16,70057,70047,Blue,0,63281,63810,529
2022-04-23,70038,70054,Blue,1,47480,48332,852
2022-02-09,70057,70838,Blue,0,85230,86268,1038
2022-11-02,70044,70058,Blue,1,25126,25944,818
2022-09-27,70053,70045,Blue,0,35164,35732,568
2022-12-02,70041,70838,Blue,0,75563,75680,117
2022-07-06,70040,70042,Blue,1,35568,35608,40
2022-11-17,70051,70043,Blue,0,40943,41445,502
2022-06-25,70039,70838,Blue,0,50991,51023,32
2022-08-31,70055,70051,Blue,0,58931,59063,132
2022-03-22,70059,70045,Blue,0,77795,78497,702
2022-09-03,70051,70041,Blue,0,49582,50160,578
2022-08-30,70043,70039,Blue,0,21861,21974,113
2022-07-27,70042,70050,Blue,1,35102,35539,437
2022-10-26,70059,70838,Blue,0,23855,25015,1160
2022-09-04,70059,70055,Blue,0,83769,83913,144
2022-03-11,70038,70050,Blue,1,61281,61906,625
2022-12-06,70038,70048,Blue,1,58333,58761,428
2022-12-24,70045,70041,Blue,0,23757,23934,177
2022-04-12,70039,70838,Blue,0,75419,75461,42
2022-09-26,70040,70042,Blue,1,65261,65294,33
2022-11-24,70044,70058,Blue,1,55579,56325,746
2022-11-13,70049,70838,Blue,0,61366,61928,562
2022-03-16,70045,70041,Blue,0,54291,54448,157
2022-04-06,70038,70056,Blue,1,29652,30536,884
2022-01-21,70055,70047,Blue,0,28967,29385,418
2022-03-07,70052,70056,Blue,1,79406,79549,143
2022-01-10,70050,70058,Blue,1,74106,74496,390
2022-02-04,70057,70838,Blue,0,62673,63765,1092
2022-01-07,70055,70045,Blue,0,68643,69267,624
2022-10-24,70040,70048,Blue,1,36671,37188,517
2022-08-25,70051,70043,Blue,0,60699,61198,499
2022-01-05,70043,70041,Blue,0,23038,23066,28
2022-10-29,70039,70838,Blue,0,54113,54148,35
2022-03-16,70057,70055,Blue,0,74421,74491,70
2022-07-14,70059,70055,Blue,0,41759,41913,154
2022-04-20,70042,70060,Blue,1,53179,54213,1034
2022-03-14,70053,70049,Blue,0,63744,63946,202
2022-12-30,70046,70060,Blue,1,53397,54228,831
2022-01-04,70042,70052,Blue,1,33692,34250,558
2022-08-22,70057,70045,Blue,0,28127,28794,667
2022-12-30,70054,70058,Blue,1,30218,30367,149
2022-11-03,70049,70041,Blue,0,59147,59580,433
2022-02-15,70049,70041,Blue,0,20091,20660,569
2022-01-03,70044,70054,Blue,1,33125,33652,527
2022-11-19,70057,70045,Blue,0,39038,39694,656
2022-01-04,70059,70049,Blue,0,79454,79936,482
2022-10-21,70057,70045,Blue,0,31494,32170,676
2022-02-26,70046,70048,Blue,1,29491,29585,94
2022-02-09,70044,70046,Blue,1,47185,47298,113
2022-08-26,70057,70045,Blue,0,56762,57403,641
2022-05-01,70056,70058,Blue,1,23646,23714,68
2022-03-28,70051,70047,Blue,0,58457,58650,193
2022-03-18,70049,70045,Blue,0,26329,26568,239
2022-10-21,70050,70054,Blue,1,53152,53371,219
2022-07-08,70045,70039,Blue,0,67556,67795,239
2022-01-24,70048,70050,Blue,1,66382,66444,62
2022-04-15,70046,70048,Blue,1,49409,49506,97
2022-11-30,70050,70058,Blue,1,50110,50549,439
2022-10-27,70057,70039,Blue,0,86601,87534,933
2022-07-03,70046,70058,Blue,1,74668,75395,727
2022-02-04,70048,70060,Blue,1,54834,55441,607
2022-01-13,70038,70046,Blue,1,71412,71804,392
2022-02-26,70038,70058,Blue,1,85511,86606,1095
2022-07-24,70038,70046,Blue,1,73203,73541,338
2022-03-08,70044,70058,Blue,1,73205,74006,801
2022-06-29,70059,70041,Blue,0,56550,57507,957
2022-09-20,70049,70045,Blue,0,72290,72526,236
2022-11-02,70038,70052,Blue,1,53386,54195,809
2022-12-18,70046,70054,Blue,1,43293,43680,387
2022-11-01,70052,70060,Blue,1,40683,41073,390
2022-10-17,70052,70060,Blue,1,68173,68509,336
2022-08-16,70059,70045,Blue,0,27226,28011,785
2022-07-21,70050,70058,Blue,1,55769,56272,503
2022-04-18,70059,70051,Blue,0,32962,33299,337
2022-09-11,70059,70055,Blue,0,39497,39637,140
2022-05-22,70038,70048,Blue,1,34512,35065,553
2022-09-19,70048,70056,Blue,1,47992,48384,392
2022-07-25,70053,70838,Blue,0,61115,61916,801
2022-06-12,70059,70047,Blue,0,86419,86958,539
2022-08-08,70050,70054,Blue,1,67122,67348,226
2022-02-12,70038,70042,Blue,1,45849,45950,101
2022-07-20,70052,70060,Blue,1,50134,50502,368
2022-09-05,70056,70058,Blue,1,48294,48365,71
2022-10-30,70049,70838,Blue,0,46801,47422,621
2022-11-29,70042,70050,Blue,1,67554,67973,419
2022-07-30,70053,70051,Blue,0,26279,26331,52
2022-02-28,70059,70047,Blue,0,44348,44960,612
2022-03-12,70053,70051,Blue,0,33318,33380,62
2022-07-28,70053,70045,Blue,0,55558,56002,444
2022-12-10,70038,70060,Blue,1,55575,56771,1196
2022-04-19,70057,70047,Blue,0,26163,26706,543
2022-11-03,70055,70838,Blue,0,59953,60836,883
2022-07-19,70038,70040,Blue,1,58088,58102,14
2022-08-23,70053,70051,Blue,0,69862,69912,50
2022-12-28,70050,70058,Blue,1,69709,70117,408
2022-06-19,70050,70058,Blue,1,47394,47798,404
2022-10-05,70048,70058,Blue,1,55733,56227,494
2022-10-28,70038,70060,Blue,1,38876,40169,1293
2022-05-27,70044,70050,Blue,1,80063,80469,406
2022-06-23,70048,70050,Blue,1,76635,76695,60
2022-01-17,70048,70056,Blue,1,73891,74298,407
2022-03-31,70055,70045,Blue,0,70692,71181,489
2022-10-02,70038,70060,Blue,1,67769,68896,1127
2022-11-06,70057,70838,Blue,0,61468,62434,966
2022-07-26,70044,70058,Blue,1,51914,52808,894
2022-03-06,70055,70053,Blue,0,29480,29543,63
2022-03-10,70059,70838,Blue,0,58992,60167,1175
2022-05-29,70044,70050,Blue,1,76916,77357,441
2022-01-10,70053,70049,Blue,0,20852,21036,184
2022-08-18,70055,70049,Blue,0,86027,86290,263
2022-05-15,70050,70056,Blue,1,41669,41938,269
2022-11-08,70046,70052,Blue,1,43996,44363,367
2022-10-07,70055,70051,Blue,0,81367,81501,134
2022-03-22,70057,70039,Blue,0,79541,80567,1026
2022-09-30,70042,70052,Blue,1,83580,84158,578
2022-07-03,70044,70060,Blue,1,76629,77597,968
2022-06-09,70040,70042,Blue,1,52211,52245,34
2022-01-19,70055,70041,Blue,0,31578,32568,990
2022-07-02,70042,70046,Blue,1,42756,42953,197
2022-11-19,70044,70058,Blue,1,61630,62425,795
2022-10-11,70055,70838,Blue,0,60499,61443,944
2022-03-08,70038,70060,Blue,1,39605,40830,1225
2022-01-22,70038,70060,Blue,1,70291,71395,1104
2022-10-03,70053,70045,Blue,0,29197,29663,466
2022-11-04,70040,70044,Blue,1,58512,58642,130
2022-05-28,70044,70050,Blue,1,27478,27874,396
2022-03-01,70038,70042,Blue,1,55327,55443,116
2022-03-01,70055,70039,Blue,0,47834,48694,860
2022-03-13,70055,70053,Blue,0,35714,35763,49
2022-10-03,70049,70043,Blue,0,23961,24347,386
2022-10-10,70048,70056,Blue,1,43235,43683,448
2022-03-15,70057,70043,Blue,0,28615,29459,844
2022-01-04,70053,70043,Blue,0,64066,64641,575
2022-01-26,70046,70048,Blue,1,57081,57206,125
2022-02-25,70046,70054,Blue,1,41905,42385,480
2022-11-14,70053,70838,Blue,0,40406,41309,903
2022-03-23,70043,70838,Blue,0,27392,27642,250
2022-05-08,70057,70055,Blue,0,66098,66169,71
2022-12-17,70048,70050,Blue,1,86167,86234,67
2022-10-25,70045,70039,Blue,0,66340,66589,249
2022-01-01,70040,70060,Blue,1,58639,59727,1088
2022-05-20,70043,70039,Blue,0,79952,80052,100
2022-02-10,70057,70053,Blue,0,56070,56246,176
2022-10-19,70049,70045,Blue,0,29834,30043,209
2022-09-01,70044,70050,Blue,1,25821,26147,326
2022-04-04,70054,70058,Blue,1,68263,68432,169
2022-03-19,70059,70047,Blue,0,79155,79687,532
2022-01-26,70055,70051,Blue,0,48376,48559,183
2022-03-18,70059,70055,Blue,0,61401,61547,146
2022-08-01,70046,70060,Blue,1,61609,62359,750
2022-11-07,70059,70047,Blue,0,68353,68911,558
2022-09-30,70052,70060,Blue,1,80676,81091,415
2022-03-16,70055,70045,Blue,0,66672,67182,510
2022-10-11,70057,70053,Blue,0,64525,64673,148
2022-06-18,70045,70043,Blue,0,46780,46897,117
2022-10-17,70059,70045,Blue,0,72790,73466,676
2022-07-24,70057,70045,Blue,0,50681,51288,607
2022-11-19,70053,70049,Blue,0,48941,49134,193
2022-10-30,70046,70052,Blue,1,80132,80454,322
2022-04-02,70053,70838,Blue,0,54346,55208,862
2022-10-05,70038,70048,Blue,1,56517,57003,486
2022-07-25,70057,70043,Blue,0,20503,21278,775
2022-04-09,70048,70058,Blue,1,64181,64673,492
2022-07-16,70042,70048,Blue,1,50896,51210,314
2022-01-25,70059,70039,Blue,0,59892,60932,1040
2022-12-29,70049,70838,Blue,0,49972,50614,642
2022-03-31,70059,70838,Blue,0,44952,45989,1037
2022-11-13,70043,70039,Blue,0,50926,51032,106
2022-08-21,70038,70042,Blue,1,40391,40501,110
2022-12-03,70038,70058,Blue,1,72842,73888,1046
2022-08-04,70059,70057,Blue,0,44206,44243,37
2022-02-01,70044,70054,Blue,1,85047,85604,557
2022-03-01,70046,70056,Blue,1,25830,26355,525
2022-02-26,70038,70056,Blue,1,40993,41874,881
2022-11-27,70059,70045,Blue,0,58695,59495,800
2022-08-13,70059,70053,Blue,0,20841,21101,260
2022-11-03,70055,70053,Blue,0,41803,41861,58
2022-08-10,70050,70060,Blue,1,59610,60161,551
2022-11-28,70049,70039,Blue,0,85631,86120,489
2022-03-24,70046,70050,Blue,1,56044,56239,195
2022-06-24,70049,70041,Blue,0,65497,65932,435
2022-11-04,70056,70060,Blue,1,61141,61330,189
2022-05-29,70041,70039,Blue,0,47755,47793,38
2022-03-31,70059,70051,Blue,0,43212,43521,309
2022-09-20,70055,70838,Blue,0,67282,68140,858
2022-09-22,70040,70052,Blue,1,82868,83571,703
2022-01-09,70048,70060,Blue,1,67142,67802,660
2022-01-05,70053,70049,Blue,0,22401,22607,206
2022-04-15,70045,70039,Blue,0,54431,54706,275
2022-12-07,70059,70053,Blue,0,69672,69907,235
2022-10-24,70055,70045,Blue,0,29481,30012,531
2022-11-10,70046,70048,Blue,1,43948,44029,81
2022-02-03,70050,70058,Blue,1,22443,22948,505
2022-03-27,70046,70056,Blue,1,33448,33961,513
2022-12-26,70046,70052,Blue,1,82735,83126,391
2022-11-04,70040,70052,Blue,1,54723,55380,657
2022-09-14,70042,70052,Blue,1,34577,35122,545
2022-01-05,70042,70054,Blue,1,84385,85010,625
2022-06-20,70048,70058,Blue,1,39351,39881,530
2022-02-18,70048,70050,Blue,1,23573,23631,58
2022-05-26,70044,70050,Blue,1,58720,59170,450
2022-12-30,70040,70052,Blue,1,58099,58704,605
2022-04-04,70057,70049,Blue,0,63870,64240,370
2022-09-07,70050,70052,Blue,1,75769,75880,111
2022-07-11,70055,70043,Blue,0,57397,58054,657
2022-08-18,70044,70046,Blue,1,49652,49755,103
2022-11-29,70048,70052,Blue,1,30721,30929,208
2022-06-27,70038,70048,Blue,1,90142,91687,1545
2022-09-29,70051,70045,Blue,0,58102,58422,320
2022-12-16,70048,70050,Blue,1,45631,45690,59
2022-04-12,70042,70052,Blue,1,64766,65377,611
2022-07-30,70049,70043,Blue,0,30280,30600,320
2022-11-05,70055,70047,Blue,0,23207,23619,412
2022-03-18,70053,70041,Blue,0,31778,32429,651
2022-08-28,70057,70838,Blue,0,59852,60885,1033
2022-07-13,70053,70838,Blue,0,46239,47228,989
2022-11-25,70047,70039,Blue,0,71264,71649,385
2022-08-17,70053,70045,Blue,0,38117,38596,479
2022-01-01,70047,70043,Blue,0,66286,66516,230
2022-08-10,70055,70047,Blue,0,37637,38166,529
2022-07-25,70040,70042,Blue,1,76588,76618,30
2022-08-11,70038,70048,Blue,1,73646,74098,452
2022-06-22,70051,70049,Blue,0,51976,52078,102
2022-09-19,70044,70060,Blue,1,78066,78927,861
2022-08-01,70050,70058,Blue,1,33141,33567,426
2022-06-21,70048,70058,Blue,1,43872,44475,603
2022-11-12,70057,70049,Blue,0,45516,45925,409
2022-04-09,70042,70044,Blue,1,21132,21158,26
2022-12-01,70051,70041,Blue,0,28454,29098,644
2022-02-26,70057,70047,Blue,0,56853,57345,492
2022-09-14,70042,70058,Blue,1,26792,27709,917
2022-05-23,70038,70048,Blue,1,21071,21638,567
2022-09-05,70042,70058,Blue,1,43795,44648,853
2022-10-19,70052,70056,Blue,1,49407,49543,136
2022-07-12,70038,70040,Blue,1,38583,38600,17
2022-09-27,70055,70045,Blue,0,39879,40550,671
2022-04-07,70059,70045,Blue,0,51554,52226,672
2022-08-06,70045,70838,Blue,0,31628,32029,401
2022-02-10,70049,70043,Blue,0,19383,19866,483
2022-04-01,70048,70052,Blue,1,26032,26240,208
2022-10-09,70059,70051,Blue,0,30887,31236,349
2022-10-09,70054,70058,Blue,1,62606,62757,151
2022-12-14,70046,70060,Blue,1,20338,21153,815
2022-01-20,70052,70060,Blue,1,87302,87719,417
2022-11-13,70053,70045,Blue,0,53028,53455,427
2022-03-02,70057,70047,Blue,0,31252,31772,520
2022-08-17,70038,70042,Blue,1,75186,75276,90
2022-09-20,70040,70048,Blue,1,84334,84754,420
2022-08-06,70044,70050,Blue,1,58046,58387,341
2022-10-04,70042,70054,Blue,1,72212,72886,674
2022-08-28,70050,70052,Blue,1,74263,74383,120
2022-12-11,70049,70039,Blue,0,33668,34133,465
2022-09-04,70046,70060,Blue,1,58979,59720,741
2022-07-30,70048,70054,Blue,1,65274,65618,344
2022-08-29,70059,70043,Blue,0,74355,75229,874
2022-08-15,70050,70054,Blue,1,69019,69261,242
2022-01-02,70040,70054,Blue,1,58142,58873,731
2022-10-15,70057,70041,Blue,0,82411,83246,835
2022-04-19,70042,70060,Blue,1,84461,85551,1090
2022-08-24,70046,70052,Blue,1,37207,37528,321
2022-07-27,70055,70049,Blue,0,68841,69109,268
2022-01-16,70049,70039,Blue,0,51630,52139,509
2022-01-08,70040,70050,Blue,1,50775,51251,476
2022-10-17,70040,70058,Blue,1,69565,70564,999
2022-08-20,70057,70039,Blue,0,74126,75049,923
2022-05-16,70054,70058,Blue,1,34229,34379,150
2022-03-13,70050,70056,Blue,1,80326,80613,287
2022-12-13,70040,70056,Blue,1,52936,53853,917
2022-01-16,70053,70049,Blue,0,71931,72124,193
2022-10-27,70041,70039,Blue,0,60258,60291,33
2022-07-15,70047,70838,Blue,0,33756,34270,514
2022-09-25,70050,70060,Blue,1,61590,62125,535
2022-12-24,70045,70043,Blue,0,52772,52863,91
2022-10-17,70038,70060,Blue,1,56472,57765,1293
2022-11-04,70040,70044,Blue,1,30032,30131,99
2022-12-09,70048,70054,Blue,1,32796,33075,279
2022-02-04,70055,70043,Blue,0,60373,61074,701
2022-11-10,70059,70041,Blue,0,67213,68126,913
2022-03-31,70046,70060,Blue,1,64766,65564,798
2022-08-19,70048,70058,Blue,1,21631,22174,543
2022-09-06,70038,70046,Blue,1,65426,65737,311
2022-05-18,70045,70838,Blue,0,64508,65256,748
2022-08-09,70046,70050,Blue,1,50833,51030,197
2022-08-03,70042,70060,Blue,1,63683,64708,1025
2022-12-16,70043,70041,Blue,0,80143,80174,31
2022-03-08,70044,70054,Blue,1,21162,21757,595
2022-03-17,70055,70045,Blue,0,22219,22749,530
2022-07-01,70057,70049,Blue,0,64023,64421,398
2022-07-20,70059,70041,Blue,0,57691,58688,997
2022-03-12,70050,70060,Blue,1,68065,68599,534
2022-03-23,70038,70050,Blue,1,52110,52677,567
2022-05-18,70048,70052,Blue,1,70977,71231,254
2022-09-17,70057,70043,Blue,0,79170,79908,738
2022-01-07,70057,70053,Blue,0,66868,67033,165
2022-07-06,70044,70046,Blue,1,35100,35235,135
2022-01-05,70055,70049,Blue,0,31601,31957,356
2022-10-25,70057,70838,Blue,0,26851,28025,1174
2022-10-19,70042,70050,Blue,1,56663,57135,472
2022-09-14,70044,70050,Blue,1,27378,27725,347
2022-02-09,70052,70056,Blue,1,30030,30163,133
2022-06-10,70038,70060,Blue,1,26351,27513,1162
2022-06-20,70052,70060,Blue,1,77546,77919,373
2022-04-14,70044,70060,Blue,1,43783,44798,1015
2022-08-29,70049,70039,Blue,0,29001,29565,564
2022-03-22,70044,70048,Blue,1,62143,62416,273
2022-06-12,70059,70045,Blue,0,80897,81631,734
2022-02-10,70044,70056,Blue,1,51901,52646,745
2022-11-14,70046,70056,Blue,1,65390,65912,522
2022-06-14,70044,70058,Blue,1,81611,82495,884
2022-11-02,70047,70045,Blue,0,32109,32220,111
2022-04-22,70047,70045,Blue,0,86917,87010,93
2022-01-08,70057,70049,Blue,0,29320,29702,382
2022-01-28,70052,70054,Blue,1,50481,50528,47
2022-12-09,70038,70048,Blue,1,73661,74111,450
2022-06-19,70051,70039,Blue,0,29673,30359,686
2022-04-21,70053,70039,Blue,0,84266,84942,676
2022-11-07,70043,70039,Blue,0,48557,48671,114
2022-04-24,70049,70047,Blue,0,41325,41383,58
2022-06-15,70042,70058,Blue,1,42138,43074,936
2022-10-02,70054,70060,Blue,1,58405,58676,271
2022-08-20,70059,70039,Blue,0,74596,75648,1052
2022-07-20,70042,70050,Blue,1,78454,78878,424
2022-01-27,70057,70041,Blue,0,28593,29495,902
2022-07-15,70044,70060,Blue,1,69044,69922,878
2022-12-26,70051,70039,Blue,0,53138,53830,692
2022-01-16,70059,70053,Blue,0,45735,45986,251
2022-12-24,70055,70041,Blue,0,60744,61492,748
2022-07-14,70049,70043,Blue,0,32357,32917,560
2022-03-07,70043,70041,Blue,0,25111,25141,30
2022-12-01,70038,70048,Blue,1,20015,20555,540
2022-03-18,70053,70043,Blue,0,61053,61592,539
2022-02-11,70050,70056,Blue,1,40753,41036,283
2022-06-13,70046,70052,Blue,1,88098,88403,305
2022-01-07,70038,70060,Blue,1,70932,72074,1142
2022-09-06,70059,70053,Blue,0,32232,32457,225
2022-09-28,70039,70838,Blue,0,54136,54169,33
2022-10-21,70053,70051,Blue,0,41866,41925,59
2022-12-14,70053,70047,Blue,0,42479,42791,312
2022-10-23,70042,70058,Blue,1,60381,61317,936
2022-08-06,70038,70060,Blue,1,31808,32913,1105
2022-10-11,70041,70039,Blue,0,38283,38315,32
2022-12-17,70038,70046,Blue,1,21021,21338,317
2022-09-09,70042,70060,Blue,1,40676,41684,1008
2022-10-09,70051,70039,Blue,0,74349,74961,612
2022-03-25,70040,70052,Blue,1,74113,74739,626
2022-03-16,70052,70058,Blue,1,39825,40085,260
2022-03-01,70059,70838,Blue,0,64298,65573,1275
2022-10-16,70050,70056,Blue,1,74840,75211,371
2022-03-08,70055,70045,Blue,0,23240,23814,574
2022-11-11,70046,70050,Blue,1,78223,78433,210
2022-01-15,70051,70043,Blue,0,71374,71949,575
2022-11-11,70049,70045,Blue,0,75442,75649,207
2022-02-04,70053,70047,Blue,0,27360,27653,293
2022-08-09,70059,70047,Blue,0,36923,37654,731
2022-12-23,70057,70047,Blue,0,43041,43610,569
2022-06-13,70038,70050,Blue,1,30848,31432,584
2022-09-13,70055,70041,Blue,0,43884,44630,746
2022-02-11,70043,70838,Blue,0,80348,80524,176
2022-07-10,70046,70052,Blue,1,41388,41730,342
2022-09-28,70059,70041,Blue,0,76464,77365,901
2022-07-26,70051,70047,Blue,0,21186,21379,193
2022-11-30,70047,70838,Blue,0,37626,38174,548
2022-07-13,70053,70047,Blue,0,20204,20501,297
2022-05-21,70059,70053,Blue,0,40583,40805,222
2022-12-13,70046,70060,Blue,1,77081,77761,680
2022-06-13,70051,70043,Blue,0,51105,51656,551
2022-07-27,70051,70047,Blue,0,45679,45875,196
2022-03-08,70059,70838,Blue,0,57795,58906,1111
2022-08-26,70059,70055,Blue,0,38482,38628,146
2022-08-18,70057,70049,Blue,0,48977,49383,406
2022-01-24,70038,70050,Blue,1,26054,26681,627
2022-12-29,70047,70039,Blue,0,70713,71066,353
2022-02-11,70055,70051,Blue,0,67698,67831,133
2022-06-29,70040,70052,Blue,1,27815,28511,696
2022-06-09,70038,70054,Blue,1,79766,80667,901
2022-02-25,70041,70039,Blue,0,67860,67901,41
2022-12-07,70052,70058,Blue,1,71891,72130,239
2022-11-09,70040,70042,Blue,1,59664,59700,36
2022-07-28,70059,70043,Blue,0,32235,33119,884
2022-02-15,70046,70052,Blue,1,86405,86778,373
2022-03-17,70044,70058,Blue,1,62747,63557,810
2022-06-09,70044,70058,Blue,1,76161,77003,842
2022-12-02,70051,70049,Blue,0,36160,36263,103
2022-04-05,70050,70054,Blue,1,30274,30484,210
2022-12-17,70049,70039,Blue,0,52468,52996,528
2022-01-05,70040,70044,Blue,1,22197,22295,98
2022-09-14,70045,70043,Blue,0,62348,62445,97
2022-10-28,70046,70054,Blue,1,69997,70420,423
2022-11-13,70044,70054,Blue,1,63647,64259,612
2022-04-08,70053,70051,Blue,0,76308,76362,54
2022-06-14,70038,70054,Blue,1,86603,87479,876
2022-09-01,70038,70052,Blue,1,40497,41896,1399
2022-04-23,70048,70054,Blue,1,49131,49434,303
2022-02-26,70059,70051,Blue,0,75133,75485,352
2022-02-28,70048,70054,Blue,1,50801,51096,295
2022-04-01,70040,70042,Blue,1,64982,65016,34
2022-05-21,70053,70039,Blue,0,29530,30364,834
2022-04-20,70053,70051,Blue,0,29029,29075,46
2022-05-12,70050,70054,Blue,1,72313,72536,223
2022-10-30,70059,70057,Blue,0,71118,71153,35
2022-12-27,70046,70060,Blue,1,33147,33899,752
2022-06-14,70055,70047,Blue,0,28962,29369,407
2022-08-29,70059,70049,Blue,0,37992,38481,489
2022-01-01,70048,70054,Blue,1,32037,32344,307
2022-07-08,70048,70050,Blue,1,85632,85694,62
2022-08-08,70059,70043,Blue,0,66021,66848,827
2022-08-21,70048,70056,Blue,1,79235,79724,489
2022-01-11,70059,70047,Blue,0,47166,47725,559
2022-10-06,70044,70052,Blue,1,61620,62097,477
2022-01-03,70053,70047,Blue,0,57186,57479,293
2022-06-11,70041,70039,Blue,0,24487,24521,34
2022-06-30,70042,70048,Blue,1,77479,77824,345
2022-11-07,70038,70058,Blue,1,81081,82080,999
2022-03-17,70047,70041,Blue,0,74409,74726,317
2022-02-22,70047,70041,Blue,0,26088,26444,356
2022-10-28,70040,70056,Blue,1,35360,36195,835
2022-02-27,70040,70056,Blue,1,62425,63312,887
2022-09-09,70055,70838,Blue,0,67570,68826,1256
2022-09-27,70050,70060,Blue,1,53460,53940,480
2022-10-10,70048,70050,Blue,1,65006,65061,55
2022-04-12,70045,70039,Blue,0,73648,73886,238
2022-05-21,70057,70039,Blue,0,66741,67814,1073
2022-11-05,70050,70060,Blue,1,50146,50641,495
2022-03-09,70039,70838,Blue,0,34113,34148,35
2022-10-11,70040,70058,Blue,1,76354,77324,970
2022-02-02,70038,70044,Blue,1,31263,31451,188
2022-03-11,70044,70060,Blue,1,42316,43309,993
2022-11-15,70052,70054,Blue,1,27275,27335,60
2022-01-13,70048,70060,Blue,1,49155,49777,622
2022-01-16,70038,70060,Blue,1,74228,75330,1102
2022-09-19,70042,70044,Blue,1,82129,82159,30
2022-02-24,70038,70044,Blue,1,75794,75966,172
2022-10-07,70051,70047,Blue,0,74739,74945,206
2022-06-10,70057,70045,Blue,0,57011,57667,656
2022-07-28,70047,70043,Blue,0,66608,66859,251
2022-08-21,70038,70046,Blue,1,48306,48655,349
2022-03-16,70046,70056,Blue,1,72758,73470,712
2022-01-25,70059,70041,Blue,0,19531,20663,1132
2022-02-08,70048,70052,Blue,1,21299,21496,197
2022-01-15,70045,70041,Blue,0,84031,84240,209
2022-02-07,70048,70056,Blue,1,25420,25832,412
2022-06-17,70038,70040,Blue,1,51710,51726,16
2022-07-30,70059,70043,Blue,0,42198,43061,863
2022-12-29,70057,70053,Blue,0,33532,33686,154
2022-08-17,70053,70051,Blue,0,58482,58539,57
2022-11-28,70048,70058,Blue,1,61280,61787,507
2022-03-03,70046,70054,Blue,1,25892,26336,444
2022-06-06,70044,70046,Blue,1,87917,88100,183
2022-04-23,70046,70054,Blue,1,27291,27671,380
2022-03-28,70051,70049,Blue,0,87823,87925,102
2022-09-07,70059,70055,Blue,0,43698,43838,140
2022-11-20,70055,70049,Blue,0,72976,73260,284
2022-02-08,70059,70051,Blue,0,87496,87830,334
2022-09-23,70057,70039,Blue,0,75459,76408,949
2022-04-19,70048,70060,Blue,1,46176,46905,729
2022-01-06,70055,70039,Blue,0,32232,33004,772
2022-10-31,70049,70039,Blue,0,56311,56813,502
2022-01-07,70038,70052,Blue,1,27248,28033,785
2022-10-21,70047,70039,Blue,0,77055,77439,384
2022-09-16,70054,70056,Blue,1,64473,64519,46
2022-02-25,70049,70043,Blue,0,65905,66270,365
2022-09-06,70046,70056,Blue,1,27912,28462,550
2022-01-03,70040,70056,Blue,1,23121,23998,877
2022-12-27,70050,70052,Blue,1,32762,32875,113
2022-09-17,70043,70041,Blue,0,56802,56830,28
2022-11-03,70040,70050,Blue,1,85991,86495,504
2022-09-09,70055,70047,Blue,0,22506,22904,398
2022-02-14,70056,70058,Blue,1,43866,43937,71
2022-02-03,70057,70838,Blue,0,58232,59638,1406
2022-06-09,70039,70838,Blue,0,23233,23268,35
2022-11-12,70047,70045,Blue,0,60374,60465,91
2022-04-12,70038,70050,Blue,1,49209,49826,617
2022-01-23,70059,70049,Blue,0,35576,36037,461
2022-01-10,70040,70056,Blue,1,85449,86306,857
2022-09-02,70059,70838,Blue,0,58214,59353,1139
2022-03-29,70038,70054,Blue,1,56525,57320,795
2022-01-16,70049,70838,Blue,0,44656,45264,608
2022-06-24,70059,70039,Blue,0,54565,55659,1094
2022-04-03,70040,70058,Blue,1,84665,85605,940
2022-09-23,70038,70044,Blue,1,62181,62354,173
2022-04-20,70053,70049,Blue,0,34452,34729,277
2022-12-11,70049,70045,Blue,0,36694,36895,201
2022-08-11,70046,70050,Blue,1,55366,55570,204
2022-08-26,70040,70044,Blue,1,53017,53122,105
2022-10-27,70046,70060,Blue,1,33581,34410,829
2022-11-23,70055,70043,Blue,0,21867,22571,704
2022-07-06,70057,70049,Blue,0,38692,39170,478
2022-03-17,70053,70051,Blue,0,67900,68021,121
2022-01-24,70046,70052,Blue,1,30918,31286,368
2022-12-02,70040,70054,Blue,1,52109,52816,707
2022-06-21,70046,70058,Blue,1,68576,69231,655
2022-06-30,70057,70053,Blue,0,74348,74506,158
2022-01-09,70057,70039,Blue,0,83078,83993,915
2022-12-03,70038,70058,Blue,1,77945,78950,1005
2022-05-23,70040,70048,Blue,1,51796,52286,490
2022-07-30,70057,70055,Blue,0,46705,46774,69
2022-08-14,70049,70045,Blue,0,72700,72896,196
2022-10-19,70043,70838,Blue,0,78439,78631,192
2022-01-19,70044,70046,Blue,1,73448,73555,107
2022-11-27,70048,70054,Blue,1,86900,87180,280
2022-10-11,70038,70054,Blue,1,52582,53455,873
2022-08-03,70059,70055,Blue,0,37137,37287,150
2022-09-06,70055,70049,Blue,0,20126,20413,287
2022-07-07,70051,70045,Blue,0,76250,76593,343
2022-11-17,70042,70058,Blue,1,25909,26845,936
2022-01-04,70054,70058,Blue,1,73484,73640,156
2022-01-16,70053,70838,Blue,0,53059,53970,911
2022-08-18,70056,70060,Blue,1,25002,25176,174
2022-07-27,70043,70041,Blue,0,21734,21764,30
2022-04-20,70048,70054,Blue,1,82082,82384,302
2022-01-18,70040,70060,Blue,1,69970,71048,1078
2022-02-18,70049,70838,Blue,0,61076,61667,591
2022-08-04,70046,70056,Blue,1,79362,79897,535
2022-10-28,70040,70044,Blue,1,87754,87882,128
2022-11-16,70057,70053,Blue,0,36028,36193,165
2022-12-14,70049,70041,Blue,0,27741,28158,417
2022-01-05,70042,70044,Blue,1,26192,26221,29
2022-08-09,70047,70043,Blue,0,50532,50803,271
2022-03-07,70050,70060,Blue,1,75325,75837,512
2022-01-24,70042,70046,Blue,1,41527,41693,166
2022-03-26,70038,70046,Blue,1,48549,48874,325
2022-01-24,70046,70060,Blue,1,53453,54230,777
2022-09-24,70040,70044,Blue,1,63197,63312,115
2022-11-24,70044,70050,Blue,1,28668,28981,313
2022-03-29,70059,70045,Blue,0,51193,51881,688
2022-12-22,70038,70046,Blue,1,19819,20443,624
2022-02-04,70055,70041,Blue,0,69154,70183,1029
2022-08-08,70045,70039,Blue,0,33477,33728,251
2022-09-21,70044,70052,Blue,1,29473,29964,491
2022-04-07,70038,70050,Blue,1,61031,61610,579
2022-05-20,70053,70051,Blue,0,21622,21678,56
2022-10-10,70059,70051,Blue,0,24256,24585,329
2022-06-09,70048,70060,Blue,1,79734,80350,616
2022-05-20,70040,70044,Blue,1,26430,26540,110
2022-12-30,70048,70058,Blue,1,29477,30004,527
2022-10-08,70054,70056,Blue,1,25221,25271,50
2022-08-19,70040,70056,Blue,1,47791,48655,864
2022-11-17,70052,70056,Blue,1,30657,30793,136
2022-01-25,70052,70056,Blue,1,61536,61679,143
2022-01-17,70041,70838,Blue,0,45444,45577,133
2022-10-22,70045,70838,Blue,0,21624,21984,360
2022-09-28,70055,70039,Blue,0,57710,58548,838
2022-11-09,70049,70039,Blue,0,33612,34129,517
2022-04-29,70059,70055,Blue,0,67651,67792,141
2022-08-18,70055,70049,Blue,0,59107,59387,280
2022-12-26,70054,70058,Blue,1,70814,70984,170
2022-08-28,70050,70058,Blue,1,31358,31740,382
2022-09-12,70052,70060,Blue,1,41609,42026,417
2022-11-18,70038,70042,Blue,1,83407,83558,151
2022-10-27,70047,70043,Blue,0,53442,53706,264
2022-03-04,70049,70039,Blue,0,42042,42556,514
2022-12-21,70048,70054,Blue,1,36577,36916,339
2022-09-16,70052,70054,Blue,1,74916,74975,59
2022-02-22,70039,70838,Blue,0,60461,60493,32
2022-02-09,70045,70838,Blue,0,52010,52473,463
2022-12-08,70049,70838,Blue,0,30180,30822,642
2022-07-24,70059,70055,Blue,0,30863,31012,149
2022-07-06,70038,70054,Blue,1,21386,22245,859
2022-09-29,70042,70058,Blue,1,60017,60905,888
2022-03-18,70042,70048,Blue,1,72158,72471,313
2022-07-07,70049,70047,Blue,0,47789,47846,57
2022-10-13,70059,70057,Blue,0,60389,60424,35
2022-03-14,70039,70838,Blue,0,63684,63717,33
2022-02-05,70045,70838,Blue,0,86449,86792,343
2022-01-18,70059,70041,Blue,0,76035,76977,942
2022-02-07,70049,70047,Blue,0,63450,63509,59
2022-01-08,70040,70050,Blue,1,53478,53944,466
2022-02-02,70042,70054,Blue,1,32491,33214,723
2022-03-17,70059,70049,Blue,0,64398,64872,474
2022-04-20,70045,70043,Blue,0,33461,33555,94
2022-06-28,70051,70045,Blue,0,35908,36304,396
2022-02-20,70057,70045,Blue,0,48512,49148,636
2022-05-08,70053,70051,Blue,0,83089,83143,54
2022-07-16,70055,70045,Blue,0,83351,83866,515
2022-04-24,70055,70043,Blue,0,64274,64901,627
2022-11-15,70056,70058,Blue,1,86380,86465,85
2022-06-05,70045,70043,Blue,0,51197,51301,104
2022-06-15,70057,70039,Blue,0,65075,66052,977
2022-10-27,70048,70050,Blue,1,27407,27466,59
2022-12-22,70048,70054,Blue,1,75455,75782,327
2022-07-28,70049,70043,Blue,0,27722,28077,355
2022-09-19,70046,70060,Blue,1,34944,35672,728
2022-07-04,70051,70047,Blue,0,80713,80901,188
2022-01-19,70050,70056,Blue,1,36892,37232,340
2022-11-05,70050,70054,Blue,1,61835,62056,221
2022-10-01,70053,70838,Blue,0,86801,87614,813
2022-03-26,70043,70039,Blue,0,30776,30889,113
2022-02-16,70057,70047,Blue,0,58175,58702,527
2022-11-27,70057,70055,Blue,0,66331,66400,69
2022-06-20,70050,70060,Blue,1,56708,57269,561
2022-09-18,70059,70838,Blue,0,36851,37937,1086
2022-06-27,70046,70054,Blue,1,76784,77215,431
2022-06-13,70043,70041,Blue,0,54869,54898,29
2022-11-21,70059,70045,Blue,0,29198,29899,701
2022-09-08,70047,70043,Blue,0,68399,68638,239
2022-04-18,70040,70054,Blue,1,65005,65796,791
2022-03-13,70057,70041,Blue,0,39578,40423,845
2022-07-27,70057,70041,Blue,0,19604,20497,893
2022-06-12,70053,70043,Blue,0,77871,78484,613
2022-09-14,70055,70053,Blue,0,27405,27452,47
2022-03-12,70038,70050,Blue,1,71774,72325,551
2022-04-04,70040,70048,Blue,1,48139,48540,401
2022-12-20,70051,70039,Blue,0,62101,62816,715
2022-08-29,70046,70048,Blue,1,69880,69952,72
2022-04-04,70049,70041,Blue,0,30790,31227,437
2022-02-18,70047,70045,Blue,0,31501,31600,99
2022-02-18,70057,70039,Blue,0,61470,62416,946
2022-08-17,70038,70042,Blue,1,66381,66473,92
2022-01-06,70047,70043,Blue,0,47211,47813,602
2022-12-14,70059,70053,Blue,0,28092,28344,252
2022-01-11,70050,70060,Blue,1,39813,40704,891
2022-04-20,70042,70052,Blue,1,36326,36994,668
2022-04-05,70045,70041,Blue,0,31372,31551,179
2022-09-22,70055,70043,Blue,0,64331,65043,712
2022-10-11,70057,70039,Blue,0,79888,80799,911
2022-07-13,70038,70056,Blue,1,55145,56074,929
2022-11-30,70051,70039,Blue,0,81103,81710,607
2022-02-14,70054,70056,Blue,1,32922,32969,47
2022-10-03,70057,70043,Blue,0,38167,38988,821
2022-07-01,70055,70045,Blue,0,87992,88594,602
2022-07-31,70042,70052,Blue,1,26421,26977,556
2022-03-02,70043,70838,Blue,0,56001,56202,201
2022-07-03,70044,70048,Blue,1,63685,63948,263
2022-02-11,70054,70058,Blue,1,87945,88098,153
2022-12-21,70044,70058,Blue,1,33290,34103,813
2022-03-08,70048,70058,Blue,1,84743,85247,504
2022-04-18,70049,70047,Blue,0,63976,64039,63
2022-04-09,70046,70060,Blue,1,53814,54556,742
2022-04-01,70051,70838,Blue,0,87220,87881,661
2022-04-08,70059,70045,Blue,0,72086,72737,651
2022-09-17,70052,70060,Blue,1,79383,79751,368
2022-09-28,70038,70046,Blue,1,70505,70804,299
2022-01-27,70044,70058,Blue,1,55115,55873,758
2022-01-17,70059,70045,Blue,0,53536,54250,714
2022-03-06,70044,70054,Blue,1,39233,39801,568
2022-08-14,70057,70051,Blue,0,24699,24951,252
2022-02-07,70054,70058,Blue,1,83458,83616,158
2022-07-09,70047,70043,Blue,0,24745,24990,245
2022-07-03,70053,70049,Blue,0,70323,70545,222
2022-01-18,70059,70049,Blue,0,63497,63998,501
2022-01-12,70038,70044,Blue,1,35280,35439,159
2022-04-04,70057,70053,Blue,0,66564,66716,152
2022-01-20,70053,70041,Blue,0,52795,53501,706
2022-12-22,70042,70060,Blue,1,23592,24557,965
2022-06-16,70046,70050,Blue,1,66353,66552,199
2022-10-18,70055,70049,Blue,0,38415,38723,308
2022-01-17,70038,70048,Blue,1,29115,29623,508
2022-11-09,70038,70040,Blue,1,35776,35792,16
2022-07-20,70048,70058,Blue,1,25477,26008,531
2022-04-14,70042,70046,Blue,1,46004,46187,183
2022-10-15,70054,70060,Blue,1,52122,52383,261
2022-10-26,70053,70039,Blue,0,38336,39234,898
2022-03-15,70041,70039,Blue,0,39305,39335,30
2022-08-07,70053,70041,Blue,0,76796,77464,668
2022-03-25,70040,70054,Blue,1,26706,27441,735
2022-04-04,70038,70046,Blue,1,21547,21831,284
2022-04-09,70050,70054,Blue,1,82762,82954,192
2022-01-19,70052,70060,Blue,1,23414,23825,411
2022-04-03,70058,70060,Blue,1,87615,87693,78
2022-08-22,70049,70838,Blue,0,63785,64367,582
2022-10-08,70050,70054,Blue,1,64293,64520,227
2022-03-16,70040,70052,Blue,1,52278,52950,672
2022-03-24,70057,70838,Blue,0,77842,78814,972
2022-03-15,70043,70838,Blue,0,66193,66395,202
2022-03-21,70049,70041,Blue,0,21508,21973,465
2022-02-08,70057,70053,Blue,0,37873,38084,211
2022-10-27,70053,70047,Blue,0,56943,57272,329
2022-06-24,70059,70049,Blue,0,61103,61554,451
2022-02-04,70057,70053,Blue,0,33282,33525,243
2022-02-04,70053,70039,Blue,0,56808,57574,766
2022-11-09,70047,70043,Blue,0,54999,55236,237
2022-10-16,70051,70047,Blue,0,43799,43985,186
2022-10-26,70057,70047,Blue,0,22151,22679,528
2022-01-13,70038,70058,Blue,1,67770,68903,1133
2022-01-07,70038,70042,Blue,1,20770,20867,97
2022-04-05,70044,70056,Blue,1,85054,85698,644
2022-05-05,70058,70060,Blue,1,63040,63108,68
2022-09-24,70051,70838,Blue,0,76147,76882,735
2022-01-17,70047,70838,Blue,0,79774,80275,501
2022-02-07,70048,70056,Blue,1,57029,57414,385
2022-09-10,70048,70060,Blue,1,70695,71333,638
2022-11-07,70051,70041,Blue,0,43949,44538,589
2022-09-07,70057,70041,Blue,0,34975,35930,955
2022-11-03,70042,70050,Blue,1,43727,44166,439
2022-08-19,70044,70050,Blue,1,65588,65951,363
2022-11-30,70059,70057,Blue,0,66268,66306,38
2022-10-07,70045,70039,Blue,0,49079,49331,252
2022-02-10,70048,70052,Blue,1,25195,25396,201
2022-09-02,70045,70838,Blue,0,77276,77613,337
2022-11-07,70059,70041,Blue,0,44366,45369,1003
2022-03-01,70053,70049,Blue,0,39571,39836,265
2022-04-01,70052,70056,Blue,1,65479,65616,137
2022-04-03,70049,70045,Blue,0,37354,37541,187
2022-09-26,70056,70058,Blue,1,65698,65815,117
2022-02-06,70046,70054,Blue,1,80715,81152,437
2022-06-30,70046,70058,Blue,1,62593,63256,663
2022-08-29,70052,70058,Blue,1,88950,89197,247
2022-11-13,70049,70047,Blue,0,48390,48446,56
2022-05-21,70044,70046,Blue,1,30592,30746,154
2022-12-10,70038,70052,Blue,1,82151,82871,720
2022-03-28,70040,70050,Blue,1,26116,26611,495
2022-09-03,70055,70047,Blue,0,34816,35182,366
2022-05-15,70056,70058,Blue,1,63148,63218,70
2022-09-30,70042,70060,Blue,1,75237,76283,1046
2022-04-14,70048,70060,Blue,1,26218,26870,652
2022-10-10,70044,70054,Blue,1,26376,26985,609
2022-01-05,70057,70053,Blue,0,62985,63170,185
2022-07-13,70059,70041,Blue,0,32678,33763,1085
2022-06-23,70052,70060,Blue,1,23757,24110,353
2022-09-29,70055,70045,Blue,0,29076,29627,551
2022-09-07,70048,70058,Blue,1,28832,29344,512
2022-03-17,70051,70047,Blue,0,65997,66197,200
2022-09-12,70059,70057,Blue,0,45745,45779,34
2022-12-28,70056,70060,Blue,1,37948,38158,210
2022-09-15,70042,70044,Blue,1,69115,69150,35
2022-02-14,70047,70043,Blue,0,24602,24877,275
2022-03-28,70054,70056,Blue,1,76687,76733,46
2022-02-26,70038,70048,Blue,1,45309,45780,471
2022-08-19,70050,70060,Blue,1,26245,26788,543
2022-11-21,70052,70060,Blue,1,46875,47230,355
2022-08-02,70051,70047,Blue,0,62071,62270,199
2022-02-03,70038,70052,Blue,1,45368,46010,642
2022-03-08,70041,70039,Blue,0,34086,34122,36
2022-12-22,70055,70043,Blue,0,83717,84364,647
2022-09-06,70044,70060,Blue,1,26156,27046,890
2022-04-30,70055,70053,Blue,0,59593,59639,46
2022-08-25,70046,70056,Blue,1,66988,67504,516
2022-11-08,70048,70050,Blue,1,48832,48888,56
2022-04-15,70050,70058,Blue,1,58608,59035,427
2022-01-10,70053,70838,Blue,0,26344,27165,821
2022-01-24,70052,70056,Blue,1,46196,46334,138
2022-10-14,70055,70838,Blue,0,70399,71335,936
2022-12-16,70048,70052,Blue,1,79386,79617,231
2022-04-11,70059,70057,Blue,0,55094,55128,34
2022-08-08,70057,70055,Blue,0,40655,40728,73
2022-12-31,70040,70046,Blue,1,29236,29494,258
2022-04-20,70055,70049,Blue,0,84806,85107,301
2022-11-03,70051,70041,Blue,0,29645,30293,648
2022-01-11,70038,70048,Blue,1,25760,26339,579
2022-11-05,70054,70056,Blue,1,83864,83911,47
2022-06-15,70048,70054,Blue,1,27485,27794,309
2022-11-30,70038,70048,Blue,1,31184,31664,480
2022-02-27,70057,70053,Blue,0,35627,35800,173
2022-01-07,70059,70053,Blue,0,78318,78569,251
2022-08-20,70057,70047,Blue,0,38491,38960,469
2022-01-19,70053,70045,Blue,0,71294,71735,441
2022-08-27,70049,70838,Blue,0,31883,32488,605
2022-07-27,70048,70052,Blue,1,57114,57341,227
2022-10-03,70057,70049,Blue,0,24341,24754,413
2022-06-29,70040,70042,Blue,1,35354,35392,38
2022-04-18,70048,70058,Blue,1,28119,28644,525
2022-02-05,70049,70039,Blue,0,66478,67008,530
2022-07-18,70038,70050,Blue,1,70604,71159,555
2022-07-17,70042,70058,Blue,1,78155,79076,921
2022-02-13,70043,70041,Blue,0,23271,23301,30
2022-10-20,70051,70041,Blue,0,30122,30774,652
2022-04-18,70053,70043,Blue,0,76925,77728,803
2022-07-02,70046,70050,Blue,1,79188,79388,200
2022-06-19,70040,70060,Blue,1,63885,65025,1140
2022-05-30,70043,70838,Blue,0,49969,50175,206
2022-08-01,70038,70044,Blue,1,64323,64546,223
2022-02-08,70043,70041,Blue,0,66765,66794,29
2022-06-25,70048,70058,Blue,1,39963,40448,485
2022-03-25,70049,70043,Blue,0,35766,36131,365
2022-07-21,70042,70056,Blue,1,77104,78200,1096
2022-12-14,70057,70053,Blue,0,21652,21821,169
2022-04-01,70053,70041,Blue,0,56267,56903,636
2022-03-31,70044,70052,Blue,1,31697,32261,564
2022-11-09,70042,70052,Blue,1,59761,60322,561
2022-04-24,70059,70838,Blue,0,77051,78099,1048
2022-04-05,70059,70043,Blue,0,62599,63498,899
2022-11-03,70059,70047,Blue,0,65790,66335,545
2022-02-10,70044,70046,Blue,1,47163,47271,108
2022-12-06,70040,70058,Blue,1,43051,44021,970
2022-01-16,70044,70054,Blue,1,60404,60991,587
2022-10-29,70044,70060,Blue,1,69256,70139,883
2022-07-04,70040,70044,Blue,1,44858,44967,109
2022-03-07,70040,70058,Blue,1,28809,29748,939
2022-11-01,70045,70043,Blue,0,51196,51291,95
2022-12-31,70048,70054,Blue,1,76194,76469,275
2022-12-20,70042,70056,Blue,1,66657,67429,772
2022-11-11,70044,70056,Blue,1,58269,58958,689
2022-07-17,70059,70045,Blue,0,26955,27676,721
2022-03-11,70047,70039,Blue,0,39237,39681,444
2022-11-14,70040,70044,Blue,1,68313,68418,105
2022-08-24,70050,70058,Blue,1,73058,73521,463
2022-01-18,70048,70050,Blue,1,27843,27899,56
2022-12-26,70059,70043,Blue,0,57613,58455,842
2022-02-16,70048,70050,Blue,1,32004,32061,57
2022-03-13,70038,70046,Blue,1,23775,24081,306
2022-11-11,70042,70060,Blue,1,67074,68074,1000
2022-08-03,70057,70045,Blue,0,50490,51098,608
2022-04-20,70041,70838,Blue,0,19874,20004,130
2022-02-27,70050,70052,Blue,1,57574,57686,112
2022-09-23,70049,70045,Blue,0,49415,49592,177
2022-10-13,70059,70049,Blue,0,34350,34831,481
2022-06-14,70057,70041,Blue,0,46756,47712,956
2022-06-13,70051,70043,Blue,0,74699,75202,503
2022-01-27,70047,70838,Blue,0,43315,43831,516
2022-06-10,70053,70039,Blue,0,31751,32620,869
2022-01-25,70048,70052,Blue,1,53420,53621,201
2022-12-17,70049,70043,Blue,0,83710,84053,343
2022-10-15,70051,70045,Blue,0,85198,85520,322
2022-10-31,70059,70045,Blue,0,31427,32140,713
2022-11-13,70053,70039,Blue,0,85796,86581,785
2022-03-04,70040,70060,Blue,1,33612,34705,1093
2022-01-01,70042,70044,Blue,1,46827,46854,27
2022-01-31,70050,70058,Blue,1,82305,82722,417
2022-05-11,70059,70055,Blue,0,35726,35900,174
2022-04-07,70052,70054,Blue,1,58743,58791,48
2022-10-14,70045,70043,Blue,0,87247,87336,89
2022-07-04,70043,70039,Blue,0,72713,72826,113
2022-02-23,70038,70048,Blue,1,63136,63659,523
2022-03-04,70051,70043,Blue,0,33380,33917,537
2022-09-25,70050,70052,Blue,1,74231,74334,103
2022-07-29,70051,70041,Blue,0,70955,71553,598
2022-08-26,70059,70838,Blue,0,28453,29660,1207
2022-09-02,70038,70052,Blue,1,67693,68439,746
2022-10-08,70046,70054,Blue,1,44049,44529,480
2022-08-22,70050,70052,Blue,1,31887,32015,128
2022-02-17,70050,70054,Blue,1,46989,47302,313
2022-03-11,70049,70039,Blue,0,42052,42553,501
2022-06-14,70045,70039,Blue,0,41400,41728,328
2022-04-11,70044,70050,Blue,1,55746,56126,380
2022-03-30,70047,70039,Blue,0,60174,60600,426
2022-07-04,70059,70045,Blue,0,64694,65358,664
2022-10-27,70054,70060,Blue,1,35832,36099,267
2022-07-04,70059,70057,Blue,0,82884,82918,34
2022-03-12,70047,70039,Blue,0,34679,35081,402
2022-01-28,70051,70045,Blue,0,86157,86508,351
2022-12-17,70057,70043,Blue,0,66034,66836,802
2022-06-19,70047,70045,Blue,0,48525,48637,112
2022-02-28,70053,70039,Blue,0,41912,42677,765
2022-04-02,70057,70055,Blue,0,60629,60697,68
2022-09-08,70038,70060,Blue,1,21402,22598,1196
2022-10-11,70051,70047,Blue,0,64369,64571,202
2022-12-09,70038,70052,Blue,1,37108,37880,772
2022-01-17,70053,70043,Blue,0,64074,64684,610
2022-03-14,70042,70052,Blue,1,63603,64136,533
2022-02-20,70040,70046,Blue,1,73221,73481,260
2022-01-24,70059,70057,Blue,0,36993,37030,37
2022-08-12,70057,70051,Blue,0,41161,41409,248
2022-10-17,70042,70050,Blue,1,59782,60179,397
2022-08-11,70049,70043,Blue,0,45830,46217,387
2022-12-27,70044,70048,Blue,1,59768,59994,226
2022-08-18,70055,70047,Blue,0,38713,39108,395
2022-11-07,70038,70044,Blue,1,59324,59534,210
2022-11-13,70038,70058,Blue,1,72613,73582,969
2022-12-24,70044,70046,Blue,1,81568,81673,105
2022-01-01,70044,70056,Blue,1,71201,72105,904
2022-10-15,70047,70041,Blue,0,74133,74484,351
2022-11-26,70052,70058,Blue,1,53069,53303,234
2022-10-03,70055,70838,Blue,0,28688,29737,1049
2022-04-22,70050,70058,Blue,1,33476,33857,381
2022-10-17,70059,70838,Blue,0,41600,42728,1128
2022-03-24,70046,70056,Blue,1,63630,64256,626
2022-11-05,70059,70051,Blue,0,88243,88556,313
2022-07-02,70048,70060,Blue,1,62664,63286,622
2022-09-15,70051,70049,Blue,0,45016,45122,106
2022-05-11,70055,70051,Blue,0,28668,28808,140
2022-04-27,70053,70049,Blue,0,80733,80933,200
2022-09-12,70055,70053,Blue,0,85158,85203,45
2022-11-18,70052,70054,Blue,1,30604,30658,54
2022-02-25,70051,70049,Blue,0,28276,28381,105
2022-04-21,70049,70043,Blue,0,42072,42413,341
2022-02-16,70051,70838,Blue,0,75835,76488,653
2022-08-18,70042,70046,Blue,1,59745,59962,217
2022-06-13,70053,70049,Blue,0,21242,21456,214
2022-08-28,70053,70051,Blue,0,34259,34324,65
2022-05-21,70041,70838,Blue,0,48091,48208,117
2022-04-13,70054,70058,Blue,1,51671,51834,163
2022-11-11,70038,70050,Blue,1,65134,65690,556
2022-01-18,70046,70058,Blue,1,29433,30107,674
2022-08-11,70054,70058,Blue,1,30552,30731,179
2022-06-20,70038,70054,Blue,1,40428,41442,1014
2022-02-17,70045,70838,Blue,0,64786,65117,331
2022-03-18,70045,70043,Blue,0,30121,30217,96
2022-03-19,70042,70060,Blue,1,42213,43148,935
2022-07-15,70057,70055,Blue,0,86617,86684,67
2022-09-21,70046,70052,Blue,1,23389,23729,340
2022-12-22,70048,70056,Blue,1,27194,27585,391
2022-01-10,70045,70039,Blue,0,50960,51194,234
2022-06-29,70044,70058,Blue,1,77020,77861,841
2022-07-31,70048,70058,Blue,1,42792,43332,540
2022-05-21,70040,70050,Blue,1,71565,72177,612
2022-06-23,70046,70056,Blue,1,25695,26236,541
2022-08-26,70044,70058,Blue,1,45399,46212,813
2022-09-21,70041,70838,Blue,0,20696,20838,142
2022-10-08,70042,70056,Blue,1,74073,74834,761
2022-05-20,70047,70043,Blue,0,67464,67822,358
2022-04-21,70040,70060,Blue,1,25800,26876,1076
2022-08-04,70047,70041,Blue,0,59108,59467,359
2022-07-26,70038,70046,Blue,1,65333,65649,316
2022-09-07,70053,70043,Blue,0,72535,73107,572
2022-09-18,70053,70047,Blue,0,31130,31455,325
2022-05-07,70055,70051,Blue,0,50005,50138,133
2022-01-26,70042,70056,Blue,1,30398,31194,796
2022-01-25,70044,70056,Blue,1,27442,28142,700
2022-02-08,70049,70047,Blue,0,83390,83451,61
2022-03-05,70047,70045,Blue,0,45490,45588,98
2022-09-22,70038,70058,Blue,1,82794,83881,1087
2022-10-02,70059,70047,Blue,0,62475,63084,609
2022-05-10,70057,70053,Blue,0,67533,67693,160
2022-04-19,70059,70043,Blue,0,29055,30047,992
2022-11-08,70040,70050,Blue,1,72138,72623,485
2022-09-07,70040,70044,Blue,1,55734,55851,117
2022-12-12,70051,70043,Blue,0,29662,30158,496
2022-10-03,70040,70056,Blue,1,58394,59198,804
2022-08-26,70052,70060,Blue,1,28850,29209,359
2022-08-15,70045,70838,Blue,0,20360,20753,393
2022-04-06,70045,70838,Blue,0,26933,27323,390
2022-01-31,70051,70047,Blue,0,52205,52403,198
2022-09-01,70052,70058,Blue,1,56784,57028,244
2022-01-26,70038,70042,Blue,1,77642,77743,101
2022-01-18,70040,70060,Blue,1,29461,30468,1007
2022-07-27,70053,70049,Blue,0,25810,26032,222
2022-05-19,70046,70060,Blue,1,59535,60322,787
2022-06-01,70038,70052,Blue,1,70873,71793,920
2022-03-27,70057,70051,Blue,0,67977,68220,243
2022-02-25,70049,70838,Blue,0,77694,78245,551
2022-11-20,70059,70055,Blue,0,88223,88366,143
2022-05-19,70044,70048,Blue,1,63691,63967,276
2022-08-30,70045,70039,Blue,0,72459,72718,259
2022-12-22,70058,70060,Blue,1,61183,61240,57
2022-08-13,70044,70046,Blue,1,70911,71013,102
2022-01-18,70048,70054,Blue,1,32996,33317,321
2022-04-11,70046,70050,Blue,1,86430,86615,185
2022-02-21,70048,70056,Blue,1,30684,31056,372
2022-11-09,70040,70046,Blue,1,33253,33513,260
2022-04-11,70040,70052,Blue,1,56589,57182,593
2022-07-27,70052,70056,Blue,1,37749,37897,148
2022-01-20,70048,70052,Blue,1,80315,80524,209
2022-03-10,70053,70049,Blue,0,81471,81666,195
2022-11-14,70051,70047,Blue,0,34163,34353,190
2022-04-04,70048,70050,Blue,1,86502,86560,58
2022-03-04,70048,70056,Blue,1,30118,30480,362
2022-02-21,70042,70048,Blue,1,63282,63604,322
2022-08-21,70049,70041,Blue,0,51623,52065,442
2022-07-23,70053,70045,Blue,0,66762,67172,410
2022-07-15,70041,70838,Blue,0,32481,32631,150
2022-03-30,70038,70044,Blue,1,48673,48853,180
2022-02-12,70047,70039,Blue,0,29301,29761,460
2022-06-13,70053,70051,Blue,0,68765,68831,66
2022-05-23,70038,70044,Blue,1,66557,66762,205
2022-06-16,70040,70058,Blue,1,78251,79236,985
2022-08-23,70049,70043,Blue,0,59466,59798,332
2022-09-13,70047,70043,Blue,0,51582,51826,244
2022-10-02,70049,70047,Blue,0,52725,52786,61
2022-12-08,70049,70838,Blue,0,49451,50070,619
2022-06-29,70059,70053,Blue,0,21984,22251,267
2022-09-28,70040,70050,Blue,1,34246,34714,468
2022-11-28,70042,70046,Blue,1,71196,71366,170
2022-07-14,70044,70048,Blue,1,41225,41557,332
2022-11-27,70050,70052,Blue,1,76425,76545,120
2022-09-30,70053,70838,Blue,0,58488,59327,839
2022-08-23,70040,70050,Blue,1,38854,39361,507
2022-07-14,70052,70058,Blue,1,30092,30345,253
2022-09-05,70059,70057,Blue,0,38835,38869,34
2022-06-05,70040,70044,Blue,1,35197,35317,120
2022-12-19,70038,70058,Blue,1,33921,34919,998
2022-12-06,70054,70060,Blue,1,46059,46321,262
2022-01-30,70042,70054,Blue,1,89787,90567,780
2022-08-22,70038,70042,Blue,1,84945,85047,102
2022-03-08,70051,70049,Blue,0,47011,47113,102
2022-09-13,70055,70053,Blue,0,85347,85392,45
2022-03-18,70057,70055,Blue,0,49296,49366,70
2022-01-25,70042,70052,Blue,1,32472,33000,528
2022-01-05,70040,70048,Blue,1,37385,37756,371
2022-05-26,70046,70050,Blue,1,73703,73963,260
2022-07-08,70046,70058,Blue,1,76425,77067,642
2022-03-24,70053,70041,Blue,0,20164,20869,705
2022-03-25,70047,70045,Blue,0,29107,29219,112
2022-06-18,70057,70039,Blue,0,74671,75572,901
2022-12-17,70057,70055,Blue,0,33111,33181,70
2022-01-17,70046,70060,Blue,1,75415,76204,789
2022-09-04,70057,70041,Blue,0,64179,65014,835
2022-01-20,70044,70056,Blue,1,60690,61380,690
2022-11-22,70047,70039,Blue,0,55251,55659,408
2022-01-21,70059,70047,Blue,0,34888,35479,591
2022-05-20,70057,70055,Blue,0,78998,79067,69
2022-08-02,70049,70043,Blue,0,79547,79915,368
2022-04-07,70049,70047,Blue,0,51212,51268,56
2022-08-25,70046,70058,Blue,1,23981,24579,598
2022-09-28,70046,70052,Blue,1,76675,77008,333
2022-06-25,70057,70043,Blue,0,41816,42615,799
2022-06-13,70042,70056,Blue,1,66907,67725,818
2022-10-19,70059,70049,Blue,0,61653,62106,453
2022-09-01,70046,70050,Blue,1,37930,38113,183
2022-03-29,70040,70058,Blue,1,26740,27721,981
2022-10-14,70055,70039,Blue,0,20148,21057,909
2022-02-21,70046,70048,Blue,1,59568,59663,95
2022-11-20,70055,70039,Blue,0,39582,40481,899
2022-08-09,70046,70052,Blue,1,51796,52150,354
2022-06-16,70040,70042,Blue,1,30482,30522,40
2022-01-19,70046,70058,Blue,1,55168,55808,640
2022-10-24,70046,70052,Blue,1,62156,62500,344
2022-11-04,70045,70041,Blue,0,55875,56085,210
2022-08-15,70042,70052,Blue,1,48281,48920,639
2022-03-02,70046,70054,Blue,1,83513,84086,573
2022-06-10,70052,70060,Blue,1,62248,63120,872
2022-02-24,70057,70047,Blue,0,79541,80016,475
2022-11-23,70046,70054,Blue,1,71413,71855,442
2022-04-08,70044,70050,Blue,1,81114,81484,370
2022-08-29,70053,70043,Blue,0,39275,39930,655
2022-04-12,70048,70056,Blue,1,51316,51717,401
2022-02-09,70058,70060,Blue,1,23837,23895,58
2022-02-06,70054,70058,Blue,1,83141,83294,153
2022-02-11,70038,70040,Blue,1,26058,26086,28
2022-06-16,70042,70054,Blue,1,48816,49562,746
2022-07-31,70054,70056,Blue,1,87233,87280,47
2022-02-28,70059,70055,Blue,0,29701,29950,249
2022-02-27,70038,70060,Blue,1,67755,68898,1143
2022-01-13,70044,70058,Blue,1,79385,80210,825
2022-11-23,70044,70054,Blue,1,44232,45000,768
2022-01-22,70057,70043,Blue,0,61711,62484,773
2022-05-24,70048,70052,Blue,1,30206,30593,387
2022-08-28,70057,70055,Blue,0,32528,32597,69
2022-01-20,70054,70058,Blue,1,44343,44506,163
2022-07-26,70048,70056,Blue,1,71577,71996,419
2022-12-22,70047,70041,Blue,0,78674,78980,306
2022-11-20,70053,70043,Blue,0,54641,55259,618
2022-09-29,70038,70040,Blue,1,66376,66395,19
2022-09-12,70048,70058,Blue,1,73290,73803,513
2022-10-10,70045,70039,Blue,0,80700,81014,314
2022-03-01,70057,70055,Blue,0,58643,58710,67
2022-02-08,70045,70043,Blue,0,55295,55426,131
2022-12-22,70059,70055,Blue,0,55782,55941,159
2022-07-17,70059,70047,Blue,0,77055,77603,548
2022-07-05,70051,70045,Blue,0,24206,24536,330
2022-08-09,70044,70048,Blue,1,55199,55435,236
2022-02-10,70049,70045,Blue,0,57419,57617,198
2022-02-14,70057,70838,Blue,0,55472,56632,1160
2022-11-12,70044,70046,Blue,1,65606,65710,104
2022-05-25,70047,70039,Blue,0,71761,72238,477
2022-06-08,70038,70050,Blue,1,75012,75596,584
2022-10-06,70040,70054,Blue,1,87476,88238,762
2022-01-25,70043,70838,Blue,0,22304,22539,235
2022-01-23,70049,70041,Blue,0,86065,86494,429
2022-12-14,70052,70056,Blue,1,25386,25546,160
2022-11-17,70044,70058,Blue,1,21367,22221,854
2022-06-30,70042,70046,Blue,1,26700,26902,202
2022-05-20,70046,70058,Blue,1,55727,56383,656
2022-03-03,70040,70044,Blue,1,67097,67215,118
2022-01-26,70057,70049,Blue,0,61185,61621,436
2022-03-07,70052,70056,Blue,1,71304,71455,151
2022-07-13,70040,70052,Blue,1,72799,73514,715
2022-12-27,70047,70039,Blue,0,21668,22114,446
2022-09-11,70057,70041,Blue,0,28622,29451,829
2022-05-05,70053,70049,Blue,0,63859,64123,264
2022-11-18,70052,70054,Blue,1,86480,86533,53
2022-08-24,70054,70056,Blue,1,51789,51836,47
2022-12-27,70044,70060,Blue,1,31173,32097,924
2022-11-21,70047,70041,Blue,0,74491,74806,315
2022-03-18,70054,70056,Blue,1,65956,66003,47
2022-01-03,70059,70051,Blue,0,42674,42977,303
2022-03-03,70049,70043,Blue,0,81750,82119,369
2022-09-01,70052,70058,Blue,1,22952,23202,250
2022-10-09,70054,70060,Blue,1,48656,48915,259
2022-11-04,70047,70838,Blue,0,71340,71772,432
2022-08-14,70055,70045,Blue,0,71830,72387,557
2022-01-07,70038,70044,Blue,1,80836,81004,168
2022-02-26,70043,70041,Blue,0,83200,83229,29
2022-09-09,70046,70060,Blue,1,56985,57731,746
2022-03-18,70048,70054,Blue,1,42510,42855,345
2022-04-15,70053,70045,Blue,0,75155,75592,437
2022-03-28,70059,70053,Blue,0,50230,50462,232
2022-10-29,70051,70049,Blue,0,61107,61213,106
2022-06-14,70045,70838,Blue,0,48432,48790,358
2022-08-12,70049,70043,Blue,0,41579,41939,360
2022-08-04,70053,70049,Blue,0,49765,49967,202
2022-03-14,70048,70052,Blue,1,57995,58198,203
2022-12-15,70041,70039,Blue,0,77449,77488,39
2022-07-07,70047,70041,Blue,0,29114,29484,370
2022-03-09,70057,70045,Blue,0,67227,67825,598
2022-11-05,70042,70052,Blue,1,84960,85617,657
2022-09-15,70042,70044,Blue,1,59823,59853,30
2022-03-14,70044,70060,Blue,1,56734,57707,973
2022-12-31,70043,70039,Blue,0,53890,53998,108
2022-03-21,70049,70047,Blue,0,60372,60426,54
2022-11-29,70043,70039,Blue,0,73091,73189,98
2022-06-28,70040,70054,Blue,1,38895,39721,826
2022-02-08,70051,70045,Blue,0,50598,50924,326
2022-07-05,70046,70054,Blue,1,37471,38033,562
2022-10-14,70049,70041,Blue,0,28605,29068,463
2022-10-25,70040,70042,Blue,1,21490,21523,33
2022-07-08,70059,70039,Blue,0,79965,81014,1049
2022-05-19,70044,70048,Blue,1,29117,29428,311
2022-03-02,70040,70048,Blue,1,40847,41214,367
2022-05-12,70054,70060,Blue,1,49393,49657,264
2022-12-29,70057,70047,Blue,0,85637,86115,478
2022-06-13,70040,70058,Blue,1,33607,34664,1057
2022-07-20,70057,70838,Blue,0,50216,51432,1216
2022-01-21,70046,70056,Blue,1,33153,33654,501
2022-02-16,70055,70039,Blue,0,76836,77802,966
2022-12-29,70048,70050,Blue,1,28147,28203,56
2022-11-23,70058,70060,Blue,1,50239,50308,69
2022-06-17,70043,70039,Blue,0,24916,25026,110
2022-09-15,70039,70838,Blue,0,89104,89134,30
2022-11-17,70043,70039,Blue,0,24368,24492,124
2022-06-16,70042,70052,Blue,1,66764,67333,569
2022-01-05,70038,70050,Blue,1,41499,42049,550
2022-08-28,70057,70047,Blue,0,37595,38090,495
2022-04-09,70041,70838,Blue,0,54616,54747,131
2022-03-29,70059,70053,Blue,0,69497,69719,222
2022-07-16,70055,70049,Blue,0,56991,57278,287
2022-03-13,70044,70056,Blue,1,78225,78893,668
2022-04-06,70052,70056,Blue,1,49926,50056,130
2022-02-15,70042,70046,Blue,1,68862,69057,195
2022-02-02,70054,70058,Blue,1,31802,31983,181
2022-12-05,70059,70838,Blue,0,68657,69706,1049
2022-11-28,70046,70058,Blue,1,20378,21067,689
2022-01-16,70055,70049,Blue,0,80466,80753,287
2022-12-27,70043,70838,Blue,0,88451,88657,206
2022-04-11,70053,70049,Blue,0,30530,30732,202
2022-01-14,70052,70058,Blue,1,65126,65378,252
2022-07-20,70059,70053,Blue,0,71254,71499,245
2022-10-02,70055,70053,Blue,0,88391,88436,45
2022-05-06,70055,70049,Blue,0,35912,36212,300
2022-06-28,70044,70048,Blue,1,49509,49805,296
2022-02-09,70051,70039,Blue,0,62715,63415,700
2022-07-11,70053,70049,Blue,0,66829,67041,212
2022-06-24,70052,70058,Blue,1,34941,35207,266
2022-12-15,70051,70041,Blue,0,28335,28929,594
2022-11-03,70038,70046,Blue,1,76273,76602,329
2022-03-22,70039,70838,Blue,0,64754,64792,38
2022-10-26,70059,70838,Blue,0,55896,57105,1209
2022-10-26,70038,70060,Blue,1,56779,57969,1190
2022-05-24,70042,70048,Blue,1,84773,85148,375
2022-01-13,70057,70051,Blue,0,58174,58417,243
2022-02-16,70040,70050,Blue,1,45365,45860,495
2022-06-30,70047,70043,Blue,0,24185,24509,324
2022-12-19,70052,70054,Blue,1,46379,46428,49
2022-07-25,70042,70044,Blue,1,74358,74396,38
2022-11-15,70038,70056,Blue,1,44589,45441,852
2022-09-14,70041,70039,Blue,0,25041,25074,33
2022-10-04,70048,70054,Blue,1,27033,27357,324
2022-09-10,70057,70045,Blue,0,43349,44008,659
2022-08-18,70042,70048,Blue,1,91011,91356,345
2022-07-21,70053,70838,Blue,0,86627,87484,857
2022-01-02,70046,70050,Blue,1,42839,43038,199
2022-08-03,70055,70838,Blue,0,60018,60960,942
2022-08-28,70038,70046,Blue,1,79101,79431,330
2022-03-31,70043,70041,Blue,0,41410,41440,30
2022-01-04,70045,70039,Blue,0,60083,60325,242
2022-05-22,70048,70050,Blue,1,77294,77355,61
2022-09-18,70053,70049,Blue,0,79833,80025,192
2022-03-07,70039,70838,Blue,0,60363,60417,54
2022-01-27,70056,70058,Blue,1,25977,26304,327
2022-09-02,70052,70056,Blue,1,84754,84905,151
2022-09-10,70056,70058,Blue,1,77573,77644,71
2022-09-30,70044,70052,Blue,1,32613,33097,484
2022-09-08,70055,70045,Blue,0,46472,47042,570
2022-02-17,70059,70055,Blue,0,18798,18961,163
2022-04-25,70059,70047,Blue,0,86896,87544,648
2022-07-22,70057,70051,Blue,0,64740,65000,260
2022-11-11,70043,70039,Blue,0,31874,31986,112
2022-08-18,70046,70060,Blue,1,65179,65931,752
2022-03-16,70042,70056,Blue,1,65363,66181,818
2022-03-22,70044,70050,Blue,1,79440,79840,400
2022-03-01,70040,70046,Blue,1,29711,29957,246
2022-09-14,70057,70045,Blue,0,59370,59968,598
2022-09-10,70040,70058,Blue,1,75621,76522,901
2022-02-17,70042,70052,Blue,1,21140,21771,631
2022-11-24,70042,70044,Blue,1,28597,28632,35
2022-08-03,70042,70046,Blue,1,85894,86077,183
2022-07-04,70047,70041,Blue,0,35248,35607,359
2022-04-09,70044,70050,Blue,1,64446,64783,337
2022-04-07,70038,70042,Blue,1,45294,45389,95
2022-09-19,70051,70045,Blue,0,39877,40253,376
2022-01-07,70046,70060,Blue,1,86468,87286,818
2022-12-06,70041,70838,Blue,0,21081,21212,131
2022-09-21,70047,70045,Blue,0,57331,57424,93
2022-10-09,70045,70838,Blue,0,60011,60408,397
2022-07-18,70055,70043,Blue,0,45445,46154,709
2022-01-12,70057,70049,Blue,0,50313,50761,448
2022-01-19,70048,70056,Blue,1,59798,60211,413
2022-01-17,70040,70054,Blue,1,50804,51614,810
2022-06-19,70053,70041,Blue,0,69447,70143,696
2022-06-23,70051,70041,Blue,0,61553,62117,564
2022-02-13,70040,70056,Blue,1,49447,50276,829
2022-02-21,70051,70041,Blue,0,72821,73420,599
2022-11-28,70049,70838,Blue,0,28487,29168,681
2022-10-12,70049,70041,Blue,0,37457,37936,479
2022-06-30,70059,70053,Blue,0,61970,62195,225
2022-09-28,70057,70051,Blue,0,28111,28377,266
2022-02-01,70050,70056,Blue,1,66731,67029,298
2022-09-26,70038,70042,Blue,1,23293,23389,96
2022-07-18,70038,70054,Blue,1,60558,61498,940
2022-03-18,70057,70043,Blue,0,41021,41855,834
2022-02-13,70057,70055,Blue,0,47974,48043,69
2022-01-02,70057,70041,Blue,0,67418,68223,805
2022-03-26,70051,70047,Blue,0,59515,59708,193
2022-12-15,70059,70041,Blue,0,19935,20986,1051
2022-12-09,70057,70838,Blue,0,35987,37122,1135
2022-10-27,70040,70046,Blue,1,39725,40000,275
2022-04-09,70055,70049,Blue,0,26185,26448,263
2022-08-02,70059,70838,Blue,0,32655,33835,1180
2022-01-07,70038,70044,Blue,1,79706,79874,168
2022-02-13,70048,70056,Blue,1,77968,78338,370
2022-12-02,70050,70052,Blue,1,30004,30126,122
2022-10-24,70059,70051,Blue,0,24841,25209,368
2022-09-23,70041,70039,Blue,0,81489,81524,35
2022-09-03,70038,70060,Blue,1,81433,82621,1188
2022-04-08,70042,70054,Blue,1,68365,69024,659
2022-09-23,70057,70053,Blue,0,81264,81409,145
2022-08-08,70057,70041,Blue,0,38064,39018,954
2022-08-03,70059,70043,Blue,0,61105,61953,848
2022-09-09,70057,70045,Blue,0,41444,42117,673
2022-03-12,70051,70043,Blue,0,40605,41117,512
2022-09-28,70051,70041,Blue,0,62609,63249,640
2022-01-13,70055,70045,Blue,0,48862,49364,502
2022-04-15,70053,70045,Blue,0,54245,54714,469
2022-07-24,70039,70838,Blue,0,83328,83361,33
2022-04-25,70056,70058,Blue,1,49194,49268,74
2022-11-03,70045,70838,Blue,0,46525,46871,346
2022-11-10,70058,70060,Blue,1,46611,46679,68
2022-02-07,70052,70056,Blue,1,72928,73164,236
2022-06-27,70058,70060,Blue,1,62321,62399,78
2022-09-06,70038,70042,Blue,1,65426,65516,90
2022-02-15,70050,70052,Blue,1,22461,22587,126
2022-08-27,70038,70060,Blue,1,35047,36139,1092
2022-01-31,70044,70056,Blue,1,81751,82606,855
2022-01-11,70054,70056,Blue,1,62258,62305,47
2022-11-08,70054,70058,Blue,1,22014,22171,157
2022-01-27,70048,70058,Blue,1,30015,30545,530
2022-10-30,70044,70046,Blue,1,89389,89496,107
2022-09-20,70047,70041,Blue,0,49490,49810,320
2022-12-16,70042,70050,Blue,1,26011,26397,386
2022-07-27,70040,70056,Blue,1,22267,23103,836
2022-04-26,70059,70055,Blue,0,83658,83807,149
2022-12-21,70059,70838,Blue,0,64761,65845,1084
2022-03-20,70038,70054,Blue,1,48656,49469,813
2022-06-10,70040,70056,Blue,1,74120,74954,834
2022-07-09,70059,70053,Blue,0,50296,50528,232
2022-05-20,70042,70060,Blue,1,35588,36887,1299
2022-02-23,70055,70043,Blue,0,19352,20256,904
2022-11-05,70044,70046,Blue,1,83224,83331,107
2022-05-22,70047,70039,Blue,0,29908,30467,559
2022-09-16,70049,70043,Blue,0,70703,71065,362
2022-11-10,70040,70044,Blue,1,70128,70245,117
2022-04-17,70045,70838,Blue,0,26102,26440,338
2022-07-04,70049,70838,Blue,0,83162,83748,586
2022-07-30,70057,70045,Blue,0,68191,68795,604
2022-03-05,70044,70056,Blue,1,63920,64580,660
2022-07-08,70040,70056,Blue,1,59994,60885,891
2022-02-15,70059,70055,Blue,0,22045,22201,156
2022-07-16,70057,70838,Blue,0,86661,87633,972
2022-01-29,70055,70047,Blue,0,38595,39276,681
2022-03-09,70044,70048,Blue,1,39790,40007,217
2022-11-29,70047,70838,Blue,0,73423,73926,503
2022-12-30,70046,70056,Blue,1,26832,27341,509
2022-11-29,70040,70060,Blue,1,53434,54513,1079
2022-12-21,70059,70041,Blue,0,88794,89822,1028
2022-07-31,70057,70838,Blue,0,81633,82654,1021
2022-01-07,70046,70058,Blue,1,56965,57696,731
2022-09-10,70038,70058,Blue,1,23001,23956,955
2022-03-10,70057,70053,Blue,0,23258,23422,164
2022-09-17,70054,70060,Blue,1,71109,71382,273
2022-02-19,70058,70060,Blue,1,68998,69055,57
2022-03-07,70051,70049,Blue,0,62653,62761,108
2022-10-15,70038,70060,Blue,1,58822,59944,1122
2022-11-28,70047,70041,Blue,0,31180,31548,368
2022-08-24,70044,70056,Blue,1,55166,55924,758
2022-02-13,70047,70041,Blue,0,58203,58513,310
2022-05-22,70044,70048,Blue,1,29326,29622,296
2022-09-26,70040,70042,Blue,1,62809,62848,39
2022-03-30,70044,70054,Blue,1,27442,28025,583
2022-09-03,70046,70056,Blue,1,74901,75430,529
2022-12-15,70052,70060,Blue,1,79150,79521,371
2022-02-20,70055,70838,Blue,0,24948,25959,1011
2022-10-07,70059,70055,Blue,0,47886,48030,144
2022-07-20,70057,70049,Blue,0,61297,61701,404
2022-05-19,70047,70838,Blue,0,55320,55957,637
2022-10-22,70059,70055,Blue,0,28689,28835,146
2022-12-25,70057,70039,Blue,0,43522,44362,840
2022-06-13,70059,70039,Blue,0,85158,86175,1017
2022-04-13,70049,70838,Blue,0,22219,22883,664
2022-02-11,70059,70057,Blue,0,54832,54866,34
2022-08-19,70051,70039,Blue,0,28007,28732,725
2022-05-19,70040,70058,Blue,1,76976,77931,955
2022-07-06,70048,70056,Blue,1,81797,82240,443
2022-09-24,70042,70058,Blue,1,45444,46247,803
2022-03-01,70049,70043,Blue,0,33201,33594,393
2022-12-14,70057,70043,Blue,0,61958,62742,784
2022-08-20,70050,70054,Blue,1,87649,87897,248
2022-12-02,70048,70056,Blue,1,29448,29826,378
2022-08-13,70056,70060,Blue,1,63697,63875,178
2022-02-09,70059,70045,Blue,0,57197,57863,666
2022-04-06,70048,70054,Blue,1,78095,78429,334
2022-07-14,70056,70058,Blue,1,66934,67006,72
2022-07-03,70056,70058,Blue,1,26292,26364,72
2022-04-12,70059,70051,Blue,0,31462,31786,324
2022-09-12,70057,70053,Blue,0,21752,21917,165
2022-04-07,70052,70058,Blue,1,39242,39488,246
2022-09-13,70038,70052,Blue,1,37412,38154,742
2022-03-10,70041,70039,Blue,0,89733,89774,41
2022-11-08,70040,70058,Blue,1,45310,46261,951
2022-12-02,70059,70047,Blue,0,23842,24427,585
2022-12-06,70053,70045,Blue,0,36635,37100,465
2022-12-22,70040,70046,Blue,1,32530,33012,482
2022-09-18,70050,70056,Blue,1,51029,51318,289
2022-09-10,70048,70054,Blue,1,55630,55921,291
2022-12-02,70042,70044,Blue,1,70199,70225,26
2022-11-17,70053,70838,Blue,0,66452,67352,900
2022-10-26,70059,70055,Blue,0,28883,29039,156
2022-05-03,70054,70060,Blue,1,67276,67558,282
2022-09-03,70053,70041,Blue,0,72165,72812,647
2022-08-29,70050,70052,Blue,1,60362,60489,127
2022-10-19,70049,70838,Blue,0,24389,24999,610
2022-03-27,70057,70053,Blue,0,59851,60000,149
2022-08-08,70055,70039,Blue,0,27400,28333,933
2022-12-06,70038,70060,Blue,1,39492,40624,1132
2022-02-23,70042,70048,Blue,1,60066,60401,335
2022-07-23,70055,70041,Blue,0,82200,82984,784
2022-04-08,70045,70043,Blue,0,30161,30250,89
2022-12-18,70057,70055,Blue,0,65845,65915,70
2022-04-08,70044,70046,Blue,1,53609,53697,88
2022-01-31,70038,70046,Blue,1,45703,46052,349
2022-02-14,70042,70054,Blue,1,60282,60912,630
2022-04-22,70051,70045,Blue,0,23758,24119,361
2022-06-21,70044,70052,Blue,1,59475,60071,596
2022-05-20,70040,70058,Blue,1,62004,63078,1074
2022-04-22,70051,70043,Blue,0,77088,77581,493
2022-08-30,70053,70045,Blue,0,87586,88022,436
2022-02-22,70054,70060,Blue,1,70448,70726,278
2022-11-05,70052,70054,Blue,1,83775,83827,52
2022-10-17,70050,70052,Blue,1,35688,35805,117
2022-10-28,70053,70049,Blue,0,42569,42766,197
2022-11-11,70040,70050,Blue,1,29536,30067,531
2022-04-02,70053,70041,Blue,0,24419,25091,672
2022-11-30,70044,70056,Blue,1,34238,34959,721
2022-11-22,70038,70054,Blue,1,41970,42807,837
2022-02-15,70052,70060,Blue,1,51585,51957,372
2022-12-15,70042,70050,Blue,1,50734,51146,412
2022-09-30,70052,70060,Blue,1,72422,72776,354
2022-02-04,70038,70052,Blue,1,65248,66064,816
2022-03-18,70046,70048,Blue,1,52270,52370,100
2022-01-07,70053,70838,Blue,0,64083,64882,799
2022-05-12,70057,70051,Blue,0,22790,23041,251
2022-11-25,70042,70054,Blue,1,62527,63249,722
2022-02-20,70059,70045,Blue,0,53295,54001,706
2022-10-29,70053,70838,Blue,0,66758,67547,789
2022-12-30,70045,70039,Blue,0,67006,67261,255
2022-07-18,70038,70052,Blue,1,72613,73324,711
2022-09-05,70038,70056,Blue,1,82330,83214,884
2022-03-26,70057,70041,Blue,0,55783,56686,903
2022-10-09,70058,70060,Blue,1,31030,31097,67
2022-03-03,70055,70047,Blue,0,35407,35780,373
2022-02-22,70055,70043,Blue,0,66070,66794,724
2022-04-18,70046,70052,Blue,1,24029,24404,375
2022-02-13,70057,70049,Blue,0,74424,74830,406
2022-08-25,70055,70047,Blue,0,55828,56235,407
2022-02-28,70053,70838,Blue,0,31131,32001,870
2022-06-21,70048,70058,Blue,1,60072,60560,488
2022-07-20,70052,70056,Blue,1,85308,85445,137
2022-04-04,70053,70043,Blue,0,86579,87227,648
2022-02-22,70038,70048,Blue,1,33249,33700,451
2022-12-11,70047,70838,Blue,0,68477,68911,434
2022-12-19,70047,70041,Blue,0,44754,45107,353
2022-09-26,70042,70052,Blue,1,45314,45898,584
2022-03-24,70042,70050,Blue,1,71715,72124,409
2022-11-07,70057,70053,Blue,0,27052,27222,170
2022-10-18,70057,70043,Blue,0,79418,80126,708
2022-12-02,70045,70838,Blue,0,69878,70205,327
2022-08-16,70038,70056,Blue,1,55537,56441,904
2022-05-22,70047,70838,Blue,0,47842,48471,629
2022-06-23,70047,70039,Blue,0,81327,81783,456
2022-06-17,70047,70041,Blue,0,53979,54364,385
2022-08-06,70046,70054,Blue,1,68416,68964,548
2022-08-22,70040,70060,Blue,1,83058,84199,1141
2022-02-13,70059,70047,Blue,0,55453,56024,571
2022-07-11,70059,70045,Blue,0,69685,70424,739
2022-10-10,70042,70058,Blue,1,79022,79921,899
2022-03-09,70053,70049,Blue,0,22750,22975,225
2022-09-13,70051,70039,Blue,0,69480,70147,667
2022-10-31,70055,70838,Blue,0,50167,51086,919
2022-04-21,70052,70060,Blue,1,49961,50337,376
2022-02-25,70046,70054,Blue,1,37584,38124,540
2022-10-31,70050,70056,Blue,1,76910,77198,288
2022-12-14,70055,70051,Blue,0,60300,60438,138
2022-08-10,70048,70050,Blue,1,66926,66983,57
2022-06-17,70044,70056,Blue,1,69335,70180,845
2022-10-26,70047,70043,Blue,0,28215,28464,249
2022-08-31,70057,70049,Blue,0,35935,36350,415
2022-08-08,70047,70838,Blue,0,28717,29219,502
2022-06-10,70040,70050,Blue,1,78180,78714,534
2022-01-28,70038,70044,Blue,1,50774,50945,171
2022-07-02,70055,70045,Blue,0,71541,72063,522
2022-10-14,70045,70043,Blue,0,49866,49961,95
2022-06-01,70041,70039,Blue,0,56433,56476,43
2022-01-24,70053,70049,Blue,0,32718,32921,203
2022-02-17,70052,70058,Blue,1,53613,53862,249
2022-03-12,70057,70838,Blue,0,55779,56813,1034
2022-06-12,70042,70044,Blue,1,66310,66346,36
2022-08-01,70058,70060,Blue,1,35132,35195,63
2022-03-09,70045,70039,Blue,0,70294,70557,263
2022-12-01,70054,70058,Blue,1,56175,56337,162
2022-11-19,70038,70040,Blue,1,79262,79277,15
2022-04-11,70046,70058,Blue,1,81420,82138,718
2022-04-04,70055,70041,Blue,0,55869,56606,737
2022-03-19,70059,70051,Blue,0,40033,40355,322
2022-01-14,70057,70051,Blue,0,31530,31762,232
2022-03-27,70058,70060,Blue,1,36618,36686,68
2022-11-27,70057,70051,Blue,0,24706,24948,242
2022-11-08,70059,70055,Blue,0,32560,32711,151
2022-02-02,70045,70039,Blue,0,62559,62866,307
2022-06-08,70039,70838,Blue,0,79900,79935,35
2022-03-25,70050,70052,Blue,1,80849,80961,112
2022-06-26,70059,70053,Blue,0,75975,76243,268
2022-03-19,70050,70060,Blue,1,74003,74526,523
2022-11-19,70048,70060,Blue,1,80442,81032,590
2022-04-20,70045,70043,Blue,0,24720,24815,95
2022-06-23,70057,70055,Blue,0,39173,39252,79
2022-10-19,70050,70054,Blue,1,65225,65435,210
2022-01-19,70047,70043,Blue,0,69630,69857,227
2022-06-18,70049,70039,Blue,0,74576,75178,602
2022-04-13,70050,70060,Blue,1,34211,34768,557
2022-06-29,70053,70051,Blue,0,74078,74147,69
2022-09-07,70042,70058,Blue,1,82796,83702,906
2022-03-02,70053,70043,Blue,0,23667,24313,646
2022-02-10,70059,70039,Blue,0,31155,32187,1032
2022-08-16,70038,70044,Blue,1,73155,73330,175
2022-01-17,70057,70039,Blue,0,22903,23928,1025
2022-02-22,70039,70838,Blue,0,68650,68685,35
2022-09-14,70049,70041,Blue,0,26548,27079,531
2022-06-14,70046,70048,Blue,1,21847,21943,96
2022-11-10,70042,70058,Blue,1,82871,83815,944
2022-08-21,70046,70050,Blue,1,26459,26648,189
2022-07-14,70051,70838,Blue,0,18801,19602,801
2022-09-20,70057,70053,Blue,0,27288,27449,161
2022-08-01,70044,70058,Blue,1,64595,65408,813
2022-09-13,70038,70050,Blue,1,29633,30187,554
2022-11-12,70052,70060,Blue,1,51523,51896,373
2022-12-21,70038,70042,Blue,1,25934,26031,97
2022-04-23,70038,70058,Blue,1,45848,46845,997
2022-02-03,70042,70044,Blue,1,54155,54184,29
2022-03-01,70040,70044,Blue,1,66331,66448,117
2022-01-14,70049,70838,Blue,0,31093,31772,679
2022-03-10,70044,70056,Blue,1,56189,56901,712
2022-02-23,70059,70051,Blue,0,59294,59666,372
2022-09-17,70054,70058,Blue,1,50008,50167,159
2022-02-08,70046,70060,Blue,1,69871,70660,789
2022-12-19,70042,70056,Blue,1,79844,80608,764
2022-10-22,70059,70049,Blue,0,42832,43302,470
2022-09-18,70038,70060,Blue,1,48333,49455,1122
2022-07-28,70052,70058,Blue,1,26975,27243,268
2022-04-15,70051,70838,Blue,0,36275,37063,788
2022-08-25,70051,70838,Blue,0,39471,40377,906
2022-01-15,70048,70058,Blue,1,31739,32258,519
2022-10-20,70048,70058,Blue,1,33049,33545,496
2022-04-07,70040,70052,Blue,1,51306,51961,655
2022-10-27,70059,70057,Blue,0,59538,59573,35
2022-02-23,70052,70058,Blue,1,29308,29569,261
2022-09-07,70040,70042,Blue,1,75832,75862,30
2022-11-15,70044,70056,Blue,1,37534,38320,786
2022-09-16,70051,70039,Blue,0,44521,45131,610
2022-12-10,70049,70043,Blue,0,25979,26334,355
2022-04-19,70050,70054,Blue,1,34513,34734,221
2022-01-06,70048,70054,Blue,1,49055,49336,281
2022-08-24,70057,70053,Blue,0,46541,46700,159
2022-09-16,70044,70052,Blue,1,42966,43463,497
2022-02-25,70046,70054,Blue,1,62007,62436,429
2022-03-10,70043,70041,Blue,0,21187,21223,36
2022-03-30,70053,70045,Blue,0,36170,36621,451
2022-04-22,70055,70049,Blue,0,81384,81662,278
2022-08-01,70045,70041,Blue,0,27091,27273,182
2022-04-11,70059,70838,Blue,0,84013,85037,1024
2022-10-06,70039,70838,Blue,0,57272,57303,31
2022-09-23,70052,70056,Blue,1,29127,29267,140
2022-04-20,70048,70058,Blue,1,22311,23097,786
2022-12-14,70059,70051,Blue,0,31408,31752,344
2022-11-05,70038,70052,Blue,1,31814,32522,708
2022-12-27,70046,70050,Blue,1,33724,33898,174
2022-07-02,70040,70046,Blue,1,37270,37546,276
2022-11-09,70038,70050,Blue,1,82632,83265,633
2022-08-21,70057,70053,Blue,0,71741,71895,154
2022-02-24,70055,70051,Blue,0,40594,40760,166
2022-06-21,70050,70054,Blue,1,37547,37786,239
2022-03-04,70057,70051,Blue,0,60267,60510,243
2022-07-19,70059,70039,Blue,0,60856,61874,1018
2022-04-22,70041,70039,Blue,0,64162,64197,35
2022-08-13,70040,70050,Blue,1,33482,33936,454
2022-07-29,70056,70058,Blue,1,65730,65804,74
2022-02-11,70044,70046,Blue,1,51491,51593,102
2022-08-26,70050,70060,Blue,1,56787,57511,724
2022-02-17,70049,70041,Blue,0,37699,38171,472
2022-09-15,70048,70050,Blue,1,32413,32469,56
2022-05-12,70058,70060,Blue,1,34725,34797,72
2022-08-29,70042,70052,Blue,1,35957,36575,618
2022-01-25,70040,70060,Blue,1,21928,23075,1147
2022-05-04,70054,70060,Blue,1,71976,72234,258
2022-07-22,70052,70058,Blue,1,65755,66027,272
2022-05-12,70055,70049,Blue,0,81202,81510,308
2022-01-20,70047,70039,Blue,0,36557,37030,473
2022-01-21,70042,70048,Blue,1,65668,65977,309
2022-11-18,70042,70056,Blue,1,53527,54255,728
2022-02-11,70042,70048,Blue,1,86710,87042,332
2022-12-13,70040,70056,Blue,1,80355,81196,841
2022-06-21,70047,70043,Blue,0,44971,45270,299
2022-06-23,70038,70060,Blue,1,73636,74910,1274
2022-11-07,70042,70050,Blue,1,24230,24758,528
2022-06-09,70046,70056,Blue,1,75167,75802,635
2022-07-23,70046,70056,Blue,1,71037,71606,569
2022-11-24,70054,70058,Blue,1,65828,65978,150
2022-10-12,70048,70052,Blue,1,91586,91773,187
2022-01-20,70046,70048,Blue,1,86916,87011,95
2022-03-31,70040,70052,Blue,1,56678,57342,664
2022-10-17,70059,70057,Blue,0,54073,54176,103
2022-02-13,70049,70043,Blue,0,55960,56355,395
2022-12-21,70059,70055,Blue,0,29241,29396,155
2022-04-04,70042,70052,Blue,1,55550,56189,639
2022-11-18,70049,70838,Blue,0,70815,71457,642
2022-07-12,70038,70048,Blue,1,30681,31154,473
2022-09-24,70040,70060,Blue,1,71839,72926,1087
2022-09-11,70048,70060,Blue,1,25414,26011,597
2022-01-12,70046,70054,Blue,1,72299,72684,385
2022-09-15,70042,70044,Blue,1,22381,22411,30
2022-10-28,70051,70041,Blue,0,56558,57145,587
2022-05-23,70049,70041,Blue,0,75695,76375,680
2022-05-02,70050,70060,Blue,1,62968,63543,575
2022-02-07,70054,70056,Blue,1,60660,60707,47
2022-02-17,70040,70048,Blue,1,65014,65414,400
2022-08-18,70042,70046,Blue,1,74217,74421,204
2022-11-22,70057,70041,Blue,0,77009,77796,787
2022-09-16,70040,70054,Blue,1,59233,59980,747
2022-04-16,70042,70058,Blue,1,28784,29656,872
2022-06-30,70046,70054,Blue,1,53082,53530,448
2022-01-15,70056,70060,Blue,1,39738,39968,230
2022-09-24,70049,70045,Blue,0,63751,63959,208
2022-05-15,70050,70058,Blue,1,66221,66646,425
2022-07-29,70046,70050,Blue,1,62153,62509,356
2022-06-21,70044,70056,Blue,1,36244,36942,698
2022-08-31,70046,70060,Blue,1,29516,30233,717
2022-01-13,70038,70040,Blue,1,29742,29758,16
2022-09-29,70052,70058,Blue,1,49438,49681,243
2022-10-05,70053,70838,Blue,0,80294,81139,845
2022-11-02,70049,70045,Blue,0,66224,66431,207
2022-02-13,70040,70052,Blue,1,58667,59326,659
2022-07-20,70042,70058,Blue,1,36911,37809,898
2022-12-18,70047,70043,Blue,0,44070,44328,258
2022-06-16,70049,70041,Blue,0,52363,52856,493
2022-04-20,70038,70058,Blue,1,66134,67224,1090
2022-07-28,70042,70060,Blue,1,48404,49426,1022
2022-10-15,70038,70046,Blue,1,66913,67288,375
2022-06-09,70059,70057,Blue,0,58100,58136,36
2022-09-17,70038,70052,Blue,1,82195,82932,737
2022-11-09,70053,70838,Blue,0,72521,73300,779
2022-09-21,70050,70052,Blue,1,66549,66654,105
2022-08-11,70044,70046,Blue,1,43034,43146,112
2022-02-10,70044,70056,Blue,1,80025,80724,699
2022-02-23,70039,70838,Blue,0,60427,60460,33
2022-12-16,70053,70049,Blue,0,82177,82369,192
2022-01-19,70051,70047,Blue,0,63898,64096,198
2022-03-06,70045,70041,Blue,0,86277,86468,191
2022-10-19,70049,70039,Blue,0,34038,34649,611
2022-08-18,70052,70058,Blue,1,34074,34316,242
2022-03-11,70056,70060,Blue,1,87527,87707,180
2022-12-21,70046,70058,Blue,1,55497,56088,591
2022-10-19,70044,70052,Blue,1,36989,37600,611
2022-08-07,70047,70043,Blue,0,73910,74144,234
2022-08-24,70055,70051,Blue,0,62192,62335,143
2022-08-01,70059,70055,Blue,0,60020,60167,147
2022-02-14,70048,70058,Blue,1,60055,60562,507
2022-06-13,70048,70050,Blue,1,41592,41655,63
2022-04-07,70051,70039,Blue,0,56703,57405,702
2022-03-03,70053,70051,Blue,0,60793,60859,66
2022-04-06,70053,70047,Blue,0,60070,60366,296
2022-12-20,70050,70060,Blue,1,89060,89563,503
2022-10-31,70050,70060,Blue,1,64462,64976,514
2022-10-22,70040,70060,Blue,1,22385,23479,1094
2022-11-24,70040,70054,Blue,1,61878,62585,707
2022-10-28,70038,70056,Blue,1,57034,57928,894
2022-11-07,70059,70041,Blue,0,58038,59048,1010
2022-08-15,70049,70043,Blue,0,26057,26421,364
2022-08-07,70046,70060,Blue,1,45291,45984,693
2022-01-13,70059,70047,Blue,0,66765,67328,563
2022-12-29,70044,70052,Blue,1,28516,28993,477
2022-12-11,70042,70060,Blue,1,61422,62421,999
2022-06-23,70050,70052,Blue,1,63940,64059,119
2022-07-28,70048,70052,Blue,1,36735,36939,204
2022-03-11,70047,70045,Blue,0,43900,44042,142
2022-03-24,70053,70047,Blue,0,26923,27208,285
2022-08-25,70040,70054,Blue,1,38428,39273,845
2022-10-07,70040,70042,Blue,1,54623,54659,36
2022-03-01,70039,70838,Blue,0,57955,57990,35
2022-12-22,70053,70039,Blue,0,31703,32508,805
2022-12-20,70051,70043,Blue,0,61865,62358,493
2022-04-05,70045,70041,Blue,0,74591,74793,202
2022-02-17,70059,70039,Blue,0,60792,61872,1080
2022-03-24,70057,70041,Blue,0,58465,59334,869
2022-08-05,70046,70060,Blue,1,32084,32816,732
2022-02-15,70045,70043,Blue,0,24764,24886,122
2022-08-28,70059,70838,Blue,0,37515,38665,1150
2022-10-09,70051,70045,Blue,0,77393,77708,315
2022-01-25,70059,70057,Blue,0,58395,58430,35
2022-04-02,70048,70060,Blue,1,74979,75711,732
2022-11-09,70054,70060,Blue,1,72450,72716,266
2022-10-23,70051,70049,Blue,0,66640,66747,107
2022-01-25,70044,70056,Blue,1,25135,25853,718
2022-01-31,70049,70047,Blue,0,63931,63987,56
2022-12-14,70046,70056,Blue,1,36111,36617,506
2022-10-18,70038,70050,Blue,1,42929,43448,519
2022-08-05,70044,70046,Blue,1,81072,81178,106
2022-10-13,70057,70049,Blue,0,41147,41549,402
2022-09-20,70040,70048,Blue,1,55000,55429,429
2022-12-31,70038,70040,Blue,1,46937,46952,15
2022-06-04,70046,70050,Blue,1,59496,59711,215
2022-02-22,70046,70048,Blue,1,35193,35302,109
2022-11-10,70048,70056,Blue,1,54725,55141,416
2022-12-12,70051,70047,Blue,0,74358,74550,192
2022-01-26,70050,70054,Blue,1,32376,32600,224
2022-08-22,70057,70053,Blue,0,80496,80651,155
2022-09-20,70047,70045,Blue,0,49007,49097,90
2022-08-25,70057,70049,Blue,0,51478,51872,394
2022-07-10,70051,70047,Blue,0,75820,76037,217
2022-11-26,70051,70039,Blue,0,76807,77425,618
2022-08-30,70053,70039,Blue,0,35186,36020,834
2022-08-26,70052,70058,Blue,1,39658,39919,261
2022-04-13,70059,70049,Blue,0,33258,33771,513
2022-03-15,70049,70838,Blue,0,72491,73040,549
2022-02-12,70057,70838,Blue,0,44433,45426,993
2022-03-09,70052,70054,Blue,1,34905,34959,54
2022-03-01,70040,70050,Blue,1,35444,35995,551
2022-06-26,70043,70039,Blue,0,45584,45690,106
2022-03-29,70050,70058,Blue,1,66809,67213,404
2022-02-15,70048,70052,Blue,1,56949,57161,212
2022-05-22,70046,70048,Blue,1,57297,57413,116
2022-07-25,70046,70048,Blue,1,67688,67763,75
2022-03-01,70056,70058,Blue,1,28817,28890,73
2022-08-18,70042,70048,Blue,1,77991,78290,299
2022-12-02,70046,70058,Blue,1,28105,28820,715
2022-12-31,70038,70044,Blue,1,75476,75643,167
2022-10-15,70042,70058,Blue,1,35168,36015,847
2022-09-13,70059,70838,Blue,0,41595,42767,1172
2022-05-05,70052,70060,Blue,1,63045,63401,356
2022-10-31,70052,70056,Blue,1,33548,33692,144
2022-08-22,70040,70050,Blue,1,71687,72229,542
2022-04-07,70040,70060,Blue,1,32723,33798,1075
2022-11-01,70047,70039,Blue,0,57301,57738,437
2022-01-13,70038,70054,Blue,1,67117,67948,831
2022-03-12,70057,70838,Blue,0,86608,87651,1043
2022-03-11,70040,70046,Blue,1,69435,69708,273
2022-04-05,70056,70060,Blue,1,59550,59812,262
2022-05-19,70045,70838,Blue,0,65849,66220,371
2022-07-26,70053,70039,Blue,0,72074,72777,703
2022-09-17,70057,70043,Blue,0,72509,73641,1132
2022-09-23,70049,70043,Blue,0,24370,24731,361
2022-07-12,70056,70060,Blue,1,42830,43002,172
2022-02-21,70042,70050,Blue,1,71390,71809,419
2022-07-21,70051,70047,Blue,0,54977,55170,193
2022-06-24,70059,70041,Blue,0,82515,83412,897
2022-04-05,70055,70838,Blue,0,28675,29634,959
2022-05-18,70055,70043,Blue,0,54995,55969,974
2022-12-21,70059,70053,Blue,0,51620,51848,228
2022-11-28,70044,70060,Blue,1,82156,83065,909
2022-01-15,70044,70046,Blue,1,71879,72005,126
2022-08-14,70038,70048,Blue,1,82335,82799,464
2022-03-28,70053,70043,Blue,0,67429,67979,550
2022-04-16,70041,70838,Blue,0,29193,29321,128
2022-08-04,70054,70056,Blue,1,68602,68652,50
2022-07-05,70054,70058,Blue,1,35656,35812,156
2022-12-12,70055,70039,Blue,0,76227,77086,859
2022-06-24,70042,70054,Blue,1,51563,52278,715
2022-02-05,70051,70047,Blue,0,62564,62760,196
2022-02-11,70055,70045,Blue,0,58579,59158,579
2022-07-14,70055,70039,Blue,0,74579,75418,839
2022-02-07,70050,70060,Blue,1,84864,85394,530
2022-12-20,70048,70056,Blue,1,36000,36491,491
2022-09-02,70051,70047,Blue,0,60173,60370,197
2022-08-15,70038,70054,Blue,1,27413,28237,824
2022-09-13,70055,70047,Blue,0,22775,23258,483
2022-01-10,70045,70043,Blue,0,23968,24060,92
2022-11-09,70050,70054,Blue,1,50022,50216,194
2022-05-07,70056,70060,Blue,1,44133,44299,166
2022-04-13,70057,70045,Blue,0,69158,69931,773
2022-09-10,70048,70060,Blue,1,45337,45955,618
2022-09-17,70048,70060,Blue,1,50153,50764,611
2022-10-02,70053,70045,Blue,0,32691,33133,442
2022-07-15,70049,70041,Blue,0,51994,52454,460
2022-08-08,70040,70044,Blue,1,22308,22411,103
2022-02-23,70049,70045,Blue,0,42556,42757,201
2022-01-10,70041,70039,Blue,0,64750,64780,30
2022-09-23,70059,70043,Blue,0,45258,46186,928
2022-09-27,70051,70039,Blue,0,52624,53375,751
2022-08-23,70040,70060,Blue,1,51470,52626,1156
2022-10-24,70049,70039,Blue,0,57146,57653,507
2022-04-17,70046,70056,Blue,1,59021,59574,553
2022-10-05,70052,70056,Blue,1,35700,35851,151
2022-11-15,70049,70039,Blue,0,39918,40442,524
2022-03-31,70053,70047,Blue,0,29325,29628,303
2022-03-08,70042,70048,Blue,1,43650,43945,295
2022-03-20,70038,70042,Blue,1,42345,42446,101
2022-06-17,70053,70045,Blue,0,65267,65679,412
2022-12-31,70042,70058,Blue,1,60236,61174,938
2022-02-23,70050,70054,Blue,1,54586,54810,224
2022-08-22,70044,70060,Blue,1,22692,23765,1073
2022-10-20,70053,70045,Blue,0,54357,54799,442
2022-02-20,70051,70043,Blue,0,55807,56305,498
2022-07-15,70044,70046,Blue,1,52134,52251,117
2022-02-24,70048,70060,Blue,1,76877,77477,600
2022-01-02,70054,70058,Blue,1,45812,45971,159
2022-03-29,70050,70056,Blue,1,69999,70287,288
2022-04-14,70045,70039,Blue,0,21902,22156,254
2022-02-25,70059,70838,Blue,0,30858,32044,1186
2022-01-20,70055,70041,Blue,0,60072,60895,823
2022-03-28,70053,70049,Blue,0,66180,66380,200
2022-03-25,70055,70049,Blue,0,54672,54968,296
2022-12-27,70059,70051,Blue,0,34036,34360,324
2022-10-31,70038,70054,Blue,1,24373,25137,764
2022-02-10,70044,70060,Blue,1,29275,30216,941
2022-09-08,70042,70044,Blue,1,23068,23099,31
2022-08-04,70049,70043,Blue,0,75431,75766,335
2022-04-19,70042,70052,Blue,1,35308,35975,667
2022-12-01,70057,70043,Blue,0,38969,39804,835
2022-06-27,70048,70060,Blue,1,69047,69946,899
2022-07-18,70056,70058,Blue,1,70553,70622,69
2022-04-08,70050,70060,Blue,1,33230,33785,555
2022-07-01,70050,70058,Blue,1,49560,49967,407
2022-04-02,70053,70041,Blue,0,64072,64760,688
2022-07-24,70038,70050,Blue,1,37027,37540,513
2022-04-21,70055,70041,Blue,0,60375,61134,759
2022-09-13,70050,70054,Blue,1,58440,58648,208
2022-07-23,70059,70055,Blue,0,61669,61819,150
2022-09-02,70057,70047,Blue,0,70598,71076,478
2022-02-11,70057,70049,Blue,0,26450,26900,450
2022-01-01,70059,70053,Blue,0,43454,43721,267
2022-08-17,70046,70060,Blue,1,65901,66652,751
2022-02-18,70038,70042,Blue,1,59239,59328,89
2022-02-03,70044,70058,Blue,1,67856,68630,774
2022-09-22,70042,70046,Blue,1,46757,46920,163
2022-02-12,70038,70050,Blue,1,81423,82024,601
2022-02-26,70042,70044,Blue,1,42746,42776,30
2022-12-13,70050,70052,Blue,1,28743,28867,124
2022-04-19,70038,70058,Blue,1,68954,69953,999
2022-04-15,70040,70054,Blue,1,24943,25704,761
2022-09-09,70053,70039,Blue,0,56931,57717,786
2022-02-26,70040,70042,Blue,1,41636,41669,33
2022-05-26,70050,70052,Blue,1,37927,38134,207
2022-09-15,70045,70043,Blue,0,22946,23039,93
2022-02-07,70053,70051,Blue,0,23012,23058,46
2022-08-03,70045,70039,Blue,0,23820,24123,303
2022-05-10,70059,70053,Blue,0,60683,60913,230
2022-03-25,70042,70044,Blue,1,35799,35829,30
2022-01-20,70054,70060,Blue,1,45052,45316,264
2022-12-12,70046,70056,Blue,1,44371,44970,599
2022-05-18,70057,70053,Blue,0,25297,25460,163
2022-08-26,70044,70052,Blue,1,34276,34802,526
2022-03-15,70046,70052,Blue,1,48552,48861,309
2022-01-23,70053,70051,Blue,0,81184,81239,55
2022-12-25,70048,70052,Blue,1,47163,47367,204
2022-04-01,70059,70039,Blue,0,32353,33403,1050
2022-06-29,70046,70056,Blue,1,70885,71508,623
2022-07-19,70044,70056,Blue,1,82871,83545,674
2022-03-09,70057,70039,Blue,0,61469,62409,940
2022-11-23,70055,70053,Blue,0,44627,44672,45
2022-08-09,70058,70060,Blue,1,46586,46653,67
2022-02-01,70053,70049,Blue,0,22322,22592,270
2022-10-16,70049,70039,Blue,0,75965,76484,519
2022-03-11,70054,70060,Blue,1,67281,67641,360
2022-05-01,70050,70058,Blue,1,45578,45998,420
2022-03-03,70052,70060,Blue,1,26884,27242,358
2022-03-17,70040,70044,Blue,1,31210,31323,113
2022-11-16,70056,70058,Blue,1,40747,40825,78
2022-03-25,70051,70039,Blue,0,50111,50755,644
2022-06-16,70051,70049,Blue,0,36751,36853,102
2022-11-14,70053,70039,Blue,0,56659,57421,762
2022-12-26,70038,70040,Blue,1,47233,47247,14
2022-06-25,70048,70054,Blue,1,47018,47335,317
2022-06-14,70059,70053,Blue,0,38992,40385,1393
2022-02-14,70042,70060,Blue,1,70053,70979,926
2022-10-20,70057,70047,Blue,0,68193,68670,477
2022-02-01,70057,70045,Blue,0,28549,29221,672
2022-07-05,70057,70047,Blue,0,68705,69165,460
2022-07-16,70045,70043,Blue,0,41806,41897,91
2022-12-30,70038,70040,Blue,1,34317,34333,16
2022-11-15,70055,70838,Blue,0,33988,34941,953
2022-01-07,70042,70056,Blue,1,81662,82577,915
2022-09-11,70048,70050,Blue,1,40880,40938,58
2022-02-16,70042,70048,Blue,1,41464,41764,300
2022-04-06,70046,70054,Blue,1,26804,27291,487
2022-12-29,70040,70054,Blue,1,69174,69908,734
2022-02-19,70053,70051,Blue,0,61933,61989,56
2022-08-17,70045,70041,Blue,0,50191,50372,181
2022-08-20,70040,70042,Blue,1,27576,27611,35
2022-07-03,70047,70043,Blue,0,54985,55274,289
2022-10-01,70039,70838,Blue,0,81742,81777,35
2022-07-15,70059,70057,Blue,0,41579,41614,35
2022-02-04,70045,70043,Blue,0,58855,58967,112
2022-10-01,70054,70058,Blue,1,40823,41001,178
2022-04-08,70053,70045,Blue,0,25149,25622,473
2022-01-02,70059,70047,Blue,0,66255,66892,637
2022-08-02,70057,70045,Blue,0,36611,37296,685
2022-01-18,70040,70056,Blue,1,80469,81341,872
2022-12-09,70047,70039,Blue,0,72395,72791,396
2022-02-04,70042,70050,Blue,1,83475,83952,477
2022-06-29,70057,70041,Blue,0,63844,64744,900
2022-02-01,70040,70058,Blue,1,37426,38543,1117
2022-08-19,70042,70060,Blue,1,50119,51114,995
2022-12-05,70057,70047,Blue,0,74971,75462,491
2022-02-15,70053,70043,Blue,0,71841,72401,560
2022-01-27,70038,70042,Blue,1,87781,87880,99
2022-05-03,70054,70060,Blue,1,87670,87944,274
2022-09-24,70038,70050,Blue,1,43691,44233,542
2022-04-11,70047,70045,Blue,0,77249,77361,112
2022-10-28,70038,70058,Blue,1,36751,37787,1036
2022-04-20,70045,70039,Blue,0,20608,20892,284
2022-10-12,70047,70041,Blue,0,87923,88235,312
2022-06-06,70049,70043,Blue,0,43975,44398,423
2022-04-13,70044,70046,Blue,1,68169,68272,103
2022-01-22,70055,70838,Blue,0,66126,67032,906
2022-11-19,70057,70047,Blue,0,66030,66488,458
2022-09-18,70039,70838,Blue,0,77072,77106,34
2022-06-12,70040,70050,Blue,1,42390,42932,542
2022-03-07,70040,70046,Blue,1,19980,20248,268
2022-01-03,70055,70041,Blue,0,58263,59361,1098
2022-11-25,70057,70047,Blue,0,34958,35502,544
2022-03-04,70059,70047,Blue,0,59295,59901,606
2022-12-22,70050,70056,Blue,1,72501,72854,353
2022-10-13,70046,70056,Blue,1,33580,34128,548
2022-11-22,70049,70045,Blue,0,75847,76020,173
2022-04-23,70043,70041,Blue,0,87456,87484,28
2022-08-12,70051,70045,Blue,0,26748,27113,365
2022-04-11,70042,70056,Blue,1,82722,83460,738
2022-08-26,70055,70049,Blue,0,48041,48318,277
2022-04-22,70048,70058,Blue,1,28633,29286,653
2022-07-13,70050,70056,Blue,1,37264,37606,342
2022-06-13,70050,70060,Blue,1,56564,57614,1050
2022-10-05,70048,70058,Blue,1,28720,29247,527
2022-07-05,70045,70043,Blue,0,63128,63217,89
2022-08-31,70038,70044,Blue,1,74708,74883,175
2022-11-20,70044,70058,Blue,1,28634,29377,743
2022-01-31,70043,70041,Blue,0,52481,52511,30
2022-02-01,70046,70048,Blue,1,82332,82403,71
2022-12-23,70051,70043,Blue,0,41177,41688,511
2022-01-07,70043,70041,Blue,0,30948,30977,29
2022-11-18,70047,70043,Blue,0,53985,54221,236
2022-01-24,70051,70039,Blue,0,45851,46493,642
2022-12-20,70053,70047,Blue,0,23498,23808,310
2022-10-09,70055,70838,Blue,0,29474,30427,953
2022-10-01,70050,70060,Blue,1,66432,66911,479
2022-11-16,70040,70042,Blue,1,33672,33707,35
2022-08-17,70042,70052,Blue,1,85068,85598,530
2022-08-10,70044,70048,Blue,1,40822,41091,269
2022-11-10,70044,70060,Blue,1,62993,63925,932
2022-05-18,70056,70060,Blue,1,60600,60861,261
2022-09-04,70040,70060,Blue,1,50025,51055,1030
2022-09-23,70044,70060,Blue,1,53324,54172,848
2022-02-14,70044,70048,Blue,1,80137,80387,250
2022-09-06,70040,70046,Blue,1,29489,29745,256
2022-03-22,70044,70060,Blue,1,62940,63906,966
2022-07-02,70040,70058,Blue,1,58908,59994,1086
2022-07-18,70040,70046,Blue,1,51022,51276,254
2022-09-14,70049,70041,Blue,0,29028,29490,462
2022-02-25,70040,70044,Blue,1,31641,31764,123
2022-09-17,70047,70045,Blue,0,65533,65620,87
2022-02-18,70059,70041,Blue,0,47117,48007,890
2022-06-24,70045,70039,Blue,0,32816,33130,314
2022-07-28,70044,70046,Blue,1,43810,43922,112
2022-08-12,70046,70058,Blue,1,45973,46625,652
2022-08-02,70055,70039,Blue,0,35549,36434,885
2022-01-22,70051,70041,Blue,0,37227,37830,603
2022-11-29,70059,70045,Blue,0,59768,60444,676
2022-11-09,70053,70838,Blue,0,86783,87528,745
2022-06-27,70051,70047,Blue,0,22173,22395,222
2022-12-16,70059,70043,Blue,0,45738,46719,981
2022-08-18,70045,70838,Blue,0,64392,64786,394
2022-02-10,70047,70041,Blue,0,49854,50215,361
2022-04-18,70044,70054,Blue,1,77829,78552,723
2022-10-31,70042,70060,Blue,1,87560,88534,974
2022-06-16,70053,70045,Blue,0,28130,28544,414
2022-06-20,70042,70046,Blue,1,78072,78248,176
2022-03-09,70042,70056,Blue,1,81003,81803,800
2022-09-14,70053,70045,Blue,0,75150,76047,897
2022-10-13,70051,70045,Blue,0,41441,41805,364
2022-11-05,70059,70045,Blue,0,53012,53717,705
2022-06-14,70048,70060,Blue,1,65500,66405,905
2022-09-28,70038,70056,Blue,1,46636,47527,891
2022-08-11,70054,70056,Blue,1,38193,38240,47
2022-08-17,70042,70044,Blue,1,80242,80270,28
2022-08-16,70053,70041,Blue,0,87643,88289,646
2022-02-06,70054,70058,Blue,1,82668,82839,171
2022-09-02,70046,70050,Blue,1,42333,42512,179
2022-04-07,70046,70056,Blue,1,55618,56202,584
2022-10-09,70059,70041,Blue,0,36851,37799,948
2022-08-21,70046,70060,Blue,1,73551,74336,785
2022-09-14,70040,70048,Blue,1,27213,27623,410
2022-08-17,70051,70039,Blue,0,33860,34577,717
2022-05-20,70042,70058,Blue,1,83988,84913,925
2022-10-05,70045,70043,Blue,0,69042,69135,93
2022-01-07,70057,70838,Blue,0,63871,64882,1011
2022-08-05,70047,70045,Blue,0,33734,33823,89
2022-02-21,70044,70058,Blue,1,20226,21112,886
2022-02-05,70039,70838,Blue,0,55243,55279,36
2022-12-01,70045,70041,Blue,0,67159,67330,171
2022-11-21,70048,70058,Blue,1,61166,61660,494
2022-08-09,70056,70058,Blue,1,82075,82145,70
2022-11-07,70057,70051,Blue,0,69206,69444,238
2022-08-30,70045,70041,Blue,0,41484,41662,178
2022-07-26,70057,70051,Blue,0,62659,62917,258
2022-12-21,70041,70838,Blue,0,26330,26480,150
2022-12-17,70053,70047,Blue,0,52775,53064,289
2022-10-06,70054,70056,Blue,1,73571,73618,47
2022-08-14,70056,70058,Blue,1,48182,48252,70
2022-09-10,70059,70039,Blue,0,72439,73474,1035
2022-09-27,70055,70041,Blue,0,69860,70606,746
2022-10-09,70042,70056,Blue,1,57646,58445,799
2022-08-22,70051,70049,Blue,0,24634,24737,103
2022-07-27,70047,70043,Blue,0,59369,59620,251
2022-02-03,70042,70060,Blue,1,75352,76345,993
2022-12-12,70055,70041,Blue,0,51662,52369,707
2022-09-18,70056,70060,Blue,1,66122,66327,205
2022-02-03,70051,70043,Blue,0,65784,66298,514
2022-03-09,70046,70050,Blue,1,34806,35003,197
2022-07-23,70042,70046,Blue,1,56348,56579,231
2022-12-21,70053,70045,Blue,0,68283,68725,442
2022-11-22,70044,70052,Blue,1,60249,60782,533
2022-07-04,70040,70052,Blue,1,81974,82623,649
2022-03-10,70044,70052,Blue,1,52363,52887,524
2022-07-17,70057,70838,Blue,0,59313,60371,1058
2022-12-22,70040,70048,Blue,1,57227,57661,434
2022-02-13,70040,70044,Blue,1,24698,24813,115
2022-11-17,70042,70046,Blue,1,45773,45989,216
2022-08-16,70057,70053,Blue,0,55896,56046,150
2022-04-20,70059,70838,Blue,0,65991,67161,1170
2022-11-07,70050,70054,Blue,1,51143,51343,200
2022-03-05,70059,70051,Blue,0,71896,72226,330
2022-06-25,70055,70051,Blue,0,24341,24479,138
2022-11-23,70044,70048,Blue,1,34265,34502,237
2022-04-01,70041,70838,Blue,0,60263,60406,143
2022-08-03,70053,70047,Blue,0,66271,66563,292
2022-11-06,70055,70053,Blue,0,62180,62231,51
2022-10-13,70059,70055,Blue,0,76936,77076,140
2022-01-28,70042,70046,Blue,1,26808,26989,181
2022-07-04,70051,70838,Blue,0,49212,50004,792
2022-06-05,70042,70046,Blue,1,71279,72055,776
2022-09-15,70057,70047,Blue,0,32742,33237,495
2022-11-08,70049,70045,Blue,0,44109,44297,188
2022-03-03,70058,70060,Blue,1,31533,31599,66
2022-09-11,70049,70043,Blue,0,60811,61172,361
2022-10-26,70049,70838,Blue,0,67581,68151,570
2022-07-11,70049,70045,Blue,0,31411,31606,195
2022-09-03,70059,70043,Blue,0,29775,30617,842
2022-11-29,70059,70053,Blue,0,30861,31117,256
2022-08-05,70059,70047,Blue,0,83735,84281,546
2022-11-10,70042,70052,Blue,1,51531,52092,561
2022-12-07,70047,70041,Blue,0,55445,55793,348
2022-06-23,70044,70060,Blue,1,67405,68462,1057
2022-07-04,70052,70056,Blue,1,69108,69256,148
2022-10-03,70059,70838,Blue,0,28048,29246,1198
2022-07-30,70040,70048,Blue,1,60503,60922,419
2022-03-11,70051,70043,Blue,0,27656,28181,525
2022-04-09,70044,70054,Blue,1,82399,82954,555
2022-02-02,70051,70043,Blue,0,65688,66239,551
2022-08-18,70054,70056,Blue,1,62781,62827,46
2022-04-11,70044,70048,Blue,1,24541,24814,273
2022-10-22,70048,70054,Blue,1,59367,59648,281
2022-08-01,70042,70060,Blue,1,53812,54864,1052
2022-07-16,70048,70056,Blue,1,60042,60470,428
2022-05-20,70042,70058,Blue,1,55808,56829,1021
2022-09-12,70048,70054,Blue,1,68952,69276,324
2022-09-30,70054,70060,Blue,1,36654,36960,306
2022-12-12,70058,70060,Blue,1,33264,33333,69
2022-08-09,70044,70056,Blue,1,41936,42687,751
2022-06-17,70051,70041,Blue,0,65960,66549,589
2022-01-06,70047,70039,Blue,0,20187,20593,406
2022-08-11,70053,70043,Blue,0,59562,60149,587
2022-04-20,70058,70060,Blue,1,84418,84490,72
2022-12-19,70054,70056,Blue,1,29579,29633,54
2022-04-13,70055,70043,Blue,0,65180,65807,627
2022-03-25,70059,70039,Blue,0,65294,66394,1100
2022-01-20,70051,70049,Blue,0,70904,71159,255
2022-12-31,70047,70041,Blue,0,87170,87560,390
2022-02-02,70059,70045,Blue,0,63799,64499,700
2022-01-26,70041,70838,Blue,0,20876,21023,147
2022-08-07,70046,70060,Blue,1,60078,61059,981
2022-10-10,70059,70047,Blue,0,75977,76527,550
2022-06-19,70055,70838,Blue,0,25087,26054,967
2022-09-03,70046,70056,Blue,1,73796,74315,519
2022-02-28,70055,70043,Blue,0,76825,77492,667
2022-10-09,70044,70046,Blue,1,43863,43985,122
2022-01-07,70051,70838,Blue,0,68256,69006,750
2022-07-08,70046,70056,Blue,1,81101,81612,511
2022-09-10,70055,70047,Blue,0,37543,37905,362
2022-07-25,70042,70056,Blue,1,57423,58262,839
2022-11-20,70043,70039,Blue,0,84654,84759,105
2022-12-01,70040,70050,Blue,1,29592,30119,527
2022-05-20,70053,70045,Blue,0,44093,44680,587
2022-01-24,70056,70060,Blue,1,53574,53864,290
2022-04-21,70043,70838,Blue,0,66246,66446,200
2022-12-28,70045,70043,Blue,0,30176,30259,83
2022-02-19,70059,70039,Blue,0,36259,37300,1041
2022-08-09,70057,70049,Blue,0,49479,49867,388
2022-01-18,70038,70060,Blue,1,74760,76002,1242
2022-12-24,70038,70044,Blue,1,62592,62762,170
2022-11-10,70041,70838,Blue,0,22619,22781,162
2022-01-14,70051,70049,Blue,0,82141,82250,109
2022-04-18,70044,70048,Blue,1,21732,21952,220
2022-01-14,70046,70050,Blue,1,31291,31486,195
2022-11-18,70059,70039,Blue,0,34275,35265,990
2022-01-14,70053,70838,Blue,0,45784,46678,894
2022-06-17,70048,70060,Blue,1,25979,26608,629
2022-03-15,70042,70048,Blue,1,49164,49472,308
2022-07-06,70038,70058,Blue,1,31512,32591,1079
2022-10-31,70050,70052,Blue,1,71698,71807,109
2022-01-04,70050,70052,Blue,1,71444,71556,112
2022-02-23,70059,70045,Blue,0,67516,68266,750
2022-06-17,70057,70053,Blue,0,41617,41774,157
2022-09-01,70052,70060,Blue,1,34020,34391,371
2022-09-24,70056,70060,Blue,1,73761,73944,183
2022-05-20,70038,70052,Blue,1,83830,84599,769
2022-07-21,70048,70052,Blue,1,56278,56487,209
2022-08-08,70048,70060,Blue,1,43156,43785,629
2022-10-16,70057,70049,Blue,0,45298,45667,369
2022-07-21,70044,70054,Blue,1,59197,59798,601
2022-08-30,70048,70056,Blue,1,41490,41915,425
2022-09-23,70057,70838,Blue,0,56730,58028,1298
2022-04-10,70051,70041,Blue,0,44450,45039,589
2022-07-06,70040,70052,Blue,1,61781,62549,768
2022-04-10,70059,70045,Blue,0,66265,66960,695
2022-09-12,70047,70041,Blue,0,83357,83672,315
2022-06-10,70044,70054,Blue,1,29520,30436,916
2022-02-04,70059,70047,Blue,0,58058,58660,602
2022-07-26,70048,70054,Blue,1,74783,75125,342
2022-07-13,70051,70047,Blue,0,31331,31523,192
2022-02-15,70038,70042,Blue,1,78081,78191,110
2022-12-12,70038,70056,Blue,1,31741,32716,975
2022-02-08,70052,70054,Blue,1,36231,36291,60
2022-10-05,70051,70047,Blue,0,52652,52852,200
2022-05-24,70045,70039,Blue,0,41737,42122,385
2022-02-24,70057,70055,Blue,0,43933,44008,75
2022-08-15,70038,70052,Blue,1,34917,35784,867
2022-04-27,70051,70047,Blue,0,54681,54942,261
2022-01-31,70044,70060,Blue,1,35385,36838,1453
2022-03-12,70044,70060,Blue,1,24525,25420,895
2022-03-05,70053,70838,Blue,0,35463,36299,836
2022-09-23,70039,70838,Blue,0,34722,34761,39
2022-08-10,70046,70048,Blue,1,33188,33281,93
2022-09-21,70057,70055,Blue,0,34453,34521,68
2022-04-09,70040,70050,Blue,1,21765,22306,541
2022-12-12,70041,70039,Blue,0,42870,42904,34
2022-08-04,70039,70838,Blue,0,85368,85397,29
2022-09-19,70053,70049,Blue,0,64551,64753,202
2022-10-04,70057,70055,Blue,0,68196,68266,70
2022-08-21,70042,70056,Blue,1,37176,37984,808
2022-11-23,70059,70041,Blue,0,37337,38499,1162
2022-02-13,70040,70042,Blue,1,26951,26980,29
2022-08-02,70055,70051,Blue,0,55655,55798,143
2022-06-01,70049,70047,Blue,0,71641,71699,58
2022-12-22,70043,70838,Blue,0,55722,55938,216
2022-10-21,70050,70056,Blue,1,67077,67369,292
2022-03-02,70055,70049,Blue,0,66069,66338,269
2022-08-06,70040,70044,Blue,1,76692,76806,114
2022-12-03,70044,70056,Blue,1,75229,75939,710
2022-03-22,70054,70056,Blue,1,24096,24143,47
2022-08-31,70049,70041,Blue,0,57702,58130,428
2022-06-20,70047,70039,Blue,0,53140,53621,481
2022-03-12,70044,70052,Blue,1,56506,57032,526
2022-09-19,70039,70838,Blue,0,26273,26314,41
2022-02-21,70053,70838,Blue,0,29519,30335,816
2022-02-23,70039,70838,Blue,0,72783,72818,35
2022-08-17,70058,70060,Blue,1,66593,66652,59
2022-05-19,70050,70060,Blue,1,27671,28211,540
2022-02-03,70057,70055,Blue,0,33045,33118,73
2022-10-07,70045,70838,Blue,0,55854,56211,357
2022-11-08,70040,70044,Blue,1,28448,28567,119
2022-02-13,70038,70060,Blue,1,80360,81510,1150
2022-12-17,70054,70056,Blue,1,57033,57080,47
2022-12-18,70048,70056,Blue,1,31284,31666,382
2022-02-15,70038,70060,Blue,1,43107,44161,1054
2022-10-14,70055,70053,Blue,0,41247,41294,47
2022-01-22,70038,70048,Blue,1,32892,33323,431
2022-11-30,70059,70051,Blue,0,33804,34118,314
2022-01-09,70046,70048,Blue,1,24148,24221,73
2022-12-24,70059,70053,Blue,0,83169,83387,218
2022-12-16,70044,70046,Blue,1,49430,49540,110
2022-02-07,70050,70054,Blue,1,49297,49522,225
2022-02-24,70045,70039,Blue,0,37836,38120,284
2022-06-14,70048,70058,Blue,1,62864,63356,492
2022-06-13,70044,70046,Blue,1,22333,22448,115
2022-10-23,70042,70054,Blue,1,72188,72799,611
2022-08-21,70046,70060,Blue,1,35033,35714,681
2022-12-08,70048,70058,Blue,1,33302,33845,543
2022-12-30,70043,70039,Blue,0,47132,47245,113
2022-12-14,70044,70054,Blue,1,30450,31041,591
2022-02-03,70047,70039,Blue,0,61800,62371,571
2022-03-08,70040,70054,Blue,1,66484,67213,729
2022-03-21,70044,70052,Blue,1,87317,87862,545
2022-08-10,70051,70049,Blue,0,27160,27266,106
2022-04-03,70046,70052,Blue,1,54683,55042,359
2022-06-24,70053,70049,Blue,0,58585,58778,193
2022-08-20,70056,70058,Blue,1,49510,49588,78
2022-08-05,70054,70060,Blue,1,68295,68599,304
2022-01-25,70049,70043,Blue,0,46719,47118,399
2022-02-04,70048,70052,Blue,1,65090,65333,243
2022-04-15,70059,70055,Blue,0,21315,21472,157
2022-05-14,70059,70051,Blue,0,35414,35751,337
2022-06-30,70038,70050,Blue,1,30672,31228,556
2022-08-30,70055,70039,Blue,0,69310,70088,778
2022-11-27,70040,70054,Blue,1,29292,30000,708
2022-07-27,70053,70045,Blue,0,37269,37784,515
2022-04-15,70050,70052,Blue,1,44833,44967,134
2022-05-17,70057,70053,Blue,0,71450,71601,151
2022-06-26,70056,70058,Blue,1,46603,46672,69
2022-04-04,70042,70048,Blue,1,87873,88210,337
2022-12-03,70045,70039,Blue,0,47868,48093,225
2022-11-16,70046,70060,Blue,1,66210,67030,820
2022-01-25,70050,70056,Blue,1,54138,54441,303
2022-09-11,70040,70044,Blue,1,45692,45794,102
2022-08-25,70056,70060,Blue,1,29184,29392,208
2022-01-11,70042,70058,Blue,1,55489,56573,1084
2022-11-04,70048,70056,Blue,1,25768,26211,443
2022-11-28,70051,70041,Blue,0,52864,53412,548
2022-02-04,70038,70048,Blue,1,56898,57361,463
2022-03-21,70038,70048,Blue,1,78552,79033,481
2022-11-11,70046,70052,Blue,1,36789,37119,330
2022-09-09,70047,70041,Blue,0,59925,60284,359
2022-07-04,70050,70060,Blue,1,73475,74026,551
2022-02-01,70047,70045,Blue,0,78999,79092,93
2022-09-27,70058,70060,Blue,1,78344,78409,65
2022-04-19,70057,70041,Blue,0,59920,60804,884
2022-07-19,70051,70049,Blue,0,50300,50405,105
2022-11-07,70046,70056,Blue,1,61633,62206,573
2022-06-17,70048,70054,Blue,1,76509,76824,315
2022-01-24,70046,70052,Blue,1,80725,81053,328
2022-08-10,70053,70047,Blue,0,49116,49456,340
2022-02-21,70057,70049,Blue,0,19598,20018,420
2022-02-10,70049,70045,Blue,0,66671,66857,186
2022-09-20,70050,70052,Blue,1,39131,39251,120
2022-02-02,70051,70838,Blue,0,26484,27281,797
2022-01-04,70051,70049,Blue,0,22367,22478,111
2022-02-16,70053,70047,Blue,0,68751,69039,288
2022-03-21,70042,70048,Blue,1,47096,47428,332
2022-12-28,70038,70060,Blue,1,50172,51271,1099
2022-11-20,70047,70045,Blue,0,47278,47369,91
2022-08-22,70053,70045,Blue,0,51215,51640,425
2022-07-04,70044,70050,Blue,1,37072,37464,392
2022-06-22,70054,70060,Blue,1,61177,61478,301
2022-10-06,70051,70045,Blue,0,67437,67770,333
2022-11-18,70044,70046,Blue,1,36469,36573,104
2022-04-22,70050,70052,Blue,1,39587,39717,130
2022-07-22,70059,70057,Blue,0,80679,80714,35
2022-04-21,70054,70058,Blue,1,84199,84376,177
2022-04-16,70049,70041,Blue,0,67538,67969,431
2022-03-11,70051,70045,Blue,0,41885,42246,361
2022-06-23,70048,70056,Blue,1,53381,53985,604
2022-12-01,70042,70060,Blue,1,40022,41081,1059
2022-12-30,70059,70049,Blue,0,23248,23723,475
2022-12-08,70053,70045,Blue,0,22160,22618,458
2022-03-04,70050,70056,Blue,1,23599,24089,490
2022-11-10,70053,70047,Blue,0,22938,23253,315
2022-01-26,70051,70043,Blue,0,70414,70879,465
2022-10-28,70040,70054,Blue,1,67438,68230,792
2022-07-10,70044,70056,Blue,1,84132,84900,768
2022-02-17,70053,70039,Blue,0,76339,77103,764
2022-11-10,70042,70054,Blue,1,88376,89066,690
2022-07-02,70055,70039,Blue,0,51027,51899,872
2022-11-11,70052,70056,Blue,1,34968,35116,148
2022-04-11,70055,70838,Blue,0,25656,26670,1014
2022-10-27,70049,70041,Blue,0,24748,25175,427
2022-10-28,70048,70060,Blue,1,66891,67517,626
2022-09-18,70043,70039,Blue,0,34097,34194,97
2022-09-22,70053,70049,Blue,0,29158,29374,216
2022-07-28,70049,70043,Blue,0,71199,71531,332
2022-09-10,70059,70045,Blue,0,58398,59137,739
2022-06-09,70048,70052,Blue,1,87655,87931,276
2022-09-21,70050,70056,Blue,1,85535,85822,287
2022-06-23,70052,70056,Blue,1,28662,28825,163
2022-02-07,70052,70060,Blue,1,24970,25538,568
2022-02-22,70046,70054,Blue,1,65012,65412,400
2022-03-07,70044,70052,Blue,1,62388,62884,496
2022-03-13,70049,70047,Blue,0,57030,57090,60
2022-06-11,70040,70054,Blue,1,56762,57664,902
2022-11-06,70046,70054,Blue,1,79517,79941,424
2022-11-19,70042,70054,Blue,1,87463,88145,682
2022-10-02,70053,70045,Blue,0,81913,82441,528
2022-03-20,70048,70058,Blue,1,79582,80136,554
2022-02-18,70047,70045,Blue,0,80059,80177,118
2022-03-20,70053,70047,Blue,0,29497,29781,284
2022-09-20,70040,70048,Blue,1,43162,43568,406
2022-09-27,70047,70041,Blue,0,65613,65918,305
2022-04-16,70059,70051,Blue,0,47055,47370,315
2022-08-07,70048,70050,Blue,1,58543,58603,60
2022-04-04,70059,70838,Blue,0,33256,34375,1119
2022-08-07,70056,70058,Blue,1,82057,82134,77
2022-01-24,70055,70051,Blue,0,31346,31482,136
2022-12-01,70054,70058,Blue,1,69366,69523,157
2022-04-12,70049,70838,Blue,0,80012,80640,628
2022-04-19,70040,70042,Blue,1,54871,54905,34
2022-06-27,70057,70053,Blue,0,71318,71470,152
2022-07-05,70059,70053,Blue,0,63673,63890,217
2022-12-02,70044,70056,Blue,1,26676,27359,683
2022-11-21,70055,70053,Blue,0,21950,21996,46
2022-06-21,70050,70058,Blue,1,25887,26694,807
2022-03-08,70044,70048,Blue,1,44885,45133,248
2022-10-31,70039,70838,Blue,0,31292,31329,37
2022-06-14,70049,70043,Blue,0,72506,72873,367
2022-05-04,70050,70054,Blue,1,29861,30094,233
2022-03-27,70044,70054,Blue,1,64200,64776,576
2022-10-04,70049,70041,Blue,0,63680,64150,470
2022-11-13,70038,70054,Blue,1,72613,73381,768
2022-05-22,70045,70043,Blue,0,27760,27915,155
2022-12-23,70042,70052,Blue,1,63412,64051,639
2022-02-04,70052,70054,Blue,1,89878,89934,56
2022-04-04,70048,70050,Blue,1,64546,64602,56
2022-09-02,70045,70039,Blue,0,29663,29926,263
2022-11-02,70046,70054,Blue,1,42704,43126,422
2022-10-02,70049,70045,Blue,0,77029,77221,192
2022-06-20,70047,70045,Blue,0,33724,33821,97
2022-09-30,70045,70838,Blue,0,79104,79489,385
2022-04-13,70044,70058,Blue,1,55703,56579,876
2022-07-27,70057,70055,Blue,0,66088,66157,69
2022-02-03,70043,70039,Blue,0,37576,37686,110
2022-09-13,70038,70046,Blue,1,23618,23925,307
2022-01-15,70051,70049,Blue,0,54463,54566,103
2022-12-21,70048,70050,Blue,1,63976,64031,55
2022-03-15,70040,70054,Blue,1,86603,87363,760
2022-12-05,70051,70043,Blue,0,62754,63198,444
2022-10-12,70040,70052,Blue,1,23445,24092,647
2022-07-28,70053,70051,Blue,0,80753,80812,59
2022-04-06,70053,70041,Blue,0,47915,48554,639
2022-08-14,70053,70045,Blue,0,35137,35579,442
2022-04-23,70045,70041,Blue,0,58620,58789,169
2022-10-13,70038,70046,Blue,1,53652,53942,290
2022-09-26,70046,70048,Blue,1,41384,41468,84
2022-10-01,70054,70058,Blue,1,49512,49663,151
2022-02-10,70038,70040,Blue,1,28814,28829,15
2022-06-20,70051,70041,Blue,0,47163,47771,608
2022-04-10,70046,70060,Blue,1,79476,80167,691
2022-08-27,70049,70045,Blue,0,82104,82301,197
2022-12-30,70042,70048,Blue,1,28169,28490,321
2022-11-07,70046,70056,Blue,1,50398,50921,523
2022-06-27,70048,70052,Blue,1,86236,86448,212
2022-02-09,70040,70044,Blue,1,34221,34332,111
2022-08-01,70038,70048,Blue,1,61460,61970,510
2022-10-27,70038,70044,Blue,1,86657,86827,170
2022-03-24,70055,70043,Blue,0,25648,26423,775
2022-11-21,70052,70060,Blue,1,33110,33482,372
2022-03-30,70049,70039,Blue,0,53043,53559,516
2022-01-28,70045,70041,Blue,0,27248,27468,220
2022-12-16,70042,70056,Blue,1,74316,75040,724
2022-06-11,70053,70041,Blue,0,71617,72304,687
2022-08-18,70048,70052,Blue,1,71393,71614,221
2022-02-04,70053,70043,Blue,0,31220,31883,663
2022-06-30,70050,70054,Blue,1,38417,38781,364
2022-10-08,70059,70057,Blue,0,51372,51407,35
2022-02-10,70038,70048,Blue,1,29978,30420,442
2022-07-27,70051,70039,Blue,0,23804,24549,745
2022-07-22,70044,70058,Blue,1,38748,39556,808
2022-02-28,70053,70047,Blue,0,21622,21913,291
2022-09-11,70055,70051,Blue,0,75632,75787,155
2022-04-07,70046,70060,Blue,1,86933,87687,754
2022-05-21,70040,70056,Blue,1,69494,70403,909
2022-09-09,70057,70043,Blue,0,55718,56533,815
2022-03-25,70046,70048,Blue,1,25004,25094,90
2022-07-22,70047,70043,Blue,0,49192,49450,258
2022-06-16,70040,70046,Blue,1,79897,80199,302
2022-09-03,70038,70052,Blue,1,19902,20580,678
2022-08-19,70055,70053,Blue,0,50176,50222,46
2022-09-03,70057,70053,Blue,0,88277,88424,147
2022-07-26,70040,70042,Blue,1,70339,70373,34
2022-01-20,70046,70056,Blue,1,65570,66070,500
2022-02-09,70048,70056,Blue,1,44013,44432,419
2022-09-01,70038,70048,Blue,1,58092,58651,559
2022-11-05,70038,70056,Blue,1,31280,32187,907
2022-01-03,70055,70041,Blue,0,36554,37280,726
2022-07-13,70054,70060,Blue,1,87296,87589,293
2022-07-04,70057,70039,Blue,0,78339,79333,994
2022-07-28,70038,70060,Blue,1,26471,27602,1131
2022-03-09,70053,70039,Blue,0,62289,63062,773
2022-05-24,70038,70052,Blue,1,67033,67927,894
2022-07-16,70040,70060,Blue,1,69182,70265,1083
2022-01-04,70057,70047,Blue,0,27327,27782,455
2022-12-16,70051,70041,Blue,0,24727,25513,786
2022-08-08,70045,70041,Blue,0,87414,87621,207
2022-03-08,70053,70051,Blue,0,48466,48516,50
2022-05-01,70051,70049,Blue,0,30998,31105,107
2022-11-28,70048,70052,Blue,1,84079,84283,204
2022-06-27,70053,70051,Blue,0,25479,25540,61
2022-08-12,70038,70052,Blue,1,75202,75976,774
2022-03-18,70058,70060,Blue,1,55389,55606,217
2022-12-16,70040,70044,Blue,1,53419,53532,113
2022-03-25,70042,70052,Blue,1,62421,63090,669
2022-04-13,70048,70058,Blue,1,76899,77405,506
2022-02-21,70051,70039,Blue,0,71721,72368,647
2022-12-13,70052,70058,Blue,1,75504,75772,268
2022-10-18,70042,70044,Blue,1,77480,77506,26
2022-08-30,70044,70054,Blue,1,60878,61459,581
2022-12-04,70042,70044,Blue,1,79890,79917,27
2022-04-10,70058,70060,Blue,1,59134,59200,66
2022-08-11,70055,70051,Blue,0,29482,29619,137
2022-06-14,70040,70058,Blue,1,84948,85913,965
2022-08-23,70041,70039,Blue,0,34970,35012,42
2022-10-22,70053,70039,Blue,0,19799,20569,770
2022-05-01,70059,70053,Blue,0,44488,44727,239
2022-11-01,70055,70047,Blue,0,59479,59837,358
2022-09-09,70053,70049,Blue,0,34201,34394,193
2022-10-09,70059,70045,Blue,0,40152,40848,696
2022-08-27,70040,70054,Blue,1,52942,53725,783
2022-06-24,70058,70060,Blue,1,28705,28802,97
2022-01-19,70046,70056,Blue,1,54173,54776,603
2022-02-13,70055,70047,Blue,0,61573,61951,378
2022-10-31,70040,70042,Blue,1,21513,21550,37
2022-12-12,70047,70838,Blue,0,73508,74009,501
2022-04-22,70041,70838,Blue,0,24433,24590,157
2022-02-11,70040,70050,Blue,1,59313,59776,463
2022-09-25,70051,70041,Blue,0,79141,79757,616
2022-09-18,70051,70838,Blue,0,74797,75537,740
2022-02-04,70055,70053,Blue,0,66086,66148,62
2022-04-18,70038,70040,Blue,1,58626,58640,14
2022-04-07,70042,70050,Blue,1,30393,30825,432
2022-07-10,70057,70039,Blue,0,39575,40578,1003
2022-03-30,70051,70838,Blue,0,22056,22864,808
2022-03-17,70047,70039,Blue,0,26755,27189,434
2022-07-13,70055,70043,Blue,0,38552,39290,738
2022-08-01,70045,70838,Blue,0,23241,23635,394
2022-10-27,70048,70052,Blue,1,62031,62248,217
2022-11-17,70040,70052,Blue,1,65913,66551,638
2022-10-06,70053,70039,Blue,0,61710,62538,828
2022-08-06,70053,70838,Blue,0,33316,34233,917
2022-10-14,70038,70050,Blue,1,57140,57720,580
2022-06-29,70059,70047,Blue,0,63767,64337,570
2022-01-12,70055,70043,Blue,0,81377,82073,696
2022-04-15,70048,70060,Blue,1,88251,88880,629
2022-01-26,70047,70045,Blue,0,63612,63704,92
2022-12-11,70059,70047,Blue,0,46821,47380,559
2022-06-29,70050,70060,Blue,1,57633,58218,585
2022-08-08,70046,70054,Blue,1,65215,65644,429
2022-04-06,70052,70058,Blue,1,29436,29687,251
2022-05-26,70038,70046,Blue,1,34932,35278,346
2022-03-08,70057,70055,Blue,0,71607,71676,69
2022-03-15,70038,70040,Blue,1,28993,29015,22
2022-12-13,70042,70050,Blue,1,32105,32506,401
2022-02-18,70055,70043,Blue,0,67718,68357,639
2022-09-14,70048,70054,Blue,1,48143,48475,332
2022-12-25,70039,70838,Blue,0,32586,32618,32
2022-05-31,70044,70050,Blue,1,38709,39108,399
2022-02-07,70055,70041,Blue,0,75668,76425,757
2022-10-26,70045,70838,Blue,0,44603,44932,329
2022-07-16,70040,70060,Blue,1,30242,31224,982
2022-07-23,70042,70052,Blue,1,59042,59605,563
2022-03-14,70051,70045,Blue,0,22075,22442,367
2022-02-23,70042,70052,Blue,1,73209,73791,582
2022-11-18,70039,70838,Blue,0,80713,80749,36
2022-01-05,70049,70047,Blue,0,43181,43240,59
2022-10-30,70053,70045,Blue,0,75164,75584,420
2022-04-09,70045,70043,Blue,0,46778,46872,94
2022-12-03,70044,70054,Blue,1,79503,80088,585
2022-11-25,70053,70047,Blue,0,83960,84241,281
2022-11-05,70048,70056,Blue,1,35059,35470,411
2022-01-11,70044,70058,Blue,1,22984,23887,903
2022-02-28,70059,70049,Blue,0,53592,54042,450
2022-07-14,70059,70055,Blue,0,19936,20082,146
2022-08-18,70038,70042,Blue,1,78284,78366,82
2022-08-18,70046,70050,Blue,1,42968,43154,186
2022-01-07,70042,70052,Blue,1,56530,57150,620
2022-12-24,70046,70054,Blue,1,53263,53712,449
2022-03-03,70049,70043,Blue,0,67291,67638,347
2022-08-18,70055,70047,Blue,0,35086,35519,433
2022-06-13,70045,70041,Blue,0,72254,72454,200
2022-01-27,70059,70838,Blue,0,23970,25283,1313
2022-03-19,70053,70051,Blue,0,66227,66287,60
2022-01-26,70052,70054,Blue,1,27133,27192,59
2022-02-25,70043,70039,Blue,0,59468,59580,112
2022-06-10,70042,70058,Blue,1,60117,61571,1454
2022-12-19,70046,70052,Blue,1,60910,61252,342
2022-11-21,70048,70056,Blue,1,58741,59248,507
2022-01-08,70038,70046,Blue,1,47475,47815,340
2022-12-10,70050,70054,Blue,1,84538,84742,204
2022-09-16,70057,70043,Blue,0,50493,51227,734
2022-07-30,70054,70056,Blue,1,71023,71069,46
2022-12-13,70052,70054,Blue,1,26886,26984,98
2022-05-19,70055,70047,Blue,0,65780,66158,378
2022-12-12,70048,70052,Blue,1,21921,22154,233
2022-02-14,70044,70048,Blue,1,75032,75268,236
2022-02-13,70042,70048,Blue,1,24781,25083,302
2022-02-14,70046,70052,Blue,1,26122,26481,359
2022-12-19,70040,70052,Blue,1,21038,21630,592
2022-01-11,70040,70050,Blue,1,69489,70017,528
2022-07-09,70051,70039,Blue,0,85234,85882,648
2022-01-12,70044,70056,Blue,1,64052,64837,785
2022-04-20,70049,70041,Blue,0,28351,28753,402
2022-03-27,70048,70050,Blue,1,38211,38269,58
2022-09-01,70049,70045,Blue,0,24363,24554,191
2022-01-22,70048,70054,Blue,1,29087,29404,317
2022-12-15,70051,70049,Blue,0,28784,28921,137
2022-10-24,70043,70838,Blue,0,46623,46816,193
2022-08-18,70059,70039,Blue,0,74990,76150,1160
2022-11-23,70056,70058,Blue,1,74512,74584,72
2022-11-08,70043,70039,Blue,0,65974,66088,114
2022-03-21,70046,70048,Blue,1,60351,60434,83
2022-09-07,70040,70050,Blue,1,82716,83255,539
2022-02-22,70044,70046,Blue,1,45084,45190,106
2022-08-18,70038,70046,Blue,1,72413,72747,334
2022-08-08,70050,70060,Blue,1,84129,84664,535
2022-09-01,70059,70039,Blue,0,26783,27861,1078
2022-02-02,70048,70058,Blue,1,39914,40548,634
2022-09-14,70048,70052,Blue,1,75269,75483,214
2022-01-03,70048,70050,Blue,1,46841,46895,54
2022-02-01,70040,70060,Blue,1,24585,25736,1151
2022-03-15,70051,70838,Blue,0,45906,46650,744
2022-12-15,70046,70050,Blue,1,73987,74151,164
2022-06-23,70046,70052,Blue,1,53022,53436,414
2022-10-01,70042,70044,Blue,1,31424,31452,28
2022-11-22,70046,70056,Blue,1,39723,40292,569
2022-07-08,70043,70838,Blue,0,44533,44758,225
2022-01-28,70057,70049,Blue,0,25883,26335,452
2022-03-17,70059,70051,Blue,0,66734,67062,328
2022-05-24,70045,70043,Blue,0,66251,66408,157
2022-01-28,70038,70056,Blue,1,65827,66826,999
2022-02-19,70038,70046,Blue,1,63666,64021,355
2022-05-10,70056,70060,Blue,1,63422,63627,205
2022-03-18,70049,70043,Blue,0,30743,31104,361
2022-07-01,70041,70838,Blue,0,27839,27968,129
2022-03-22,70056,70060,Blue,1,30149,31529,1380
2022-10-24,70041,70039,Blue,0,23035,23067,32
2022-01-03,70051,70047,Blue,0,85561,85765,204
2022-06-13,70050,70052,Blue,1,56564,56920,356
2022-06-26,70059,70045,Blue,0,24793,25506,713
2022-10-06,70053,70047,Blue,0,20212,20509,297
2022-04-14,70055,70049,Blue,0,21156,21467,311
2022-10-16,70043,70838,Blue,0,27037,27222,185
2022-07-29,70053,70039,Blue,0,51758,52500,742
2022-01-21,70057,70047,Blue,0,33344,33846,502
2022-10-18,70042,70046,Blue,1,38973,39150,177
2022-09-30,70047,70838,Blue,0,53207,53735,528
2022-09-02,70046,70054,Blue,1,23955,24422,467
2022-08-12,70042,70054,Blue,1,22507,23194,687
2022-12-18,70043,70039,Blue,0,74701,74807,106
2022-12-21,70053,70039,Blue,0,77740,78502,762
2022-09-03,70052,70056,Blue,1,52096,52235,139
2022-09-07,70042,70054,Blue,1,26257,26923,666
2022-09-27,70045,70838,Blue,0,73005,73354,349
2022-12-02,70049,70043,Blue,0,38922,39272,350
2022-11-29,70038,70052,Blue,1,29834,30553,719
2022-09-28,70057,70041,Blue,0,43785,44689,904
2022-09-08,70047,70045,Blue,0,21011,21109,98
2022-12-10,70042,70046,Blue,1,65449,65624,175
2022-11-06,70046,70060,Blue,1,48145,48856,711
2022-12-26,70044,70054,Blue,1,41945,42539,594
2022-03-27,70059,70041,Blue,0,46815,47685,870
2022-12-17,70059,70041,Blue,0,77279,78156,877
2022-11-05,70053,70051,Blue,0,58661,58707,46
2022-11-28,70042,70044,Blue,1,30383,30412,29
2022-10-01,70050,70060,Blue,1,72380,72898,518
2022-03-30,70057,70051,Blue,0,33026,33277,251
2022-01-12,70057,70055,Blue,0,21036,21112,76
2022-02-24,70057,70049,Blue,0,32734,33164,430
2022-01-03,70047,70045,Blue,0,75285,75377,92
2022-08-02,70048,70058,Blue,1,46919,47439,520
2022-09-16,70054,70058,Blue,1,69981,70149,168
2022-03-13,70057,70053,Blue,0,86484,86794,310
2022-09-30,70044,70048,Blue,1,60358,60586,228
2022-07-09,70044,70052,Blue,1,68219,68773,554
2022-02-14,70046,70056,Blue,1,20881,21449,568
2022-03-05,70056,70058,Blue,1,78184,78253,69
2022-04-11,70044,70050,Blue,1,26917,27269,352
2022-01-10,70038,70060,Blue,1,44647,45697,1050
2022-08-10,70040,70046,Blue,1,40670,40947,277
2022-04-20,70042,70050,Blue,1,24791,25210,419
2022-05-27,70046,70052,Blue,1,30052,30525,473
2022-07-20,70049,70045,Blue,0,43160,43389,229
2022-10-27,70040,70056,Blue,1,77639,78543,904
2022-12-03,70048,70058,Blue,1,60846,61425,579
2022-08-29,70050,70058,Blue,1,22599,22993,394
2022-03-17,70053,70838,Blue,0,29343,30241,898
2022-03-02,70042,70058,Blue,1,34609,35595,986
2022-07-20,70051,70043,Blue,0,28419,28946,527
2022-02-04,70046,70048,Blue,1,34288,34378,90
2022-09-08,70055,70043,Blue,0,81438,82113,675
2022-01-05,70044,70054,Blue,1,61556,62159,603
2022-03-25,70038,70058,Blue,1,48679,49726,1047
2022-10-01,70055,70049,Blue,0,25628,25903,275
2022-02-23,70052,70060,Blue,1,85027,85384,357
2022-02-26,70043,70039,Blue,0,45215,45318,103
2022-12-31,70059,70045,Blue,0,90126,90858,732
2022-06-11,70059,70055,Blue,0,77776,77921,145
2022-03-08,70054,70060,Blue,1,82841,83194,353
2022-01-02,70040,70052,Blue,1,59718,60454,736
2022-02-12,70038,70048,Blue,1,81423,81921,498
2022-02-14,70052,70054,Blue,1,89899,89945,46
2022-09-29,70055,70053,Blue,0,66212,66259,47
2022-04-15,70043,70039,Blue,0,77444,77553,109
2022-10-05,70044,70054,Blue,1,31327,31916,589
2022-02-19,70042,70050,Blue,1,58979,59405,426
2022-11-22,70038,70054,Blue,1,39868,40780,912
2022-09-15,70044,70060,Blue,1,26396,27388,992
2022-04-10,70058,70060,Blue,1,73188,73261,73
2022-11-17,70057,70041,Blue,0,30214,31107,893
2022-09-27,70051,70043,Blue,0,31352,31869,517
2022-11-21,70052,70056,Blue,1,36768,36913,145
2022-07-31,70040,70050,Blue,1,40432,40968,536
2022-12-03,70049,70039,Blue,0,81153,81657,504
2022-12-22,70053,70041,Blue,0,26524,27227,703
2022-01-14,70052,70060,Blue,1,64007,64365,358
2022-04-05,70051,70041,Blue,0,74161,74793,632
2022-03-12,70050,70058,Blue,1,51896,52348,452
2022-11-27,70051,70039,Blue,0,79287,79931,644
2022-02-11,70050,70056,Blue,1,20949,21245,296
2022-10-15,70059,70053,Blue,0,44910,45146,236
2022-08-20,70040,70044,Blue,1,44343,44470,127
2022-06-21,70053,70051,Blue,0,57578,57639,61
2022-12-17,70051,70045,Blue,0,27469,27830,361
2022-03-11,70048,70054,Blue,1,52637,52939,302
2022-09-16,70053,70041,Blue,0,26643,27394,751
2022-07-02,70055,70049,Blue,0,69914,70200,286
2022-06-23,70050,70060,Blue,1,76733,77301,568
2022-11-25,70044,70046,Blue,1,30048,30154,106
2022-05-31,70047,70039,Blue,0,61222,61738,516
2022-01-30,70059,70041,Blue,0,72478,74019,1541
2022-10-08,70045,70043,Blue,0,39696,39795,99
2022-01-31,70042,70044,Blue,1,63085,63114,29
2022-12-17,70055,70051,Blue,0,66713,66843,130
2022-12-23,70046,70052,Blue,1,32711,33057,346
2022-03-11,70051,70039,Blue,0,34315,35107,792
2022-08-20,70059,70057,Blue,0,48699,48734,35
2022-04-13,70038,70040,Blue,1,40194,40209,15
2022-01-31,70055,70053,Blue,0,27351,27427,76
2022-06-20,70048,70052,Blue,1,62625,62838,213
2022-10-16,70045,70043,Blue,0,65392,65484,92
2022-07-07,70052,70058,Blue,1,41416,41702,286
2022-04-06,70051,70049,Blue,0,27615,27721,106
2022-09-17,70046,70052,Blue,1,57762,58104,342
2022-07-07,70046,70056,Blue,1,60250,60819,569
2022-04-15,70040,70046,Blue,1,52915,53199,284
2022-08-26,70059,70041,Blue,0,26778,27721,943
2022-07-04,70059,70057,Blue,0,47595,47630,35
2022-06-10,70040,70044,Blue,1,42805,42936,131
2022-12-28,70050,70060,Blue,1,61854,62415,561
2022-07-28,70045,70039,Blue,0,42379,42647,268
2022-09-12,70050,70058,Blue,1,86263,86654,391
2022-12-31,70051,70043,Blue,0,39916,40402,486
2022-01-13,70044,70056,Blue,1,60635,61495,860
2022-03-04,70055,70053,Blue,0,59178,59223,45
2022-03-07,70048,70060,Blue,1,66712,67422,710
2022-08-27,70050,70058,Blue,1,86467,86945,478
2022-06-12,70048,70050,Blue,1,44824,44883,59
2022-01-07,70040,70044,Blue,1,65600,65720,120
2022-08-11,70040,70056,Blue,1,53050,53961,911
2022-02-23,70038,70046,Blue,1,73046,73385,339
2022-09-08,70040,70042,Blue,1,46795,46827,32
2022-10-31,70045,70838,Blue,0,24026,24380,354
2022-08-05,70049,70041,Blue,0,43160,43546,386
2022-09-02,70050,70054,Blue,1,61766,61980,214
2022-10-11,70042,70048,Blue,1,62483,62822,339
2022-07-16,70056,70058,Blue,1,73263,73335,72
2022-11-25,70057,70055,Blue,0,70311,70381,70
2022-10-12,70038,70040,Blue,1,44956,44971,15
2022-08-03,70046,70052,Blue,1,67330,67673,343
2022-12-20,70041,70039,Blue,0,52433,52464,31
2022-01-17,70059,70039,Blue,0,35716,36720,1004
2022-10-10,70044,70054,Blue,1,49534,50126,592
2022-11-22,70045,70041,Blue,0,25797,25973,176
2022-09-06,70041,70838,Blue,0,25317,25443,126
2022-08-12,70048,70060,Blue,1,66144,66923,779
2022-08-29,70042,70048,Blue,1,53015,53309,294
2022-10-13,70055,70047,Blue,0,30754,31128,374
2022-08-18,70059,70051,Blue,0,30145,30478,333
2022-09-20,70059,70053,Blue,0,31783,32016,233
2022-01-18,70042,70046,Blue,1,21197,21487,290
2022-09-22,70053,70043,Blue,0,21815,22441,626
2022-08-08,70049,70838,Blue,0,34470,35160,690
2022-08-04,70040,70044,Blue,1,46245,46359,114
2022-03-28,70052,70056,Blue,1,61198,61329,131
2022-08-24,70040,70052,Blue,1,54422,55140,718
2022-07-18,70055,70041,Blue,0,70931,71673,742
2022-03-18,70038,70060,Blue,1,25786,27480,1694
2022-02-21,70057,70047,Blue,0,44436,44991,555
2022-02-17,70055,70049,Blue,0,65475,65790,315
2022-04-20,70038,70044,Blue,1,30261,30448,187
2022-02-01,70057,70047,Blue,0,22860,23628,768
2022-03-01,70044,70054,Blue,1,27185,27792,607
2022-05-16,70059,70053,Blue,0,24278,24516,238
2022-10-04,70040,70046,Blue,1,30003,30290,287
2022-07-21,70051,70045,Blue,0,37320,37676,356
2022-12-14,70057,70053,Blue,0,33572,33724,152
2022-02-25,70052,70056,Blue,1,25871,26028,157
2022-06-29,70057,70055,Blue,0,63844,63914,70
2022-01-17,70043,70039,Blue,0,83173,83271,98
2022-02-20,70040,70050,Blue,1,61345,61846,501
2022-06-19,70059,70053,Blue,0,30853,31090,237
2022-05-13,70052,70056,Blue,1,57076,57209,133
2022-04-17,70042,70058,Blue,1,60349,61219,870
2022-06-03,70044,70052,Blue,1,77658,78254,596
2022-03-05,70042,70048,Blue,1,71418,71757,339
2022-04-06,70042,70060,Blue,1,29215,30203,988
2022-11-28,70045,70041,Blue,0,24138,24321,183
2022-12-24,70040,70058,Blue,1,31452,32339,887
2022-03-27,70040,70056,Blue,1,55937,56779,842
2022-03-23,70042,70044,Blue,1,82744,82772,28
2022-03-05,70038,70056,Blue,1,62055,63009,954
2022-02-14,70055,70045,Blue,0,63674,64218,544
2022-12-10,70040,70046,Blue,1,70762,71012,250
2022-07-24,70049,70041,Blue,0,54361,54792,431
2022-09-15,70054,70056,Blue,1,78327,78373,46
2022-05-19,70052,70056,Blue,1,29737,29911,174
2022-04-19,70046,70052,Blue,1,41702,42063,361
2022-12-05,70056,70058,Blue,1,24093,24165,72
2022-08-09,70051,70043,Blue,0,26753,27273,520
2022-09-20,70049,70047,Blue,0,82511,82566,55
2022-09-05,70047,70039,Blue,0,57664,58074,410
2022-01-16,70051,70049,Blue,0,80649,80753,104
2022-02-24,70053,70043,Blue,0,30601,31234,633
2022-03-03,70045,70043,Blue,0,28332,28435,103
2022-04-05,70055,70053,Blue,0,68044,68091,47
2022-05-31,70038,70050,Blue,1,52646,53369,723
2022-12-22,70043,70838,Blue,0,63313,63497,184
2022-10-14,70055,70838,Blue,0,62612,63540,928
2022-03-10,70040,70048,Blue,1,66209,66599,390
2022-12-19,70051,70041,Blue,0,45844,46718,874
2022-04-08,70046,70048,Blue,1,47289,47387,98
2022-08-01,70038,70054,Blue,1,63794,64639,845
2022-08-18,70048,70050,Blue,1,55672,55732,60
2022-04-14,70048,70058,Blue,1,73049,73556,507
2022-06-27,70046,70048,Blue,1,26356,26471,115
2022-02-03,70054,70058,Blue,1,29970,30176,206
2022-03-19,70049,70043,Blue,0,85386,85707,321
2022-07-25,70058,70060,Blue,1,30601,30672,71
2022-07-02,70057,70045,Blue,0,27158,27782,624
2022-09-06,70046,70058,Blue,1,62809,63439,630
2022-07-03,70050,70060,Blue,1,77051,77597,546
2022-12-22,70042,70060,Blue,1,29960,31017,1057
2022-02-07,70040,70050,Blue,1,53580,54144,564
2022-09-09,70055,70039,Blue,0,43904,44773,869
2022-12-30,70045,70041,Blue,0,25577,25736,159
2022-03-09,70047,70039,Blue,0,35343,35778,435
2022-03-25,70046,70054,Blue,1,58798,59359,561
2022-10-03,70059,70051,Blue,0,44780,45111,331
2022-03-17,70054,70060,Blue,1,34072,34412,340
2022-03-09,70050,70052,Blue,1,54278,54397,119
2022-03-10,70057,70053,Blue,0,63868,64018,150
2022-04-18,70051,70838,Blue,0,71334,72137,803
2022-07-05,70059,70045,Blue,0,30973,31663,690
2022-08-16,70055,70049,Blue,0,31609,31916,307
2022-01-08,70059,70039,Blue,0,55162,56125,963
2022-04-19,70042,70048,Blue,1,90919,91233,314
2022-10-25,70040,70048,Blue,1,89179,89589,410
2022-03-02,70052,70056,Blue,1,30246,30389,143
2022-05-26,70045,70041,Blue,0,66120,66320,200
2022-03-27,70051,70838,Blue,0,78664,79410,746
2022-11-09,70047,70041,Blue,0,62997,63318,321
2022-12-10,70038,70058,Blue,1,32356,33380,1024
2022-04-01,70057,70049,Blue,0,19977,20369,392
2022-08-14,70046,70054,Blue,1,71911,72362,451
2022-04-14,70050,70058,Blue,1,46261,46699,438
2022-12-27,70040,70044,Blue,1,20945,21049,104
2022-08-27,70059,70047,Blue,0,68657,69207,550
2022-04-07,70046,70052,Blue,1,37708,38056,348
2022-06-04,70045,70041,Blue,0,49350,49567,217
2022-04-17,70057,70051,Blue,0,83858,84101,243
2022-06-21,70050,70052,Blue,1,36642,36767,125
2022-10-19,70043,70041,Blue,0,30294,30323,29
2022-07-18,70047,70041,Blue,0,56982,57349,367
2022-03-11,70044,70052,Blue,1,64506,65009,503
2022-02-25,70051,70041,Blue,0,79346,79879,533
2022-10-01,70053,70049,Blue,0,62798,63017,219
2022-10-18,70038,70046,Blue,1,47263,47581,318
2022-11-11,70057,70053,Blue,0,69762,69942,180
2022-08-05,70038,70050,Blue,1,73068,73609,541
2022-06-20,70055,70039,Blue,0,23745,24608,863
2022-10-23,70040,70054,Blue,1,39070,39764,694
2022-12-12,70059,70838,Blue,0,54074,55205,1131
2022-10-23,70041,70838,Blue,0,56521,56638,117
2022-10-13,70059,70043,Blue,0,62896,63821,925
2022-02-10,70040,70046,Blue,1,33006,33255,249
2022-07-27,70059,70043,Blue,0,27198,28112,914
2022-09-11,70050,70060,Blue,1,73191,73703,512
2022-01-31,70046,70054,Blue,1,49467,49974,507
2022-02-06,70047,70043,Blue,0,48008,48301,293
2022-09-28,70040,70044,Blue,1,37806,37913,107
2022-07-14,70050,70058,Blue,1,58592,59022,430
2022-06-17,70038,70058,Blue,1,24892,25985,1093
2022-11-03,70044,70060,Blue,1,60264,61224,960
2022-04-04,70038,70056,Blue,1,23062,23979,917
2022-11-27,70059,70838,Blue,0,72736,73905,1169
2022-07-05,70058,70060,Blue,1,78109,78180,71
2022-03-10,70042,70060,Blue,1,52929,54016,1087
2022-08-24,70053,70041,Blue,0,65515,66488,973
2022-05-18,70057,70053,Blue,0,47378,47529,151
2022-07-25,70045,70043,Blue,0,65157,65262,105
2022-02-21,70059,70049,Blue,0,65421,65974,553
2022-06-22,70055,70049,Blue,0,33706,34025,319
2022-09-14,70055,70045,Blue,0,68299,68808,509
2022-08-19,70048,70050,Blue,1,30776,30852,76
2022-04-22,70038,70052,Blue,1,40319,41133,814
2022-11-01,70042,70052,Blue,1,40553,41136,583
2022-01-12,70059,70043,Blue,0,63802,64588,786
2022-12-01,70048,70056,Blue,1,50223,50603,380
2022-01-15,70042,70054,Blue,1,40065,40732,667
2022-09-07,70055,70051,Blue,0,84368,84507,139
2022-12-03,70048,70056,Blue,1,71736,72145,409
2022-07-31,70059,70053,Blue,0,43457,43677,220
2022-12-14,70059,70053,Blue,0,61882,62114,232
2022-05-18,70045,70838,Blue,0,22745,23139,394
2022-04-06,70044,70050,Blue,1,58473,58867,394
2022-12-13,70038,70042,Blue,1,62294,62390,96
2022-12-05,70042,70050,Blue,1,73841,74262,421
2022-07-11,70059,70041,Blue,0,60879,61832,953
2022-04-19,70038,70056,Blue,1,33553,34499,946
2022-09-14,70055,70049,Blue,0,36544,36821,277
2022-11-21,70053,70043,Blue,0,87578,88137,559
2022-03-28,70038,70054,Blue,1,50294,51096,802
2022-03-02,70057,70055,Blue,0,65374,65444,70
2022-02-06,70040,70044,Blue,1,65200,65317,117
2022-09-28,70049,70039,Blue,0,26740,27489,749
2022-01-25,70059,70838,Blue,0,61093,62184,1091
2022-10-07,70047,70043,Blue,0,65269,65510,241
2022-01-17,70040,70044,Blue,1,55104,55221,117
2022-08-17,70057,70041,Blue,0,30484,31428,944
2022-11-08,70043,70838,Blue,0,82978,83165,187
2022-03-21,70038,70046,Blue,1,38553,38889,336
2022-09-06,70055,70838,Blue,0,33683,34687,1004
2022-11-05,70042,70052,Blue,1,45462,46034,572
2022-04-20,70046,70052,Blue,1,68347,68712,365
2022-01-24,70053,70051,Blue,0,31133,31182,49
2022-12-31,70042,70044,Blue,1,88447,88481,34
2022-07-21,70048,70056,Blue,1,87214,87666,452
2022-09-20,70053,70041,Blue,0,58761,59399,638
2022-03-25,70057,70039,Blue,0,64514,65391,877
2022-08-30,70052,70056,Blue,1,28065,28212,147
2022-08-16,70051,70838,Blue,0,43294,44104,810
2022-09-20,70059,70047,Blue,0,42606,43259,653
2022-02-06,70043,70838,Blue,0,24105,24300,195
2022-10-26,70048,70056,Blue,1,68962,69358,396
2022-06-27,70050,70054,Blue,1,22880,23122,242
2022-10-30,70044,70048,Blue,1,60459,60696,237
2022-07-12,70045,70838,Blue,0,25896,26267,371
2022-11-17,70038,70040,Blue,1,74161,74177,16
2022-08-15,70047,70043,Blue,0,75998,76240,242
2022-02-08,70059,70043,Blue,0,33936,34817,881
2022-01-25,70042,70060,Blue,1,63895,64936,1041
2022-10-04,70059,70055,Blue,0,57193,57336,143
2022-06-10,70053,70039,Blue,0,62637,63432,795
2022-10-30,70042,70054,Blue,1,59267,59926,659
2022-12-03,70044,70050,Blue,1,23399,23737,338
2022-08-31,70049,70838,Blue,0,46226,46850,624
2022-10-11,70051,70049,Blue,0,46268,46372,104
2022-06-21,70056,70060,Blue,1,35818,36007,189
2022-12-15,70048,70054,Blue,1,44161,44503,342
2022-03-14,70047,70041,Blue,0,74438,74744,306
2022-08-19,70047,70039,Blue,0,19063,19523,460
2022-01-28,70051,70039,Blue,0,40255,40911,656
2022-11-15,70051,70047,Blue,0,57834,58025,191
2022-11-03,70046,70054,Blue,1,78325,78758,433
2022-08-18,70051,70049,Blue,0,28828,28929,101
2022-02-15,70058,70060,Blue,1,26058,26158,100
2022-04-05,70049,70041,Blue,0,22953,23427,474
2022-07-27,70047,70041,Blue,0,45287,45621,334
2022-10-31,70057,70055,Blue,0,70288,70356,68
2022-03-25,70050,70054,Blue,1,23672,23880,208
2022-05-27,70038,70046,Blue,1,29598,29998,400
2022-04-07,70057,70039,Blue,0,27939,28849,910
2022-07-27,70038,70052,Blue,1,23691,24558,867
2022-05-27,70038,70044,Blue,1,77428,77598,170
2022-11-08,70052,70054,Blue,1,65058,65107,49
2022-09-24,70042,70050,Blue,1,23844,24266,422
2022-12-27,70059,70043,Blue,0,75157,75987,830
2022-06-03,70045,70041,Blue,0,22082,22266,184
2022-11-13,70046,70056,Blue,1,52450,52935,485
2022-02-20,70040,70048,Blue,1,83795,84204,409
2022-05-08,70055,70053,Blue,0,70991,71038,47
2022-10-20,70057,70053,Blue,0,78191,78337,146
2022-03-01,70059,70047,Blue,0,46098,46714,616
2022-08-07,70044,70052,Blue,1,47477,47969,492
2022-04-17,70038,70048,Blue,1,30006,30466,460
2022-01-29,70046,70050,Blue,1,26842,27287,445
2022-06-12,70055,70049,Blue,0,45948,46231,283
2022-08-29,70045,70838,Blue,0,78210,78569,359
2022-09-29,70059,70043,Blue,0,48377,49187,810
2022-03-10,70057,70838,Blue,0,32438,33607,1169
2022-06-24,70047,70039,Blue,0,63120,63538,418
2022-08-07,70040,70048,Blue,1,25381,25746,365
2022-02-25,70049,70041,Blue,0,66459,66905,446
2022-03-08,70044,70056,Blue,1,88687,89426,739
2022-09-03,70044,70054,Blue,1,21231,21817,586
2022-01-14,70040,70046,Blue,1,60482,60751,269
2022-11-02,70042,70050,Blue,1,79699,80096,397
2022-12-16,70056,70060,Blue,1,62843,63011,168
2022-12-29,70053,70045,Blue,0,22565,23023,458
2022-08-04,70046,70060,Blue,1,20265,21009,744
2022-07-16,70040,70044,Blue,1,76695,76817,122
2022-03-16,70040,70044,Blue,1,63486,63605,119
2022-03-03,70051,70045,Blue,0,46527,46889,362
2022-02-08,70053,70049,Blue,0,57182,57389,207
2022-11-06,70045,70838,Blue,0,83731,84051,320
2022-08-17,70042,70054,Blue,1,72809,73498,689
2022-03-10,70054,70056,Blue,1,61665,61712,47
2022-10-07,70059,70055,Blue,0,20415,20561,146
2022-08-12,70038,70042,Blue,1,67014,67112,98
2022-04-21,70057,70055,Blue,0,24365,24433,68
2022-02-20,70051,70041,Blue,0,50403,50975,572
2022-07-28,70038,70048,Blue,1,57135,57603,468
2022-09-01,70045,70838,Blue,0,70447,70802,355
2022-09-10,70050,70054,Blue,1,38357,38559,202
2022-02-16,70049,70039,Blue,0,58282,58751,469
2022-05-25,70041,70838,Blue,0,80982,81097,115
2022-09-12,70048,70050,Blue,1,48170,48227,57
2022-01-10,70044,70054,Blue,1,58161,58844,683
2022-10-31,70045,70043,Blue,0,49130,49226,96
2022-04-01,70042,70044,Blue,1,51324,51353,29
2022-01-23,70056,70058,Blue,1,27311,27385,74
2022-10-21,70057,70049,Blue,0,72329,72701,372
2022-03-03,70049,70045,Blue,0,72572,72789,217
2022-09-02,70053,70047,Blue,0,86077,86375,298
2022-05-28,70039,70838,Blue,0,30946,30990,44
2022-07-05,70046,70056,Blue,1,53034,53583,549
2022-09-24,70048,70052,Blue,1,61564,61769,205
2022-10-25,70044,70046,Blue,1,36874,36982,108
2022-04-11,70053,70041,Blue,0,45773,46470,697
2022-10-07,70050,70054,Blue,1,28819,29043,224
2022-03-11,70059,70055,Blue,0,24860,25006,146
2022-10-20,70038,70046,Blue,1,41650,41994,344
2022-12-10,70044,70046,Blue,1,77515,77626,111
2022-10-27,70038,70044,Blue,1,44069,44248,179
2022-04-14,70044,70050,Blue,1,55551,55904,353
2022-05-25,70045,70039,Blue,0,32562,32870,308
2022-10-02,70047,70039,Blue,0,52837,53447,610
2022-03-03,70054,70058,Blue,1,50041,50200,159
2022-02-02,70040,70060,Blue,1,22219,23535,1316
2022-02-17,70057,70043,Blue,0,64165,64902,737
2022-01-04,70057,70053,Blue,0,57267,57414,147
2022-02-26,70042,70046,Blue,1,40614,40798,184
2022-09-27,70055,70838,Blue,0,27080,28153,1073
2022-08-13,70057,70053,Blue,0,85764,85914,150
2022-05-09,70059,70049,Blue,0,39322,39937,615
2022-10-14,70053,70838,Blue,0,53791,54598,807
2022-02-20,70044,70060,Blue,1,88431,89323,892
2022-09-17,70045,70043,Blue,0,27884,27983,99
2022-12-18,70048,70050,Blue,1,60766,60823,57
2022-04-07,70055,70043,Blue,0,32538,33231,693
2022-11-18,70050,70052,Blue,1,32495,32598,103
2022-09-30,70053,70838,Blue,0,82402,83233,831
2022-05-21,70048,70052,Blue,1,23654,23872,218
2022-01-19,70038,70042,Blue,1,45264,45351,87
2022-01-06,70046,70060,Blue,1,36542,37474,932
2022-03-03,70048,70052,Blue,1,34977,35337,360
2022-04-03,70051,70838,Blue,0,47127,47786,659
2022-08-26,70056,70058,Blue,1,59670,59745,75
2022-10-10,70046,70048,Blue,1,44339,44420,81
2022-09-25,70042,70044,Blue,1,64859,64889,30
2022-07-15,70044,70056,Blue,1,34369,35094,725
2022-04-07,70040,70042,Blue,1,46086,46120,34
2022-10-19,70038,70054,Blue,1,24209,25000,791
2022-08-24,70047,70043,Blue,0,81491,81735,244
2022-12-07,70055,70047,Blue,0,53276,53674,398
2022-11-02,70052,70058,Blue,1,81428,81661,233
2022-05-05,70051,70049,Blue,0,26324,26427,103
2022-07-25,70044,70056,Blue,1,43103,43855,752
2022-01-22,70043,70838,Blue,0,72363,72565,202
2022-08-17,70039,70838,Blue,0,59826,59859,33
2022-10-18,70057,70045,Blue,0,64778,65419,641
2022-12-10,70046,70054,Blue,1,24046,24485,439
2022-10-08,70038,70060,Blue,1,82158,83357,1199
2022-01-15,70053,70039,Blue,0,71788,72633,845
2022-03-23,70056,70058,Blue,1,36811,36888,77
2022-03-06,70046,70058,Blue,1,30454,31040,586
2022-01-06,70039,70838,Blue,0,83888,83927,39
2022-11-28,70059,70053,Blue,0,80477,80709,232
2022-09-28,70046,70058,Blue,1,44413,45028,615
2022-04-12,70049,70838,Blue,0,71089,71661,572
2022-07-11,70044,70048,Blue,1,70895,71142,247
2022-10-08,70046,70058,Blue,1,72150,72819,669
2022-01-12,70057,70041,Blue,0,70584,71350,766
2022-10-22,70044,70046,Blue,1,59082,59190,108
2022-03-18,70049,70838,Blue,0,61034,61710,676
2022-10-10,70038,70046,Blue,1,78870,79202,332
2022-08-30,70053,70039,Blue,0,74020,74746,726
2022-03-08,70055,70043,Blue,0,39455,40198,743
2022-03-15,70038,70042,Blue,1,81962,82057,95
2022-06-10,70055,70053,Blue,0,66225,66271,46
2022-03-01,70057,70051,Blue,0,29737,30049,312
2022-09-23,70044,70054,Blue,1,74931,75564,633
2022-03-25,70054,70056,Blue,1,73385,73432,47
2022-07-27,70057,70039,Blue,0,45833,46837,1004
2022-04-20,70048,70060,Blue,1,66709,67468,759
2022-07-11,70042,70052,Blue,1,26007,26639,632
2022-10-26,70051,70039,Blue,0,67442,68076,634
2022-11-20,70057,70047,Blue,0,48511,48980,469
2022-04-10,70038,70050,Blue,1,54248,54854,606
2022-04-24,70040,70050,Blue,1,65610,66092,482
2022-04-03,70042,70054,Blue,1,32496,33162,666
2022-10-17,70057,70047,Blue,0,29801,30319,518
2022-09-21,70045,70043,Blue,0,79464,79571,107
2022-02-08,70055,70838,Blue,0,68059,69132,1073
2022-02-09,70059,70039,Blue,0,29369,30576,1207
2022-04-21,70053,70051,Blue,0,22304,22353,49
2022-08-12,70055,70049,Blue,0,79658,79948,290
2022-01-31,70057,70039,Blue,0,34621,35906,1285
2022-11-13,70049,70047,Blue,0,61879,61937,58
2022-11-29,70048,70054,Blue,1,36300,36624,324
2022-03-10,70059,70057,Blue,0,19160,19197,37
2022-04-20,70042,70054,Blue,1,87279,87943,664
2022-04-23,70042,70056,Blue,1,25112,25849,737
2022-12-19,70042,70054,Blue,1,85798,86399,601
2022-11-15,70048,70060,Blue,1,60067,60750,683
2022-08-08,70053,70039,Blue,0,24892,25674,782
2022-05-06,70054,70056,Blue,1,79249,79296,47
2022-01-05,70057,70045,Blue,0,38742,39550,808
2022-01-04,70040,70054,Blue,1,31511,32306,795
2022-11-02,70042,70052,Blue,1,80228,80799,571
2022-11-06,70056,70060,Blue,1,46607,46795,188
2022-10-03,70057,70047,Blue,0,55711,56223,512
2022-08-08,70051,70047,Blue,0,35315,35511,196
2022-03-17,70049,70041,Blue,0,74856,75282,426
2022-05-20,70044,70058,Blue,1,25702,26581,879
2022-10-25,70049,70047,Blue,0,63596,63653,57
2022-02-12,70049,70043,Blue,0,48099,48495,396
2022-10-19,70047,70039,Blue,0,31954,32369,415
2022-09-26,70054,70056,Blue,1,34089,34138,49
2022-08-12,70054,70060,Blue,1,35096,35369,273
2022-03-12,70054,70060,Blue,1,29938,30217,279
2022-01-25,70055,70049,Blue,0,83663,83967,304
2022-04-01,70039,70838,Blue,0,82777,82808,31
2022-04-07,70055,70051,Blue,0,41130,41278,148
2022-04-04,70049,70039,Blue,0,22216,22793,577
2022-05-11,70056,70058,Blue,1,31368,31448,80
2022-12-09,70041,70838,Blue,0,80918,81034,116
2022-01-05,70047,70043,Blue,0,30057,30312,255
2022-08-29,70038,70050,Blue,1,40467,41039,572
2022-03-28,70059,70041,Blue,0,86294,87311,1017
2022-01-04,70042,70058,Blue,1,65381,66298,917
2022-08-09,70053,70049,Blue,0,55660,55863,203
2022-12-19,70040,70058,Blue,1,48891,49821,930
2022-01-24,70048,70050,Blue,1,82071,82136,65
2022-09-19,70042,70044,Blue,1,27034,27063,29
2022-09-05,70038,70060,Blue,1,54286,55438,1152
2022-08-24,70059,70045,Blue,0,30564,31345,781
2022-09-28,70040,70046,Blue,1,40469,40745,276
2022-08-20,70059,70053,Blue,0,57380,57612,232
2022-02-18,70057,70047,Blue,0,47189,47653,464
2022-01-20,70057,70041,Blue,0,60889,61843,954
2022-02-17,70046,70050,Blue,1,29434,29621,187
2022-06-02,70045,70043,Blue,0,74824,74966,142
2022-07-09,70041,70039,Blue,0,42172,42207,35
2022-11-23,70038,70050,Blue,1,53408,54004,596
2022-09-11,70047,70838,Blue,0,45260,45766,506
2022-01-31,70044,70052,Blue,1,22089,24348,2259
2022-12-30,70046,70054,Blue,1,67477,67893,416
2022-04-12,70052,70056,Blue,1,31575,31713,138
2022-06-18,70038,70050,Blue,1,35594,36360,766
2022-09-09,70059,70047,Blue,0,28462,29051,589
2022-01-13,70038,70058,Blue,1,23669,24775,1106
2022-08-21,70040,70046,Blue,1,74842,75118,276
2022-10-02,70042,70054,Blue,1,23908,24558,650
2022-04-13,70049,70039,Blue,0,52062,52549,487
2022-10-31,70059,70838,Blue,0,57203,58301,1098
2022-04-11,70055,70049,Blue,0,24745,25031,286
2022-01-07,70046,70048,Blue,1,37280,37363,83
2022-07-03,70048,70058,Blue,1,38878,39402,524
2022-06-11,70048,70060,Blue,1,33968,34590,622
2022-06-13,70044,70058,Blue,1,21760,22602,842
2022-11-15,70052,70058,Blue,1,24016,24255,239
2022-09-18,70049,70045,Blue,0,50573,50804,231
2022-09-22,70044,70048,Blue,1,49465,49709,244
2022-08-03,70041,70838,Blue,0,89429,89555,126
2022-04-07,70050,70056,Blue,1,60199,60495,296
2022-09-10,70055,70838,Blue,0,70991,71911,920
2022-04-06,70057,70049,Blue,0,59571,59965,394
2022-04-16,70038,70048,Blue,1,42633,43138,505
2022-02-17,70039,70838,Blue,0,32355,32389,34
2022-01-14,70051,70041,Blue,0,72423,72969,546
2022-10-12,70040,70048,Blue,1,54600,55030,430
2022-01-03,70038,70060,Blue,1,54317,55445,1128
2022-02-09,70047,70039,Blue,0,28838,29249,411
2022-07-31,70042,70046,Blue,1,52218,52387,169
2022-09-18,70046,70050,Blue,1,38064,38242,178
2022-07-02,70040,70054,Blue,1,29168,29887,719
2022-03-31,70053,70041,Blue,0,55952,56706,754
2022-04-08,70055,70838,Blue,0,39969,40965,996
2022-09-12,70057,70045,Blue,0,30645,31327,682
2022-11-02,70044,70048,Blue,1,40206,40447,241
2022-04-22,70053,70047,Blue,0,67770,68056,286
2022-12-13,70051,70043,Blue,0,51442,51958,516
2022-08-10,70053,70051,Blue,0,27487,27553,66
2022-10-07,70049,70045,Blue,0,68064,68254,190
2022-11-04,70059,70051,Blue,0,33633,33982,349
2022-04-22,70038,70060,Blue,1,35387,36708,1321
2022-08-25,70044,70052,Blue,1,44773,45291,518
2022-03-08,70047,70045,Blue,0,62574,62682,108
2022-08-12,70040,70052,Blue,1,31245,32004,759
2022-02-21,70042,70054,Blue,1,76783,77426,643
2022-12-19,70051,70043,Blue,0,33815,34486,671
2022-01-14,70053,70039,Blue,0,71826,72569,743
2022-09-02,70040,70060,Blue,1,36342,37459,1117
2022-03-30,70042,70056,Blue,1,33386,34135,749
2022-09-17,70044,70058,Blue,1,62337,63162,825
2022-01-16,70059,70055,Blue,0,42797,42944,147
2022-06-12,70040,70042,Blue,1,71164,71200,36
2022-01-22,70044,70052,Blue,1,38644,39200,556
2022-03-01,70052,70056,Blue,1,72229,72375,146
2022-03-14,70057,70043,Blue,0,85824,86547,723
2022-06-21,70040,70056,Blue,1,79039,79952,913
2022-02-23,70047,70041,Blue,0,27619,28035,416
2022-10-31,70051,70039,Blue,0,85323,85926,603
2022-11-15,70047,70041,Blue,0,36419,36758,339
2022-08-31,70042,70048,Blue,1,32442,32753,311
2022-07-04,70040,70056,Blue,1,40000,40906,906
2022-07-14,70042,70058,Blue,1,39453,40439,986
2022-01-08,70057,70049,Blue,0,39656,40091,435
2022-02-16,70057,70047,Blue,0,46709,47167,458
2022-09-30,70046,70048,Blue,1,43899,43984,85
2022-02-02,70059,70045,Blue,0,28162,28929,767
2022-11-07,70051,70049,Blue,0,30787,31180,393
2022-10-01,70042,70044,Blue,1,88371,88401,30
2022-10-20,70048,70060,Blue,1,79917,80487,570
2022-06-19,70057,70051,Blue,0,67723,67977,254
2022-02-23,70038,70054,Blue,1,68654,69441,787
2022-06-19,70042,70054,Blue,1,44442,45149,707
2022-03-18,70059,70047,Blue,0,64395,64924,529
2022-04-04,70046,70052,Blue,1,54928,55262,334
2022-05-28,70042,70048,Blue,1,34012,34358,346
2022-09-12,70054,70056,Blue,1,46087,46134,47
2022-10-14,70050,70058,Blue,1,44704,45113,409
2022-05-21,70046,70048,Blue,1,59529,59603,74
2022-10-30,70059,70057,Blue,0,61395,61429,34
2022-02-02,70057,70049,Blue,0,31825,32203,378
2022-12-20,70059,70049,Blue,0,63833,64298,465
2022-11-20,70048,70060,Blue,1,33605,34170,565
2022-06-29,70042,70052,Blue,1,48379,49001,622
2022-02-25,70055,70838,Blue,0,87082,88023,941
2022-04-08,70049,70043,Blue,0,37684,38059,375
2022-01-27,70038,70048,Blue,1,63455,63938,483
2022-09-06,70054,70056,Blue,1,41737,41783,46
2022-02-08,70044,70058,Blue,1,25716,26584,868
2022-03-17,70042,70058,Blue,1,32232,33116,884
2022-10-16,70042,70052,Blue,1,54398,54978,580
2022-08-01,70052,70058,Blue,1,87380,87646,266
2022-04-19,70051,70043,Blue,0,46489,47018,529
2022-11-24,70059,70838,Blue,0,76514,77612,1098
2022-08-14,70055,70039,Blue,0,41001,41901,900
2022-11-12,70045,70043,Blue,0,26247,26339,92
2022-02-22,70055,70047,Blue,0,76217,76631,414
2022-08-11,70038,70046,Blue,1,68468,68779,311
2022-08-04,70043,70041,Blue,0,27363,27393,30
2022-03-15,70046,70056,Blue,1,41201,41798,597
2022-02-09,70057,70053,Blue,0,61185,61335,150
2022-11-05,70057,70053,Blue,0,73585,73736,151
2022-01-03,70039,70838,Blue,0,20359,20399,40
2022-10-05,70051,70041,Blue,0,28251,28876,625
2022-03-18,70041,70838,Blue,0,49143,49261,118
2022-04-15,70050,70056,Blue,1,20994,21303,309
2022-06-01,70047,70041,Blue,0,53616,54074,458
2022-03-14,70057,70838,Blue,0,64774,65928,1154
2022-01-21,70040,70056,Blue,1,29721,30556,835
2022-03-09,70048,70050,Blue,1,48583,48642,59
2022-11-21,70048,70052,Blue,1,51917,52123,206
2022-02-17,70047,70039,Blue,0,61165,61595,430
2022-01-22,70051,70049,Blue,0,71219,71323,104
2022-09-14,70056,70058,Blue,1,54348,54418,70
2022-11-13,70042,70056,Blue,1,53880,54559,679
2022-03-05,70052,70054,Blue,1,39540,39587,47
2022-07-12,70059,70057,Blue,0,61358,61393,35
2022-07-07,70055,70047,Blue,0,26977,27377,400
2022-06-21,70051,70043,Blue,0,48779,49300,521
2022-11-26,70050,70060,Blue,1,43765,44284,519
2022-07-17,70046,70060,Blue,1,85888,86644,756
2022-09-09,70038,70054,Blue,1,33674,34487,813
2022-11-19,70038,70058,Blue,1,72318,73364,1046
2022-10-02,70057,70049,Blue,0,64188,64578,390
2022-09-19,70049,70047,Blue,0,33668,33774,106
2022-10-13,70059,70041,Blue,0,59430,60511,1081
2022-01-15,70055,70049,Blue,0,50617,50924,307
2022-11-27,70040,70046,Blue,1,33981,34240,259
2022-04-21,70038,70058,Blue,1,24547,25555,1008
2022-02-16,70042,70058,Blue,1,23514,24568,1054
2022-09-15,70045,70838,Blue,0,48061,48474,413
2022-04-01,70047,70039,Blue,0,60501,60941,440
2022-12-15,70059,70049,Blue,0,22604,23242,638
2022-12-22,70049,70838,Blue,0,43932,44560,628
2022-02-03,70051,70049,Blue,0,20625,20747,122
2022-01-15,70053,70045,Blue,0,40474,40914,440
2022-11-29,70047,70838,Blue,0,73941,74403,462
2022-01-31,70046,70050,Blue,1,48274,48474,200
2022-03-05,70051,70049,Blue,0,70080,70189,109
2022-07-21,70059,70043,Blue,0,69072,69920,848
2022-04-03,70046,70054,Blue,1,29578,29980,402
2022-02-26,70042,70044,Blue,1,54104,54133,29
2022-06-23,70040,70052,Blue,1,56696,57423,727
2022-08-04,70057,70039,Blue,0,59375,60317,942
2022-05-05,70055,70051,Blue,0,20257,20409,152
2022-03-02,70038,70056,Blue,1,45292,46188,896
2022-05-01,70058,70060,Blue,1,65439,65504,65
2022-11-03,70052,70054,Blue,1,57973,58030,57
2022-07-17,70059,70043,Blue,0,57076,57944,868
2022-02-28,70044,70056,Blue,1,52688,53413,725
2022-12-04,70038,70048,Blue,1,57938,58391,453
2022-08-31,70040,70056,Blue,1,74775,75574,799
2022-12-13,70057,70045,Blue,0,63214,63799,585
2022-06-24,70059,70045,Blue,0,26031,26740,709
2022-05-20,70047,70838,Blue,0,23420,24159,739
2022-10-14,70042,70048,Blue,1,50609,50907,298
2022-03-28,70046,70050,Blue,1,26088,26273,185
2022-08-07,70057,70049,Blue,0,83070,83459,389
2022-11-09,70052,70060,Blue,1,33967,34332,365
2022-12-04,70051,70045,Blue,0,68772,69128,356
2022-07-13,70043,70838,Blue,0,53277,53491,214
2022-10-19,70046,70058,Blue,1,59882,60525,643
2022-08-29,70040,70050,Blue,1,38942,39449,507
2022-02-18,70040,70052,Blue,1,44183,44856,673
2022-12-23,70052,70060,Blue,1,76871,77260,389
2022-04-02,70049,70041,Blue,0,51897,52344,447
2022-09-27,70049,70039,Blue,0,75894,76368,474
2022-11-14,70038,70046,Blue,1,59607,59983,376
2022-02-07,70051,70045,Blue,0,62782,63135,353
2022-06-19,70043,70041,Blue,0,81269,81298,29
2022-04-24,70045,70039,Blue,0,60183,60428,245
2022-01-27,70059,70043,Blue,0,57203,57997,794
2022-01-11,70049,70043,Blue,0,42557,42899,342
2022-06-10,70051,70049,Blue,0,83836,83940,104
2022-03-08,70045,70043,Blue,0,72301,72400,99
2022-07-01,70057,70051,Blue,0,50336,50579,243
2022-09-15,70057,70053,Blue,0,27665,27817,152
2022-06-18,70044,70048,Blue,1,72683,72942,259
2022-08-25,70040,70042,Blue,1,55672,55707,35
2022-01-07,70055,70053,Blue,0,74544,74591,47
2022-06-26,70051,70838,Blue,0,80656,81418,762
2022-08-31,70051,70045,Blue,0,50294,50625,331
2022-06-20,70055,70049,Blue,0,62462,62765,303
2022-07-04,70041,70838,Blue,0,72792,72920,128
2022-08-03,70042,70058,Blue,1,55598,56467,869
2022-05-01,70050,70060,Blue,1,64954,65504,550
2022-01-18,70040,70042,Blue,1,28517,28555,38
2022-12-29,70046,70060,Blue,1,27455,28489,1034
2022-11-11,70046,70058,Blue,1,34886,35483,597
2022-06-23,70050,70054,Blue,1,80498,80734,236
2022-01-21,70055,70045,Blue,0,30147,30715,568
2022-02-28,70059,70039,Blue,0,26087,27264,1177
2022-09-06,70040,70050,Blue,1,55906,56510,604
2022-06-15,70055,70047,Blue,0,75076,75431,355
2022-05-19,70051,70041,Blue,0,84972,85686,714
2022-09-06,70050,70060,Blue,1,82058,82615,557
2022-02-21,70053,70838,Blue,0,65735,66671,936
2022-08-14,70040,70044,Blue,1,50537,50655,118
2022-12-25,70038,70058,Blue,1,50488,51493,1005
2022-07-21,70056,70058,Blue,1,59928,60000,72
2022-09-29,70038,70044,Blue,1,24116,24273,157
2022-04-08,70057,70053,Blue,0,60876,61026,150
2022-01-20,70044,70060,Blue,1,44844,45695,851
2022-11-30,70045,70043,Blue,0,30826,30924,98
2022-02-11,70048,70050,Blue,1,55529,55584,55
2022-06-18,70052,70054,Blue,1,68825,68882,57
2022-04-13,70047,70039,Blue,0,61726,62163,437
2022-02-05,70044,70052,Blue,1,59051,59530,479
2022-04-02,70044,70050,Blue,1,35804,36144,340
2022-04-10,70043,70039,Blue,0,62791,62892,101
2022-07-26,70042,70050,Blue,1,33495,33928,433
2022-03-20,70055,70039,Blue,0,36376,37233,857
2022-12-24,70038,70046,Blue,1,87337,87672,335
2022-01-13,70048,70050,Blue,1,52405,52461,56
2022-05-18,70049,70047,Blue,0,25750,25814,64
2022-05-15,70057,70051,Blue,0,75098,75379,281
2022-10-11,70040,70060,Blue,1,57100,58141,1041
2022-06-30,70051,70049,Blue,0,33869,33980,111
2022-10-20,70042,70046,Blue,1,62416,62613,197
2022-08-09,70050,70058,Blue,1,80220,80620,400
2022-01-03,70059,70838,Blue,0,86298,87341,1043
2022-06-11,70049,70041,Blue,0,58422,58884,462
2022-09-08,70044,70058,Blue,1,55883,56739,856
2022-08-12,70053,70041,Blue,0,25028,25754,726
2022-06-07,70042,70044,Blue,1,68151,68189,38
2022-03-01,70055,70049,Blue,0,62707,63020,313
2022-06-20,70040,70044,Blue,1,32072,32206,134
2022-09-08,70038,70040,Blue,1,23169,23185,16
2022-07-22,70041,70838,Blue,0,25363,25495,132
2022-06-30,70059,70041,Blue,0,58558,59555,997
2022-12-27,70057,70043,Blue,0,27276,28097,821
2022-01-05,70048,70060,Blue,1,29523,30222,699
2022-06-21,70042,70052,Blue,1,45474,46126,652
2022-07-08,70047,70039,Blue,0,54669,55083,414
2022-01-29,70052,70054,Blue,1,80392,80466,74
2022-06-28,70038,70042,Blue,1,57872,57990,118
2022-08-09,70049,70041,Blue,0,23543,24014,471
2022-01-25,70057,70045,Blue,0,77854,78510,656
2022-04-04,70044,70060,Blue,1,59195,60314,1119
2022-03-14,70057,70051,Blue,0,19242,19508,266
2022-10-23,70054,70058,Blue,1,57423,57585,162
2022-08-02,70052,70054,Blue,1,47472,47537,65
2022-12-25,70038,70054,Blue,1,46688,47451,763
2022-09-04,70043,70039,Blue,0,45551,45660,109
2022-02-27,70040,70054,Blue,1,75382,76086,704
2022-04-17,70042,70054,Blue,1,32552,33250,698
2022-02-12,70059,70045,Blue,0,86749,87521,772
2022-08-01,70038,70054,Blue,1,65837,66677,840
2022-06-30,70059,70053,Blue,0,71125,71359,234
2022-01-20,70048,70052,Blue,1,27439,27655,216
2022-03-03,70045,70041,Blue,0,62249,62426,177
2022-10-13,70045,70043,Blue,0,42946,43048,102
2022-07-04,70040,70058,Blue,1,67100,68098,998
2022-01-27,70040,70060,Blue,1,37393,38519,1126
2022-03-21,70049,70045,Blue,0,29884,30119,235
2022-12-01,70055,70051,Blue,0,85418,85563,145
2022-02-13,70041,70838,Blue,0,76444,76557,113
2022-02-05,70051,70838,Blue,0,45867,46717,850
2022-09-25,70048,70052,Blue,1,89606,89806,200
2022-06-22,70058,70060,Blue,1,70902,70968,66
2022-08-10,70049,70043,Blue,0,87115,87434,319
2022-06-16,70038,70046,Blue,1,71594,72047,453
2022-09-08,70057,70055,Blue,0,77002,77070,68
2022-07-31,70042,70044,Blue,1,52218,52245,27
2022-10-10,70044,70060,Blue,1,35496,36333,837
2022-07-09,70051,70045,Blue,0,69544,69881,337
2022-10-23,70046,70050,Blue,1,45323,45500,177
2022-07-15,70050,70058,Blue,1,61111,61538,427
2022-01-26,70042,70056,Blue,1,51750,52441,691
2022-06-13,70049,70039,Blue,0,33451,33991,540
2022-09-17,70048,70052,Blue,1,47477,47703,226
2022-04-20,70055,70053,Blue,0,27443,27488,45
2022-04-18,70044,70058,Blue,1,20563,21424,861
2022-10-11,70055,70838,Blue,0,69744,70646,902
2022-07-04,70059,70041,Blue,0,66901,67881,980
2022-02-17,70047,70039,Blue,0,25002,25501,499
2022-10-27,70045,70838,Blue,0,47644,47988,344
2022-04-17,70038,70048,Blue,1,60192,60667,475
2022-12-01,70048,70060,Blue,1,35401,36015,614
2022-11-11,70038,70060,Blue,1,78462,79630,1168
2022-10-08,70050,70052,Blue,1,22507,22621,114
2022-11-17,70059,70055,Blue,0,32243,32389,146
2022-12-21,70055,70047,Blue,0,51801,52163,362
2022-04-06,70043,70838,Blue,0,31528,31740,212
2022-01-08,70048,70056,Blue,1,70639,71069,430
2022-04-24,70040,70060,Blue,1,30066,31054,988
2022-10-18,70052,70056,Blue,1,63759,63942,183
2022-02-28,70045,70838,Blue,0,47379,47713,334
2022-06-11,70051,70047,Blue,0,36666,36868,202
2022-06-22,70049,70041,Blue,0,29434,29928,494
2022-05-21,70053,70838,Blue,0,57131,58289,1158
2022-07-21,70050,70056,Blue,1,76649,76996,347
2022-05-14,70050,70054,Blue,1,59291,59507,216
2022-04-18,70057,70041,Blue,0,86966,87808,842
2022-03-24,70052,70056,Blue,1,30387,30534,147
2022-11-07,70046,70050,Blue,1,36185,36372,187
2022-02-15,70055,70047,Blue,0,25052,25504,452
2022-08-18,70038,70056,Blue,1,70881,71810,929
2022-10-30,70042,70052,Blue,1,79894,80454,560
2022-06-13,70051,70041,Blue,0,37930,38565,635
2022-03-04,70050,70054,Blue,1,88326,88539,213
2022-07-12,70047,70041,Blue,0,25424,25759,335
2022-03-02,70059,70051,Blue,0,36992,37484,492
2022-05-29,70046,70050,Blue,1,27701,27917,216
2022-02-01,70046,70060,Blue,1,34551,35420,869
2022-06-21,70051,70049,Blue,0,35715,35901,186
2022-01-13,70038,70058,Blue,1,44242,45401,1159
2022-11-30,70057,70043,Blue,0,34878,35779,901
2022-04-11,70039,70838,Blue,0,39778,39814,36
2022-10-12,70051,70045,Blue,0,20770,21106,336
2022-09-13,70044,70046,Blue,1,71902,72003,101
2022-12-18,70053,70051,Blue,0,64928,64986,58
2022-05-11,70052,70060,Blue,1,32459,32827,368
2022-03-01,70046,70052,Blue,1,59565,59891,326
2022-12-29,70055,70039,Blue,0,59830,60648,818
2022-12-21,70038,70052,Blue,1,31870,32545,675
2022-09-20,70051,70039,Blue,0,74773,75442,669
2022-04-13,70040,70052,Blue,1,22817,23461,644
2022-08-13,70038,70046,Blue,1,48553,48888,335
2022-01-06,70042,70050,Blue,1,56670,57106,436
2022-12-29,70046,70058,Blue,1,29075,29748,673
2022-09-25,70051,70043,Blue,0,45022,45532,510
2022-10-25,70055,70051,Blue,0,70390,70521,131
2022-10-06,70042,70050,Blue,1,55619,56047,428
2022-01-20,70055,70047,Blue,0,24464,24938,474
2022-08-02,70042,70050,Blue,1,38977,39365,388
2022-02-22,70052,70056,Blue,1,40881,41018,137
2022-10-07,70043,70838,Blue,0,79532,79707,175
2022-01-08,70051,70838,Blue,0,36665,37423,758
2022-10-19,70046,70056,Blue,1,63135,63652,517
2022-06-20,70053,70045,Blue,0,33575,33979,404
2022-02-04,70050,70052,Blue,1,43921,44041,120
2022-02-18,70040,70042,Blue,1,57068,57109,41
2022-09-22,70039,70838,Blue,0,74690,74725,35
2022-12-02,70040,70056,Blue,1,41718,42558,840
2022-08-25,70051,70041,Blue,0,71085,71677,592
2022-02-25,70040,70046,Blue,1,83797,84040,243
2022-01-05,70059,70049,Blue,0,83488,84006,518
2022-12-08,70040,70050,Blue,1,23226,23703,477
2022-06-01,70042,70046,Blue,1,60461,60670,209
2022-11-06,70052,70054,Blue,1,31489,31533,44
2022-06-10,70048,70052,Blue,1,65075,65273,198
2022-08-22,70045,70041,Blue,0,51693,51871,178
2022-10-21,70038,70060,Blue,1,70515,71713,1198
2022-03-29,70049,70039,Blue,0,70486,70998,512
2022-07-11,70055,70838,Blue,0,34304,35323,1019
2022-01-26,70053,70041,Blue,0,33817,34584,767
2022-02-09,70042,70046,Blue,1,53533,53714,181
2022-09-17,70057,70838,Blue,0,48750,49911,1161
2022-08-03,70044,70054,Blue,1,51094,51740,646
2022-09-16,70053,70043,Blue,0,55909,56497,588
2022-11-21,70040,70048,Blue,1,83734,84121,387
2022-03-31,70042,70058,Blue,1,70088,71027,939
2022-04-12,70048,70056,Blue,1,61863,62253,390
2022-09-10,70054,70060,Blue,1,41825,42087,262
2022-11-14,70043,70838,Blue,0,60735,60953,218
2022-04-21,70056,70058,Blue,1,59251,59323,72
2022-09-02,70044,70052,Blue,1,32103,32591,488
2022-02-18,70038,70044,Blue,1,86130,86331,201
2022-07-30,70046,70048,Blue,1,48534,48610,76
2022-09-07,70038,70058,Blue,1,55861,56851,990
2022-11-27,70040,70048,Blue,1,65117,65522,405
2022-03-02,70051,70043,Blue,0,28818,29311,493
2022-07-11,70058,70060,Blue,1,84982,85043,61
2022-12-01,70057,70053,Blue,0,83503,83661,158
2022-11-26,70047,70045,Blue,0,62785,62895,110
2022-08-11,70049,70039,Blue,0,25601,26163,562
2022-04-22,70040,70060,Blue,1,75258,76464,1206
2022-07-25,70044,70056,Blue,1,50144,50900,756
2022-11-26,70049,70838,Blue,0,48654,49297,643
2022-08-15,70057,70047,Blue,0,30641,31105,464
2022-06-10,70043,70838,Blue,0,60679,60941,262
2022-04-15,70044,70056,Blue,1,27474,28172,698
2022-02-14,70042,70050,Blue,1,31451,31887,436
2022-06-16,70048,70058,Blue,1,30249,30737,488
2022-10-06,70055,70045,Blue,0,62679,63186,507
2022-06-23,70050,70058,Blue,1,30804,31259,455
2022-03-23,70040,70060,Blue,1,34505,35923,1418
2022-04-04,70040,70058,Blue,1,54074,55030,956
2022-01-04,70049,70039,Blue,0,51385,52029,644
2022-10-21,70048,70058,Blue,1,68439,68946,507
2022-09-30,70046,70054,Blue,1,36188,36614,426
2022-04-18,70042,70044,Blue,1,57342,57377,35
2022-07-11,70042,70046,Blue,1,86843,87017,174
2022-02-08,70053,70838,Blue,0,74043,75011,968
2022-08-26,70045,70838,Blue,0,22551,22932,381
2022-08-06,70038,70060,Blue,1,53416,54548,1132
2022-04-19,70054,70056,Blue,1,24247,24296,49
2022-04-12,70038,70050,Blue,1,76896,77497,601
2022-01-07,70048,70054,Blue,1,22071,22412,341
2022-04-14,70053,70049,Blue,0,23305,23502,197
2022-10-08,70044,70052,Blue,1,31495,31995,500
2022-12-18,70042,70054,Blue,1,72214,72858,644
2022-04-08,70048,70056,Blue,1,68467,68868,401
2022-12-29,70046,70052,Blue,1,86144,86478,334
2022-04-12,70045,70039,Blue,0,65473,65726,253
2022-08-24,70048,70054,Blue,1,87813,88106,293
2022-12-23,70058,70060,Blue,1,75905,75966,61
2022-06-19,70055,70041,Blue,0,77790,78575,785
2022-09-30,70055,70041,Blue,0,42870,43698,828
2022-06-09,70059,70051,Blue,0,34696,35094,398
2022-08-27,70046,70060,Blue,1,44040,44736,696
2022-04-22,70049,70039,Blue,0,19694,20239,545
2022-04-11,70042,70046,Blue,1,65110,65277,167
2022-11-13,70053,70039,Blue,0,28796,29561,765
2022-06-15,70038,70048,Blue,1,46394,46910,516
2022-03-03,70059,70045,Blue,0,32957,33766,809
2022-10-01,70055,70041,Blue,0,25023,25786,763
2022-12-13,70053,70838,Blue,0,27367,28254,887
2022-02-10,70042,70058,Blue,1,76998,77802,804
2022-06-01,70038,70050,Blue,1,62234,62966,732
2022-04-11,70046,70060,Blue,1,31896,32702,806
2022-02-15,70055,70053,Blue,0,22246,22335,89
2022-05-06,70053,70049,Blue,0,54997,55204,207
2022-07-03,70044,70046,Blue,1,26326,26440,114
2022-06-10,70050,70060,Blue,1,27291,27846,555
2022-03-17,70045,70043,Blue,0,82511,82604,93
2022-03-06,70045,70039,Blue,0,61109,61363,254
2022-12-13,70055,70047,Blue,0,61576,61956,380
2022-10-17,70043,70838,Blue,0,52673,52929,256
2022-01-24,70048,70060,Blue,1,63658,64356,698
2022-09-23,70055,70041,Blue,0,72978,73749,771
2022-03-17,70038,70042,Blue,1,78008,78106,98
2022-03-02,70051,70045,Blue,0,87928,88286,358
2022-09-19,70059,70041,Blue,0,75915,76894,979
2022-07-31,70050,70060,Blue,1,69410,69901,491
2022-12-01,70038,70056,Blue,1,73660,74550,890
2022-11-17,70046,70058,Blue,1,46490,47181,691
2022-10-03,70050,70054,Blue,1,45814,46027,213
2022-09-11,70050,70054,Blue,1,64548,64754,206
2022-08-06,70057,70045,Blue,0,47674,48327,653
2022-11-25,70056,70060,Blue,1,49235,49417,182
2022-03-08,70038,70058,Blue,1,50780,51831,1051
2022-06-16,70046,70052,Blue,1,30006,30445,439
2022-10-13,70038,70058,Blue,1,76354,77430,1076
2022-08-14,70054,70060,Blue,1,77428,77704,276
2022-08-12,70039,70838,Blue,0,45300,45335,35
2022-06-24,70049,70039,Blue,0,25962,26631,669
2022-05-17,70055,70051,Blue,0,70946,71185,239
2022-02-26,70047,70039,Blue,0,20168,20573,405
2022-07-06,70038,70052,Blue,1,48273,49044,771
2022-01-29,70044,70056,Blue,1,44831,46186,1355
2022-10-10,70059,70043,Blue,0,70694,71493,799
2022-06-04,70046,70048,Blue,1,79292,79413,121
2022-03-04,70051,70041,Blue,0,68883,69422,539
2022-03-09,70038,70046,Blue,1,36196,36513,317
2022-07-06,70038,70058,Blue,1,42045,43111,1066
2022-03-24,70053,70838,Blue,0,59300,60114,814
2022-02-27,70057,70053,Blue,0,84712,84884,172
2022-11-04,70054,70056,Blue,1,58078,58145,67
2022-08-23,70041,70838,Blue,0,31691,31837,146
2022-09-04,70038,70050,Blue,1,62893,63429,536
2022-12-09,70051,70045,Blue,0,20336,20708,372
2022-11-24,70038,70044,Blue,1,82992,83190,198
2022-11-02,70044,70050,Blue,1,77588,77920,332
2022-12-17,70047,70838,Blue,0,63343,63815,472
2022-06-01,70044,70046,Blue,1,33660,33795,135
2022-11-23,70055,70041,Blue,0,40410,41148,738
2022-08-27,70044,70052,Blue,1,67150,67634,484
2022-05-04,70057,70051,Blue,0,61539,61786,247
2022-12-14,70046,70050,Blue,1,68374,68547,173
2022-07-05,70040,70046,Blue,1,36645,37087,442
2022-05-18,70042,70060,Blue,1,79687,80948,1261
2022-05-19,70048,70060,Blue,1,66999,67644,645
2022-01-12,70045,70838,Blue,0,69212,69536,324
2022-06-30,70044,70048,Blue,1,75214,75488,274
2022-04-01,70040,70058,Blue,1,24629,25681,1052
2022-11-30,70046,70056,Blue,1,73670,74211,541
2022-03-23,70049,70041,Blue,0,80005,80492,487
2022-01-09,70040,70042,Blue,1,28505,28536,31
2022-02-10,70059,70057,Blue,0,28457,28500,43
2022-10-16,70042,70046,Blue,1,63590,63776,186
2022-03-02,70053,70049,Blue,0,65860,66057,197
2022-12-30,70044,70048,Blue,1,75520,75746,226
2022-10-11,70059,70049,Blue,0,47865,48342,477
2022-09-26,70047,70043,Blue,0,53160,53413,253
2022-02-02,70049,70045,Blue,0,77293,77521,228
2022-03-21,70048,70060,Blue,1,29298,29947,649
2022-03-31,70057,70053,Blue,0,27628,27785,157
2022-12-28,70055,70047,Blue,0,27562,27939,377
2022-08-31,70059,70838,Blue,0,34396,35453,1057
2022-11-05,70056,70058,Blue,1,35519,35593,74
2022-11-02,70047,70838,Blue,0,61479,61956,477
2022-01-01,70057,70053,Blue,0,41559,41747,188
2022-01-06,70059,70057,Blue,0,60196,60231,35
2022-10-31,70050,70054,Blue,1,46679,46876,197
2022-10-18,70048,70060,Blue,1,77226,77800,574
2022-10-18,70057,70055,Blue,0,68239,68308,69
2022-04-10,70038,70056,Blue,1,54248,55181,933
2022-04-10,70042,70046,Blue,1,52813,52992,179
2022-11-17,70046,70048,Blue,1,63480,63562,82
2022-01-20,70050,70058,Blue,1,63131,63552,421
2022-02-27,70046,70050,Blue,1,57349,57540,191
2022-10-20,70045,70039,Blue,0,75146,75389,243
2022-11-12,70057,70043,Blue,0,31484,32280,796
2022-01-11,70047,70043,Blue,0,66782,67006,224
2022-09-01,70049,70043,Blue,0,37936,38282,346
2022-03-03,70054,70056,Blue,1,84552,84599,47
2022-01-17,70042,70052,Blue,1,29255,29906,651
2022-03-15,70055,70049,Blue,0,29273,29587,314
2022-10-15,70059,70039,Blue,0,24132,25164,1032
2022-08-07,70038,70040,Blue,1,89138,89153,15
2022-09-28,70040,70042,Blue,1,46206,46241,35
2022-12-07,70041,70039,Blue,0,34759,34793,34
2022-03-21,70052,70058,Blue,1,71748,72016,268
2022-08-18,70055,70041,Blue,0,53737,54503,766
2022-01-24,70038,70050,Blue,1,89906,91182,1276
2022-01-07,70059,70043,Blue,0,56359,57245,886
2022-02-23,70053,70043,Blue,0,84321,84932,611
2022-09-19,70052,70056,Blue,1,70880,71032,152
2022-02-04,70053,70043,Blue,0,58870,59502,632
2022-03-07,70047,70043,Blue,0,26077,26328,251
2022-12-30,70055,70051,Blue,0,28758,28895,137
2022-08-14,70046,70058,Blue,1,28814,29461,647
2022-04-07,70042,70058,Blue,1,52051,52915,864
2022-08-03,70039,70838,Blue,0,75596,75627,31
2022-06-08,70049,70039,Blue,0,62933,63578,645
2022-08-16,70053,70047,Blue,0,32538,32844,306
2022-11-04,70059,70043,Blue,0,72831,73754,923
2022-01-28,70047,70838,Blue,0,51113,51785,672
2022-10-28,70049,70838,Blue,0,33671,34296,625
2022-08-30,70042,70044,Blue,1,47400,47425,25
2022-09-26,70059,70051,Blue,0,30146,30497,351
2022-06-11,70044,70048,Blue,1,76879,77143,264
2022-01-07,70047,70043,Blue,0,56354,56615,261
2022-01-27,70059,70043,Blue,0,64696,65627,931
2022-03-18,70053,70043,Blue,0,58069,58633,564
2022-10-24,70049,70043,Blue,0,80963,81314,351
2022-04-11,70048,70052,Blue,1,64545,64757,212
2022-08-12,70059,70053,Blue,0,49935,50165,230
2022-02-23,70042,70052,Blue,1,28136,28735,599
2022-11-09,70053,70051,Blue,0,19825,19885,60
2022-01-25,70059,70045,Blue,0,64126,64864,738
2022-01-21,70046,70050,Blue,1,52559,52757,198
2022-12-15,70044,70046,Blue,1,25060,25165,105
2022-05-15,70059,70057,Blue,0,24608,24647,39
2022-10-31,70043,70041,Blue,0,42554,42586,32
2022-03-24,70038,70060,Blue,1,47527,48646,1119
2022-12-24,70050,70060,Blue,1,51545,52024,479
2022-11-09,70040,70046,Blue,1,69560,69842,282
2022-11-15,70042,70048,Blue,1,32076,32384,308
2022-11-28,70053,70049,Blue,0,64465,64715,250
2022-10-12,70052,70060,Blue,1,79117,79473,356
2022-03-29,70038,70046,Blue,1,61326,61626,300
2022-12-01,70049,70045,Blue,0,54297,54497,200
2022-08-22,70056,70060,Blue,1,60424,60630,206
2022-10-06,70057,70043,Blue,0,81179,81972,793
2022-08-14,70043,70838,Blue,0,82430,82620,190
2022-04-06,70042,70054,Blue,1,86194,86849,655
2022-07-27,70042,70052,Blue,1,87508,88024,516
2022-12-23,70046,70054,Blue,1,72446,72927,481
2022-08-08,70055,70039,Blue,0,44333,45257,924
2022-03-18,70059,70057,Blue,0,87497,87532,35
2022-07-02,70057,70039,Blue,0,86625,87537,912
2022-08-13,70048,70060,Blue,1,88128,88851,723
2022-09-11,70044,70050,Blue,1,89350,89798,448
2022-01-20,70038,70052,Blue,1,26006,26742,736
2022-06-26,70057,70039,Blue,0,77118,78132,1014
2022-05-24,70045,70043,Blue,0,84492,84636,144
2022-01-23,70051,70049,Blue,0,22664,22770,106
2022-03-20,70055,70838,Blue,0,58659,59662,1003
2022-09-12,70054,70056,Blue,1,33844,33892,48
2022-02-18,70042,70056,Blue,1,74301,75097,796
2022-03-14,70038,70056,Blue,1,60437,61377,940
2022-04-03,70045,70043,Blue,0,64866,64958,92
2022-08-31,70051,70041,Blue,0,29117,29688,571
2022-05-09,70052,70060,Blue,1,65153,65509,356
2022-08-22,70042,70048,Blue,1,47350,47664,314
2022-03-21,70057,70053,Blue,0,50804,50962,158
2022-08-08,70059,70043,Blue,0,37007,37980,973
2022-10-29,70053,70047,Blue,0,44651,44942,291
2022-08-04,70042,70058,Blue,1,48547,49537,990
2022-10-02,70055,70041,Blue,0,33384,34126,742
2022-11-29,70051,70838,Blue,0,79756,80457,701
2022-06-16,70049,70047,Blue,0,58341,58399,58
2022-08-03,70055,70049,Blue,0,53953,54224,271
2022-09-17,70052,70054,Blue,1,59643,59700,57
2022-06-16,70047,70041,Blue,0,84609,84951,342
2022-07-29,70049,70039,Blue,0,84909,85454,545
2022-09-23,70049,70838,Blue,0,50461,51230,769
2022-09-17,70057,70838,Blue,0,84950,86037,1087
2022-06-30,70048,70050,Blue,1,27119,27175,56
2022-12-31,70059,70838,Blue,0,45984,47101,1117
2022-02-15,70051,70043,Blue,0,67170,67649,479
2022-11-24,70046,70052,Blue,1,58414,58773,359
2022-07-10,70059,70041,Blue,0,39495,40459,964
2022-09-27,70051,70039,Blue,0,35289,36096,807
2022-07-17,70040,70054,Blue,1,63508,64300,792
2022-12-25,70059,70838,Blue,0,34756,35865,1109
2022-10-26,70042,70048,Blue,1,51245,51539,294
2022-12-13,70055,70043,Blue,0,24473,25176,703
2022-03-04,70046,70052,Blue,1,26744,27107,363
2022-07-31,70038,70044,Blue,1,26284,26449,165
2022-06-20,70059,70045,Blue,0,48919,49662,743
2022-07-14,70059,70055,Blue,0,70708,70863,155
2022-12-24,70038,70044,Blue,1,31395,31559,164
2022-04-04,70057,70838,Blue,0,37606,38740,1134
2022-03-23,70047,70043,Blue,0,22301,22588,287
2022-04-24,70057,70055,Blue,0,65246,65315,69
2022-03-31,70059,70049,Blue,0,67517,68000,483
2022-01-27,70055,70053,Blue,0,31338,31400,62
2022-03-16,70054,70060,Blue,1,77657,77907,250
2022-09-28,70057,70045,Blue,0,67240,67868,628
2022-09-01,70058,70060,Blue,1,53533,53609,76
2022-01-18,70049,70041,Blue,0,79961,80356,395
2022-01-19,70059,70053,Blue,0,67878,68130,252
2022-04-18,70053,70047,Blue,0,58638,58954,316
2022-09-22,70038,70050,Blue,1,62730,63296,566
2022-10-14,70053,70047,Blue,0,25829,26147,318
2022-02-23,70040,70056,Blue,1,32722,33587,865
2022-10-24,70055,70041,Blue,0,31164,31975,811
2022-01-17,70042,70056,Blue,1,69801,70579,778
2022-02-28,70042,70048,Blue,1,24690,24987,297
2022-02-04,70044,70058,Blue,1,29928,30996,1068
2022-09-13,70038,70048,Blue,1,52967,53516,549
2022-09-21,70059,70049,Blue,0,87315,87789,474
2022-12-22,70038,70052,Blue,1,40111,40874,763
2022-01-18,70040,70046,Blue,1,45377,45665,288
2022-10-31,70039,70838,Blue,0,85422,85454,32
2022-11-28,70046,70060,Blue,1,37202,37969,767
2022-07-17,70045,70039,Blue,0,76720,76974,254
2022-01-25,70040,70044,Blue,1,45820,45925,105
2022-06-14,70038,70040,Blue,1,37427,37444,17
2022-10-01,70038,70058,Blue,1,21673,22661,988
2022-12-15,70057,70838,Blue,0,53736,54737,1001
2022-04-22,70055,70051,Blue,0,31414,31560,146
2022-04-05,70055,70047,Blue,0,65475,65853,378
2022-01-25,70042,70056,Blue,1,53646,54441,795
2022-05-22,70046,70048,Blue,1,26538,26637,99
2022-12-16,70050,70052,Blue,1,39382,39501,119
2022-06-19,70045,70838,Blue,0,59461,59841,380
2022-11-30,70053,70039,Blue,0,48363,49153,790
2022-06-09,70040,70048,Blue,1,44522,45000,478
2022-06-22,70045,70041,Blue,0,75323,75534,211
2022-07-13,70053,70043,Blue,0,51318,51901,583
2022-04-11,70051,70043,Blue,0,30947,31463,516
2022-05-02,70054,70056,Blue,1,63568,63615,47
2022-04-15,70040,70056,Blue,1,54865,55740,875
2022-12-24,70040,70056,Blue,1,69676,70537,861
2022-10-26,70038,70054,Blue,1,24889,25696,807
2022-09-20,70046,70060,Blue,1,36143,36900,757
2022-01-22,70057,70039,Blue,0,24925,25903,978
2022-01-10,70038,70044,Blue,1,81971,82143,172
2022-07-13,70041,70039,Blue,0,26140,26172,32
2022-11-23,70046,70056,Blue,1,59515,60021,506
2022-06-14,70051,70049,Blue,0,48020,48122,102
2022-05-19,70042,70048,Blue,1,34292,34686,394
2022-05-29,70047,70043,Blue,0,24455,24720,265
2022-11-17,70055,70838,Blue,0,35022,36104,1082
2022-10-02,70042,70056,Blue,1,74376,75143,767
2022-07-21,70044,70058,Blue,1,65224,66061,837
2022-12-07,70050,70056,Blue,1,30445,30769,324
2022-11-15,70048,70054,Blue,1,39817,40210,393
2022-07-26,70051,70041,Blue,0,74162,74703,541
2022-10-30,70059,70041,Blue,0,79577,80453,876
2022-12-26,70057,70041,Blue,0,36270,37160,890
2022-09-08,70043,70041,Blue,0,77762,77790,28
2022-01-27,70053,70049,Blue,0,27919,28121,202
2022-02-23,70040,70050,Blue,1,20944,21508,564
2022-11-28,70057,70039,Blue,0,73897,74865,968
2022-06-19,70051,70045,Blue,0,59055,59406,351
2022-03-30,70046,70060,Blue,1,53118,53879,761
2022-08-13,70045,70039,Blue,0,50554,50833,279
2022-09-19,70055,70045,Blue,0,43896,44427,531
2022-08-31,70057,70049,Blue,0,31112,31477,365
2022-03-11,70041,70838,Blue,0,51667,51902,235
2022-11-13,70048,70054,Blue,1,24470,24818,348
2022-02-15,70042,70054,Blue,1,30995,31726,731
2022-02-12,70053,70041,Blue,0,47866,48584,718
2022-02-04,70053,70045,Blue,0,28434,28902,468
2022-08-25,70058,70060,Blue,1,44437,44499,62
2022-02-04,70059,70838,Blue,0,44384,45601,1217
2022-07-17,70043,70039,Blue,0,46683,46791,108
2022-11-26,70057,70053,Blue,0,26608,26754,146
2022-09-08,70057,70051,Blue,0,24329,24593,264
2022-06-09,70040,70042,Blue,1,59729,59764,35
2022-01-26,70053,70041,Blue,0,83183,83927,744
2022-11-09,70057,70053,Blue,0,22234,22387,153
2022-06-27,70057,70041,Blue,0,47405,48289,884
2022-06-25,70040,70042,Blue,1,41662,41696,34
2022-07-11,70048,70058,Blue,1,64389,64913,524
2022-09-19,70048,70056,Blue,1,82600,83009,409
2022-09-05,70054,70056,Blue,1,40606,40653,47
2022-08-24,70051,70045,Blue,0,30128,30493,365
2022-06-09,70059,70057,Blue,0,64823,64863,40
2022-06-15,70040,70056,Blue,1,62313,63268,955
2022-01-14,70053,70045,Blue,0,30268,30735,467
2022-07-31,70043,70041,Blue,0,43118,43147,29
2022-04-08,70053,70051,Blue,0,63746,63809,63
2022-09-25,70047,70045,Blue,0,36809,36907,98
2022-07-21,70042,70060,Blue,1,45911,46925,1014
2022-07-26,70047,70041,Blue,0,42940,43296,356
2022-11-03,70042,70048,Blue,1,74366,74664,298
2022-11-09,70055,70053,Blue,0,63081,63128,47
2022-11-02,70038,70056,Blue,1,89113,90130,1017
2022-11-21,70054,70060,Blue,1,39940,40281,341
2022-12-16,70053,70049,Blue,0,24628,25061,433
2022-11-28,70045,70838,Blue,0,86724,87065,341
2022-06-04,70043,70838,Blue,0,50053,50286,233
2022-04-06,70040,70044,Blue,1,83192,83321,129
2022-07-25,70040,70058,Blue,1,66105,67104,999
2022-08-24,70042,70050,Blue,1,49687,50110,423
2022-09-19,70046,70058,Blue,1,65249,65922,673
2022-10-19,70040,70044,Blue,1,68213,68328,115
2022-07-15,70056,70058,Blue,1,57698,57771,73
2022-10-22,70053,70043,Blue,0,85958,86513,555
2022-07-23,70057,70051,Blue,0,64194,64438,244
2022-10-05,70042,70056,Blue,1,56204,56967,763
2022-09-04,70046,70056,Blue,1,55750,56275,525
2022-06-16,70044,70048,Blue,1,30836,31090,254
2022-01-12,70040,70058,Blue,1,43122,44135,1013
2022-06-15,70053,70039,Blue,0,43511,44354,843
2022-10-13,70044,70048,Blue,1,65070,65298,228
2022-06-18,70049,70039,Blue,0,34047,34621,574
2022-05-31,70047,70838,Blue,0,27134,27780,646
2022-03-21,70047,70045,Blue,0,78985,79085,100
2022-02-04,70049,70838,Blue,0,54121,54774,653
2022-07-22,70038,70058,Blue,1,36833,37897,1064
2022-11-06,70038,70050,Blue,1,71536,72570,1034
2022-03-03,70038,70060,Blue,1,68231,69481,1250
2022-05-27,70042,70052,Blue,1,60540,61255,715
2022-11-10,70038,70040,Blue,1,49207,49225,18
2022-06-25,70044,70050,Blue,1,52916,53280,364
2022-10-05,70052,70060,Blue,1,69274,69627,353
2022-01-17,70059,70043,Blue,0,69736,70595,859
2022-12-13,70048,70058,Blue,1,34965,35466,501
2022-11-02,70042,70050,Blue,1,71732,72134,402
2022-10-22,70057,70045,Blue,0,67110,67776,666
2022-12-28,70038,70044,Blue,1,64108,64293,185
2022-07-31,70042,70052,Blue,1,85676,86271,595
2022-08-29,70044,70050,Blue,1,76036,76381,345
2022-07-04,70057,70053,Blue,0,74273,74432,159
2022-11-18,70053,70043,Blue,0,79846,80509,663
2022-06-13,70053,70049,Blue,0,34444,34691,247
2022-03-14,70044,70060,Blue,1,22100,23022,922
2022-09-21,70053,70047,Blue,0,35214,35590,376
2022-01-27,70046,70060,Blue,1,63192,63995,803
2022-02-03,70048,70060,Blue,1,26851,27743,892
2022-10-14,70044,70052,Blue,1,58941,59452,511
2022-01-10,70049,70045,Blue,0,81727,81920,193
2022-01-21,70051,70045,Blue,0,26501,26855,354
2022-03-24,70057,70049,Blue,0,33031,33423,392
2022-09-13,70049,70838,Blue,0,37512,38140,628
2022-02-22,70038,70054,Blue,1,31756,32585,829
2022-08-25,70042,70052,Blue,1,64338,64940,602
2022-03-27,70053,70041,Blue,0,58948,59577,629
2022-02-13,70040,70056,Blue,1,78631,79494,863
2022-10-20,70040,70044,Blue,1,25934,26038,104
2022-06-28,70040,70058,Blue,1,84196,85128,932
2022-01-09,70057,70053,Blue,0,30938,31095,157
2022-06-29,70052,70060,Blue,1,74997,75355,358
2022-02-15,70050,70058,Blue,1,66776,67190,414
2022-02-08,70046,70048,Blue,1,33906,33992,86
2022-12-10,70052,70060,Blue,1,78642,78979,337
2022-03-10,70042,70060,Blue,1,25239,26261,1022
2022-08-19,70059,70039,Blue,0,35897,36965,1068
2022-07-28,70047,70041,Blue,0,69459,69781,322
2022-07-15,70040,70044,Blue,1,67369,67499,130
2022-07-28,70040,70046,Blue,1,75251,75522,271
2022-02-13,70055,70051,Blue,0,82400,82572,172
2022-10-29,70055,70039,Blue,0,30029,30880,851
2022-02-09,70042,70052,Blue,1,28752,29406,654
2022-09-13,70051,70047,Blue,0,46630,46823,193
2022-07-28,70054,70058,Blue,1,71724,71877,153
2022-10-18,70052,70056,Blue,1,71861,72000,139
2022-12-27,70046,70052,Blue,1,33147,33489,342
2022-08-23,70057,70053,Blue,0,36392,36553,161
2022-09-15,70045,70039,Blue,0,74667,74932,265
2022-02-02,70051,70838,Blue,0,63022,63748,726
2022-12-08,70043,70838,Blue,0,52874,53078,204
2022-01-08,70052,70060,Blue,1,45672,46029,357
2022-03-18,70059,70045,Blue,0,73214,73934,720
2022-10-10,70042,70056,Blue,1,89257,90051,794
2022-06-16,70048,70058,Blue,1,41803,42409,606
2022-05-09,70057,70051,Blue,0,47786,48025,239
2022-06-14,70057,70053,Blue,0,67236,67398,162
2022-08-29,70055,70047,Blue,0,76637,76991,354
2022-04-12,70053,70039,Blue,0,86595,87390,795
2022-08-04,70059,70047,Blue,0,36406,37082,676
2022-06-30,70059,70057,Blue,0,34891,34926,35
2022-11-16,70039,70838,Blue,0,44641,44673,32
2022-07-07,70045,70039,Blue,0,35217,35498,281
2022-12-28,70038,70046,Blue,1,81975,82317,342
2022-06-22,70051,70049,Blue,0,54457,54561,104
2022-03-18,70059,70051,Blue,0,30582,30922,340
2022-03-01,70059,70041,Blue,0,60709,61782,1073
2022-09-28,70051,70043,Blue,0,48370,48856,486
2022-04-03,70044,70050,Blue,1,79918,80270,352
2022-09-03,70051,70045,Blue,0,59286,59618,332
2022-02-06,70053,70041,Blue,0,28783,29444,661
2022-03-31,70038,70042,Blue,1,64629,64721,92
2022-12-25,70044,70052,Blue,1,30202,30646,444
2022-09-09,70040,70050,Blue,1,33470,33981,511
2022-03-31,70055,70043,Blue,0,21877,22589,712
2022-11-08,70042,70054,Blue,1,85866,86554,688
2022-04-02,70047,70041,Blue,0,31979,32270,291
2022-01-10,70059,70047,Blue,0,23055,23716,661
2022-10-26,70043,70039,Blue,0,29196,29312,116
2022-01-04,70049,70047,Blue,0,58957,59011,54
2022-03-17,70051,70039,Blue,0,50832,51547,715
2022-03-08,70043,70041,Blue,0,62655,62684,29
2022-08-31,70053,70051,Blue,0,39304,39385,81
2022-02-08,70052,70060,Blue,1,80630,80989,359
2022-11-04,70055,70049,Blue,0,24030,24370,340
2022-02-26,70057,70049,Blue,0,21701,22114,413
2022-07-24,70059,70053,Blue,0,60856,61084,228
2022-01-24,70054,70058,Blue,1,40682,40835,153
2022-01-09,70044,70050,Blue,1,47978,48345,367
2022-10-03,70059,70051,Blue,0,33502,34086,584
2022-11-07,70059,70039,Blue,0,31681,33085,1404
2022-07-13,70057,70051,Blue,0,83365,83620,255
2022-08-17,70042,70044,Blue,1,28764,28797,33
2022-03-11,70049,70041,Blue,0,24764,25216,452
2022-06-07,70046,70048,Blue,1,60855,60962,107
2022-04-13,70038,70050,Blue,1,31453,32065,612
2022-09-11,70039,70838,Blue,0,26177,26216,39
2022-03-01,70055,70041,Blue,0,44535,45327,792
2022-01-02,70042,70054,Blue,1,70596,71246,650
2022-04-03,70053,70049,Blue,0,44368,44563,195
2022-12-06,70053,70039,Blue,0,25723,26524,801
2022-02-27,70055,70043,Blue,0,77228,77941,713
2022-03-21,70045,70039,Blue,0,70736,70976,240
2022-02-11,70055,70047,Blue,0,20427,20845,418
2022-03-24,70049,70043,Blue,0,57405,57793,388
2022-03-21,70042,70056,Blue,1,67529,68362,833
2022-01-25,70046,70060,Blue,1,66081,66813,732
2022-06-30,70053,70047,Blue,0,61663,61932,269
2022-03-19,70051,70838,Blue,0,46331,47060,729
2022-03-04,70049,70838,Blue,0,79488,80091,603
2022-03-05,70052,70054,Blue,1,69792,69840,48
2022-01-25,70040,70058,Blue,1,24610,25639,1029
2022-04-01,70050,70052,Blue,1,40226,40341,115
2022-01-12,70059,70057,Blue,0,23663,23700,37
2022-12-02,70044,70060,Blue,1,76192,77100,908
2022-06-08,70038,70052,Blue,1,82816,83735,919
2022-09-22,70057,70043,Blue,0,22668,23596,928
2022-04-19,70049,70043,Blue,0,33802,34169,367
2022-03-22,70059,70045,Blue,0,51201,51918,717
2022-11-04,70059,70055,Blue,0,41532,41681,149
2022-07-01,70053,70039,Blue,0,27686,28497,811
2022-05-18,70049,70041,Blue,0,46731,47320,589
2022-07-27,70051,70047,Blue,0,47764,47960,196
2022-02-08,70051,70043,Blue,0,24960,25490,530
2022-02-08,70056,70058,Blue,1,83180,83251,71
2022-04-12,70046,70060,Blue,1,71281,72013,732
2022-04-18,70038,70040,Blue,1,34450,34469,19
2022-11-02,70050,70060,Blue,1,23776,24306,530
2022-12-24,70042,70044,Blue,1,80098,80127,29
2022-10-24,70040,70050,Blue,1,52518,53082,564
2022-11-14,70040,70056,Blue,1,26538,27472,934
2022-11-26,70057,70041,Blue,0,65486,66329,843
2022-02-13,70043,70039,Blue,0,73124,73243,119
2022-02-15,70044,70056,Blue,1,57124,57894,770
2022-08-18,70049,70045,Blue,0,27357,27577,220
2022-09-10,70042,70058,Blue,1,62406,63306,900
2022-11-11,70046,70054,Blue,1,35692,36124,432
2022-06-11,70038,70054,Blue,1,45142,45980,838
2022-04-05,70053,70051,Blue,0,33861,33929,68
2022-10-01,70057,70055,Blue,0,76558,76626,68
2022-07-16,70047,70039,Blue,0,48202,48616,414
2022-12-29,70048,70050,Blue,1,55664,55729,65
2022-09-23,70051,70045,Blue,0,87685,88016,331
2022-03-07,70058,70060,Blue,1,65194,65258,64
2022-07-15,70055,70041,Blue,0,24466,25278,812
2022-12-08,70048,70050,Blue,1,32412,32468,56
2022-01-31,70047,70039,Blue,0,78989,79457,468
2022-09-20,70040,70060,Blue,1,26004,27030,1026
2022-08-27,70057,70049,Blue,0,62286,62683,397
2022-06-09,70050,70054,Blue,1,63528,63750,222
2022-11-24,70042,70052,Blue,1,65178,65703,525
2022-10-20,70057,70051,Blue,0,30871,31120,249
2022-06-27,70042,70052,Blue,1,49346,49946,600
2022-03-04,70043,70041,Blue,0,60232,60261,29
2022-08-18,70059,70057,Blue,0,41410,41445,35
2022-12-29,70038,70044,Blue,1,24007,24176,169
2022-08-22,70040,70048,Blue,1,26204,26589,385
2022-02-09,70038,70054,Blue,1,26956,27762,806
2022-03-06,70045,70043,Blue,0,74595,74687,92
2022-02-27,70044,70054,Blue,1,73413,74010,597
2022-06-04,70047,70838,Blue,0,33389,33895,506
2022-06-14,70044,70052,Blue,1,55320,55836,516
2022-11-20,70047,70041,Blue,0,56032,56323,291
2022-09-17,70042,70052,Blue,1,27639,28217,578
2022-08-31,70051,70043,Blue,0,43187,43670,483
2022-11-02,70057,70051,Blue,0,45821,46077,256
2022-12-26,70047,70039,Blue,0,72853,73267,414
2022-09-16,70040,70046,Blue,1,76843,77092,249
2022-04-23,70040,70048,Blue,1,72950,73362,412
2022-12-21,70048,70052,Blue,1,33228,33442,214
2022-03-31,70059,70838,Blue,0,45495,46615,1120
2022-01-05,70055,70041,Blue,0,76836,77626,790
2022-03-30,70050,70060,Blue,1,60172,60734,562
2022-11-28,70052,70060,Blue,1,39389,39831,442
2022-04-07,70054,70056,Blue,1,53947,53994,47
2022-06-21,70038,70040,Blue,1,40447,40463,16
2022-08-18,70059,70838,Blue,0,22593,23933,1340
2022-03-27,70046,70056,Blue,1,77313,77856,543
2022-08-13,70049,70041,Blue,0,32150,32586,436
2022-12-09,70055,70838,Blue,0,43878,44763,885
2022-09-11,70042,70056,Blue,1,50068,50782,714
2022-01-14,70059,70051,Blue,0,63494,63852,358
2022-02-01,70038,70054,Blue,1,59240,60177,937
2022-06-14,70042,70048,Blue,1,32809,33163,354
2022-05-20,70055,70838,Blue,0,62766,63807,1041
2022-02-23,70046,70052,Blue,1,71348,71707,359
2022-09-17,70053,70043,Blue,0,31113,31702,589
2022-03-29,70057,70053,Blue,0,57567,57712,145
2022-07-06,70059,70057,Blue,0,56179,56216,37
2022-04-19,70059,70045,Blue,0,55093,55787,694
2022-07-07,70043,70039,Blue,0,54340,54563,223
2022-01-28,70046,70058,Blue,1,56892,57501,609
2022-03-10,70055,70039,Blue,0,78513,79343,830
2022-07-19,70057,70045,Blue,0,20493,21089,596
2022-07-20,70047,70838,Blue,0,75994,76482,488
2022-10-12,70042,70052,Blue,1,63488,64098,610
2022-10-10,70042,70056,Blue,1,35082,35838,756
2022-03-14,70040,70052,Blue,1,42054,42773,719
2022-02-09,70053,70043,Blue,0,28132,28721,589
2022-07-20,70057,70041,Blue,0,29808,30766,958
2022-12-11,70055,70051,Blue,0,70768,70910,142
2022-01-20,70057,70039,Blue,0,33338,34506,1168
2022-02-10,70042,70052,Blue,1,33691,34240,549
2022-08-28,70056,70058,Blue,1,56267,56340,73
2022-11-30,70050,70060,Blue,1,21946,22634,688
2022-08-06,70059,70039,Blue,0,48684,49690,1006
2022-07-09,70038,70048,Blue,1,26290,26767,477
2022-01-21,70059,70051,Blue,0,21929,22285,356
2022-07-19,70042,70048,Blue,1,24268,24598,330
2022-09-10,70049,70047,Blue,0,67010,67068,58
2022-09-04,70051,70041,Blue,0,46092,46656,564
2022-12-16,70042,70048,Blue,1,51936,52231,295
2022-11-04,70056,70058,Blue,1,61789,61892,103
2022-07-28,70038,70052,Blue,1,27410,28235,825
2022-10-21,70057,70838,Blue,0,58371,59411,1040
2022-10-24,70042,70056,Blue,1,56678,57433,755
2022-12-31,70053,70045,Blue,0,54875,55364,489
2022-07-06,70051,70045,Blue,0,49963,50364,401
2022-03-09,70051,70047,Blue,0,53524,53725,201
2022-01-24,70046,70058,Blue,1,21805,22598,793
2022-02-10,70045,70838,Blue,0,33757,34172,415
2022-03-12,70048,70054,Blue,1,55565,55873,308
2022-04-23,70040,70056,Blue,1,83132,84019,887
2022-12-12,70046,70052,Blue,1,33169,33493,324
2022-04-30,70054,70058,Blue,1,70052,70213,161
2022-03-14,70052,70058,Blue,1,53519,53778,259
2022-03-15,70045,70041,Blue,0,34614,35051,437
2022-02-09,70054,70060,Blue,1,46750,47037,287
2022-12-01,70057,70041,Blue,0,35364,36263,899
2022-12-19,70040,70044,Blue,1,29523,29631,108
2022-03-07,70042,70052,Blue,1,57031,57641,610
2022-12-20,70049,70047,Blue,0,31257,31311,54
2022-08-22,70059,70057,Blue,0,47298,47333,35
2022-07-20,70050,70054,Blue,1,72178,72457,279
2022-04-01,70052,70058,Blue,1,45927,46181,254
2022-08-11,70056,70060,Blue,1,44157,44393,236
2022-09-12,70038,70046,Blue,1,44589,44895,306
2022-08-09,70039,70838,Blue,0,32617,32652,35
2022-10-07,70044,70050,Blue,1,45746,46077,331
2022-06-15,70052,70058,Blue,1,89016,89246,230
2022-01-25,70057,70053,Blue,0,22131,22342,211
2022-12-31,70038,70054,Blue,1,22997,23792,795
2022-03-30,70048,70054,Blue,1,47458,47848,390
2022-07-18,70046,70054,Blue,1,74003,74429,426
2022-11-28,70038,70048,Blue,1,40993,41419,426
2022-01-24,70059,70051,Blue,0,77176,77497,321
2022-10-15,70046,70048,Blue,1,56029,56102,73
2022-12-27,70053,70838,Blue,0,30695,31518,823
2022-01-13,70057,70041,Blue,0,38212,39156,944
2022-09-16,70048,70052,Blue,1,82449,82649,200
2022-05-18,70057,70039,Blue,0,71019,72208,1189
2022-02-28,70045,70043,Blue,0,34469,34573,104
2022-02-28,70055,70043,Blue,0,54095,54801,706
2022-10-19,70057,70051,Blue,0,78818,79068,250
2022-04-05,70058,70060,Blue,1,69664,69769,105
2022-12-14,70059,70049,Blue,0,70701,71209,508
2022-04-15,70046,70048,Blue,1,86926,87014,88
2022-02-01,70040,70044,Blue,1,56367,56487,120
2022-02-21,70058,70060,Blue,1,61686,61750,64
2022-09-08,70059,70041,Blue,0,31221,32272,1051
2022-09-28,70049,70043,Blue,0,26060,26546,486
2022-10-24,70057,70041,Blue,0,45809,46653,844
2022-02-17,70059,70045,Blue,0,64986,65676,690
2022-11-23,70049,70043,Blue,0,38952,39317,365
2022-10-06,70047,70838,Blue,0,34979,35487,508
2022-10-01,70045,70041,Blue,0,60753,61007,254
2022-06-22,70044,70060,Blue,1,56416,57362,946
2022-03-03,70042,70050,Blue,1,67791,68224,433
2022-04-22,70041,70838,Blue,0,29794,29949,155
2022-08-20,70048,70054,Blue,1,44786,45091,305
2022-01-08,70040,70054,Blue,1,58468,59229,761
2022-10-13,70051,70047,Blue,0,57573,57766,193
2022-03-31,70042,70048,Blue,1,82215,82544,329
2022-11-03,70048,70054,Blue,1,31266,31585,319
2022-05-11,70056,70058,Blue,1,54920,54992,72
2022-11-18,70051,70039,Blue,0,76275,76973,698
2022-02-26,70042,70058,Blue,1,64923,65836,913
2022-05-13,70059,70049,Blue,0,36358,36886,528
2022-03-20,70048,70054,Blue,1,47954,48275,321
2022-05-21,70047,70045,Blue,0,61480,61643,163
2022-03-24,70042,70060,Blue,1,88457,89338,881
2022-02-25,70057,70039,Blue,0,54575,55523,948
2022-01-26,70050,70056,Blue,1,50426,50717,291
2022-04-21,70044,70050,Blue,1,54524,55779,1255
2022-12-02,70039,70838,Blue,0,23700,23734,34
2022-07-18,70049,70045,Blue,0,76939,77154,215
2022-08-15,70046,70050,Blue,1,73591,73792,201
2022-12-09,70057,70041,Blue,0,33581,34454,873
2022-12-04,70055,70049,Blue,0,47408,47705,297
2022-06-09,70047,70043,Blue,0,65718,66001,283
2022-12-12,70059,70053,Blue,0,44787,45032,245
2022-08-18,70053,70043,Blue,0,43518,44148,630
2022-11-05,70055,70047,Blue,0,72610,72979,369
2022-02-12,70054,70056,Blue,1,32161,32208,47
2022-02-07,70040,70058,Blue,1,28604,29571,967
2022-03-14,70044,70046,Blue,1,80537,80640,103
2022-02-28,70059,70051,Blue,0,29977,30344,367
2022-09-03,70038,70044,Blue,1,84214,84409,195
2022-03-12,70053,70051,Blue,0,85952,86005,53
2022-11-24,70051,70838,Blue,0,85043,85746,703
2022-03-14,70052,70056,Blue,1,78782,78922,140
2022-01-18,70038,70060,Blue,1,75296,76380,1084
2022-09-28,70040,70044,Blue,1,84374,84491,117
2022-02-26,70052,70058,Blue,1,73088,73341,253
2022-05-26,70046,70050,Blue,1,59866,60079,213
2022-03-11,70038,70046,Blue,1,57444,57763,319
2022-06-13,70043,70838,Blue,0,87813,87997,184
2022-06-20,70056,70058,Blue,1,48806,48878,72
2022-10-28,70044,70058,Blue,1,54161,54977,816
2022-02-02,70059,70047,Blue,0,78905,79484,579
2022-08-23,70048,70050,Blue,1,26972,27031,59
2022-10-03,70038,70048,Blue,1,68500,68956,456
2022-07-12,70044,70052,Blue,1,25308,25855,547
2022-10-25,70051,70041,Blue,0,54516,55081,565
2022-09-06,70051,70047,Blue,0,78943,79133,190
2022-06-12,70038,70054,Blue,1,23029,23894,865
2022-05-05,70052,70056,Blue,1,78192,78338,146
2022-09-12,70042,70058,Blue,1,79021,79893,872
2022-08-14,70053,70049,Blue,0,63833,64042,209
2022-02-06,70048,70056,Blue,1,68804,69194,390
2022-03-31,70053,70045,Blue,0,85422,85858,436
2022-01-13,70056,70060,Blue,1,84664,84841,177
2022-02-05,70053,70047,Blue,0,77389,77707,318
2022-07-01,70048,70056,Blue,1,25787,26158,371
2022-05-20,70043,70041,Blue,0,29228,29257,29
2022-08-27,70039,70838,Blue,0,34104,34142,38
2022-08-09,70042,70056,Blue,1,69137,69885,748
2022-07-12,70038,70046,Blue,1,85689,86055,366
2022-07-18,70045,70041,Blue,0,23824,24033,209
2022-10-27,70059,70045,Blue,0,33836,34569,733
2022-06-15,70038,70056,Blue,1,36210,37271,1061
2022-03-22,70038,70044,Blue,1,57130,57298,168
2022-08-03,70042,70044,Blue,1,66083,66113,30
2022-11-20,70047,70838,Blue,0,70676,71158,482
2022-03-05,70044,70054,Blue,1,48264,48884,620
2022-01-15,70042,70054,Blue,1,80914,81583,669
2022-02-08,70059,70039,Blue,0,72615,73625,1010
2022-04-03,70053,70838,Blue,0,25681,26480,799
2022-10-23,70040,70052,Blue,1,74830,75503,673
2022-08-03,70057,70055,Blue,0,28550,28618,68
2022-02-22,70057,70049,Blue,0,68561,68968,407
2022-12-18,70046,70048,Blue,1,30401,30479,78
2022-08-20,70041,70838,Blue,0,46941,47075,134
2022-04-20,70057,70041,Blue,0,26779,27771,992
2022-03-23,70040,70042,Blue,1,65006,65044,38
2022-05-21,70050,70054,Blue,1,62198,62441,243
2022-01-26,70055,70039,Blue,0,38833,39662,829
2022-01-06,70051,70039,Blue,0,25859,26502,643
2022-09-20,70057,70041,Blue,0,66328,67139,811
2022-04-21,70040,70058,Blue,1,69967,70858,891
2022-12-21,70046,70054,Blue,1,27408,27834,426
2022-07-09,70042,70046,Blue,1,29812,30022,210
2022-10-05,70038,70050,Blue,1,55213,55789,576
2022-09-16,70052,70056,Blue,1,72416,72558,142
2022-11-03,70043,70838,Blue,0,85458,85641,183
2022-01-25,70047,70039,Blue,0,72252,72687,435
2022-03-31,70057,70043,Blue,0,66562,67320,758
2022-09-19,70053,70043,Blue,0,54871,55499,628
2022-03-22,70042,70050,Blue,1,36520,36914,394
2022-01-17,70053,70838,Blue,0,41518,42414,896
2022-12-25,70050,70056,Blue,1,51055,51391,336
2022-05-28,70045,70043,Blue,0,59024,59141,117
2022-07-26,70038,70048,Blue,1,34982,35419,437
2022-03-21,70048,70058,Blue,1,76350,76870,520
2022-12-24,70055,70051,Blue,0,78633,78782,149
2022-04-17,70040,70054,Blue,1,62418,63195,777
2022-02-09,70058,70060,Blue,1,45242,45318,76
2022-08-25,70057,70045,Blue,0,64051,64650,599
2022-04-12,70040,70048,Blue,1,32114,32510,396
2022-08-05,70040,70056,Blue,1,34926,35725,799
2022-09-21,70038,70040,Blue,1,60796,60810,14
2022-06-10,70040,70054,Blue,1,29612,30632,1020
2022-07-30,70044,70054,Blue,1,63426,64072,646
2022-12-03,70053,70051,Blue,0,30091,30142,51
2022-01-03,70057,70047,Blue,0,46169,46625,456
2022-12-05,70042,70052,Blue,1,40571,41198,627
2022-01-14,70044,70048,Blue,1,68437,68713,276
2022-01-12,70046,70050,Blue,1,34234,34412,178
2022-06-22,70038,70054,Blue,1,33620,34488,868
2022-08-24,70038,70042,Blue,1,72861,72963,102
2022-01-15,70038,70050,Blue,1,29108,29684,576
2022-10-02,70048,70050,Blue,1,43456,43510,54
2022-09-09,70054,70056,Blue,1,54870,54918,48
2022-07-25,70043,70039,Blue,0,41553,41675,122
2022-09-23,70057,70051,Blue,0,64584,64831,247
2022-10-20,70059,70041,Blue,0,79862,80752,890
2022-08-28,70044,70046,Blue,1,49600,49704,104
2022-02-06,70044,70054,Blue,1,48044,48607,563
2022-04-06,70051,70039,Blue,0,62284,62922,638
2022-05-19,70044,70058,Blue,1,59359,60223,864
2022-06-23,70042,70046,Blue,1,80825,81046,221
2022-02-16,70045,70838,Blue,0,85926,86261,335
2022-11-21,70046,70054,Blue,1,56410,56870,460
2022-09-09,70050,70054,Blue,1,77841,78042,201
2022-07-16,70045,70838,Blue,0,32653,33004,351
2022-07-31,70050,70056,Blue,1,42882,43229,347
2022-01-18,70038,70058,Blue,1,72604,73705,1101
2022-01-18,70040,70052,Blue,1,68440,69218,778
2022-01-25,70059,70045,Blue,0,43395,44206,811
2022-12-09,70044,70048,Blue,1,79118,79367,249
2022-11-12,70042,70044,Blue,1,61244,61270,26
2022-03-18,70038,70054,Blue,1,68957,69798,841
2022-02-20,70052,70058,Blue,1,76554,76788,234
2022-02-22,70042,70048,Blue,1,64787,65086,299
2022-03-10,70038,70054,Blue,1,46977,47920,943
2022-02-20,70042,70044,Blue,1,44491,44526,35
2022-02-03,70048,70058,Blue,1,40206,40745,539
2022-10-08,70045,70039,Blue,0,47297,47558,261
2022-12-17,70038,70054,Blue,1,30187,30937,750
2022-05-09,70052,70060,Blue,1,30874,31227,353
2022-10-27,70049,70838,Blue,0,68070,68642,572
2022-07-01,70045,70041,Blue,0,39596,39819,223
2022-08-24,70055,70838,Blue,0,34125,35237,1112
2022-09-29,70050,70060,Blue,1,44199,44727,528
2022-07-04,70049,70041,Blue,0,87761,88157,396
2022-05-19,70046,70060,Blue,1,28207,29057,850
2022-03-22,70038,70044,Blue,1,55669,55869,200
2022-07-04,70056,70058,Blue,1,36506,36579,73
2022-07-31,70044,70056,Blue,1,79327,80055,728
2022-07-05,70038,70058,Blue,1,40878,42002,1124
2022-07-28,70057,70053,Blue,0,39607,39764,157
2022-03-05,70038,70040,Blue,1,25629,25651,22
2022-08-24,70054,70060,Blue,1,69490,69745,255
2022-06-23,70040,70054,Blue,1,44316,45121,805
2022-08-20,70041,70039,Blue,0,50258,50292,34
2022-06-09,70038,70054,Blue,1,23060,24118,1058
2022-04-21,70038,70044,Blue,1,51953,52113,160
2022-11-02,70038,70048,Blue,1,61163,61661,498
2022-07-30,70042,70054,Blue,1,54130,54830,700
2022-06-15,70048,70050,Blue,1,67876,67937,61
2022-07-22,70040,70052,Blue,1,30025,30660,635
2022-04-13,70048,70056,Blue,1,40694,41149,455
2022-10-27,70048,70054,Blue,1,41090,41449,359
2022-02-28,70053,70051,Blue,0,63481,63539,58
2022-10-26,70057,70049,Blue,0,26434,26860,426
2022-04-24,70047,70838,Blue,0,22896,23395,499
2022-01-12,70051,70838,Blue,0,33085,33809,724
2022-01-20,70038,70046,Blue,1,66180,66530,350
2022-10-23,70059,70047,Blue,0,26179,26700,521
2022-02-01,70052,70054,Blue,1,60614,60671,57
2022-02-03,70048,70060,Blue,1,80292,80937,645
2022-06-05,70045,70838,Blue,0,45690,46049,359
2022-04-11,70055,70049,Blue,0,27427,27709,282
2022-04-06,70040,70048,Blue,1,19884,20305,421
2022-03-15,70048,70050,Blue,1,28135,28189,54
2022-09-29,70046,70058,Blue,1,26654,27301,647
2022-03-24,70038,70040,Blue,1,66792,66806,14
2022-03-05,70055,70049,Blue,0,74234,74511,277
2022-12-16,70042,70050,Blue,1,52199,52595,396
2022-03-08,70040,70044,Blue,1,48761,48891,130
2022-09-17,70055,70053,Blue,0,47303,47350,47
2022-08-19,70052,70054,Blue,1,61229,61297,68
2022-09-01,70059,70047,Blue,0,70221,70759,538
2022-03-22,70044,70056,Blue,1,43731,44475,744
2022-10-21,70050,70060,Blue,1,74466,74958,492
2022-10-04,70052,70060,Blue,1,66807,67219,412
2022-06-09,70059,70041,Blue,0,23962,25009,1047
2022-06-26,70042,70048,Blue,1,32606,32937,331
2022-10-28,70046,70050,Blue,1,42412,42609,197
2022-12-20,70055,70049,Blue,0,73715,74108,393
2022-12-27,70059,70045,Blue,0,78180,78879,699
2022-05-26,70042,70044,Blue,1,84782,84809,27
2022-03-23,70055,70838,Blue,0,32872,33823,951
2022-02-17,70056,70058,Blue,1,61108,61194,86
2022-04-12,70038,70058,Blue,1,51917,52911,994
2022-08-31,70055,70039,Blue,0,22772,23659,887
2022-05-20,70040,70060,Blue,1,27049,28161,1112
2022-03-31,70042,70050,Blue,1,32195,32630,435
2022-08-19,70042,70046,Blue,1,35915,36097,182
2022-07-01,70053,70838,Blue,0,54721,55635,914
2022-12-08,70056,70058,Blue,1,72088,72163,75
2022-12-05,70059,70043,Blue,0,50957,51785,828
2022-01-12,70054,70056,Blue,1,21227,21276,49
2022-09-29,70056,70060,Blue,1,49283,49451,168
2022-08-20,70050,70056,Blue,1,51879,52170,291
2022-12-03,70051,70047,Blue,0,69005,69202,197
2022-11-29,70048,70054,Blue,1,62736,63037,301
2022-03-07,70038,70056,Blue,1,81444,82368,924
2022-12-15,70052,70056,Blue,1,25020,25173,153
2022-03-22,70043,70039,Blue,0,79819,79928,109
2022-02-13,70053,70838,Blue,0,55724,56607,883
2022-09-28,70057,70055,Blue,0,57608,57677,69
2022-12-11,70038,70044,Blue,1,26896,27063,167
2022-04-27,70050,70052,Blue,1,58650,58758,108
2022-12-11,70038,70058,Blue,1,69374,70346,972
2022-07-05,70049,70047,Blue,0,78011,78071,60
2022-04-14,70052,70058,Blue,1,75988,76248,260
2022-03-14,70038,70058,Blue,1,66426,67401,975
2022-02-18,70051,70039,Blue,0,21767,22521,754
2022-01-14,70046,70048,Blue,1,43903,43987,84
2022-03-07,70044,70050,Blue,1,42601,42958,357
2022-06-16,70038,70052,Blue,1,56228,57003,775
2022-01-06,70047,70041,Blue,0,86348,86635,287
2022-06-10,70055,70045,Blue,0,22235,22753,518
2022-04-02,70046,70048,Blue,1,58661,58756,95
2022-05-30,70040,70048,Blue,1,84423,84919,496
2022-07-25,70053,70838,Blue,0,23700,24624,924
2022-01-27,70059,70057,Blue,0,41538,41573,35
2022-02-21,70042,70060,Blue,1,81528,82517,989
2022-06-29,70042,70058,Blue,1,62134,63137,1003
2022-02-23,70053,70045,Blue,0,40736,41297,561
2022-02-15,70059,70055,Blue,0,62612,62757,145
2022-01-31,70044,70058,Blue,1,52801,53697,896
2022-08-11,70046,70054,Blue,1,21472,21952,480
2022-03-27,70056,70058,Blue,1,63301,63383,82
2022-09-16,70051,70045,Blue,0,63859,64274,415
2022-05-05,70053,70047,Blue,0,40213,40568,355
2022-12-08,70055,70049,Blue,0,27279,27554,275
2022-05-26,70038,70046,Blue,1,43878,44230,352
2022-07-31,70059,70043,Blue,0,43457,44293,836
2022-03-01,70040,70042,Blue,1,51672,51703,31
2022-08-03,70059,70039,Blue,0,65532,66515,983
2022-07-08,70046,70052,Blue,1,54185,54537,352
2022-04-09,70049,70045,Blue,0,18932,19168,236
2022-08-02,70056,70060,Blue,1,70668,70896,228
2022-06-19,70052,70060,Blue,1,86350,86721,371
2022-11-23,70048,70052,Blue,1,27367,27577,210
2022-04-12,70059,70045,Blue,0,64695,65416,721
2022-01-13,70053,70047,Blue,0,61662,61945,283
2022-03-10,70057,70838,Blue,0,44431,45522,1091
2022-08-08,70055,70051,Blue,0,70411,70545,134
2022-04-18,70050,70058,Blue,1,67071,67452,381
2022-04-22,70044,70056,Blue,1,45107,45847,740
2022-07-13,70045,70039,Blue,0,72484,72750,266
2022-05-19,70049,70838,Blue,0,33185,33909,724
2022-08-02,70044,70046,Blue,1,44359,44466,107
2022-06-19,70038,70054,Blue,1,28516,29410,894
2022-02-21,70059,70045,Blue,0,71353,72069,716
2022-03-30,70038,70046,Blue,1,31455,31796,341
2022-12-13,70049,70838,Blue,0,31369,32030,661
2022-03-15,70051,70049,Blue,0,55778,55883,105
2022-01-06,70055,70041,Blue,0,24448,25152,704
2022-03-31,70059,70057,Blue,0,59896,59931,35
2022-02-24,70041,70039,Blue,0,55666,55714,48
2022-11-12,70053,70045,Blue,0,46770,47185,415
2022-06-20,70038,70050,Blue,1,46117,46703,586
2022-10-06,70049,70047,Blue,0,87118,87173,55
2022-02-11,70055,70039,Blue,0,31341,32205,864
2022-07-14,70051,70838,Blue,0,85383,86202,819
2022-02-22,70043,70041,Blue,0,38025,38056,31
2022-01-19,70047,70041,Blue,0,63254,63557,303
2022-01-07,70040,70042,Blue,1,52844,52881,37
2022-11-18,70059,70049,Blue,0,42897,43451,554
2022-06-15,70047,70045,Blue,0,75470,75572,102
2022-05-18,70059,70051,Blue,0,45071,45404,333
2022-10-28,70059,70039,Blue,0,38476,39543,1067
2022-09-02,70044,70048,Blue,1,62988,63231,243
2022-07-20,70051,70049,Blue,0,75249,75351,102
2022-02-16,70050,70060,Blue,1,25751,26276,525
2022-03-22,70046,70050,Blue,1,68916,69112,196
2022-09-10,70048,70058,Blue,1,84461,84995,534
2022-10-05,70047,70039,Blue,0,29550,30047,497
2022-03-11,70054,70056,Blue,1,69143,69190,47
2022-12-19,70048,70058,Blue,1,64354,64932,578
2022-06-16,70057,70838,Blue,0,54896,55999,1103
2022-02-07,70053,70043,Blue,0,66779,67391,612
2022-10-27,70049,70043,Blue,0,27519,27880,361
2022-10-03,70057,70039,Blue,0,43783,44773,990
2022-04-04,70059,70055,Blue,0,41535,41676,141
2022-04-09,70057,70039,Blue,0,69835,70710,875
2022-07-25,70038,70048,Blue,1,26921,27393,472
2022-02-17,70040,70050,Blue,1,86312,86878,566
2022-08-13,70047,70045,Blue,0,65496,65597,101
2022-11-17,70057,70049,Blue,0,29169,29563,394
2022-11-16,70048,70058,Blue,1,24879,25402,523
2022-02-14,70053,70049,Blue,0,88433,88619,186
2022-12-02,70054,70060,Blue,1,23941,24218,277
2022-10-28,70044,70052,Blue,1,54161,54679,518
2022-06-25,70044,70054,Blue,1,53945,54586,641
2022-08-22,70051,70049,Blue,0,25448,25551,103
2022-02-15,70059,70053,Blue,0,63192,63415,223
2022-04-20,70043,70041,Blue,0,27741,27771,30
2022-11-05,70052,70056,Blue,1,67885,68026,141
2022-08-16,70048,70060,Blue,1,46260,46871,611
2022-02-25,70058,70060,Blue,1,89396,89465,69
2022-07-26,70055,70039,Blue,0,65941,66829,888
2022-06-17,70038,70050,Blue,1,52565,53185,620
2022-03-28,70048,70050,Blue,1,33812,33870,58
2022-12-30,70051,70043,Blue,0,47816,48303,487
2022-04-07,70059,70057,Blue,0,64398,64432,34
2022-12-11,70058,70060,Blue,1,66144,66211,67
2022-11-22,70049,70838,Blue,0,48854,49406,552
2022-12-21,70055,70051,Blue,0,34297,34431,134
2022-08-31,70057,70045,Blue,0,71314,71930,616
2022-10-27,70053,70051,Blue,0,33766,33831,65
2022-07-07,70053,70838,Blue,0,46864,47728,864
2022-08-17,70048,70052,Blue,1,44187,44382,195
2022-07-03,70044,70048,Blue,1,55573,55822,249
2022-07-31,70057,70051,Blue,0,64173,64408,235
2022-02-07,70059,70043,Blue,0,54460,55330,870
2022-03-15,70051,70039,Blue,0,88143,88880,737
2022-04-03,70047,70045,Blue,0,23650,23773,123
2022-04-11,70046,70052,Blue,1,47902,48242,340
2022-05-19,70038,70040,Blue,1,24628,24647,19
2022-04-06,70054,70056,Blue,1,76119,76166,47
2022-05-27,70045,70039,Blue,0,45572,45878,306
2022-06-09,70046,70052,Blue,1,68696,69020,324
2022-03-22,70051,70043,Blue,0,29711,30182,471
2022-03-09,70053,70047,Blue,0,70225,70512,287
2022-03-06,70048,70052,Blue,1,69917,70128,211
2022-07-26,70057,70039,Blue,0,62868,63805,937
2022-01-14,70044,70060,Blue,1,22981,23985,1004
2022-07-02,70041,70838,Blue,0,66448,66566,118
2022-08-18,70055,70043,Blue,0,26549,27275,726
2022-02-23,70049,70045,Blue,0,84055,84302,247
2022-02-16,70046,70054,Blue,1,69625,70076,451
2022-07-31,70053,70043,Blue,0,69246,69820,574
2022-02-25,70057,70053,Blue,0,23741,23906,165
2022-02-01,70045,70041,Blue,0,41650,41825,175
2022-10-23,70055,70045,Blue,0,24010,24503,493
2022-02-16,70050,70060,Blue,1,88321,88817,496
2022-09-02,70044,70060,Blue,1,29701,30796,1095
2022-10-21,70057,70051,Blue,0,30215,30455,240
2022-03-13,70042,70050,Blue,1,23428,23883,455
2022-10-17,70055,70049,Blue,0,40343,40669,326
2022-01-24,70052,70058,Blue,1,24460,24723,263
2022-04-15,70050,70058,Blue,1,23648,24072,424
2022-10-02,70040,70042,Blue,1,55941,55972,31
2022-10-02,70040,70046,Blue,1,73756,74009,253
2022-10-16,70042,70052,Blue,1,89248,89807,559
2022-02-08,70048,70058,Blue,1,41246,41826,580
2022-01-27,70057,70039,Blue,0,76716,77741,1025
2022-11-21,70049,70043,Blue,0,84192,84551,359
2022-04-20,70059,70057,Blue,0,53589,53624,35
2022-09-08,70051,70041,Blue,0,37329,37925,596
2022-10-16,70053,70041,Blue,0,64363,65005,642
2022-08-25,70048,70054,Blue,1,56658,56965,307
2022-11-21,70059,70043,Blue,0,21755,22655,900
2022-11-25,70044,70046,Blue,1,74396,74507,111
2022-10-19,70039,70838,Blue,0,85978,86007,29
2022-02-01,70055,70051,Blue,0,84181,84329,148
2022-03-31,70055,70043,Blue,0,43387,44045,658
2022-11-21,70052,70056,Blue,1,73546,73693,147
2022-07-26,70052,70056,Blue,1,82681,82830,149
2022-10-14,70048,70056,Blue,1,35762,36125,363
2022-03-22,70054,70056,Blue,1,47223,47269,46
2022-03-25,70049,70041,Blue,0,45490,45911,421
2022-05-18,70038,70048,Blue,1,29705,30259,554
2022-01-25,70057,70043,Blue,0,59970,60771,801
2022-08-21,70051,70049,Blue,0,69307,69407,100
2022-08-25,70041,70039,Blue,0,65425,65456,31
2022-02-27,70047,70041,Blue,0,50626,50971,345
2022-04-09,70042,70048,Blue,1,83965,84339,374
2022-08-24,70051,70041,Blue,0,59364,60038,674
2022-04-13,70046,70056,Blue,1,60615,61190,575
2022-07-25,70044,70050,Blue,1,47504,47865,361
2022-03-26,70043,70039,Blue,0,46509,46631,122
2022-03-25,70040,70042,Blue,1,65304,65335,31
2022-12-15,70059,70053,Blue,0,74894,75126,232
2022-02-26,70048,70056,Blue,1,53481,53890,409
2022-01-14,70057,70045,Blue,0,80155,80822,667
2022-11-29,70044,70058,Blue,1,57359,58188,829
2022-02-25,70040,70052,Blue,1,54382,55061,679
2022-04-13,70047,70045,Blue,0,24865,24952,87
2022-12-14,70044,70060,Blue,1,66130,67043,913
2022-02-02,70056,70058,Blue,1,80789,80885,96
2022-04-21,70054,70056,Blue,1,59426,59473,47
2022-11-03,70038,70056,Blue,1,22217,23053,836
2022-03-10,70040,70058,Blue,1,69971,70905,934
2022-03-13,70040,70052,Blue,1,68355,69010,655
2022-09-16,70044,70060,Blue,1,60426,61281,855
2022-04-01,70056,70060,Blue,1,88118,88292,174
2022-03-25,70047,70838,Blue,0,58076,58593,517
2022-06-08,70042,70052,Blue,1,27341,28038,697
2022-12-17,70059,70043,Blue,0,46512,47369,857
2022-08-17,70058,70060,Blue,1,62415,62480,65
2022-02-08,70057,70055,Blue,0,68548,68616,68
2022-11-18,70038,70056,Blue,1,34033,34944,911
2022-01-27,70055,70041,Blue,0,22953,23818,865
2022-10-15,70051,70838,Blue,0,76639,77420,781
2022-10-29,70042,70054,Blue,1,43854,44556,702
2022-08-07,70059,70039,Blue,0,46272,47290,1018
2022-04-21,70059,70047,Blue,0,40934,41576,642
2022-06-13,70048,70050,Blue,1,71446,71500,54
2022-06-12,70055,70041,Blue,0,44853,45676,823
2022-07-13,70042,70048,Blue,1,27989,28335,346
2022-09-06,70045,70838,Blue,0,27190,27596,406
2022-03-31,70053,70051,Blue,0,64964,65019,55
2022-02-24,70046,70058,Blue,1,44528,45250,722
2022-03-14,70042,70060,Blue,1,23212,24202,990
2022-02-26,70043,70041,Blue,0,70713,70741,28
2022-06-10,70048,70056,Blue,1,39940,40373,433
2022-02-06,70041,70838,Blue,0,78570,78680,110
2022-04-07,70059,70041,Blue,0,31159,32092,933
2022-01-25,70042,70060,Blue,1,55419,56432,1013
2022-08-26,70055,70049,Blue,0,29913,30218,305
2022-06-14,70051,70049,Blue,0,51664,51768,104
2022-05-19,70052,70056,Blue,1,74278,74437,159
2022-08-30,70057,70041,Blue,0,33990,34848,858
2022-02-21,70042,70050,Blue,1,60060,60483,423
2022-09-14,70057,70053,Blue,0,31063,31229,166
2022-05-20,70059,70838,Blue,0,59294,60558,1264
2022-07-21,70051,70041,Blue,0,22946,23572,626
2022-09-12,70044,70056,Blue,1,28490,29175,685
2022-01-13,70046,70050,Blue,1,27434,27614,180
2022-02-07,70043,70041,Blue,0,68493,68523,30
2022-03-31,70040,70054,Blue,1,50842,51642,800
2022-11-21,70049,70838,Blue,0,28080,28719,639
2022-01-17,70048,70050,Blue,1,34459,34518,59
2022-01-14,70041,70039,Blue,0,30726,30756,30
2022-04-21,70050,70060,Blue,1,21538,22074,536
2022-01-11,70055,70045,Blue,0,48368,48846,478
2022-08-10,70055,70045,Blue,0,23194,23721,527
2022-09-19,70059,70047,Blue,0,38474,39065,591
2022-11-11,70048,70054,Blue,1,61353,61695,342
2022-06-16,70040,70046,Blue,1,82070,82379,309
2022-08-08,70053,70047,Blue,0,69461,69742,281
2022-06-01,70045,70041,Blue,0,22098,22304,206
2022-07-22,70057,70838,Blue,0,74062,75108,1046
2022-05-27,70045,70838,Blue,0,56192,56616,424
2022-03-24,70040,70056,Blue,1,54387,55263,876
2022-07-22,70053,70049,Blue,0,48102,48295,193
2022-11-03,70044,70056,Blue,1,85153,85878,725
2022-07-27,70042,70058,Blue,1,72215,73116,901
2022-04-04,70048,70050,Blue,1,25449,25509,60
2022-04-16,70055,70053,Blue,0,53181,53228,47
2022-10-24,70048,70058,Blue,1,80779,81281,502
2022-01-03,70047,70838,Blue,0,52151,52596,445
2022-10-31,70053,70039,Blue,0,63705,64483,778
2022-04-13,70052,70058,Blue,1,71670,71909,239
2022-05-04,70053,70047,Blue,0,61729,62137,408
2022-09-21,70041,70838,Blue,0,76955,77067,112
2022-06-29,70041,70838,Blue,0,35979,36101,122
2022-07-31,70052,70058,Blue,1,85398,85660,262
2022-01-28,70057,70043,Blue,0,29436,30370,934
2022-09-20,70044,70050,Blue,1,62504,62856,352
2022-02-06,70045,70043,Blue,0,79028,79156,128
2022-05-28,70038,70044,Blue,1,63875,64057,182
2022-10-21,70054,70056,Blue,1,79156,79203,47
2022-08-04,70057,70838,Blue,0,55409,56467,1058
2022-07-25,70047,70043,Blue,0,39876,40124,248
2022-01-04,70038,70044,Blue,1,39617,39767,150
2022-08-29,70042,70056,Blue,1,49885,50602,717
2022-04-12,70057,70051,Blue,0,33335,33609,274
2022-05-21,70040,70046,Blue,1,75085,75394,309
2022-02-27,70042,70058,Blue,1,47384,48233,849
2022-06-04,70038,70042,Blue,1,48857,48946,89
2022-07-29,70046,70058,Blue,1,29029,29771,742
2022-09-09,70048,70058,Blue,1,46393,46898,505
2022-12-26,70053,70049,Blue,0,44360,44540,180
2022-01-10,70053,70043,Blue,0,78592,79176,584
2022-02-24,70057,70043,Blue,0,81280,82142,862
2022-08-27,70048,70060,Blue,1,74075,74681,606
2022-02-10,70042,70058,Blue,1,89288,90078,790
2022-12-13,70044,70060,Blue,1,84490,85437,947
2022-09-29,70042,70046,Blue,1,53514,53683,169
2022-02-01,70046,70050,Blue,1,28620,28808,188
2022-01-12,70044,70056,Blue,1,66107,66857,750
2022-08-30,70055,70045,Blue,0,45508,46105,597
2022-03-30,70045,70838,Blue,0,61821,62134,313
2022-10-02,70048,70054,Blue,1,49843,50129,286
2022-02-18,70051,70049,Blue,0,69586,69691,105
2022-04-24,70043,70838,Blue,0,67614,67802,188
2022-02-13,70057,70055,Blue,0,57694,57763,69
2022-03-17,70040,70044,Blue,1,76998,77117,119
2022-02-04,70044,70048,Blue,1,71672,71911,239
2022-12-09,70055,70053,Blue,0,42282,42335,53
2022-04-01,70041,70838,Blue,0,62684,62814,130
2022-10-18,70053,70838,Blue,0,50683,51772,1089
2022-10-29,70050,70056,Blue,1,70330,70631,301
2022-11-04,70046,70052,Blue,1,21586,22074,488
2022-04-18,70042,70054,Blue,1,66304,66977,673
2022-10-28,70044,70046,Blue,1,78561,78671,110
2022-12-27,70057,70051,Blue,0,78254,78501,247
2022-11-22,70038,70048,Blue,1,75186,75633,447
2022-08-03,70043,70838,Blue,0,28990,29209,219
2022-07-07,70053,70045,Blue,0,87557,87960,403
2022-07-15,70059,70051,Blue,0,30982,31540,558
2022-04-19,70050,70058,Blue,1,25051,25504,453
2022-03-22,70042,70054,Blue,1,51358,52017,659
2022-07-04,70055,70045,Blue,0,71651,72176,525
2022-11-18,70055,70838,Blue,0,22746,23754,1008
2022-07-08,70055,70838,Blue,0,65536,66472,936
2022-02-23,70055,70045,Blue,0,31925,32436,511
2022-02-11,70057,70043,Blue,0,85233,86044,811
2022-09-14,70046,70060,Blue,1,79904,80616,712
2022-09-01,70044,70052,Blue,1,25821,26296,475
2022-08-06,70044,70054,Blue,1,77599,78241,642
2022-04-07,70049,70838,Blue,0,29273,29878,605
2022-03-11,70038,70052,Blue,1,23352,24080,728
2022-03-07,70042,70054,Blue,1,60189,61005,816
2022-07-09,70047,70041,Blue,0,37937,38310,373
2022-10-05,70054,70056,Blue,1,72513,72561,48
2022-01-31,70040,70046,Blue,1,63854,64124,270
2022-08-04,70059,70043,Blue,0,44206,45096,890
2022-08-23,70049,70838,Blue,0,50459,51117,658
2022-02-15,70054,70060,Blue,1,79344,79604,260
2022-08-28,70059,70043,Blue,0,46278,47119,841
2022-04-09,70040,70044,Blue,1,30245,30356,111
2022-10-28,70057,70047,Blue,0,44853,45344,491
2022-08-08,70052,70060,Blue,1,45301,45656,355
2022-10-05,70041,70039,Blue,0,55088,55123,35
2022-08-08,70046,70060,Blue,1,83915,84664,749
2022-02-08,70041,70838,Blue,0,75926,76048,122
2022-02-04,70045,70039,Blue,0,80995,81313,318
2022-02-11,70044,70050,Blue,1,67631,68012,381
2022-01-15,70040,70044,Blue,1,69405,69514,109
2022-08-17,70057,70051,Blue,0,61955,62201,246
2022-10-01,70040,70052,Blue,1,89192,89873,681
2022-01-11,70044,70046,Blue,1,55560,55694,134
2022-11-12,70059,70055,Blue,0,48132,48278,146
2022-01-10,70053,70043,Blue,0,83118,83704,586
2022-01-07,70055,70039,Blue,0,31064,31970,906
2022-08-23,70040,70056,Blue,1,25418,26295,877
2022-06-27,70038,70048,Blue,1,30181,30697,516
2022-10-24,70054,70060,Blue,1,71447,71757,310
2022-02-23,70049,70047,Blue,0,45477,45531,54
2022-11-08,70055,70051,Blue,0,76639,76771,132
2022-02-21,70053,70047,Blue,0,54898,55179,281
2022-08-23,70057,70838,Blue,0,42353,43535,1182
2022-08-25,70054,70056,Blue,1,85243,85290,47
2022-02-05,70057,70041,Blue,0,37956,38759,803
2022-06-22,70056,70058,Blue,1,38322,38394,72
2022-09-30,70049,70039,Blue,0,32738,33228,490
2022-09-05,70057,70053,Blue,0,79752,79911,159
2022-10-23,70039,70838,Blue,0,68330,68359,29
2022-07-29,70050,70054,Blue,1,34322,34589,267
2022-07-06,70057,70055,Blue,0,50055,50139,84
2022-04-21,70059,70051,Blue,0,48192,48508,316
2022-06-20,70057,70055,Blue,0,67399,67469,70
2022-09-19,70055,70047,Blue,0,43896,44274,378
2022-08-09,70059,70039,Blue,0,45350,46473,1123
2022-06-14,70055,70043,Blue,0,80778,81532,754
2022-06-10,70051,70049,Blue,0,27371,27474,103
2022-09-07,70045,70041,Blue,0,61304,61476,172
2022-05-20,70049,70045,Blue,0,83376,83633,257
2022-09-16,70053,70045,Blue,0,27460,27880,420
2022-09-25,70052,70056,Blue,1,88928,89061,133
2022-11-06,70048,70058,Blue,1,36727,37215,488
2022-02-17,70043,70041,Blue,0,79855,79883,28
2022-05-02,70055,70053,Blue,0,57435,57481,46
2022-04-15,70048,70056,Blue,1,25740,26188,448
2022-11-05,70053,70045,Blue,0,48409,48843,434
2022-03-27,70040,70058,Blue,1,76460,77540,1080
2022-01-11,70055,70838,Blue,0,20066,20958,892
2022-11-29,70051,70047,Blue,0,33375,33593,218
2022-05-18,70055,70047,Blue,0,70546,70926,380
2022-12-17,70042,70058,Blue,1,87496,88416,920
2022-04-13,70051,70043,Blue,0,45308,45808,500
2022-05-20,70047,70045,Blue,0,74944,75099,155
2022-01-24,70042,70058,Blue,1,35848,36893,1045
2022-02-05,70051,70041,Blue,0,61518,62098,580
2022-12-02,70039,70838,Blue,0,20842,20877,35
2022-12-02,70053,70838,Blue,0,52814,53660,846
2022-04-15,70054,70060,Blue,1,22983,23384,401
2022-05-20,70057,70045,Blue,0,67953,68667,714
2022-12-04,70050,70058,Blue,1,61051,61552,501
2022-01-13,70044,70054,Blue,1,86279,86852,573
2022-02-04,70038,70052,Blue,1,76900,77732,832
2022-07-31,70039,70838,Blue,0,84892,84926,34
2022-10-21,70051,70043,Blue,0,43730,44269,539
2022-10-29,70040,70042,Blue,1,36738,36774,36
2022-03-10,70049,70043,Blue,0,52603,52975,372
2022-11-17,70047,70039,Blue,0,46218,46630,412
2022-04-23,70055,70051,Blue,0,60735,60875,140
2022-03-03,70059,70041,Blue,0,58399,59317,918
2022-11-10,70040,70048,Blue,1,54218,54661,443
2022-01-22,70044,70056,Blue,1,47688,48361,673
2022-08-31,70059,70051,Blue,0,85554,85861,307
2022-06-07,70040,70048,Blue,1,87746,88340,594
2022-11-11,70053,70047,Blue,0,35840,36160,320
2022-04-20,70040,70044,Blue,1,32724,32836,112
2022-02-10,70051,70039,Blue,0,52217,52906,689
2022-08-04,70047,70838,Blue,0,60349,60843,494
2022-06-23,70051,70047,Blue,0,54849,55054,205
2022-07-16,70057,70053,Blue,0,50918,51077,159
2022-03-16,70038,70050,Blue,1,45253,45824,571
2022-01-03,70047,70043,Blue,0,57539,57874,335
2022-12-24,70042,70048,Blue,1,57884,58190,306
2022-03-11,70049,70838,Blue,0,40401,41070,669
2022-07-15,70048,70060,Blue,1,72408,73001,593
2022-11-20,70059,70051,Blue,0,22997,23345,348
2022-09-22,70038,70042,Blue,1,30896,30999,103
2022-03-29,70052,70060,Blue,1,62658,63112,454
2022-01-29,70054,70058,Blue,1,84645,84950,305
2022-07-02,70040,70042,Blue,1,79995,80026,31
2022-03-20,70055,70049,Blue,0,63731,63995,264
2022-02-17,70055,70039,Blue,0,37265,38263,998
2022-08-16,70044,70058,Blue,1,51749,52586,837
2022-06-13,70038,70044,Blue,1,59284,59493,209
2022-04-14,70044,70054,Blue,1,81687,82239,552
2022-12-21,70051,70041,Blue,0,33891,34480,589
2022-10-12,70055,70047,Blue,0,24812,25190,378
2022-01-01,70046,70056,Blue,1,29579,30073,494
2022-12-31,70055,70041,Blue,0,52660,53394,734
2022-01-10,70040,70044,Blue,1,52535,52657,122
2022-01-24,70059,70039,Blue,0,56296,57398,1102
2022-10-24,70056,70058,Blue,1,65746,65815,69
2022-04-14,70051,70039,Blue,0,61744,62407,663
2022-02-18,70039,70838,Blue,0,56631,56668,37
2022-12-04,70059,70051,Blue,0,72212,72530,318
2022-11-08,70042,70046,Blue,1,21927,22094,167
2022-07-02,70055,70045,Blue,0,60747,61284,537
2022-04-04,70059,70049,Blue,0,30254,30753,499
2022-10-05,70046,70060,Blue,1,25608,26321,713
2022-12-14,70053,70049,Blue,0,85401,85610,209
2022-09-24,70052,70054,Blue,1,68827,68871,44
2022-01-21,70041,70838,Blue,0,43016,43140,124
2022-07-20,70057,70041,Blue,0,59110,59987,877
2022-09-05,70043,70838,Blue,0,59065,59284,219
2022-02-08,70045,70041,Blue,0,58215,58404,189
2022-06-20,70044,70058,Blue,1,25163,26190,1027
2022-11-22,70053,70045,Blue,0,49658,50084,426
2022-03-14,70057,70043,Blue,0,26748,27540,792
2022-01-04,70043,70041,Blue,0,82651,82681,30
2022-07-28,70049,70047,Blue,0,55063,55132,69
2022-08-18,70048,70058,Blue,1,84030,84604,574
2022-05-21,70040,70042,Blue,1,65625,65656,31
2022-07-10,70044,70052,Blue,1,86659,87158,499
2022-07-02,70047,70043,Blue,0,51466,51727,261
2022-11-04,70055,70838,Blue,0,67188,68199,1011
2022-07-06,70055,70041,Blue,0,85991,86726,735
2022-06-30,70046,70054,Blue,1,62593,63054,461
2022-09-23,70038,70044,Blue,1,37420,37584,164
2022-06-22,70038,70056,Blue,1,52676,53692,1016
2022-11-24,70041,70039,Blue,0,47728,47760,32
2022-04-19,70040,70054,Blue,1,61701,62434,733
2022-12-24,70044,70046,Blue,1,76877,76984,107
2022-03-14,70040,70044,Blue,1,59617,59740,123
2022-08-31,70042,70052,Blue,1,87032,87580,548
2022-11-16,70051,70838,Blue,0,20291,21098,807
2022-08-25,70049,70039,Blue,0,53656,54236,580
2022-07-20,70053,70047,Blue,0,25354,25652,298
2022-07-09,70057,70049,Blue,0,36344,36759,415
2022-03-30,70042,70050,Blue,1,35494,35887,393
2022-01-31,70040,70048,Blue,1,32967,33466,499
2022-09-12,70047,70043,Blue,0,33738,33971,233
2022-10-19,70049,70039,Blue,0,76410,76927,517
2022-11-20,70057,70041,Blue,0,49598,50471,873
2022-07-06,70047,70041,Blue,0,77099,77430,331
2022-03-06,70059,70041,Blue,0,52753,53664,911
2022-06-09,70042,70056,Blue,1,23198,24222,1024
2022-03-05,70057,70049,Blue,0,33629,34059,430
2022-10-11,70038,70042,Blue,1,80094,80193,99
2022-07-05,70042,70050,Blue,1,64264,64692,428
2022-04-14,70053,70049,Blue,0,73489,73708,219
2022-01-13,70046,70054,Blue,1,55356,55786,430
2022-04-03,70038,70058,Blue,1,70456,71435,979
2022-01-15,70042,70046,Blue,1,22463,22638,175
2022-07-06,70057,70039,Blue,0,31907,32932,1025
2022-12-11,70059,70053,Blue,0,66255,66487,232
2022-03-02,70042,70046,Blue,1,59729,59918,189
2022-04-19,70049,70047,Blue,0,57659,57716,57
2022-07-01,70055,70051,Blue,0,78012,78154,142
2022-01-03,70048,70058,Blue,1,69998,70508,510
2022-07-25,70046,70052,Blue,1,47663,48074,411
2022-05-24,70038,70050,Blue,1,68961,69610,649
2022-11-04,70038,70046,Blue,1,54659,54993,334
2022-03-25,70046,70052,Blue,1,86415,86724,309
2022-06-22,70047,70041,Blue,0,69680,70024,344
2022-06-12,70057,70051,Blue,0,75611,75869,258
2022-09-14,70057,70047,Blue,0,82746,83290,544
2022-02-12,70055,70041,Blue,0,55886,56697,811
2022-10-13,70054,70060,Blue,1,79216,79477,261
2022-09-23,70050,70054,Blue,1,55459,55680,221
2022-07-18,70044,70046,Blue,1,62675,62775,100
2022-01-27,70046,70052,Blue,1,72901,73238,337
2022-06-15,70059,70039,Blue,0,72074,73144,1070
2022-04-09,70059,70043,Blue,0,75793,76672,879
2022-07-22,70051,70039,Blue,0,50335,51007,672
2022-04-13,70045,70838,Blue,0,76896,77243,347
2022-08-24,70047,70838,Blue,0,29970,30636,666
2022-07-24,70053,70049,Blue,0,33481,33684,203
2022-04-12,70052,70058,Blue,1,45035,45307,272
2022-09-22,70042,70048,Blue,1,33058,33374,316
2022-03-22,70040,70056,Blue,1,48816,49659,843
2022-07-25,70046,70052,Blue,1,70618,70938,320
2022-01-27,70048,70056,Blue,1,50792,51215,423
2022-02-08,70048,70052,Blue,1,34388,34612,224
2022-05-01,70056,70060,Blue,1,23646,23803,157
2022-02-21,70053,70047,Blue,0,24467,24771,304
2022-09-05,70055,70047,Blue,0,66970,67324,354
2022-10-04,70051,70047,Blue,0,61948,62162,214
2022-08-19,70044,70060,Blue,1,24242,25148,906
2022-01-29,70042,70060,Blue,1,35793,37776,1983
2022-07-02,70051,70049,Blue,0,69013,69118,105
2022-04-04,70059,70051,Blue,0,36375,36734,359
2022-12-31,70053,70047,Blue,0,78520,78823,303
2022-02-01,70055,70041,Blue,0,62484,63282,798
2022-11-05,70057,70039,Blue,0,38494,39465,971
2022-06-09,70046,70056,Blue,1,62835,63379,544
2022-07-07,70044,70046,Blue,1,63911,64034,123
2022-04-18,70052,70058,Blue,1,53284,53560,276
2022-06-27,70038,70044,Blue,1,21502,21664,162
2022-08-11,70055,70838,Blue,0,29482,30477,995
2022-12-12,70049,70041,Blue,0,22778,23236,458
2022-02-13,70046,70048,Blue,1,38092,38166,74
2022-01-01,70057,70047,Blue,0,31715,32189,474
2022-01-17,70038,70052,Blue,1,64216,64987,771
2022-01-21,70055,70053,Blue,0,80251,80305,54
2022-02-25,70040,70054,Blue,1,25089,25937,848
2022-04-22,70055,70043,Blue,0,22584,23304,720
2022-08-16,70059,70049,Blue,0,33501,33971,470
2022-03-30,70053,70838,Blue,0,30875,31764,889
2022-02-08,70050,70054,Blue,1,81413,81620,207
2022-07-13,70038,70048,Blue,1,21096,21629,533
2022-12-15,70059,70045,Blue,0,32541,33265,724
2022-01-08,70040,70052,Blue,1,73983,74596,613
2022-12-02,70059,70053,Blue,0,46841,47076,235
2022-10-22,70043,70838,Blue,0,60943,61136,193
2022-12-27,70059,70051,Blue,0,37132,37481,349
2022-01-20,70055,70045,Blue,0,67699,68203,504
2022-03-23,70051,70047,Blue,0,41875,42065,190
2022-09-30,70046,70054,Blue,1,58517,59136,619
2022-08-06,70053,70838,Blue,0,57673,58540,867
2022-07-14,70059,70039,Blue,0,66327,67409,1082
2022-09-06,70045,70041,Blue,0,51774,51947,173
2022-12-01,70055,70039,Blue,0,77659,78521,862
2022-12-28,70059,70051,Blue,0,80004,80330,326
2022-12-19,70046,70054,Blue,1,29828,30237,409
2022-08-27,70050,70056,Blue,1,68108,68389,281
2022-12-31,70052,70056,Blue,1,86869,87001,132
2022-08-26,70057,70838,Blue,0,81809,82979,1170
2022-12-21,70053,70045,Blue,0,27546,27955,409
2022-07-20,70057,70051,Blue,0,55927,56193,266
2022-01-02,70038,70042,Blue,1,77474,77572,98
2022-12-14,70047,70045,Blue,0,80646,80740,94
2022-05-25,70038,70050,Blue,1,76210,76850,640
2022-02-02,70051,70047,Blue,0,85509,85698,189
2022-03-25,70038,70056,Blue,1,22751,23729,978
2022-10-13,70044,70060,Blue,1,62823,63753,930
2022-11-19,70055,70051,Blue,0,35939,36067,128
2022-09-02,70046,70056,Blue,1,31565,32278,713
2022-10-27,70047,70043,Blue,0,56001,56241,240
2022-12-22,70048,70052,Blue,1,66844,67061,217
2022-05-14,70052,70056,Blue,1,80127,80276,149
2022-04-07,70055,70047,Blue,0,51370,51732,362
2022-10-05,70040,70060,Blue,1,40947,41964,1017
2022-01-11,70059,70039,Blue,0,22753,23861,1108
2022-10-20,70042,70050,Blue,1,61311,61741,430
2022-01-01,70057,70047,Blue,0,26315,26797,482
2022-06-28,70042,70058,Blue,1,77024,77915,891
2022-05-09,70050,70054,Blue,1,25202,25415,213
2022-02-27,70044,70054,Blue,1,83207,83811,604
2022-08-03,70053,70041,Blue,0,62670,63340,670
2022-09-05,70042,70052,Blue,1,80724,81305,581
2022-12-26,70051,70043,Blue,0,49319,49790,471
2022-11-19,70046,70050,Blue,1,74828,75008,180
2022-09-29,70059,70055,Blue,0,68115,68263,148
2022-08-25,70047,70039,Blue,0,40598,41059,461
2022-04-09,70042,70056,Blue,1,51954,52692,738
2022-11-18,70050,70058,Blue,1,51046,51475,429
2022-03-13,70055,70041,Blue,0,66442,67200,758
2022-01-04,70044,70056,Blue,1,76080,76771,691
2022-08-17,70049,70047,Blue,0,73890,73951,61
2022-01-22,70038,70044,Blue,1,44779,44944,165
2022-10-12,70048,70050,Blue,1,79954,80009,55
2022-10-28,70053,70047,Blue,0,38747,39058,311
2022-07-15,70051,70045,Blue,0,74492,74840,348
2022-08-26,70054,70058,Blue,1,75378,75539,161
2022-01-21,70059,70039,Blue,0,53598,54620,1022
2022-08-31,70057,70045,Blue,0,25936,26628,692
2022-04-07,70055,70041,Blue,0,29540,30269,729
2022-02-18,70052,70058,Blue,1,35508,36008,500
2022-01-27,70045,70039,Blue,0,25394,25686,292
2022-10-05,70046,70058,Blue,1,71034,71700,666
2022-12-24,70038,70042,Blue,1,59890,59982,92
2022-12-08,70050,70060,Blue,1,46725,47256,531
2022-02-25,70051,70049,Blue,0,73640,73749,109
2022-07-28,70050,70058,Blue,1,52455,52882,427
2022-02-03,70054,70060,Blue,1,65067,65469,402
2022-01-26,70051,70047,Blue,0,80452,80676,224
2022-12-04,70038,70058,Blue,1,65660,66684,1024
2022-01-19,70040,70058,Blue,1,25475,26360,885
2022-10-18,70052,70060,Blue,1,53298,53687,389
2022-07-05,70040,70056,Blue,1,30752,31616,864
2022-06-23,70057,70838,Blue,0,77017,78118,1101
2022-09-28,70055,70043,Blue,0,43370,44118,748
2022-10-16,70055,70045,Blue,0,74586,75405,819
2022-07-07,70053,70049,Blue,0,62140,62359,219
2022-11-25,70044,70060,Blue,1,39042,39964,922
2022-01-12,70053,70039,Blue,0,62867,63681,814
2022-04-19,70057,70039,Blue,0,34250,35288,1038
2022-11-19,70038,70054,Blue,1,45846,46593,747
2022-03-18,70054,70058,Blue,1,52995,53148,153
2022-04-18,70055,70039,Blue,0,31336,32156,820
2022-09-10,70051,70045,Blue,0,66311,66636,325
2022-07-30,70050,70052,Blue,1,63827,63936,109
2022-12-20,70057,70045,Blue,0,54751,55364,613
2022-07-09,70041,70039,Blue,0,29154,29187,33
2022-03-16,70055,70041,Blue,0,70140,70875,735
2022-01-15,70048,70052,Blue,1,36674,36870,196
2022-10-01,70051,70041,Blue,0,42560,43160,600
2022-04-07,70051,70838,Blue,0,19239,20031,792
2022-07-25,70046,70056,Blue,1,30729,31270,541
2022-09-23,70052,70058,Blue,1,42405,42668,263
2022-04-14,70056,70060,Blue,1,26424,26655,231
2022-11-27,70059,70057,Blue,0,39389,39424,35
2022-02-24,70046,70050,Blue,1,67695,67870,175
2022-06-24,70053,70043,Blue,0,76836,77420,584
2022-10-20,70048,70056,Blue,1,27010,27406,396
2022-03-09,70051,70049,Blue,0,25829,25932,103
2022-07-04,70043,70041,Blue,0,72259,72291,32
2022-03-16,70054,70058,Blue,1,64885,65045,160
2022-11-07,70048,70052,Blue,1,40822,41034,212
2022-11-15,70057,70039,Blue,0,30948,31986,1038
2022-01-10,70046,70054,Blue,1,54444,54858,414
2022-05-25,70045,70041,Blue,0,74070,74281,211
2022-02-15,70054,70058,Blue,1,68216,68379,163
2022-06-25,70059,70057,Blue,0,49887,49922,35
2022-08-16,70042,70056,Blue,1,81286,82074,788
2022-07-16,70042,70056,Blue,1,58050,58814,764
2022-04-19,70040,70046,Blue,1,60822,61125,303
2022-09-30,70041,70838,Blue,0,80230,80343,113
2022-10-17,70049,70045,Blue,0,71301,71493,192
2022-02-07,70038,70052,Blue,1,29696,30543,847
2022-01-12,70049,70838,Blue,0,52339,52937,598
2022-11-13,70041,70838,Blue,0,44387,44499,112
2022-11-12,70042,70054,Blue,1,41261,41962,701
2022-09-13,70057,70051,Blue,0,82882,83136,254
2022-10-25,70046,70054,Blue,1,29766,30205,439
2022-06-12,70053,70045,Blue,0,70304,70734,430
2022-04-13,70044,70056,Blue,1,65481,66161,680
2022-03-08,70040,70054,Blue,1,35303,36090,787
2022-04-27,70053,70049,Blue,0,32502,32699,197
2022-05-13,70058,70060,Blue,1,59563,59652,89
2022-11-03,70059,70838,Blue,0,56221,57367,1146
2022-03-10,70042,70046,Blue,1,56113,56303,190
2022-02-10,70045,70838,Blue,0,40779,41168,389
2022-08-19,70053,70043,Blue,0,71534,72120,586
2022-10-08,70055,70045,Blue,0,69386,69894,508
2022-09-18,70045,70043,Blue,0,51437,51541,104
2022-11-12,70038,70050,Blue,1,54500,55093,593
2022-03-04,70043,70838,Blue,0,54284,54558,274
2022-12-11,70040,70056,Blue,1,36307,37092,785
2022-07-31,70049,70041,Blue,0,55505,56000,495
2022-09-22,70057,70051,Blue,0,86614,86855,241
2022-08-07,70053,70045,Blue,0,58988,59424,436
2022-02-21,70040,70056,Blue,1,33507,34318,811
2022-01-23,70048,70060,Blue,1,55303,55887,584
2022-06-20,70051,70039,Blue,0,75732,76411,679
2022-01-23,70047,70838,Blue,0,53374,53931,557
2022-01-10,70051,70041,Blue,0,59675,60240,565
2022-02-19,70040,70044,Blue,1,36733,36852,119
2022-12-03,70059,70045,Blue,0,30331,31053,722
2022-02-26,70043,70041,Blue,0,65252,65281,29
2022-01-02,70042,70060,Blue,1,75990,76882,892
2022-03-14,70040,70052,Blue,1,54095,54753,658
2022-02-02,70059,70053,Blue,0,50286,50559,273
2022-04-11,70056,70060,Blue,1,30724,30914,190
2022-03-30,70052,70060,Blue,1,38612,39038,426
2022-02-20,70042,70060,Blue,1,66388,67422,1034
2022-11-23,70045,70041,Blue,0,54282,54440,158
2022-04-22,70051,70049,Blue,0,84347,84449,102
2022-02-23,70053,70049,Blue,0,76332,76527,195
2022-12-08,70049,70039,Blue,0,40021,40504,483
2022-06-09,70053,70049,Blue,0,78598,78836,238
2022-07-03,70044,70058,Blue,1,36479,37309,830
2022-07-13,70048,70054,Blue,1,89587,89915,328
2022-04-03,70055,70041,Blue,0,24030,24842,812
2022-12-06,70051,70045,Blue,0,67938,68271,333
2022-05-23,70038,70044,Blue,1,39073,39268,195
2022-03-18,70055,70043,Blue,0,76208,76808,600
2022-03-17,70059,70053,Blue,0,67886,68131,245
2022-11-03,70046,70058,Blue,1,22169,22797,628
2022-04-24,70057,70838,Blue,0,27027,28111,1084
2022-12-30,70040,70042,Blue,1,39954,39985,31
2022-04-18,70057,70041,Blue,0,61901,62833,932
2022-01-26,70059,70039,Blue,0,66515,67541,1026
2022-09-01,70046,70058,Blue,1,80009,80612,603
2022-08-06,70057,70051,Blue,0,62828,63071,243
2022-09-17,70043,70039,Blue,0,30196,30305,109
2022-05-20,70038,70040,Blue,1,86248,86262,14
2022-03-31,70042,70052,Blue,1,83849,84421,572
2022-10-04,70046,70060,Blue,1,78854,79599,745
2022-04-02,70049,70039,Blue,0,87849,88296,447
2022-11-04,70040,70048,Blue,1,69588,70115,527
2022-01-20,70051,70043,Blue,0,21058,21676,618
2022-12-24,70043,70838,Blue,0,37144,37358,214
2022-06-10,70042,70050,Blue,1,86198,86662,464
2022-03-28,70038,70052,Blue,1,51195,51914,719
2022-09-03,70042,70052,Blue,1,88343,88896,553
2022-08-22,70057,70041,Blue,0,87442,88391,949
2022-01-15,70048,70052,Blue,1,24811,25012,201
2022-11-08,70056,70060,Blue,1,78268,78449,181
2022-11-05,70044,70046,Blue,1,28260,28365,105
2022-10-13,70057,70838,Blue,0,26467,27592,1125
2022-12-07,70055,70041,Blue,0,56897,57572,675
2022-08-29,70038,70046,Blue,1,27313,27634,321
2022-09-17,70055,70051,Blue,0,33739,33879,140
2022-03-06,70059,70055,Blue,0,74896,75041,145
2022-02-19,70046,70058,Blue,1,70530,71214,684
2022-04-14,70038,70050,Blue,1,80313,80854,541
2022-08-09,70059,70041,Blue,0,69692,70621,929
2022-01-09,70049,70045,Blue,0,73242,73443,201
2022-09-13,70057,70049,Blue,0,69880,70734,854
2022-02-25,70050,70054,Blue,1,22505,22737,232
2022-08-19,70057,70838,Blue,0,20031,21150,1119
2022-11-29,70052,70056,Blue,1,45266,45403,137
2022-06-09,70047,70045,Blue,0,23543,23645,102
2022-06-09,70050,70054,Blue,1,63318,63536,218
2022-09-09,70055,70043,Blue,0,63077,63744,667
2022-12-27,70038,70052,Blue,1,60507,61267,760
2022-07-02,70042,70046,Blue,1,61151,61339,188
2022-10-21,70057,70055,Blue,0,45824,45893,69
2022-02-14,70059,70055,Blue,0,59295,59438,143
2022-12-06,70040,70058,Blue,1,64579,65631,1052
2022-02-14,70046,70050,Blue,1,77246,77419,173
2022-02-16,70055,70053,Blue,0,62468,62552,84
2022-12-18,70040,70050,Blue,1,89177,89662,485
2022-09-13,70038,70040,Blue,1,54918,54934,16
2022-09-25,70053,70049,Blue,0,52539,52738,199
2022-12-17,70046,70052,Blue,1,37550,37880,330
2022-12-22,70040,70060,Blue,1,63037,64135,1098
2022-08-06,70049,70047,Blue,0,38360,38416,56
2022-12-07,70052,70060,Blue,1,46281,46651,370
2022-05-13,70050,70056,Blue,1,38012,38314,302
2022-04-10,70048,70054,Blue,1,38863,39149,286
2022-11-14,70044,70058,Blue,1,49949,50679,730
2022-11-18,70055,70039,Blue,0,83677,84506,829
2022-09-27,70046,70052,Blue,1,72457,72776,319
2022-02-22,70048,70050,Blue,1,87759,87817,58
2022-02-23,70057,70838,Blue,0,61305,62380,1075
2022-05-18,70047,70039,Blue,0,51685,52298,613
2022-03-16,70038,70052,Blue,1,25555,26294,739
2022-05-26,70045,70039,Blue,0,43567,43842,275
2022-03-23,70040,70048,Blue,1,65886,66259,373
2022-04-12,70040,70048,Blue,1,20962,21397,435
2022-05-22,70044,70048,Blue,1,85895,86189,294
2022-11-07,70042,70050,Blue,1,66833,67278,445
2022-12-10,70053,70838,Blue,0,67310,68137,827
2022-01-22,70051,70045,Blue,0,70144,70500,356
2022-09-27,70055,70047,Blue,0,27080,27492,412
2022-07-06,70054,70058,Blue,1,20804,20970,166
2022-03-09,70057,70047,Blue,0,33938,34418,480
2022-09-06,70055,70039,Blue,0,52184,53055,871
2022-07-10,70055,70039,Blue,0,44313,45214,901
2022-06-28,70053,70051,Blue,0,75676,75729,53
2022-08-22,70044,70056,Blue,1,30049,30752,703
2022-06-28,70046,70060,Blue,1,27358,28186,828
2022-01-22,70048,70050,Blue,1,30706,30776,70
2022-11-27,70054,70060,Blue,1,41191,41457,266
2022-01-13,70055,70041,Blue,0,61562,62293,731
2022-04-22,70051,70049,Blue,0,60541,60644,103
2022-02-21,70049,70043,Blue,0,51896,52270,374
2022-02-01,70038,70058,Blue,1,22818,24191,1373
2022-05-11,70055,70049,Blue,0,19027,19340,313
2022-06-14,70059,70053,Blue,0,24258,24492,234
2022-09-16,70057,70055,Blue,0,65148,65218,70
2022-12-27,70040,70046,Blue,1,62748,63041,293
2022-02-22,70049,70047,Blue,0,47251,47304,53
2022-03-22,70049,70047,Blue,0,80525,80580,55
2022-08-02,70040,70052,Blue,1,56667,57353,686
2022-01-09,70059,70057,Blue,0,50597,50632,35
2022-01-27,70049,70041,Blue,0,64959,65457,498
2022-10-24,70049,70045,Blue,0,86254,86455,201
2022-10-29,70047,70043,Blue,0,53631,53885,254
2022-09-29,70048,70052,Blue,1,75714,75916,202
2022-07-23,70050,70056,Blue,1,67756,68101,345
2022-06-20,70055,70043,Blue,0,87189,87870,681
2022-09-22,70049,70039,Blue,0,48395,48921,526
2022-04-06,70046,70058,Blue,1,66526,67291,765
2022-09-12,70052,70056,Blue,1,47316,47455,139
2022-03-05,70057,70053,Blue,0,37951,38103,152
2022-12-06,70044,70060,Blue,1,45888,46790,902
2022-06-06,70049,70045,Blue,0,82336,82549,213
2022-02-20,70057,70047,Blue,0,52839,53300,461
2022-08-01,70053,70047,Blue,0,27884,28183,299
2022-06-30,70055,70041,Blue,0,73059,73790,731
2022-02-08,70041,70039,Blue,0,31933,31978,45
2022-10-27,70038,70056,Blue,1,35294,36212,918
2022-10-13,70038,70042,Blue,1,56000,56103,103
2022-11-18,70053,70049,Blue,0,51540,51742,202
2022-01-04,70043,70041,Blue,0,28724,28753,29
2022-09-17,70045,70043,Blue,0,30035,30141,106
2022-11-25,70047,70045,Blue,0,77076,77184,108
2022-04-13,70043,70039,Blue,0,24920,25031,111
2022-09-27,70051,70039,Blue,0,21980,22651,671
2022-03-25,70055,70043,Blue,0,21498,22179,681
2022-07-14,70059,70047,Blue,0,22578,23253,675
2022-12-02,70043,70838,Blue,0,25106,25292,186
2022-12-28,70046,70048,Blue,1,24159,24237,78
2022-11-11,70058,70060,Blue,1,79565,79630,65
2022-03-14,70059,70045,Blue,0,65967,66739,772
2022-04-19,70055,70043,Blue,0,48461,49142,681
2022-03-03,70055,70838,Blue,0,61880,62801,921
2022-02-25,70053,70051,Blue,0,29044,29106,62
2022-12-30,70051,70838,Blue,0,78552,79265,713
2022-02-13,70041,70039,Blue,0,68871,68906,35
2022-10-04,70049,70039,Blue,0,30709,31285,576
2022-06-19,70048,70050,Blue,1,78554,78615,61
2022-03-19,70048,70052,Blue,1,69055,69284,229
2022-04-11,70055,70039,Blue,0,26264,27163,899
2022-09-30,70057,70055,Blue,0,19603,19675,72
2022-03-17,70040,70060,Blue,1,66581,68013,1432
2022-02-06,70042,70054,Blue,1,63063,63736,673
2022-05-21,70057,70043,Blue,0,43889,44780,891
2022-03-10,70059,70051,Blue,0,31152,31519,367
2022-02-12,70040,70060,Blue,1,80664,81824,1160
2022-09-16,70051,70045,Blue,0,50758,51077,319
2022-07-27,70049,70041,Blue,0,29867,30431,564
2022-07-29,70047,70043,Blue,0,56970,57221,251
2022-11-11,70038,70058,Blue,1,50265,51236,971
2022-10-01,70057,70041,Blue,0,67651,68492,841
2022-04-12,70051,70047,Blue,0,82092,82309,217
2022-08-16,70053,70039,Blue,0,53110,53889,779
2022-12-29,70053,70047,Blue,0,84623,84946,323
2022-02-28,70057,70049,Blue,0,74429,74854,425
2022-01-20,70055,70051,Blue,0,64579,64740,161
2022-03-30,70058,70060,Blue,1,37333,37423,90
2022-01-06,70040,70056,Blue,1,36257,37268,1011
2022-07-21,70040,70052,Blue,1,29191,29911,720
2022-11-25,70059,70043,Blue,0,31393,32218,825
2022-08-28,70059,70039,Blue,0,50593,51651,1058
2022-09-19,70051,70043,Blue,0,23734,24314,580
2022-03-14,70038,70044,Blue,1,51198,51367,169
2022-01-13,70044,70056,Blue,1,56188,56889,701
2022-01-16,70055,70049,Blue,0,78434,78724,290
2022-02-08,70044,70048,Blue,1,33077,33308,231
2022-04-11,70049,70039,Blue,0,64289,64753,464
2022-01-11,70059,70049,Blue,0,58997,59524,527
2022-04-22,70042,70054,Blue,1,72105,72780,675
2022-07-07,70050,70052,Blue,1,53395,53503,108
2022-01-14,70038,70052,Blue,1,31464,32159,695
2022-07-05,70046,70048,Blue,1,50534,50629,95
2022-08-18,70042,70060,Blue,1,68332,69304,972
2022-05-21,70040,70060,Blue,1,38483,39669,1186
2022-03-10,70046,70048,Blue,1,60506,60622,116
2022-10-10,70057,70049,Blue,0,78261,78636,375
2022-07-28,70044,70052,Blue,1,21553,22072,519
2022-06-14,70038,70052,Blue,1,53740,54487,747
2022-01-02,70057,70049,Blue,0,42886,43308,422
2022-03-25,70059,70053,Blue,0,44376,44595,219
2022-12-31,70038,70044,Blue,1,51246,51430,184
2022-02-05,70047,70838,Blue,0,61176,61682,506
2022-06-10,70047,70041,Blue,0,31655,32034,379
2022-09-09,70051,70041,Blue,0,36724,37282,558
2022-08-14,70038,70060,Blue,1,66128,67248,1120
2022-01-14,70044,70046,Blue,1,28674,28883,209
2022-04-03,70053,70047,Blue,0,27278,27575,297
2022-11-20,70044,70052,Blue,1,62568,63045,477
2022-03-31,70047,70041,Blue,0,56613,56949,336
2022-06-10,70038,70042,Blue,1,21192,21315,123
2022-08-22,70048,70054,Blue,1,73793,74095,302
2022-03-14,70057,70041,Blue,0,50298,51105,807
2022-12-30,70058,70060,Blue,1,79872,79933,61
2022-04-08,70040,70050,Blue,1,83192,83729,537
2022-06-17,70042,70052,Blue,1,63619,64233,614
2022-09-12,70038,70044,Blue,1,34263,34444,181
2022-02-09,70049,70045,Blue,0,22686,22884,198
2022-01-23,70057,70043,Blue,0,82299,83101,802
2022-03-30,70046,70050,Blue,1,34503,34700,197
2022-10-22,70049,70041,Blue,0,65376,65796,420
2022-05-19,70056,70058,Blue,1,69138,69214,76
2022-10-14,70053,70047,Blue,0,78613,78907,294
2022-02-01,70045,70043,Blue,0,72130,72254,124
2022-04-20,70038,70056,Blue,1,40723,41690,967
2022-09-03,70054,70056,Blue,1,35941,35988,47
2022-07-17,70053,70838,Blue,0,53172,54030,858
2022-02-17,70055,70051,Blue,0,46835,46987,152
2022-05-23,70044,70050,Blue,1,29398,29793,395
2022-04-24,70056,70058,Blue,1,67070,67142,72
2022-09-01,70042,70056,Blue,1,70634,71353,719
2022-01-19,70055,70053,Blue,0,65762,65814,52
2022-06-16,70051,70045,Blue,0,38589,38917,328
2022-11-07,70059,70838,Blue,0,61334,62449,1115
2022-10-25,70048,70058,Blue,1,71638,72162,524
2022-09-13,70053,70043,Blue,0,74095,74681,586
2022-10-10,70042,70054,Blue,1,49458,50126,668
2022-05-02,70059,70055,Blue,0,71786,71928,142
2022-06-01,70040,70048,Blue,1,24368,24785,417
2022-06-25,70051,70043,Blue,0,77616,78159,543
2022-09-14,70057,70043,Blue,0,52597,53347,750
2022-09-28,70046,70048,Blue,1,64122,64195,73
2022-06-15,70052,70058,Blue,1,38246,38555,309
2022-06-04,70042,70052,Blue,1,76625,77339,714
2022-07-11,70055,70047,Blue,0,45919,46331,412
2022-10-03,70038,70048,Blue,1,34889,35312,423
2022-04-23,70055,70041,Blue,0,81833,82567,734
2022-04-19,70058,70060,Blue,1,81383,81450,67
2022-12-07,70042,70060,Blue,1,38972,39968,996
2022-08-09,70053,70043,Blue,0,38832,39445,613
2022-03-16,70050,70060,Blue,1,46427,46928,501
2022-10-26,70046,70054,Blue,1,70637,71066,429
2022-12-21,70051,70039,Blue,0,78553,79226,673
2022-05-09,70054,70056,Blue,1,29980,30026,46
2022-09-21,70048,70054,Blue,1,58663,58981,318
2022-09-15,70047,70041,Blue,0,61929,62260,331
2022-11-01,70059,70047,Blue,0,47835,48421,586
2022-09-17,70042,70056,Blue,1,49796,50561,765
2022-02-14,70050,70056,Blue,1,32370,32751,381
2022-04-20,70038,70056,Blue,1,27853,28739,886
2022-01-27,70043,70041,Blue,0,42091,42118,27
2022-07-18,70046,70054,Blue,1,42924,43418,494
2022-11-30,70054,70058,Blue,1,62392,62548,156
2022-12-18,70059,70041,Blue,0,26190,27121,931
2022-03-24,70038,70044,Blue,1,56231,56408,177
2022-12-06,70044,70050,Blue,1,56505,56871,366
2022-09-07,70045,70043,Blue,0,37922,38039,117
2022-02-05,70040,70044,Blue,1,22644,22773,129
2022-02-15,70048,70056,Blue,1,40110,40475,365
2022-01-17,70059,70043,Blue,0,52457,53401,944
2022-03-25,70048,70054,Blue,1,20342,20669,327
2022-04-18,70047,70045,Blue,0,31756,31858,102
2022-12-01,70039,70838,Blue,0,33265,33299,34
2022-04-15,70040,70046,Blue,1,56915,57196,281
2022-07-21,70046,70052,Blue,1,69488,69825,337
2022-10-29,70039,70838,Blue,0,40583,40618,35
2022-01-31,70059,70041,Blue,0,65946,66944,998
2022-03-07,70049,70039,Blue,0,64025,64535,510
2022-09-25,70045,70043,Blue,0,69205,69302,97
2022-08-02,70056,70060,Blue,1,81729,81918,189
2022-10-04,70040,70042,Blue,1,57693,57724,31
2022-02-06,70038,70052,Blue,1,38358,39078,720
2022-04-19,70059,70043,Blue,0,33259,34169,910
2022-10-09,70049,70838,Blue,0,77530,78073,543
2022-04-14,70047,70043,Blue,0,86348,86578,230
2022-04-14,70046,70058,Blue,1,81429,82139,710
2022-05-18,70048,70052,Blue,1,63195,63401,206
2022-03-03,70052,70058,Blue,1,59495,59792,297
2022-02-14,70040,70048,Blue,1,83355,83767,412
2022-02-11,70045,70041,Blue,0,50924,51106,182
2022-03-31,70051,70043,Blue,0,36731,37369,638
2022-08-03,70045,70838,Blue,0,74128,74468,340
2022-03-10,70045,70838,Blue,0,53376,53766,390
2022-12-05,70046,70054,Blue,1,76183,76621,438
2022-08-26,70051,70041,Blue,0,87035,87654,619
2022-12-16,70038,70056,Blue,1,53906,54801,895
2022-07-16,70044,70050,Blue,1,84867,85248,381
2022-02-04,70055,70045,Blue,0,41730,42382,652
2022-05-06,70057,70047,Blue,0,79303,79955,652
2022-04-03,70055,70053,Blue,0,49161,49206,45
2022-11-19,70042,70054,Blue,1,51981,52705,724
2022-04-09,70046,70060,Blue,1,28942,29681,739
2022-10-31,70039,70838,Blue,0,78082,78115,33
2022-07-17,70040,70052,Blue,1,70510,71188,678
2022-09-13,70047,70041,Blue,0,88756,89070,314
2022-07-16,70048,70050,Blue,1,50219,50276,57
2022-08-06,70048,70060,Blue,1,43676,44273,597
2022-01-22,70045,70039,Blue,0,27235,27455,220
2022-02-02,70055,70051,Blue,0,65764,65911,147
2022-12-30,70057,70041,Blue,0,88178,89056,878
2022-06-20,70056,70060,Blue,1,78389,78593,204
2022-12-30,70055,70045,Blue,0,56961,57437,476
2022-09-10,70055,70049,Blue,0,75320,75592,272
2022-04-03,70046,70052,Blue,1,35840,36195,355
2022-11-28,70044,70052,Blue,1,33818,34292,474
2022-12-11,70040,70048,Blue,1,60262,60713,451
2022-05-07,70055,70053,Blue,0,68006,68053,47
2022-01-28,70045,70043,Blue,0,64842,64933,91
2022-10-12,70044,70060,Blue,1,48513,49403,890
2022-09-16,70055,70051,Blue,0,44356,44488,132
2022-12-31,70056,70058,Blue,1,37616,37774,158
2022-08-25,70039,70838,Blue,0,28823,28857,34
2022-12-23,70055,70838,Blue,0,68829,69859,1030
2022-08-27,70044,70056,Blue,1,44994,45677,683
2022-06-26,70044,70054,Blue,1,26505,27151,646
2022-03-08,70038,70050,Blue,1,61332,61858,526
2022-03-05,70047,70039,Blue,0,30362,30733,371
2022-08-08,70051,70041,Blue,0,42559,43295,736
2022-11-30,70043,70039,Blue,0,68051,68165,114
2022-01-05,70055,70053,Blue,0,20783,20828,45
2022-12-25,70042,70060,Blue,1,80489,81461,972
2022-06-15,70040,70056,Blue,1,49283,50125,842
2022-07-06,70057,70053,Blue,0,73897,74064,167
2022-12-14,70040,70046,Blue,1,22106,22348,242
2022-07-18,70047,70838,Blue,0,73913,74438,525
2022-07-15,70048,70054,Blue,1,73635,73958,323
2022-04-21,70046,70058,Blue,1,22180,22814,634
2022-11-07,70057,70838,Blue,0,63854,64928,1074
2022-02-26,70051,70041,Blue,0,29579,30134,555
2022-02-09,70053,70838,Blue,0,82031,82861,830
2022-12-13,70046,70054,Blue,1,53280,53805,525
2022-01-13,70046,70050,Blue,1,20241,20422,181
2022-06-28,70053,70039,Blue,0,47567,48316,749
2022-10-26,70051,70838,Blue,0,49619,50386,767
2022-12-01,70059,70055,Blue,0,88096,88239,143
2022-02-12,70056,70058,Blue,1,76071,76142,71
2022-10-23,70052,70060,Blue,1,61046,61429,383
2022-04-02,70053,70047,Blue,0,81919,82190,271
2022-12-23,70040,70056,Blue,1,84034,84887,853
2022-05-31,70047,70041,Blue,0,25273,25640,367
2022-02-03,70059,70049,Blue,0,40423,41038,615
2022-01-09,70056,70060,Blue,1,33309,33492,183
2022-06-18,70053,70047,Blue,0,21867,22159,292
2022-08-20,70044,70060,Blue,1,57497,58394,897
2022-05-19,70050,70056,Blue,1,68307,68633,326
2022-09-30,70057,70055,Blue,0,35417,35487,70
2022-03-05,70042,70048,Blue,1,55765,56106,341
2022-10-07,70045,70039,Blue,0,48679,48953,274
2022-07-05,70052,70060,Blue,1,73905,74262,357
2022-09-28,70042,70044,Blue,1,45305,45331,26
2022-03-30,70048,70054,Blue,1,27517,27809,292
2022-11-10,70040,70050,Blue,1,76796,77261,465
2022-02-10,70040,70050,Blue,1,41515,42070,555
2022-09-19,70046,70060,Blue,1,50126,50919,793
2022-04-16,70055,70041,Blue,0,35373,36193,820
2022-07-18,70052,70054,Blue,1,32742,32808,66
2022-08-10,70044,70050,Blue,1,29183,29514,331
2022-03-01,70040,70056,Blue,1,67789,68633,844
2022-09-21,70055,70039,Blue,0,37145,38060,915
2022-07-14,70048,70050,Blue,1,66495,66553,58
2022-02-10,70051,70049,Blue,0,20636,20761,125
2022-07-19,70044,70056,Blue,1,72583,73311,728
2022-12-29,70057,70041,Blue,0,22372,23238,866
2022-09-15,70038,70056,Blue,1,50380,51330,950
2022-07-05,70042,70048,Blue,1,60013,60324,311
2022-09-21,70051,70039,Blue,0,39855,40495,640
2022-10-30,70045,70041,Blue,0,39021,39199,178
2022-12-15,70055,70039,Blue,0,74542,75610,1068
2022-06-18,70059,70055,Blue,0,37894,38048,154
2022-08-26,70059,70043,Blue,0,66425,67237,812
2022-06-09,70059,70039,Blue,0,52100,53169,1069
2022-01-10,70055,70039,Blue,0,21139,21895,756
2022-07-17,70044,70060,Blue,1,72294,73266,972
2022-10-26,70038,70044,Blue,1,69497,69715,218
2022-12-11,70045,70838,Blue,0,49170,49507,337
2022-11-04,70040,70044,Blue,1,27413,27515,102
2022-12-06,70049,70047,Blue,0,57796,57851,55
2022-04-07,70051,70045,Blue,0,59092,59493,401
2022-03-16,70055,70043,Blue,0,63974,64706,732
2022-03-02,70038,70056,Blue,1,29055,29965,910
2022-12-22,70059,70057,Blue,0,23082,23117,35
2022-11-28,70053,70039,Blue,0,20199,20979,780
2022-03-15,70040,70046,Blue,1,68287,68549,262
2022-07-27,70053,70039,Blue,0,81524,82283,759
2022-09-19,70053,70838,Blue,0,64551,65403,852
2022-05-19,70052,70058,Blue,1,21796,22097,301
2022-07-23,70052,70056,Blue,1,44968,45116,148
2022-03-08,70057,70041,Blue,0,51273,52216,943
2022-03-01,70055,70041,Blue,0,57870,58633,763
2022-03-20,70053,70039,Blue,0,76814,77541,727
2022-09-07,70056,70060,Blue,1,47679,47856,177
2022-02-18,70051,70838,Blue,0,23749,24689,940
2022-11-23,70042,70060,Blue,1,37422,38463,1041
2022-04-16,70053,70051,Blue,0,72700,72751,51
2022-10-28,70055,70039,Blue,0,55813,56646,833
2022-05-21,70049,70047,Blue,0,69698,69753,55
2022-01-12,70045,70838,Blue,0,43456,43820,364
2022-05-27,70049,70045,Blue,0,28018,28222,204
2022-11-03,70059,70053,Blue,0,36997,37234,237
2022-02-28,70059,70041,Blue,0,67151,68037,886
2022-01-14,70055,70043,Blue,0,23587,24374,787
2022-11-11,70055,70043,Blue,0,83209,83852,643
2022-03-18,70044,70054,Blue,1,34635,35291,656
2022-04-05,70046,70056,Blue,1,44547,45057,510
2022-02-18,70057,70838,Blue,0,60270,61299,1029
2022-05-10,70050,70052,Blue,1,32020,32139,119
2022-01-03,70051,70039,Blue,0,29740,30310,570
2022-07-07,70046,70056,Blue,1,24427,24978,551
2022-12-09,70042,70048,Blue,1,57096,57421,325
2022-12-05,70042,70048,Blue,1,53525,53837,312
2022-01-09,70046,70048,Blue,1,75148,75228,80
2022-07-20,70049,70047,Blue,0,78282,78336,54
2022-09-23,70055,70047,Blue,0,31193,31722,529
2022-10-24,70057,70053,Blue,0,67654,67806,152
2022-11-26,70049,70047,Blue,0,28120,28176,56
2022-08-12,70055,70045,Blue,0,71519,72045,526
2022-10-16,70053,70047,Blue,0,50313,50581,268
2022-01-13,70055,70039,Blue,0,31942,32832,890
2022-12-27,70040,70054,Blue,1,73549,74414,865
2022-08-14,70045,70838,Blue,0,74017,74350,333
2022-12-23,70046,70056,Blue,1,41462,42167,705
2022-05-28,70045,70838,Blue,0,75786,76193,407
2022-12-26,70053,70051,Blue,0,29546,29597,51
2022-06-20,70059,70043,Blue,0,71821,72692,871
2022-03-25,70052,70060,Blue,1,48261,48635,374
2022-09-22,70056,70058,Blue,1,25206,25274,68
2022-03-14,70044,70054,Blue,1,48950,49610,660
2022-10-30,70046,70058,Blue,1,32715,33356,641
2022-08-10,70041,70039,Blue,0,31197,31229,32
2022-03-01,70040,70048,Blue,1,54622,55016,394
2022-12-08,70050,70052,Blue,1,88804,88914,110
2022-05-25,70050,70052,Blue,1,23766,24002,236
2022-11-17,70040,70054,Blue,1,32414,33127,713
2022-02-22,70057,70051,Blue,0,78977,79223,246
2022-04-13,70054,70058,Blue,1,87882,88033,151
2022-03-23,70044,70060,Blue,1,27218,28141,923
2022-03-11,70045,70043,Blue,0,32732,32823,91
2022-01-17,70049,70838,Blue,0,24070,24738,668
2022-02-23,70053,70047,Blue,0,21277,21580,303
2022-03-10,70038,70056,Blue,1,70525,71456,931
2022-02-12,70051,70041,Blue,0,24510,25125,615
2022-06-06,70040,70052,Blue,1,38539,39379,840
2022-10-20,70053,70041,Blue,0,34589,35259,670
2022-11-12,70044,70056,Blue,1,66054,66696,642
2022-02-04,70038,70050,Blue,1,82003,82559,556
2022-07-08,70040,70046,Blue,1,54205,54509,304
2022-06-30,70042,70056,Blue,1,22473,23279,806
2022-01-29,70044,70058,Blue,1,73859,76523,2664
2022-07-21,70047,70045,Blue,0,48013,48105,92
2022-09-30,70038,70048,Blue,1,90767,91777,1010
2022-08-13,70038,70058,Blue,1,71780,72891,1111
2022-09-21,70048,70050,Blue,1,24604,24657,53
2022-10-21,70058,70060,Blue,1,65365,65426,61
2022-11-22,70055,70045,Blue,0,66448,66936,488
2022-03-24,70045,70043,Blue,0,23615,23715,100
2022-11-02,70057,70838,Blue,0,79424,80400,976
2022-03-29,70042,70044,Blue,1,42129,42164,35
2022-11-26,70039,70838,Blue,0,45353,45383,30
2022-10-24,70053,70045,Blue,0,59570,59991,421
2022-05-21,70040,70054,Blue,1,53533,54362,829
2022-02-23,70038,70056,Blue,1,54818,55802,984
2022-08-11,70046,70056,Blue,1,44172,44698,526
2022-06-29,70055,70838,Blue,0,72371,73517,1146
2022-07-22,70040,70042,Blue,1,48437,48471,34
2022-12-16,70053,70049,Blue,0,67842,68057,215
2022-02-11,70054,70060,Blue,1,24185,24570,385
2022-05-20,70049,70039,Blue,0,29850,30504,654
2022-03-25,70053,70047,Blue,0,22303,22594,291
2022-06-17,70038,70056,Blue,1,54793,55769,976
2022-09-21,70054,70056,Blue,1,53746,53792,46
2022-01-20,70048,70060,Blue,1,63042,63751,709
2022-03-29,70038,70040,Blue,1,60437,60453,16
2022-04-04,70047,70043,Blue,0,52702,52957,255
2022-12-02,70059,70055,Blue,0,61635,61786,151
2022-09-05,70051,70043,Blue,0,80044,80575,531
2022-06-17,70059,70057,Blue,0,63793,63831,38
2022-02-27,70047,70043,Blue,0,23688,23966,278
2022-08-28,70040,70044,Blue,1,32351,32460,109
2022-10-08,70043,70838,Blue,0,43098,43305,207
2022-12-24,70040,70060,Blue,1,43320,44917,1597
2022-01-26,70052,70058,Blue,1,25119,25373,254
2022-03-30,70055,70051,Blue,0,57978,58122,144
2022-02-15,70059,70055,Blue,0,56589,56737,148
2022-01-22,70042,70056,Blue,1,44917,45660,743
2022-07-22,70057,70045,Blue,0,87857,88460,603
2022-05-20,70042,70060,Blue,1,67283,68614,1331
2022-03-07,70049,70045,Blue,0,33843,34069,226
2022-09-25,70040,70044,Blue,1,41084,41187,103
2022-07-29,70040,70048,Blue,1,22892,23295,403
2022-01-16,70047,70838,Blue,0,42903,43449,546
2022-03-23,70048,70056,Blue,1,54286,54683,397
2022-04-18,70053,70045,Blue,0,29043,29505,462
2022-11-23,70053,70043,Blue,0,58255,58853,598
2022-03-31,70059,70039,Blue,0,20236,21295,1059
2022-08-22,70038,70058,Blue,1,55461,56507,1046
2022-07-07,70047,70045,Blue,0,31903,32005,102
2022-07-02,70052,70058,Blue,1,48825,49087,262
2022-08-23,70057,70051,Blue,0,69676,69912,236
2022-09-11,70046,70058,Blue,1,89521,90257,736
2022-05-27,70047,70043,Blue,0,56421,56723,302
2022-02-19,70039,70838,Blue,0,30345,30391,46
2022-03-21,70042,70058,Blue,1,38178,39174,996
2022-01-09,70051,70047,Blue,0,76031,76221,190
2022-06-13,70040,70060,Blue,1,33931,35060,1129
2022-07-16,70042,70054,Blue,1,54683,55351,668
2022-01-25,70057,70049,Blue,0,64199,64617,418
2022-09-30,70038,70052,Blue,1,71157,71897,740
2022-02-10,70053,70051,Blue,0,29957,30026,69
2022-01-16,70044,70056,Blue,1,85746,86445,699
2022-08-23,70050,70058,Blue,1,50779,51268,489
2022-08-08,70044,70058,Blue,1,81623,82425,802
2022-01-12,70040,70050,Blue,1,25289,25838,549
2022-08-07,70050,70054,Blue,1,67791,67985,194
2022-06-28,70038,70056,Blue,1,80314,81265,951
2022-12-23,70051,70041,Blue,0,31606,32180,574
2022-01-11,70042,70052,Blue,1,74185,74823,638
2022-08-28,70053,70051,Blue,0,63341,63395,54
2022-11-25,70044,70060,Blue,1,72285,73192,907
2022-05-18,70057,70838,Blue,0,23411,24786,1375
2022-07-06,70056,70058,Blue,1,78323,78396,73
2022-12-21,70046,70052,Blue,1,54848,55192,344
2022-04-03,70050,70060,Blue,1,52696,53226,530
2022-12-16,70038,70056,Blue,1,26439,27370,931
2022-02-17,70044,70060,Blue,1,22964,24269,1305
2022-02-13,70039,70838,Blue,0,26066,26100,34
2022-04-22,70054,70058,Blue,1,21188,21352,164
2022-03-08,70044,70050,Blue,1,58556,58936,380
2022-12-02,70048,70050,Blue,1,31837,31898,61
2022-08-24,70055,70053,Blue,0,61440,61486,46
2022-02-14,70040,70046,Blue,1,82768,83034,266
2022-02-26,70059,70041,Blue,0,61633,62549,916
2022-11-10,70038,70048,Blue,1,67396,67836,440
2022-04-19,70055,70045,Blue,0,66985,67561,576
2022-01-20,70054,70060,Blue,1,24624,24984,360
2022-10-07,70057,70053,Blue,0,59052,59228,176
2022-12-23,70038,70042,Blue,1,48397,48506,109
2022-12-27,70049,70838,Blue,0,30452,31089,637
2022-11-21,70040,70056,Blue,1,85752,86600,848
2022-01-03,70054,70058,Blue,1,55179,55341,162
2022-06-14,70038,70048,Blue,1,65240,65718,478
2022-10-03,70048,70060,Blue,1,31719,32336,617
2022-09-27,70059,70053,Blue,0,54086,54331,245
2022-01-31,70047,70043,Blue,0,71841,72159,318
2022-08-28,70055,70053,Blue,0,56189,56239,50
2022-08-14,70059,70041,Blue,0,51171,52145,974
2022-07-30,70042,70048,Blue,1,81561,81873,312
2022-01-25,70049,70838,Blue,0,30807,31578,771
2022-04-03,70043,70041,Blue,0,37740,37767,27
2022-10-14,70048,70054,Blue,1,40005,40316,311
2022-06-09,70038,70050,Blue,1,77472,78128,656
2022-12-12,70044,70050,Blue,1,68150,68485,335
2022-04-05,70055,70041,Blue,0,31931,32684,753
2022-11-18,70042,70048,Blue,1,25757,26045,288
2022-11-10,70057,70051,Blue,0,72331,72564,233
2022-08-20,70053,70041,Blue,0,41907,42617,710
2022-02-18,70045,70838,Blue,0,30285,30719,434
2022-09-15,70055,70043,Blue,0,51681,52417,736
2022-02-02,70044,70056,Blue,1,28362,29040,678
2022-02-01,70054,70060,Blue,1,76803,77068,265
2022-03-17,70059,70039,Blue,0,73214,74212,998
2022-01-24,70042,70058,Blue,1,47745,48680,935
2022-08-10,70047,70838,Blue,0,66111,66565,454
2022-07-05,70053,70045,Blue,0,50207,50657,450
2022-03-19,70053,70043,Blue,0,56483,57009,526
2022-09-22,70043,70838,Blue,0,73777,73956,179
2022-08-03,70038,70052,Blue,1,75922,76634,712
2022-07-14,70051,70039,Blue,0,41292,42058,766
2022-03-05,70048,70056,Blue,1,36191,36569,378
2022-11-07,70053,70838,Blue,0,73593,74347,754
2022-11-11,70054,70056,Blue,1,23223,23271,48
2022-07-25,70057,70055,Blue,0,87383,87450,67
2022-07-06,70059,70838,Blue,0,23013,24238,1225
2022-10-01,70047,70043,Blue,0,69804,70055,251
2022-06-27,70054,70056,Blue,1,61519,61566,47
2022-11-08,70042,70056,Blue,1,22416,23152,736
2022-02-22,70040,70044,Blue,1,71190,71307,117
2022-03-24,70050,70054,Blue,1,77603,77795,192
2022-02-06,70044,70056,Blue,1,60011,60710,699
2022-07-23,70046,70056,Blue,1,70020,70562,542
2022-07-18,70047,70039,Blue,0,22779,23233,454
2022-11-07,70057,70049,Blue,0,50172,50557,385
2022-02-01,70055,70053,Blue,0,31046,31093,47
2022-10-05,70042,70050,Blue,1,31257,31658,401
2022-07-27,70046,70052,Blue,1,50126,50442,316
2022-11-15,70059,70049,Blue,0,72796,73285,489
2022-02-27,70045,70838,Blue,0,86290,86601,311
2022-01-13,70040,70042,Blue,1,26412,26451,39
2022-03-13,70053,70045,Blue,0,74088,74543,455
2022-03-11,70059,70045,Blue,0,60194,60872,678
2022-02-23,70047,70838,Blue,0,59635,60165,530
2022-03-17,70057,70041,Blue,0,31240,32103,863
2022-06-13,70050,70054,Blue,1,44469,44705,236
2022-03-15,70052,70054,Blue,1,38830,38885,55
2022-10-14,70059,70049,Blue,0,71775,72243,468
2022-01-26,70054,70056,Blue,1,52746,52792,46
2022-11-17,70046,70056,Blue,1,25323,25895,572
2022-02-17,70057,70051,Blue,0,30046,30313,267
2022-10-30,70049,70045,Blue,0,30566,30755,189
2022-09-27,70050,70058,Blue,1,55212,55617,405
2022-02-08,70053,70039,Blue,0,85441,86200,759
2022-10-07,70040,70044,Blue,1,60881,61017,136
2022-12-25,70047,70045,Blue,0,80181,80278,97
2022-09-22,70042,70056,Blue,1,50364,51091,727
2022-10-16,70050,70058,Blue,1,42227,42619,392
2022-04-11,70057,70055,Blue,0,54899,54970,71
2022-10-29,70057,70055,Blue,0,66029,66098,69
2022-11-06,70051,70045,Blue,0,69317,69649,332
2022-01-02,70057,70049,Blue,0,77667,78057,390
2022-12-12,70059,70057,Blue,0,86874,86911,37
2022-11-16,70055,70045,Blue,0,60492,61043,551
2022-07-30,70042,70060,Blue,1,28714,29674,960
2022-12-19,70052,70058,Blue,1,85921,86175,254
2022-04-19,70053,70039,Blue,0,25150,26120,970
2022-01-18,70042,70054,Blue,1,25591,26372,781
2022-01-19,70045,70043,Blue,0,24162,24313,151
2022-04-03,70059,70045,Blue,0,68953,69637,684
2022-10-29,70040,70048,Blue,1,35105,35455,350
2022-04-12,70040,70046,Blue,1,20962,21228,266
2022-07-11,70050,70058,Blue,1,61562,62005,443
2022-10-02,70051,70049,Blue,0,48779,48896,117
2022-03-27,70059,70039,Blue,0,78256,79322,1066
2022-01-15,70042,70052,Blue,1,58353,58929,576
2022-12-05,70042,70046,Blue,1,71744,71910,166
2022-09-19,70055,70039,Blue,0,60519,61354,835
2022-12-11,70041,70838,Blue,0,75386,75509,123
2022-07-20,70040,70046,Blue,1,19942,20180,238
2022-07-24,70059,70045,Blue,0,48982,49706,724
2022-06-29,70046,70050,Blue,1,34842,35028,186
2022-02-06,70050,70060,Blue,1,75363,75877,514
2022-06-26,70059,70053,Blue,0,57654,57894,240
2022-02-12,70038,70044,Blue,1,71317,71514,197
2022-01-15,70051,70043,Blue,0,34455,34930,475
2022-01-11,70038,70050,Blue,1,70926,71438,512
2022-12-27,70053,70039,Blue,0,66039,66746,707
2022-06-29,70041,70838,Blue,0,39819,39963,144
2022-11-18,70059,70041,Blue,0,31712,32685,973
2022-11-30,70049,70039,Blue,0,20143,20778,635
2022-12-10,70042,70044,Blue,1,76236,76267,31
2022-12-17,70055,70047,Blue,0,22998,23385,387
2022-01-27,70051,70043,Blue,0,67141,67667,526
2022-01-13,70057,70045,Blue,0,22469,23107,638
2022-04-18,70058,70060,Blue,1,60940,61019,79
2022-06-13,70040,70050,Blue,1,67720,68233,513
2022-04-11,70044,70050,Blue,1,81234,81640,406
2022-01-25,70047,70039,Blue,0,57845,58308,463
2022-10-17,70057,70041,Blue,0,32382,33274,892
2022-10-17,70052,70054,Blue,1,29775,29833,58
2022-10-16,70050,70060,Blue,1,47297,47803,506
2022-03-19,70047,70041,Blue,0,23402,23738,336
2022-08-11,70051,70047,Blue,0,44372,44576,204
2022-06-08,70040,70046,Blue,1,71873,72220,347
2022-03-16,70044,70048,Blue,1,33131,33351,220
2022-12-29,70044,70054,Blue,1,33052,33651,599
2022-12-09,70040,70056,Blue,1,23253,24064,811
2022-07-14,70046,70054,Blue,1,33788,34254,466
2022-11-10,70055,70045,Blue,0,76081,76555,474
2022-08-27,70053,70049,Blue,0,51100,51298,198
2022-02-07,70038,70042,Blue,1,23995,24094,99
2022-11-07,70043,70041,Blue,0,64957,64984,27
2022-11-25,70047,70041,Blue,0,84905,85213,308
2022-09-13,70040,70048,Blue,1,43577,43974,397
2022-08-12,70040,70058,Blue,1,21156,22306,1150
2022-04-17,70044,70056,Blue,1,61506,62194,688
2022-11-29,70038,70054,Blue,1,82705,83505,800
2022-07-29,70059,70047,Blue,0,46595,47187,592
2022-04-16,70046,70060,Blue,1,52176,52920,744
2022-08-15,70046,70058,Blue,1,88847,89459,612
2022-08-20,70044,70056,Blue,1,49869,50563,694
2022-09-26,70046,70048,Blue,1,50657,50732,75
2022-08-18,70053,70838,Blue,0,35183,36134,951
2022-03-24,70040,70042,Blue,1,89223,89252,29
2022-04-21,70055,70053,Blue,0,36575,36620,45
2022-04-07,70042,70050,Blue,1,57900,58340,440
2022-01-01,70052,70054,Blue,1,48959,49011,52
2022-07-06,70040,70060,Blue,1,69343,70686,1343
2022-02-14,70040,70060,Blue,1,61710,62810,1100
2022-06-23,70049,70041,Blue,0,44481,45046,565
2022-11-29,70052,70054,Blue,1,77427,77474,47
2022-11-17,70042,70056,Blue,1,40585,41353,768
2022-04-05,70059,70053,Blue,0,62599,62818,219
2022-12-05,70038,70050,Blue,1,68476,69036,560
2022-10-24,70042,70056,Blue,1,29675,30483,808
2022-03-23,70048,70054,Blue,1,54877,55190,313
2022-02-28,70045,70043,Blue,0,26703,26808,105
2022-12-02,70052,70060,Blue,1,24122,24527,405
2022-10-31,70042,70048,Blue,1,22573,22908,335
2022-06-29,70048,70050,Blue,1,22443,22495,52
2022-05-28,70038,70040,Blue,1,83700,83715,15
2022-02-24,70038,70056,Blue,1,72974,73908,934
2022-10-30,70058,70060,Blue,1,63641,63705,64
2022-04-16,70038,70052,Blue,1,43152,43942,790
2022-12-12,70053,70049,Blue,0,23290,23499,209
2022-09-05,70057,70053,Blue,0,56609,56760,151
2022-07-13,70057,70051,Blue,0,28292,28559,267
2022-07-24,70038,70048,Blue,1,43637,44143,506
2022-09-02,70055,70041,Blue,0,62073,62811,738
2022-12-19,70042,70050,Blue,1,81507,81922,415
2022-04-25,70059,70051,Blue,0,71353,71665,312
2022-12-14,70053,70051,Blue,0,73086,73148,62
2022-03-03,70047,70838,Blue,0,26079,26708,629
2022-06-10,70059,70043,Blue,0,56910,57844,934
2022-09-22,70048,70052,Blue,1,38871,39092,221
2022-04-01,70057,70049,Blue,0,21781,22219,438
2022-03-22,70044,70052,Blue,1,56723,57174,451
2022-07-12,70042,70048,Blue,1,44222,44557,335
2022-01-21,70038,70060,Blue,1,76336,77465,1129
2022-02-06,70055,70041,Blue,0,50767,51612,845
2022-12-12,70038,70044,Blue,1,28386,28585,199
2022-04-21,70050,70056,Blue,1,26285,26560,275
2022-03-25,70057,70055,Blue,0,67666,67734,68
2022-04-17,70045,70838,Blue,0,64844,65175,331
2022-08-02,70048,70054,Blue,1,24804,25111,307
2022-02-01,70057,70053,Blue,0,62074,62260,186
2022-03-24,70044,70052,Blue,1,64857,65509,652
2022-08-11,70059,70049,Blue,0,75917,76374,457
2022-11-21,70054,70056,Blue,1,43306,43354,48
2022-12-23,70053,70047,Blue,0,67040,67423,383
2022-11-21,70053,70043,Blue,0,42304,43022,718
2022-02-07,70038,70042,Blue,1,30286,30389,103
2022-10-09,70054,70058,Blue,1,85457,85611,154
2022-08-10,70040,70060,Blue,1,27367,28374,1007
2022-12-27,70040,70052,Blue,1,61941,62592,651
2022-11-24,70056,70060,Blue,1,40240,40412,172
2022-11-25,70041,70039,Blue,0,63416,63448,32
2022-11-12,70055,70045,Blue,0,44533,45042,509
2022-09-06,70056,70058,Blue,1,56910,56984,74
2022-12-16,70055,70047,Blue,0,50586,50964,378
2022-09-19,70043,70039,Blue,0,76333,76429,96
2022-10-28,70059,70039,Blue,0,25098,26158,1060
2022-10-21,70046,70054,Blue,1,35232,35656,424
2022-02-25,70059,70051,Blue,0,84619,84996,377
2022-08-13,70048,70054,Blue,1,34476,34797,321
2022-07-25,70042,70052,Blue,1,72368,72989,621
2022-09-10,70038,70046,Blue,1,28620,28920,300
2022-02-22,70055,70047,Blue,0,45137,45530,393
2022-01-03,70038,70058,Blue,1,29346,30248,902
2022-02-06,70057,70043,Blue,0,68488,69323,835
2022-07-05,70042,70048,Blue,1,25446,25770,324
2022-09-29,70053,70051,Blue,0,55903,55959,56
2022-12-09,70043,70041,Blue,0,69535,69564,29
2022-09-22,70053,70051,Blue,0,30000,30074,74
2022-01-29,70045,70039,Blue,0,46862,47131,269
2022-09-19,70054,70056,Blue,1,26592,26640,48
2022-12-20,70049,70047,Blue,0,26512,26568,56
2022-02-10,70047,70041,Blue,0,56332,56761,429
2022-07-31,70051,70045,Blue,0,48843,49186,343
2022-02-13,70051,70838,Blue,0,37236,37999,763
2022-10-09,70046,70054,Blue,1,84996,85421,425
2022-09-03,70042,70048,Blue,1,67085,67431,346
2022-10-13,70046,70058,Blue,1,51185,51826,641
2022-10-15,70038,70044,Blue,1,32428,32598,170
2022-03-23,70054,70056,Blue,1,47201,47247,46
2022-02-02,70038,70040,Blue,1,32346,32361,15
2022-11-30,70044,70058,Blue,1,70255,71019,764
2022-07-01,70046,70056,Blue,1,53113,53682,569
2022-04-13,70040,70042,Blue,1,28803,28834,31
2022-08-15,70046,70050,Blue,1,28506,28693,187
2022-09-24,70049,70045,Blue,0,57806,58005,199
2022-06-13,70057,70045,Blue,0,86974,87598,624
2022-09-04,70055,70045,Blue,0,81104,81600,496
2022-03-14,70052,70060,Blue,1,70204,70568,364
2022-10-03,70046,70058,Blue,1,60579,61258,679
2022-03-28,70038,70060,Blue,1,54798,55981,1183
2022-02-03,70042,70052,Blue,1,25619,26202,583
2022-03-22,70059,70055,Blue,0,75492,75633,141
2022-01-14,70050,70052,Blue,1,77456,77569,113
2022-08-24,70040,70054,Blue,1,62824,63597,773
2022-06-15,70050,70058,Blue,1,74659,75118,459
2022-11-01,70052,70054,Blue,1,52595,52653,58
2022-01-11,70053,70043,Blue,0,37251,37813,562
2022-10-18,70038,70048,Blue,1,28577,29010,433
2022-11-06,70038,70056,Blue,1,30016,30903,887
2022-04-06,70038,70056,Blue,1,39658,40659,1001
2022-08-27,70046,70052,Blue,1,69487,69826,339
2022-11-25,70038,70040,Blue,1,57100,57115,15
2022-07-07,70054,70058,Blue,1,59176,59341,165
2022-12-02,70051,70043,Blue,0,50324,50823,499
2022-03-15,70048,70050,Blue,1,43557,43611,54
2022-02-09,70045,70838,Blue,0,63425,63776,351
2022-01-12,70051,70041,Blue,0,32693,33287,594
2022-05-26,70043,70838,Blue,0,67402,67609,207
2022-10-30,70050,70052,Blue,1,42925,43050,125
2022-07-21,70052,70056,Blue,1,52750,52893,143
2022-05-19,70039,70838,Blue,0,66821,66862,41
2022-12-19,70050,70052,Blue,1,58703,58827,124
2022-02-21,70059,70838,Blue,0,66496,67585,1089
2022-10-16,70040,70058,Blue,1,53771,54677,906
2022-08-13,70047,70045,Blue,0,57924,58020,96
2022-01-06,70045,70041,Blue,0,51617,51792,175
2022-02-01,70058,70060,Blue,1,48108,48172,64
2022-06-25,70048,70054,Blue,1,54267,54586,319
2022-11-23,70054,70058,Blue,1,26446,26604,158
2022-04-24,70046,70054,Blue,1,53578,54019,441
2022-06-15,70055,70049,Blue,0,54415,54699,284
2022-10-31,70054,70058,Blue,1,63323,63484,161
2022-11-09,70048,70056,Blue,1,33319,33731,412
2022-10-20,70038,70048,Blue,1,51789,52271,482
2022-02-02,70051,70041,Blue,0,31533,32129,596
2022-12-24,70048,70050,Blue,1,83723,83780,57
2022-07-05,70046,70050,Blue,1,54427,54608,181
2022-10-16,70059,70838,Blue,0,35535,36678,1143
2022-08-12,70059,70045,Blue,0,68233,68939,706
2022-06-19,70049,70047,Blue,0,58416,58471,55
2022-11-04,70038,70054,Blue,1,25272,26115,843
2022-08-01,70051,70049,Blue,0,39386,39490,104
2022-07-11,70053,70043,Blue,0,48016,48624,608
2022-08-21,70040,70044,Blue,1,75933,76038,105
2022-01-13,70052,70056,Blue,1,83399,83528,129
2022-06-11,70059,70039,Blue,0,20834,21970,1136
2022-03-05,70056,70060,Blue,1,55998,56184,186
2022-10-14,70055,70838,Blue,0,43382,44349,967
2022-02-17,70046,70054,Blue,1,21997,22476,479
2022-09-03,70053,70049,Blue,0,72165,72359,194
2022-01-24,70042,70044,Blue,1,39750,39779,29
2022-01-29,70055,70838,Blue,0,28306,29469,1163
2022-10-26,70044,70054,Blue,1,30196,30891,695
2022-01-19,70052,70060,Blue,1,60855,61491,636
2022-06-22,70044,70056,Blue,1,56905,57665,760
2022-11-16,70040,70060,Blue,1,26955,27966,1011
2022-02-01,70043,70838,Blue,0,24015,24233,218
2022-06-19,70046,70060,Blue,1,62769,63512,743
2022-11-26,70045,70041,Blue,0,49460,49640,180
2022-02-24,70051,70039,Blue,0,62128,62780,652
2022-02-18,70049,70041,Blue,0,46661,47162,501
2022-12-21,70040,70046,Blue,1,54657,54898,241
2022-11-18,70044,70046,Blue,1,31305,31410,105
2022-03-04,70049,70043,Blue,0,62549,62939,390
2022-09-07,70057,70049,Blue,0,83530,83894,364
2022-12-25,70052,70060,Blue,1,50145,50493,348
2022-03-28,70038,70042,Blue,1,78654,78762,108
2022-06-13,70040,70050,Blue,1,57201,57722,521
2022-08-12,70053,70043,Blue,0,29136,29730,594
2022-04-08,70051,70838,Blue,0,82112,82844,732
2022-07-26,70053,70047,Blue,0,67323,67592,269
2022-04-17,70042,70046,Blue,1,30162,30344,182
2022-07-12,70057,70055,Blue,0,53132,53201,69
2022-01-04,70042,70048,Blue,1,46517,46802,285
2022-09-04,70049,70047,Blue,0,48917,48971,54
2022-06-16,70044,70052,Blue,1,68196,68824,628
2022-02-04,70043,70039,Blue,0,50764,50891,127
2022-02-27,70048,70050,Blue,1,47742,47799,57
2022-11-09,70059,70055,Blue,0,27520,27685,165
2022-03-16,70046,70060,Blue,1,41077,41977,900
2022-08-14,70059,70041,Blue,0,61501,62462,961
2022-04-17,70056,70060,Blue,1,83991,84171,180
2022-03-14,70044,70050,Blue,1,85600,85933,333
2022-02-19,70038,70058,Blue,1,23660,24726,1066
2022-10-23,70039,70838,Blue,0,72133,72163,30
2022-10-13,70057,70051,Blue,0,28988,29255,267
2022-02-28,70055,70041,Blue,0,56771,57489,718
2022-10-03,70059,70043,Blue,0,57732,58623,891
2022-09-10,70059,70055,Blue,0,25464,25608,144
2022-07-24,70038,70048,Blue,1,52086,52524,438
2022-04-22,70050,70052,Blue,1,66986,67095,109
2022-10-04,70050,70052,Blue,1,84779,84887,108
2022-08-14,70047,70043,Blue,0,33024,33305,281
2022-03-24,70051,70041,Blue,0,28550,29133,583
2022-11-07,70059,70043,Blue,0,77446,78288,842
2022-02-15,70044,70056,Blue,1,41500,42151,651
2022-12-12,70040,70056,Blue,1,42716,43617,901
2022-04-18,70059,70053,Blue,0,28153,28385,232
2022-11-17,70047,70838,Blue,0,39096,39586,490
2022-06-22,70049,70838,Blue,0,37302,37930,628
2022-01-28,70038,70044,Blue,1,23953,24131,178
2022-12-10,70049,70039,Blue,0,71865,72349,484
2022-05-19,70057,70053,Blue,0,33695,33865,170
2022-07-16,70045,70838,Blue,0,64658,65027,369
2022-09-07,70046,70050,Blue,1,46439,46608,169
2022-06-29,70053,70049,Blue,0,60285,60490,205
2022-08-20,70048,70060,Blue,1,47493,48177,684
2022-01-14,70046,70050,Blue,1,72817,73015,198
2022-07-15,70057,70041,Blue,0,88176,89068,892
2022-03-24,70038,70054,Blue,1,46387,47171,784
2022-06-12,70053,70051,Blue,0,62281,62331,50
2022-11-15,70046,70054,Blue,1,42397,42844,447
2022-05-20,70048,70056,Blue,1,55693,56086,393
2022-08-12,70051,70047,Blue,0,30102,30306,204
2022-02-28,70040,70042,Blue,1,60207,60244,37
2022-02-24,70045,70039,Blue,0,28445,28960,515
2022-09-28,70044,70046,Blue,1,85930,86031,101
2022-05-01,70049,70047,Blue,0,29321,29381,60
2022-01-24,70046,70048,Blue,1,74401,74507,106
2022-03-14,70038,70058,Blue,1,84926,85930,1004
2022-07-09,70046,70050,Blue,1,63054,63268,214
2022-11-29,70049,70039,Blue,0,60253,60739,486
2022-11-08,70055,70043,Blue,0,50121,50791,670
2022-03-01,70057,70039,Blue,0,30625,31620,995
2022-02-13,70040,70056,Blue,1,71049,71835,786
2022-03-24,70048,70054,Blue,1,53524,53877,353
2022-09-29,70055,70838,Blue,0,73992,74877,885
2022-07-13,70050,70052,Blue,1,58473,58588,115
2022-08-09,70053,70045,Blue,0,67882,68294,412
2022-09-20,70048,70054,Blue,1,34968,35269,301
2022-09-23,70046,70048,Blue,1,84899,84977,78
2022-02-03,70052,70054,Blue,1,47120,47174,54
2022-12-21,70057,70043,Blue,0,67427,68196,769
2022-02-25,70044,70046,Blue,1,33244,33354,110
2022-08-01,70045,70041,Blue,0,25228,25417,189
2022-10-28,70059,70049,Blue,0,67095,67547,452
2022-10-21,70048,70060,Blue,1,34619,35402,783
2022-12-23,70044,70056,Blue,1,69791,70498,707
2022-12-05,70059,70039,Blue,0,44175,45198,1023
2022-02-08,70049,70838,Blue,0,24835,25511,676
2022-04-12,70055,70047,Blue,0,48378,48820,442
2022-06-06,70043,70041,Blue,0,81130,81158,28
2022-08-21,70038,70050,Blue,1,46153,46699,546
2022-03-07,70059,70053,Blue,0,65305,65575,270
2022-12-07,70048,70050,Blue,1,34581,34640,59
2022-07-07,70042,70056,Blue,1,61996,62839,843
2022-08-09,70059,70039,Blue,0,60614,61707,1093
2022-01-12,70038,70040,Blue,1,32041,32061,20
2022-05-31,70040,70048,Blue,1,28226,28709,483
2022-10-06,70038,70058,Blue,1,68475,69513,1038
2022-03-13,70048,70058,Blue,1,41504,41996,492
2022-09-20,70046,70056,Blue,1,34535,35115,580
2022-07-29,70047,70043,Blue,0,22778,23044,266
2022-09-09,70051,70049,Blue,0,38849,38955,106
2022-10-09,70055,70039,Blue,0,50235,51036,801
2022-05-19,70052,70060,Blue,1,41686,42087,401
2022-12-04,70050,70056,Blue,1,67822,68117,295
2022-12-22,70053,70045,Blue,0,34583,35047,464
2022-06-11,70050,70058,Blue,1,65448,65865,417
2022-11-11,70056,70058,Blue,1,72105,72179,74
2022-02-20,70049,70838,Blue,0,42686,43386,700
2022-10-21,70045,70043,Blue,0,56401,56498,97
2022-12-16,70054,70056,Blue,1,29898,29947,49
2022-07-21,70043,70039,Blue,0,33173,33295,122
2022-04-30,70049,70047,Blue,0,22006,22049,43
2022-01-18,70059,70047,Blue,0,59597,60115,518
2022-07-06,70049,70041,Blue,0,54330,54788,458
2022-01-31,70048,70056,Blue,1,51008,51402,394
2022-03-30,70046,70060,Blue,1,30638,31436,798
2022-03-02,70057,70039,Blue,0,62974,63922,948
2022-03-23,70050,70054,Blue,1,73118,73336,218
2022-02-04,70045,70041,Blue,0,73508,73712,204
2022-03-16,70051,70041,Blue,0,48535,49100,565
2022-03-08,70040,70060,Blue,1,31509,32654,1145
2022-12-03,70059,70055,Blue,0,34635,34785,150
2022-12-18,70044,70050,Blue,1,79963,80304,341
2022-10-17,70044,70056,Blue,1,61417,62066,649
2022-10-29,70044,70060,Blue,1,88495,89500,1005
2022-11-04,70054,70058,Blue,1,50638,50806,168
2022-10-18,70040,70054,Blue,1,25705,26447,742
2022-12-29,70042,70058,Blue,1,31656,32528,872
2022-01-18,70057,70051,Blue,0,52280,52562,282
2022-01-24,70047,70043,Blue,0,87730,88053,323
2022-09-30,70043,70838,Blue,0,62349,62551,202
2022-07-08,70044,70046,Blue,1,25592,25749,157
2022-10-17,70055,70039,Blue,0,61570,62378,808
2022-01-18,70038,70050,Blue,1,33899,34569,670
2022-07-03,70057,70039,Blue,0,21585,22644,1059
2022-01-15,70047,70039,Blue,0,72542,72941,399
2022-01-18,70052,70058,Blue,1,28393,28780,387
2022-07-25,70042,70052,Blue,1,31380,31945,565
2022-03-30,70053,70047,Blue,0,55052,55335,283
2022-09-19,70050,70060,Blue,1,29923,30568,645
2022-01-13,70042,70044,Blue,1,66005,66039,34
2022-11-23,70052,70058,Blue,1,69274,69528,254
2022-09-27,70051,70039,Blue,0,83894,84542,648
2022-07-14,70047,70039,Blue,0,50654,51110,456
2022-07-21,70044,70046,Blue,1,55985,56090,105
2022-10-21,70048,70052,Blue,1,52657,52878,221
2022-08-11,70050,70054,Blue,1,65431,65668,237
2022-07-26,70059,70043,Blue,0,73334,74162,828
2022-01-14,70040,70054,Blue,1,53768,54474,706
2022-06-15,70038,70056,Blue,1,66135,67129,994
2022-01-21,70038,70040,Blue,1,43508,43523,15
2022-08-28,70042,70056,Blue,1,31708,32460,752
2022-12-16,70055,70041,Blue,0,77717,78463,746
2022-10-04,70046,70054,Blue,1,58479,58910,431
2022-04-26,70052,70056,Blue,1,85732,85886,154
2022-11-29,70055,70838,Blue,0,62628,63531,903
2022-01-02,70040,70054,Blue,1,67267,67995,728
2022-07-29,70049,70039,Blue,0,53658,54180,522
2022-02-16,70059,70055,Blue,0,44380,44523,143
2022-08-05,70053,70047,Blue,0,62855,63138,283
2022-10-30,70040,70056,Blue,1,45024,45883,859
2022-03-24,70038,70044,Blue,1,28808,29001,193
2022-08-08,70044,70050,Blue,1,26532,26899,367
2022-05-11,70059,70055,Blue,0,23417,23568,151
2022-01-11,70053,70047,Blue,0,54155,54437,282
2022-03-09,70051,70045,Blue,0,69896,70240,344
2022-06-22,70050,70056,Blue,1,44402,44764,362
2022-02-25,70059,70043,Blue,0,80599,81411,812
2022-01-03,70042,70054,Blue,1,74315,75224,909
2022-03-10,70053,70041,Blue,0,26083,26828,745
2022-02-02,70038,70060,Blue,1,75927,77139,1212
2022-03-26,70044,70058,Blue,1,80161,80982,821
2022-12-27,70049,70047,Blue,0,27711,27767,56
2022-10-15,70053,70049,Blue,0,25708,25901,193
2022-07-17,70057,70039,Blue,0,55027,56039,1012
2022-09-18,70046,70054,Blue,1,45384,45836,452
2022-04-15,70048,70052,Blue,1,62678,62892,214
2022-04-09,70053,70043,Blue,0,50035,50667,632
2022-08-06,70051,70043,Blue,0,82720,83283,563
2022-04-26,70054,70060,Blue,1,59905,60194,289
2022-04-15,70049,70047,Blue,0,85089,85141,52
2022-08-12,70050,70054,Blue,1,36837,37048,211
2022-12-30,70057,70051,Blue,0,51592,51837,245
2022-11-23,70056,70060,Blue,1,27788,27959,171
2022-10-28,70053,70051,Blue,0,84172,84221,49
2022-02-05,70051,70838,Blue,0,86061,86792,731
2022-01-05,70047,70045,Blue,0,67437,67540,103
2022-08-18,70049,70041,Blue,0,32743,33197,454
2022-07-25,70051,70043,Blue,0,54942,55420,478
2022-09-22,70046,70054,Blue,1,27006,27436,430
2022-06-24,70038,70040,Blue,1,22048,22074,26
2022-02-08,70053,70045,Blue,0,58649,59091,442
2022-02-20,70055,70041,Blue,0,73458,74292,834
2022-01-22,70051,70047,Blue,0,29080,29274,194
2022-09-26,70042,70046,Blue,1,46299,46480,181
2022-10-18,70044,70050,Blue,1,25399,25717,318
2022-06-12,70050,70052,Blue,1,42962,43077,115
2022-11-14,70051,70039,Blue,0,34650,35322,672
2022-10-31,70055,70049,Blue,0,37115,37475,360
2022-04-16,70042,70044,Blue,1,27628,27658,30
2022-04-18,70047,70039,Blue,0,36823,37284,461
2022-02-15,70059,70051,Blue,0,59294,59654,360
2022-10-17,70057,70043,Blue,0,67653,68393,740
2022-11-24,70038,70046,Blue,1,86413,86732,319
2022-01-31,70057,70838,Blue,0,33451,34800,1349
2022-06-29,70055,70053,Blue,0,36879,36925,46
2022-08-31,70057,70039,Blue,0,30164,31290,1126
2022-10-25,70046,70050,Blue,1,39307,39517,210
2022-03-22,70057,70049,Blue,0,29432,29812,380
2022-12-14,70055,70043,Blue,0,21027,21690,663
2022-03-28,70044,70056,Blue,1,65764,66441,677
2022-02-04,70044,70048,Blue,1,27436,27664,228
2022-11-28,70056,70058,Blue,1,29909,29982,73
2022-01-04,70059,70051,Blue,0,25768,26405,637
2022-09-15,70057,70047,Blue,0,41733,43342,1609
2022-12-13,70055,70838,Blue,0,87501,88433,932
2022-02-03,70049,70041,Blue,0,65738,66134,396
2022-01-10,70040,70042,Blue,1,82039,82074,35
2022-03-05,70042,70052,Blue,1,54102,54637,535
2022-02-28,70051,70049,Blue,0,55799,55900,101
2022-01-25,70055,70045,Blue,0,27993,28513,520
2022-07-11,70058,70060,Blue,1,54168,54270,102
2022-06-17,70055,70039,Blue,0,35446,36329,883
2022-08-05,70048,70056,Blue,1,70752,71156,404
2022-06-10,70041,70039,Blue,0,52114,52148,34
2022-12-29,70052,70060,Blue,1,67004,67515,511
2022-08-26,70040,70056,Blue,1,82707,83580,873
2022-05-20,70038,70048,Blue,1,53262,53764,502
2022-07-05,70044,70060,Blue,1,57076,58007,931
2022-12-28,70051,70047,Blue,0,61436,61617,181
2022-11-06,70042,70058,Blue,1,47917,48751,834
2022-09-03,70047,70043,Blue,0,49294,49543,249
2022-04-24,70045,70838,Blue,0,28592,28978,386
2022-06-09,70059,70055,Blue,0,32956,33124,168
2022-10-25,70042,70046,Blue,1,21571,21752,181
2022-03-01,70040,70052,Blue,1,80578,81266,688
2022-09-19,70051,70838,Blue,0,75273,76037,764
2022-10-22,70051,70041,Blue,0,75484,76082,598
2022-12-14,70048,70052,Blue,1,29458,29670,212
2022-04-12,70038,70046,Blue,1,21133,21410,277
2022-01-09,70057,70043,Blue,0,40896,41678,782
2022-06-29,70057,70043,Blue,0,29375,30156,781
2022-12-19,70059,70055,Blue,0,53823,53987,164
2022-09-07,70058,70060,Blue,1,25997,26062,65
2022-03-28,70055,70838,Blue,0,21521,22613,1092
2022-09-03,70038,70044,Blue,1,29109,29281,172
2022-09-19,70045,70043,Blue,0,47786,47894,108
2022-12-17,70049,70041,Blue,0,33655,34095,440
2022-01-06,70039,70838,Blue,0,23728,23761,33
2022-09-19,70042,70060,Blue,1,64121,65175,1054
2022-11-08,70053,70045,Blue,0,77729,78139,410
2022-08-26,70039,70838,Blue,0,32988,33020,32
2022-05-01,70059,70057,Blue,0,24008,24044,36
2022-03-02,70042,70054,Blue,1,24480,25198,718
2022-06-16,70050,70052,Blue,1,86068,86174,106
2022-02-10,70046,70054,Blue,1,68319,68754,435
2022-04-17,70057,70049,Blue,0,60388,60793,405
2022-10-05,70053,70039,Blue,0,39295,40091,796
2022-02-25,70040,70060,Blue,1,37263,38943,1680
2022-01-26,70038,70040,Blue,1,76332,76347,15
2022-02-21,70050,70056,Blue,1,45394,45698,304
2022-02-09,70059,70049,Blue,0,53114,53657,543
2022-08-17,70040,70056,Blue,1,74323,75179,856
2022-06-29,70047,70838,Blue,0,25390,25911,521
2022-08-22,70051,70049,Blue,0,20358,20460,102
2022-11-23,70047,70041,Blue,0,27324,27667,343
2022-11-17,70046,70060,Blue,1,64183,64889,706
2022-01-28,70038,70054,Blue,1,51821,52704,883
2022-10-15,70041,70039,Blue,0,61552,61587,35
2022-07-18,70038,70044,Blue,1,73629,73803,174
2022-12-30,70055,70051,Blue,0,48288,48436,148
2022-09-29,70038,70060,Blue,1,22382,23528,1146
2022-10-21,70052,70056,Blue,1,82119,82263,144
2022-02-17,70055,70838,Blue,0,85933,86863,930
2022-04-09,70047,70041,Blue,0,37478,37820,342
2022-01-12,70038,70042,Blue,1,65534,65617,83
2022-06-03,70044,70050,Blue,1,25982,26427,445
2022-07-25,70046,70050,Blue,1,78021,78229,208
2022-06-06,70043,70838,Blue,0,40115,40327,212
2022-12-31,70040,70048,Blue,1,67081,67473,392
2022-11-06,70052,70054,Blue,1,63121,63176,55
2022-03-17,70047,70041,Blue,0,66236,66562,326
2022-03-14,70047,70039,Blue,0,56890,57316,426
2022-12-22,70048,70050,Blue,1,61337,61399,62
2022-12-25,70040,70056,Blue,1,66302,67159,857
2022-01-01,70040,70048,Blue,1,26163,26516,353
2022-07-28,70040,70048,Blue,1,57978,58371,393
2022-08-30,70053,70045,Blue,0,40385,40850,465
2022-01-13,70042,70060,Blue,1,68422,69644,1222
2022-06-14,70048,70054,Blue,1,76863,77176,313
2022-03-14,70041,70039,Blue,0,66485,66518,33
2022-10-25,70055,70838,Blue,0,49070,49987,917
2022-03-26,70042,70056,Blue,1,55753,56596,843
2022-03-28,70038,70052,Blue,1,34772,35577,805
2022-08-20,70042,70058,Blue,1,29791,30694,903
2022-09-14,70053,70838,Blue,0,84496,85277,781
2022-09-04,70050,70056,Blue,1,47308,47608,300
2022-05-20,70038,70056,Blue,1,52023,53010,987
2022-03-05,70040,70042,Blue,1,64279,64313,34
2022-07-05,70048,70050,Blue,1,42147,42212,65
2022-05-15,70056,70058,Blue,1,38389,38459,70
2022-07-06,70051,70039,Blue,0,55728,56377,649
2022-07-13,70046,70056,Blue,1,74022,74608,586
2022-11-13,70053,70049,Blue,0,34244,34425,181
2022-06-24,70055,70043,Blue,0,45919,46580,661
2022-10-07,70059,70051,Blue,0,71241,71566,325
2022-03-02,70046,70048,Blue,1,50677,50759,82
2022-08-27,70047,70045,Blue,0,36876,36965,89
2022-12-16,70055,70043,Blue,0,29135,29832,697
2022-11-01,70038,70040,Blue,1,49752,49766,14
2022-03-18,70057,70051,Blue,0,30034,30293,259
2022-12-12,70057,70045,Blue,0,42688,43329,641
2022-03-25,70059,70049,Blue,0,43280,43753,473
2022-03-05,70059,70039,Blue,0,61094,62116,1022
2022-12-02,70053,70045,Blue,0,53367,53808,441
2022-02-08,70042,70048,Blue,1,81603,81945,342
2022-09-07,70042,70058,Blue,1,59118,59968,850
2022-12-01,70051,70043,Blue,0,53887,54366,479
2022-05-18,70051,70047,Blue,0,51079,51275,196
2022-05-03,70050,70060,Blue,1,36674,37266,592
2022-01-28,70038,70058,Blue,1,46938,48000,1062
2022-05-10,70057,70049,Blue,0,32728,33101,373
2022-03-12,70057,70039,Blue,0,85769,86637,868
2022-10-23,70059,70055,Blue,0,68954,69096,142
2022-03-01,70049,70047,Blue,0,80641,80711,70
2022-11-27,70042,70052,Blue,1,46274,46797,523
2022-01-05,70053,70041,Blue,0,57466,58084,618
2022-12-01,70045,70041,Blue,0,70387,70544,157
2022-09-08,70059,70049,Blue,0,39502,40014,512
2022-06-08,70049,70043,Blue,0,87237,87622,385
2022-03-25,70059,70838,Blue,0,24860,26024,1164
2022-06-23,70042,70050,Blue,1,61511,61996,485
2022-01-12,70052,70056,Blue,1,59712,59846,134
2022-06-17,70053,70041,Blue,0,34201,34869,668
2022-07-18,70045,70041,Blue,0,67734,67912,178
2022-01-12,70041,70838,Blue,0,58251,58367,116
2022-04-12,70059,70051,Blue,0,70993,71340,347
2022-08-15,70042,70050,Blue,1,57838,58284,446
2022-02-23,70057,70049,Blue,0,49295,49705,410
2022-07-10,70057,70838,Blue,0,52870,53867,997
2022-04-04,70041,70838,Blue,0,67771,67890,119
2022-01-21,70057,70045,Blue,0,84700,85347,647
2022-08-28,70050,70060,Blue,1,60277,60800,523
2022-09-09,70046,70050,Blue,1,78314,78514,200
2022-10-24,70053,70039,Blue,0,86024,86770,746
2022-09-01,70038,70040,Blue,1,74266,74281,15
2022-02-08,70047,70838,Blue,0,73207,73705,498
2022-03-14,70040,70048,Blue,1,53430,53859,429
2022-03-22,70051,70838,Blue,0,23860,24692,832
2022-04-18,70044,70054,Blue,1,86319,86879,560
2022-08-25,70053,70051,Blue,0,24116,24171,55
2022-08-06,70047,70039,Blue,0,74630,75038,408
2022-09-19,70051,70838,Blue,0,46800,47786,986
2022-03-15,70053,70838,Blue,0,31417,32745,1328
2022-02-19,70040,70056,Blue,1,51942,52809,867
2022-07-08,70053,70041,Blue,0,86920,87587,667
2022-01-26,70046,70060,Blue,1,20768,21560,792
2022-12-22,70040,70054,Blue,1,21254,22278,1024
2022-01-06,70038,70042,Blue,1,78552,78648,96
2022-10-01,70049,70043,Blue,0,28665,29006,341
2022-08-15,70042,70044,Blue,1,59262,59291,29
2022-03-28,70044,70046,Blue,1,70111,70211,100
2022-10-19,70042,70054,Blue,1,77969,78613,644
2022-08-31,70041,70039,Blue,0,21192,21236,44
2022-03-31,70051,70041,Blue,0,53465,54017,552
2022-07-04,70039,70838,Blue,0,68656,68690,34
2022-12-29,70038,70058,Blue,1,32856,33859,1003
2022-05-23,70049,70045,Blue,0,54394,54665,271
2022-08-03,70048,70060,Blue,1,33855,34581,726
2022-07-19,70042,70058,Blue,1,69675,70599,924
2022-10-10,70050,70054,Blue,1,40405,40662,257
2022-01-23,70040,70042,Blue,1,45012,45055,43
2022-02-17,70038,70042,Blue,1,50773,50884,111
2022-07-09,70056,70060,Blue,1,55471,55656,185
2022-10-01,70040,70058,Blue,1,49726,50708,982
2022-03-02,70047,70041,Blue,0,65393,65739,346
2022-01-13,70040,70058,Blue,1,72507,73500,993
2022-03-18,70046,70052,Blue,1,35708,36079,371
2022-02-22,70044,70054,Blue,1,85584,86141,557
2022-01-09,70055,70045,Blue,0,50255,50753,498
2022-07-19,70050,70060,Blue,1,64953,65455,502
2022-04-06,70049,70838,Blue,0,51238,51847,609
2022-10-13,70049,70045,Blue,0,73469,73674,205
2022-06-22,70040,70044,Blue,1,24006,24118,112
2022-04-07,70053,70049,Blue,0,64959,65151,192
2022-01-06,70038,70060,Blue,1,36202,37474,1272
2022-07-07,70040,70044,Blue,1,42149,42264,115
2022-04-05,70059,70043,Blue,0,29060,29949,889
2022-12-10,70046,70058,Blue,1,46772,47391,619
2022-01-14,70042,70050,Blue,1,85111,85593,482
2022-09-09,70041,70039,Blue,0,54774,54806,32
2022-09-22,70053,70043,Blue,0,34187,34785,598
2022-03-02,70051,70049,Blue,0,61984,62093,109
2022-01-03,70057,70049,Blue,0,53674,54057,383
2022-01-10,70038,70058,Blue,1,83706,84760,1054
2022-06-21,70042,70048,Blue,1,30047,30444,397
2022-04-05,70051,70838,Blue,0,58158,58896,738
2022-03-10,70048,70054,Blue,1,29071,29388,317
2022-08-30,70052,70060,Blue,1,28621,28974,353
2022-02-24,70052,70060,Blue,1,31668,32046,378
2022-09-02,70051,70838,Blue,0,27972,28691,719
2022-11-14,70042,70048,Blue,1,49888,50169,281
2022-04-23,70053,70047,Blue,0,57053,57343,290
2022-01-04,70059,70045,Blue,0,28766,29598,832
2022-08-01,70047,70043,Blue,0,44303,44581,278
2022-06-17,70059,70051,Blue,0,61394,61697,303
2022-10-27,70059,70057,Blue,0,75372,75407,35
2022-03-21,70048,70056,Blue,1,54115,54514,399
2022-09-18,70059,70045,Blue,0,58179,58892,713
2022-09-15,70044,70046,Blue,1,84365,84466,101
2022-02-18,70059,70057,Blue,0,25753,25789,36
2022-04-07,70044,70056,Blue,1,43860,44618,758
2022-07-04,70050,70054,Blue,1,42717,42963,246
2022-01-12,70048,70060,Blue,1,56775,57510,735
2022-01-26,70049,70043,Blue,0,46683,47077,394
2022-05-19,70049,70047,Blue,0,26691,26750,59
2022-02-26,70049,70039,Blue,0,42191,42711,520
2022-02-08,70059,70838,Blue,0,61387,62982,1595
2022-08-21,70051,70838,Blue,0,60673,61444,771
2022-03-21,70043,70838,Blue,0,84853,85028,175
2022-12-27,70049,70043,Blue,0,76134,76455,321
2022-09-23,70053,70039,Blue,0,41621,42492,871
2022-08-11,70044,70050,Blue,1,55183,55570,387
2022-03-19,70043,70041,Blue,0,34996,35024,28
2022-08-09,70049,70039,Blue,0,20446,20997,551
2022-04-30,70051,70049,Blue,0,87104,87270,166
2022-12-14,70052,70058,Blue,1,39387,39701,314
2022-03-09,70051,70047,Blue,0,28884,29083,199
2022-10-18,70044,70050,Blue,1,72285,72602,317
2022-08-06,70045,70039,Blue,0,59161,59422,261
2022-04-22,70051,70045,Blue,0,19893,20223,330
2022-08-04,70041,70039,Blue,0,87673,87711,38
2022-08-07,70042,70054,Blue,1,59810,60731,921
2022-12-13,70044,70046,Blue,1,34690,34796,106
2022-12-08,70050,70056,Blue,1,65029,65342,313
2022-02-14,70040,70046,Blue,1,62703,62977,274
2022-06-17,70059,70045,Blue,0,41081,41896,815
2022-12-01,70052,70054,Blue,1,47873,47927,54
2022-09-15,70054,70056,Blue,1,58789,58836,47
2022-04-07,70053,70047,Blue,0,55052,55355,303
2022-01-02,70049,70039,Blue,0,49382,50276,894
2022-07-05,70042,70044,Blue,1,52019,52052,33
2022-02-16,70047,70045,Blue,0,70617,70730,113
2022-07-22,70056,70060,Blue,1,57311,57488,177
2022-02-25,70045,70838,Blue,0,42354,42691,337
2022-03-11,70055,70053,Blue,0,57546,57591,45
2022-07-24,70038,70056,Blue,1,46158,47095,937
2022-03-01,70044,70058,Blue,1,64109,65129,1020
2022-05-10,70058,70060,Blue,1,61022,61081,59
2022-02-23,70059,70047,Blue,0,20970,21580,610
2022-12-20,70046,70056,Blue,1,47322,47834,512
2022-08-30,70039,70838,Blue,0,56396,56434,38
2022-11-25,70053,70043,Blue,0,45562,46152,590
2022-07-12,70053,70043,Blue,0,86835,87383,548
2022-03-18,70051,70045,Blue,0,75857,76218,361
2022-08-27,70047,70043,Blue,0,52035,52283,248
2022-02-20,70042,70050,Blue,1,39176,39587,411
2022-08-22,70051,70041,Blue,0,77999,78593,594
2022-11-01,70048,70056,Blue,1,42539,42928,389
2022-02-24,70048,70052,Blue,1,65469,65684,215
2022-05-19,70039,70838,Blue,0,68332,68366,34
2022-11-04,70038,70056,Blue,1,76372,77349,977
2022-03-19,70053,70051,Blue,0,65125,65178,53
2022-02-27,70045,70838,Blue,0,57328,57700,372
2022-02-07,70053,70051,Blue,0,86596,86655,59
2022-09-26,70043,70039,Blue,0,60198,60302,104
2022-04-01,70041,70039,Blue,0,79311,79343,32
2022-12-22,70038,70042,Blue,1,19819,19922,103
2022-11-20,70048,70060,Blue,1,36039,36669,630
2022-10-15,70047,70045,Blue,0,44408,44494,86
2022-03-09,70040,70044,Blue,1,34813,34918,105
2022-08-23,70055,70043,Blue,0,31097,31764,667
2022-03-03,70038,70040,Blue,1,55056,55075,19
2022-10-06,70038,70050,Blue,1,81907,82521,614
2022-01-31,70048,70056,Blue,1,38244,38698,454
2022-09-22,70055,70051,Blue,0,20604,20755,151
2022-06-18,70048,70050,Blue,1,76076,76132,56
2022-06-12,70049,70045,Blue,0,71054,71247,193
2022-01-04,70055,70838,Blue,0,85939,86805,866
2022-08-05,70044,70046,Blue,1,34362,34462,100
2022-09-12,70038,70048,Blue,1,33193,33651,458
2022-04-15,70047,70045,Blue,0,65886,65985,99
2022-01-13,70046,70058,Blue,1,42761,43457,696
2022-12-17,70049,70838,Blue,0,29190,29745,555
2022-09-20,70040,70044,Blue,1,55207,55304,97
2022-05-19,70040,70052,Blue,1,25337,26056,719
2022-12-22,70042,70048,Blue,1,68050,68362,312
2022-05-12,70059,70057,Blue,0,82219,82261,42
2022-02-09,70043,70041,Blue,0,35092,35124,32
2022-09-26,70059,70043,Blue,0,31496,32352,856
2022-04-15,70042,70058,Blue,1,79497,80348,851
2022-12-14,70042,70058,Blue,1,59012,60040,1028
2022-01-26,70055,70041,Blue,0,31344,32135,791
2022-02-23,70047,70041,Blue,0,54191,54516,325
2022-10-25,70052,70060,Blue,1,55315,55684,369
2022-09-07,70056,70060,Blue,1,80913,81076,163
2022-01-11,70040,70054,Blue,1,52841,53745,904
2022-11-20,70049,70045,Blue,0,87152,87339,187
2022-02-01,70057,70039,Blue,0,69989,70912,923
2022-04-12,70059,70838,Blue,0,65897,67097,1200
2022-09-27,70046,70060,Blue,1,67819,68599,780
2022-01-05,70051,70049,Blue,0,36919,37050,131
2022-04-07,70040,70054,Blue,1,43673,44533,860
2022-10-13,70045,70041,Blue,0,78930,79111,181
2022-06-18,70040,70046,Blue,1,66120,66387,267
2022-03-30,70049,70041,Blue,0,54689,55104,415
2022-02-06,70052,70054,Blue,1,64803,64858,55
2022-01-10,70047,70045,Blue,0,24857,24942,85
2022-02-19,70038,70044,Blue,1,38406,38588,182
2022-10-03,70046,70054,Blue,1,47051,47456,405
2022-06-09,70044,70060,Blue,1,25957,26881,924
2022-07-18,70046,70050,Blue,1,47521,47716,195
2022-09-30,70059,70053,Blue,0,82967,83186,219
2022-03-22,70038,70042,Blue,1,42966,43055,89
2022-12-30,70046,70050,Blue,1,34522,34712,190
2022-04-02,70038,70040,Blue,1,53954,53967,13
2022-08-31,70059,70838,Blue,0,33504,34825,1321
2022-08-01,70046,70058,Blue,1,54054,54764,710
2022-03-25,70052,70060,Blue,1,37046,37422,376
2022-04-15,70040,70056,Blue,1,49815,50601,786
2022-01-26,70055,70043,Blue,0,52694,53397,703
2022-02-19,70057,70049,Blue,0,59550,59970,420
2022-03-05,70055,70041,Blue,0,41834,42576,742
2022-09-15,70053,70041,Blue,0,79769,80421,652
2022-02-12,70052,70054,Blue,1,38513,38565,52
2022-11-30,70055,70049,Blue,0,26011,26295,284
2022-08-06,70049,70043,Blue,0,51925,52278,353
2022-10-05,70048,70056,Blue,1,27526,27969,443
2022-04-13,70056,70058,Blue,1,49630,49708,78
2022-07-06,70043,70041,Blue,0,27763,27801,38
2022-04-07,70051,70039,Blue,0,24924,25633,709
2022-02-17,70055,70051,Blue,0,83662,83812,150
2022-03-24,70052,70056,Blue,1,75957,76101,144
2022-02-03,70038,70052,Blue,1,66765,67486,721
2022-08-23,70046,70056,Blue,1,62710,63251,541
2022-03-01,70049,70047,Blue,0,52085,52142,57
2022-07-10,70043,70041,Blue,0,59867,59896,29
2022-11-11,70045,70043,Blue,0,83768,83852,84
2022-03-26,70045,70041,Blue,0,54840,55014,174
2022-04-04,70042,70052,Blue,1,57880,58429,549
2022-07-18,70053,70051,Blue,0,80724,80780,56
2022-10-01,70055,70838,Blue,0,44002,44940,938
2022-01-05,70042,70044,Blue,1,44249,44277,28
2022-03-06,70058,70060,Blue,1,53597,53659,62
2022-06-10,70055,70047,Blue,0,59823,60755,932
2022-02-09,70051,70838,Blue,0,77599,78404,805
2022-10-27,70045,70039,Blue,0,63898,64150,252
2022-11-07,70049,70043,Blue,0,75401,75727,326
2022-09-09,70057,70043,Blue,0,83171,83997,826
2022-04-09,70042,70048,Blue,1,45475,45754,279
2022-12-24,70045,70039,Blue,0,42614,42885,271
2022-02-25,70050,70056,Blue,1,53060,53389,329
2022-12-01,70038,70048,Blue,1,88219,88701,482
2022-07-18,70057,70051,Blue,0,59447,59722,275
2022-03-28,70042,70044,Blue,1,26196,26226,30
2022-01-28,70042,70060,Blue,1,25876,26968,1092
2022-04-21,70054,70056,Blue,1,67035,67081,46
2022-04-22,70059,70049,Blue,0,82337,82789,452
2022-07-18,70056,70058,Blue,1,28237,28315,78
2022-04-20,70038,70060,Blue,1,25148,26313,1165
2022-05-21,70059,70053,Blue,0,75814,76044,230
2022-08-16,70053,70043,Blue,0,58317,58909,592
2022-08-23,70053,70041,Blue,0,23310,24061,751
2022-01-31,70045,70039,Blue,0,21526,21808,282
2022-01-20,70038,70058,Blue,1,74107,75347,1240
2022-08-10,70053,70049,Blue,0,22848,23035,187
2022-03-17,70057,70049,Blue,0,50330,50754,424
2022-08-16,70053,70049,Blue,0,76176,76364,188
2022-09-17,70042,70052,Blue,1,49264,49873,609
2022-06-13,70059,70057,Blue,0,26360,26396,36
2022-08-30,70047,70043,Blue,0,59831,60084,253
2022-07-17,70048,70060,Blue,1,70028,70720,692
2022-03-23,70051,70045,Blue,0,61737,62064,327
2022-04-15,70043,70041,Blue,0,33307,33337,30
2022-06-23,70047,70039,Blue,0,42893,43361,468
2022-09-13,70055,70041,Blue,0,37648,38475,827
2022-12-19,70042,70058,Blue,1,52855,53745,890
2022-08-24,70039,70838,Blue,0,52749,52781,32
2022-05-04,70055,70051,Blue,0,52417,52563,146
2022-04-12,70038,70040,Blue,1,20904,20921,17
2022-10-20,70049,70043,Blue,0,71718,72050,332
2022-11-03,70048,70058,Blue,1,69466,69973,507
2022-09-08,70040,70054,Blue,1,54982,55757,775
2022-11-03,70040,70056,Blue,1,44280,45100,820
2022-01-12,70058,70060,Blue,1,46927,47156,229
2022-08-18,70053,70039,Blue,0,74251,74956,705
2022-04-14,70050,70052,Blue,1,38023,38149,126
2022-01-10,70046,70056,Blue,1,88738,89304,566
2022-07-26,70050,70054,Blue,1,53652,53857,205
2022-04-19,70051,70838,Blue,0,63790,64588,798
2022-06-09,70038,70050,Blue,1,56593,57562,969
2022-01-19,70040,70042,Blue,1,54381,54415,34
2022-08-03,70059,70039,Blue,0,28474,29547,1073
2022-03-29,70038,70046,Blue,1,56525,56833,308
2022-04-22,70051,70039,Blue,0,65665,66340,675
2022-11-18,70042,70050,Blue,1,48279,48673,394
2022-03-20,70050,70060,Blue,1,48882,49514,632
2022-10-10,70044,70050,Blue,1,64516,64882,366
2022-03-01,70047,70041,Blue,0,43254,43623,369
2022-10-13,70055,70041,Blue,0,27003,27827,824
2022-10-10,70047,70838,Blue,0,33750,34298,548
2022-11-03,70055,70043,Blue,0,34518,35216,698
2022-07-30,70040,70042,Blue,1,66434,66470,36
2022-01-09,70040,70050,Blue,1,54317,54827,510
2022-07-09,70044,70056,Blue,1,50952,51650,698
2022-08-11,70055,70041,Blue,0,80000,80699,699
2022-03-20,70045,70039,Blue,0,58772,59040,268
2022-08-16,70038,70058,Blue,1,30393,31409,1016
2022-12-19,70054,70056,Blue,1,33155,33203,48
2022-11-07,70044,70056,Blue,1,57618,58630,1012
2022-06-20,70055,70053,Blue,0,24051,24101,50
2022-07-06,70044,70052,Blue,1,28984,29554,570
2022-07-01,70054,70056,Blue,1,54335,54381,46
2022-02-28,70053,70051,Blue,0,86024,86076,52
2022-02-08,70039,70838,Blue,0,75503,75540,37
2022-10-11,70049,70043,Blue,0,57715,58067,352
2022-01-31,70051,70047,Blue,0,68070,68270,200
2022-12-08,70038,70052,Blue,1,35293,36011,718
2022-06-28,70038,70058,Blue,1,21084,22229,1145
2022-04-04,70041,70039,Blue,0,65655,65688,33
2022-07-19,70054,70056,Blue,1,22223,22270,47
2022-11-19,70057,70055,Blue,0,69821,69892,71
2022-11-04,70038,70042,Blue,1,57459,57586,127
2022-07-01,70059,70055,Blue,0,45279,45504,225
2022-07-11,70044,70058,Blue,1,76018,76885,867
2022-08-27,70053,70045,Blue,0,36531,36965,434
2022-08-30,70049,70047,Blue,0,71679,71734,55
2022-12-27,70045,70043,Blue,0,75175,75264,89
2022-08-24,70059,70039,Blue,0,44174,45256,1082
2022-03-18,70055,70053,Blue,0,38306,38358,52
2022-01-04,70046,70058,Blue,1,23788,24455,667
2022-04-04,70041,70838,Blue,0,52155,52407,252
2022-10-29,70051,70039,Blue,0,46436,47125,689
2022-11-02,70051,70047,Blue,0,55544,55740,196
2022-02-02,70047,70045,Blue,0,66384,66672,288
2022-10-19,70043,70041,Blue,0,79000,79028,28
2022-04-14,70041,70838,Blue,0,65139,65255,116
2022-04-24,70044,70060,Blue,1,74487,75396,909
2022-07-14,70051,70043,Blue,0,82191,82780,589
2022-11-20,70042,70060,Blue,1,78153,79145,992
2022-03-15,70049,70047,Blue,0,67965,68020,55
2022-12-29,70057,70055,Blue,0,55300,55369,69
2022-06-20,70050,70052,Blue,1,33477,33607,130
2022-03-08,70040,70058,Blue,1,46487,47447,960
2022-07-02,70054,70060,Blue,1,61403,61694,291
2022-07-14,70055,70053,Blue,0,32005,32052,47
2022-11-22,70051,70043,Blue,0,45574,46034,460
2022-02-20,70046,70056,Blue,1,55176,55700,524
2022-11-25,70050,70054,Blue,1,75323,75533,210
2022-12-02,70042,70050,Blue,1,55615,56073,458
2022-04-23,70049,70039,Blue,0,87591,88057,466
2022-05-20,70053,70043,Blue,0,20159,20916,757
2022-04-12,70052,70060,Blue,1,34456,34825,369
2022-08-01,70040,70046,Blue,1,65904,66182,278
2022-08-08,70051,70045,Blue,0,45071,45412,341
2022-02-02,70042,70044,Blue,1,31420,31451,31
2022-04-09,70059,70043,Blue,0,61093,61907,814
2022-07-11,70052,70058,Blue,1,30284,30563,279
2022-10-14,70040,70060,Blue,1,65896,66917,1021
2022-10-01,70059,70041,Blue,0,22815,23798,983
2022-11-14,70051,70047,Blue,0,22632,22856,224
2022-04-18,70055,70039,Blue,0,43408,44224,816
2022-02-23,70040,70052,Blue,1,50406,51072,666
2022-09-02,70042,70052,Blue,1,81186,81791,605
2022-01-16,70049,70047,Blue,0,54881,54938,57
2022-01-07,70042,70052,Blue,1,40303,40884,581
2022-08-07,70040,70042,Blue,1,31654,31690,36
2022-06-30,70053,70045,Blue,0,27061,27518,457
2022-11-14,70055,70053,Blue,0,49591,49637,46
2022-02-04,70047,70838,Blue,0,76696,77234,538
2022-04-08,70038,70044,Blue,1,32056,32241,185
2022-02-05,70047,70043,Blue,0,50951,51250,299
2022-04-15,70059,70053,Blue,0,66195,66417,222
2022-12-22,70042,70060,Blue,1,56880,57855,975
2022-04-04,70055,70043,Blue,0,49400,50105,705
2022-10-09,70050,70056,Blue,1,38898,39220,322
2022-09-28,70045,70039,Blue,0,67920,68157,237
2022-04-16,70038,70054,Blue,1,48565,49376,811
2022-01-03,70054,70060,Blue,1,65389,65638,249
2022-02-15,70040,70052,Blue,1,86096,86778,682
2022-07-29,70046,70058,Blue,1,75822,76473,651
2022-02-23,70045,70039,Blue,0,27980,28269,289
2022-09-29,70057,70047,Blue,0,23922,24432,510
2022-12-07,70051,70043,Blue,0,35660,36122,462
2022-07-01,70050,70052,Blue,1,30118,30239,121
2022-03-20,70044,70046,Blue,1,83324,83433,109
2022-09-25,70048,70052,Blue,1,43079,43289,210
2022-01-04,70050,70054,Blue,1,56943,57158,215
2022-09-12,70040,70054,Blue,1,22313,23016,703
2022-08-27,70058,70060,Blue,1,75018,75098,80
2022-07-18,70050,70058,Blue,1,64832,65480,648
2022-02-02,70040,70050,Blue,1,59011,59497,486
2022-08-30,70049,70045,Blue,0,32348,32560,212
2022-08-22,70038,70050,Blue,1,51792,52336,544
2022-03-26,70057,70049,Blue,0,22898,23273,375
2022-04-13,70054,70060,Blue,1,66113,66402,289
2022-03-24,70045,70838,Blue,0,70964,71285,321
2022-01-15,70055,70039,Blue,0,58791,60147,1356
2022-03-26,70057,70055,Blue,0,22898,22966,68
2022-01-14,70044,70048,Blue,1,25656,25916,260
2022-10-21,70043,70039,Blue,0,55012,55130,118
2022-10-04,70046,70052,Blue,1,80620,80955,335
2022-05-29,70040,70048,Blue,1,49588,50125,537
2022-10-18,70045,70039,Blue,0,32980,33239,259
2022-10-31,70054,70056,Blue,1,81874,81922,48
2022-05-22,70048,70050,Blue,1,48880,48937,57
2022-08-06,70046,70054,Blue,1,48951,49382,431
2022-12-03,70042,70052,Blue,1,76764,77341,577
2022-11-04,70040,70052,Blue,1,52688,53329,641
2022-05-18,70040,70058,Blue,1,59971,60979,1008
2022-07-07,70040,70052,Blue,1,73758,74489,731
2022-02-27,70059,70053,Blue,0,21531,21804,273
2022-08-26,70048,70054,Blue,1,31981,32274,293
2022-06-15,70057,70041,Blue,0,79539,80413,874
2022-04-22,70040,70046,Blue,1,76467,76746,279
2022-08-15,70057,70039,Blue,0,68207,69111,904
2022-11-01,70041,70838,Blue,0,24113,24242,129
2022-02-21,70048,70054,Blue,1,28571,28872,301
2022-10-29,70059,70053,Blue,0,82337,82556,219
2022-03-22,70053,70045,Blue,0,80873,81337,464
2022-06-18,70044,70046,Blue,1,40132,40256,124
2022-12-29,70057,70049,Blue,0,78213,78612,399
2022-10-13,70052,70060,Blue,1,44860,45270,410
2022-11-27,70055,70051,Blue,0,40924,41089,165
2022-12-19,70059,70047,Blue,0,48095,48661,566
2022-06-25,70048,70060,Blue,1,30748,31365,617
2022-08-06,70045,70043,Blue,0,33241,33332,91
2022-08-21,70054,70056,Blue,1,26107,26154,47
2022-07-31,70057,70838,Blue,0,64710,65765,1055
2022-11-28,70038,70050,Blue,1,83581,84134,553
2022-01-08,70059,70838,Blue,0,43544,44650,1106
2022-08-10,70038,70044,Blue,1,50824,51016,192
2022-08-11,70052,70054,Blue,1,37790,37870,80
2022-05-23,70043,70838,Blue,0,43474,43657,183
2022-04-09,70043,70039,Blue,0,25091,25210,119
2022-10-18,70051,70049,Blue,0,63253,63355,102
2022-09-22,70057,70045,Blue,0,61161,61737,576
2022-08-11,70055,70053,Blue,0,53723,53769,46
2022-07-24,70050,70058,Blue,1,42233,42641,408
2022-01-05,70038,70042,Blue,1,27856,27955,99
2022-10-20,70056,70058,Blue,1,29433,29504,71
2022-01-30,70053,70041,Blue,0,85870,86742,872
2022-03-24,70047,70045,Blue,0,48796,48882,86
2022-04-21,70044,70060,Blue,1,33453,34428,975
2022-07-09,70054,70058,Blue,1,31592,31741,149
2022-12-26,70040,70056,Blue,1,71058,71912,854
2022-07-29,70053,70045,Blue,0,56931,57389,458
2022-10-20,70055,70049,Blue,0,73521,73809,288
2022-04-07,70038,70050,Blue,1,24898,25471,573
2022-12-29,70042,70046,Blue,1,80246,80416,170
2022-10-28,70058,70060,Blue,1,29050,29130,80
2022-03-17,70043,70838,Blue,0,55951,56151,200
2022-12-09,70038,70040,Blue,1,78335,78349,14
2022-01-02,70055,70045,Blue,0,39698,40258,560
2022-07-26,70057,70043,Blue,0,64579,65342,763
2022-04-14,70043,70039,Blue,0,38805,38929,124
2022-02-04,70059,70049,Blue,0,49753,50243,490
2022-03-15,70040,70044,Blue,1,28713,28831,118
2022-06-25,70059,70051,Blue,0,54734,55109,375
2022-12-12,70044,70046,Blue,1,32296,32405,109
2022-01-28,70042,70046,Blue,1,35816,36006,190
2022-03-28,70040,70060,Blue,1,64691,65903,1212
2022-02-08,70059,70051,Blue,0,81205,81552,347
2022-07-12,70053,70051,Blue,0,50202,50256,54
2022-03-04,70059,70043,Blue,0,73214,74197,983
2022-02-14,70038,70042,Blue,1,29962,30059,97
2022-10-31,70057,70039,Blue,0,26859,27857,998
2022-02-18,70042,70048,Blue,1,63895,64219,324
2022-06-05,70049,70045,Blue,0,85525,85741,216
2022-03-04,70038,70044,Blue,1,22694,22872,178
2022-10-15,70057,70041,Blue,0,21637,22602,965
2022-06-28,70043,70041,Blue,0,46442,46471,29
2022-04-22,70038,70060,Blue,1,21574,22729,1155
2022-10-24,70046,70048,Blue,1,68320,68391,71
2022-11-12,70047,70043,Blue,0,27718,27975,257
2022-06-25,70059,70053,Blue,0,84936,85167,231
2022-03-14,70050,70056,Blue,1,27841,28134,293
2022-11-02,70055,70838,Blue,0,75083,76018,935
2022-11-17,70041,70039,Blue,0,50933,50963,30
2022-03-29,70043,70041,Blue,0,27557,27590,33
2022-01-08,70040,70058,Blue,1,72383,73341,958
2022-04-21,70045,70039,Blue,0,26646,26917,271
2022-09-07,70059,70057,Blue,0,62378,62414,36
2022-12-22,70057,70047,Blue,0,71235,71848,613
2022-12-14,70038,70058,Blue,1,43527,44649,1122
2022-01-21,70050,70060,Blue,1,37023,37695,672
2022-08-15,70055,70041,Blue,0,47212,48016,804
2022-02-10,70043,70838,Blue,0,48679,48896,217
2022-08-24,70049,70043,Blue,0,41641,42010,369
2022-12-22,70046,70054,Blue,1,38649,39160,511
2022-08-19,70038,70054,Blue,1,36441,37332,891
2022-08-17,70042,70060,Blue,1,64973,65971,998
2022-12-10,70057,70039,Blue,0,54165,55137,972
2022-06-15,70055,70049,Blue,0,23854,24152,298
2022-11-17,70049,70047,Blue,0,60562,60619,57
2022-11-26,70046,70048,Blue,1,85106,85191,85
2022-06-13,70046,70048,Blue,1,64128,64198,70
2022-01-09,70055,70049,Blue,0,84784,85070,286
2022-07-04,70040,70052,Blue,1,60822,61500,678
2022-11-07,70049,70047,Blue,0,75854,75908,54
2022-07-28,70057,70055,Blue,0,64450,64520,70
2022-01-30,70039,70838,Blue,0,73853,73904,51
2022-08-28,70054,70056,Blue,1,31590,31637,47
2022-12-29,70049,70047,Blue,0,22346,22399,53
2022-09-20,70048,70060,Blue,1,61276,61903,627
2022-09-29,70043,70039,Blue,0,54695,54798,103
2022-03-01,70053,70049,Blue,0,29355,29572,217
2022-02-26,70040,70058,Blue,1,43229,44215,986
2022-02-09,70051,70043,Blue,0,19636,20203,567
2022-05-29,70038,70048,Blue,1,36307,36857,550
2022-03-11,70046,70054,Blue,1,43967,44487,520
2022-03-02,70044,70056,Blue,1,57098,57897,799
2022-11-25,70057,70041,Blue,0,59871,60754,883
2022-12-29,70057,70838,Blue,0,48819,49835,1016
2022-03-04,70042,70046,Blue,1,29514,29677,163
2022-03-27,70048,70056,Blue,1,36053,36457,404
2022-02-26,70048,70050,Blue,1,71792,71852,60
2022-04-20,70059,70049,Blue,0,53115,53608,493
2022-04-20,70059,70051,Blue,0,80595,80917,322
2022-04-14,70044,70048,Blue,1,62510,62739,229
2022-09-19,70040,70052,Blue,1,55579,56329,750
2022-01-26,70044,70052,Blue,1,44377,44958,581
2022-09-12,70057,70043,Blue,0,20911,21702,791
2022-02-08,70040,70052,Blue,1,63989,64617,628
2022-07-05,70057,70838,Blue,0,62773,63867,1094
2022-09-09,70040,70044,Blue,1,62313,62425,112
2022-04-06,70038,70052,Blue,1,51643,52343,700
2022-12-22,70056,70060,Blue,1,38635,38818,183
2022-03-11,70046,70050,Blue,1,71854,72062,208
2022-07-12,70040,70044,Blue,1,44138,44255,117
2022-02-20,70046,70048,Blue,1,82075,82167,92
2022-12-31,70059,70057,Blue,0,56534,56571,37
2022-02-12,70041,70838,Blue,0,29727,29858,131
2022-04-07,70051,70045,Blue,0,53559,53952,393
2022-09-13,70040,70044,Blue,1,85767,85870,103
2022-06-27,70044,70050,Blue,1,86888,87246,358
2022-07-27,70051,70838,Blue,0,19895,20679,784
2022-09-04,70038,70050,Blue,1,84680,85278,598
2022-05-19,70055,70051,Blue,0,67756,67903,147
2022-06-16,70045,70043,Blue,0,52073,52192,119
2022-01-09,70059,70043,Blue,0,53296,54066,770
2022-11-07,70055,70045,Blue,0,62803,63318,515
2022-03-17,70058,70060,Blue,1,24687,24855,168
2022-02-15,70040,70060,Blue,1,45923,47051,1128
2022-08-08,70040,70050,Blue,1,37137,37656,519
2022-09-19,70050,70060,Blue,1,33940,34461,521
2022-12-30,70043,70041,Blue,0,36691,36720,29
2022-10-25,70053,70041,Blue,0,58767,59413,646
2022-09-30,70048,70054,Blue,1,29078,29365,287
2022-04-30,70059,70049,Blue,0,69014,69455,441
2022-12-27,70055,70051,Blue,0,19652,19791,139
2022-12-06,70048,70056,Blue,1,70966,71340,374
2022-12-31,70046,70060,Blue,1,62091,62903,812
2022-08-26,70049,70045,Blue,0,37633,37848,215
2022-06-14,70052,70054,Blue,1,52626,52679,53
2022-12-25,70058,70060,Blue,1,70991,71053,62
2022-12-15,70044,70046,Blue,1,85765,85873,108
2022-03-10,70044,70052,Blue,1,32294,32854,560
2022-06-28,70048,70060,Blue,1,57790,58604,814
2022-10-27,70040,70046,Blue,1,74836,75091,255
2022-12-05,70057,70838,Blue,0,86648,87657,1009
2022-04-14,70052,70056,Blue,1,55848,55990,142
2022-10-18,70052,70060,Blue,1,25321,25715,394
2022-10-21,70050,70056,Blue,1,29970,30289,319
2022-03-24,70055,70045,Blue,0,64695,65306,611
2022-02-28,70046,70054,Blue,1,82507,82935,428
2022-02-07,70044,70054,Blue,1,58527,59116,589
2022-06-23,70059,70047,Blue,0,35054,35732,678
2022-04-15,70055,70047,Blue,0,31629,32012,383
2022-07-17,70038,70044,Blue,1,72074,72255,181
2022-01-07,70046,70048,Blue,1,54371,54443,72
2022-01-20,70038,70054,Blue,1,32662,33509,847
2022-10-31,70059,70039,Blue,0,61355,62351,996
2022-01-10,70040,70050,Blue,1,27036,32931,5895
2022-10-15,70038,70060,Blue,1,22334,23613,1279
2022-09-08,70052,70054,Blue,1,23679,23733,54
2022-12-29,70044,70046,Blue,1,28516,28624,108
2022-08-15,70054,70056,Blue,1,26655,26704,49
2022-04-16,70055,70039,Blue,0,47234,48109,875
2022-02-03,70044,70058,Blue,1,37545,38411,866
2022-09-14,70046,70054,Blue,1,32324,32769,445
2022-09-26,70054,70060,Blue,1,61625,61889,264
2022-09-05,70038,70046,Blue,1,28450,28760,310
2022-05-27,70049,70045,Blue,0,60169,60387,218
2022-03-14,70055,70045,Blue,0,29267,29821,554
2022-03-08,70046,70054,Blue,1,20389,20870,481
2022-06-29,70059,70051,Blue,0,52245,52571,326
2022-04-06,70040,70042,Blue,1,86114,86147,33
2022-03-01,70053,70043,Blue,0,65890,66483,593
2022-08-31,70051,70041,Blue,0,66380,66977,597
2022-02-18,70055,70838,Blue,0,74543,75441,898
2022-04-12,70049,70047,Blue,0,86858,86927,69
2022-10-18,70045,70043,Blue,0,54596,54697,101
2022-04-17,70040,70052,Blue,1,78611,79271,660
2022-09-15,70059,70039,Blue,0,61876,62876,1000
2022-07-27,70051,70043,Blue,0,74752,75229,477
2022-05-31,70043,70039,Blue,0,40385,40523,138
2022-02-28,70059,70838,Blue,0,62597,63677,1080
2022-02-12,70045,70838,Blue,0,27853,28234,381
2022-04-02,70054,70060,Blue,1,64024,64275,251
2022-02-18,70042,70052,Blue,1,74301,74899,598
2022-06-19,70041,70039,Blue,0,65311,65343,32
2022-05-23,70047,70838,Blue,0,62892,63599,707
2022-07-15,70059,70047,Blue,0,23849,24435,586
2022-03-25,70050,70060,Blue,1,55520,56156,636
2022-03-24,70057,70047,Blue,0,53674,54180,506
2022-04-24,70053,70838,Blue,0,56817,57657,840
2022-09-23,70051,70049,Blue,0,51934,52034,100
2022-09-24,70055,70838,Blue,0,32224,33195,971
2022-09-22,70038,70052,Blue,1,44180,44951,771
2022-10-20,70055,70043,Blue,0,78292,78911,619
2022-10-07,70040,70044,Blue,1,82753,82882,129
2022-08-02,70059,70045,Blue,0,84193,84865,672
2022-08-11,70046,70048,Blue,1,36341,36425,84
2022-11-09,70038,70040,Blue,1,55449,55464,15
2022-12-11,70040,70058,Blue,1,53242,54177,935
2022-08-02,70048,70058,Blue,1,78775,79259,484
2022-09-27,70038,70042,Blue,1,76774,76864,90
2022-06-21,70047,70043,Blue,0,50532,50833,301
2022-10-24,70042,70056,Blue,1,60918,61678,760
2022-04-12,70038,70056,Blue,1,74184,75096,912
2022-12-07,70046,70052,Blue,1,67735,68037,302
2022-07-26,70059,70047,Blue,0,79401,79945,544
2022-03-22,70053,70039,Blue,0,22547,23347,800
2022-06-30,70055,70053,Blue,0,25713,25763,50
2022-03-22,70055,70045,Blue,0,66981,67540,559
2022-09-10,70048,70052,Blue,1,27390,27588,198
2022-02-15,70059,70051,Blue,0,72622,72947,325
2022-04-07,70052,70054,Blue,1,42075,42127,52
2022-09-27,70057,70045,Blue,0,35739,36415,676
2022-12-24,70052,70058,Blue,1,41238,41485,247
2022-06-21,70040,70052,Blue,1,51136,51860,724
2022-08-16,70057,70047,Blue,0,54181,54664,483
2022-09-16,70051,70049,Blue,0,73682,73788,106
2022-09-15,70038,70050,Blue,1,28593,29128,535
2022-11-17,70038,70046,Blue,1,29933,30249,316
2022-08-24,70040,70054,Blue,1,59002,59783,781
2022-10-05,70057,70838,Blue,0,56261,57302,1041
2022-02-26,70044,70056,Blue,1,85781,86497,716
2022-09-29,70048,70056,Blue,1,69078,69477,399
2022-12-13,70053,70051,Blue,0,55043,55106,63
2022-06-17,70046,70052,Blue,1,81882,82222,340
2022-09-01,70040,70058,Blue,1,56379,57292,913
2022-03-28,70045,70043,Blue,0,34112,34214,102
2022-08-30,70044,70046,Blue,1,45086,45198,112
2022-04-15,70046,70050,Blue,1,63253,63418,165
2022-03-07,70049,70047,Blue,0,31416,31474,58
2022-03-21,70048,70054,Blue,1,67300,67678,378
2022-07-10,70042,70048,Blue,1,61579,61911,332
2022-02-05,70057,70051,Blue,0,55238,55524,286
2022-05-20,70048,70056,Blue,1,66769,67162,393
2022-03-07,70053,70049,Blue,0,48449,48635,186
2022-01-07,70053,70039,Blue,0,29849,30685,836
2022-12-26,70057,70041,Blue,0,53388,54225,837
2022-08-03,70059,70051,Blue,0,78515,78919,404
2022-11-09,70045,70043,Blue,0,52755,52848,93
2022-01-10,70043,70041,Blue,0,87806,87836,30
2022-09-16,70038,70060,Blue,1,53046,54244,1198
2022-06-14,70056,70058,Blue,1,25335,25416,81
2022-04-07,70059,70049,Blue,0,62003,62443,440
2022-07-17,70042,70060,Blue,1,43798,44762,964
2022-12-25,70038,70042,Blue,1,78556,78652,96
2022-05-20,70052,70054,Blue,1,22411,22474,63
2022-03-28,70050,70058,Blue,1,85374,85827,453
2022-08-19,70046,70048,Blue,1,48762,48847,85
2022-08-15,70053,70045,Blue,0,24605,25076,471
2022-08-05,70049,70039,Blue,0,30275,30854,579
2022-10-07,70048,70056,Blue,1,75230,75652,422
2022-07-11,70049,70047,Blue,0,69427,69482,55
2022-01-24,70038,70056,Blue,1,84313,85226,913
2022-01-16,70040,70060,Blue,1,68959,70145,1186
2022-07-06,70046,70058,Blue,1,54553,55203,650
2022-12-23,70052,70060,Blue,1,40656,41068,412
2022-11-12,70051,70049,Blue,0,22002,22134,132
2022-08-29,70042,70058,Blue,1,30537,31403,866
2022-02-09,70057,70047,Blue,0,43898,44466,568
2022-03-20,70048,70050,Blue,1,82805,82863,58
2022-01-03,70038,70052,Blue,1,71665,72335,670
2022-08-15,70056,70058,Blue,1,85786,85855,69
2022-02-02,70054,70060,Blue,1,63839,64252,413
2022-06-26,70053,70041,Blue,0,30350,31069,719
2022-01-02,70040,70060,Blue,1,45674,46816,1142
2022-06-06,70047,70045,Blue,0,30983,31083,100
2022-06-23,70051,70043,Blue,0,22931,23436,505
2022-12-18,70038,70058,Blue,1,54789,55878,1089
2022-09-01,70051,70838,Blue,0,57568,58363,795
2022-04-20,70052,70056,Blue,1,87415,87565,150
2022-04-03,70042,70046,Blue,1,75469,75654,185
2022-11-30,70038,70048,Blue,1,84907,85372,465
2022-11-15,70049,70043,Blue,0,74325,74660,335
2022-06-10,70045,70838,Blue,0,53310,53680,370
2022-02-22,70044,70056,Blue,1,72306,73011,705
2022-02-14,70041,70039,Blue,0,81213,81251,38
2022-09-20,70051,70041,Blue,0,74171,74760,589
2022-09-13,70045,70043,Blue,0,54300,54395,95
2022-01-25,70040,70058,Blue,1,49277,50326,1049
2022-01-13,70053,70043,Blue,0,33840,34474,634
2022-11-05,70050,70060,Blue,1,33864,34424,560
2022-03-01,70059,70047,Blue,0,23957,24537,580
2022-08-28,70057,70049,Blue,0,21580,21993,413
2022-07-27,70041,70039,Blue,0,51956,51988,32
2022-08-16,70055,70049,Blue,0,57934,58209,275
2022-12-26,70039,70838,Blue,0,55433,55467,34
2022-12-20,70059,70045,Blue,0,69403,70105,702
2022-08-18,70052,70056,Blue,1,50195,50354,159
2022-02-09,70044,70046,Blue,1,56201,56302,101
2022-02-04,70048,70058,Blue,1,34240,35331,1091
2022-03-14,70048,70054,Blue,1,89224,89519,295
2022-06-12,70057,70051,Blue,0,42340,42603,263
2022-11-28,70043,70039,Blue,0,88131,88224,93
2022-06-29,70048,70052,Blue,1,67073,67304,231
2022-02-24,70055,70043,Blue,0,65783,66514,731
2022-06-02,70043,70838,Blue,0,72675,72870,195
2022-11-30,70047,70043,Blue,0,57565,57801,236
2022-10-20,70038,70048,Blue,1,31935,32343,408
2022-06-05,70039,70838,Blue,0,79049,79083,34
2022-06-27,70059,70053,Blue,0,36057,36331,274
2022-08-18,70047,70045,Blue,0,87207,87319,112
2022-10-28,70053,70043,Blue,0,66825,67439,614
2022-01-23,70038,70048,Blue,1,60186,60610,424
2022-04-09,70050,70058,Blue,1,31263,31668,405
2022-08-28,70044,70050,Blue,1,39874,40196,322
2022-03-31,70045,70041,Blue,0,56423,56706,283
2022-01-28,70046,70058,Blue,1,40501,41092,591
2022-09-12,70053,70047,Blue,0,24987,25288,301
2022-04-13,70057,70043,Blue,0,22499,23376,877
2022-09-03,70054,70058,Blue,1,76395,76563,168
2022-08-25,70053,70041,Blue,0,54605,55267,662
2022-01-12,70038,70050,Blue,1,27863,28458,595
2022-11-12,70042,70056,Blue,1,31418,32174,756
2022-01-02,70038,70040,Blue,1,54792,54807,15
2022-10-28,70038,70054,Blue,1,79041,79936,895
2022-07-26,70051,70041,Blue,0,29666,30279,613
2022-04-14,70059,70049,Blue,0,20592,21065,473
2022-05-15,70059,70055,Blue,0,48014,48155,141
2022-01-21,70043,70838,Blue,0,23789,24013,224
2022-06-15,70057,70053,Blue,0,39887,40039,152
2022-04-29,70059,70047,Blue,0,63143,63889,746
2022-05-27,70049,70043,Blue,0,80650,81038,388
2022-01-09,70055,70838,Blue,0,34932,35871,939
2022-08-29,70050,70058,Blue,1,62866,63302,436
2022-02-02,70048,70054,Blue,1,58136,58436,300
2022-12-14,70058,70060,Blue,1,25959,26028,69
2022-04-05,70047,70043,Blue,0,68422,68634,212
2022-03-10,70040,70050,Blue,1,36783,37248,465
2022-09-24,70046,70056,Blue,1,81797,82328,531
2022-02-15,70040,70054,Blue,1,22814,23583,769
2022-07-11,70053,70051,Blue,0,79892,79947,55
2022-08-16,70042,70060,Blue,1,54379,55375,996
2022-12-05,70045,70838,Blue,0,56995,57332,337
2022-08-19,70052,70060,Blue,1,47999,48372,373
2022-09-16,70044,70046,Blue,1,43462,43570,108
2022-02-14,70042,70048,Blue,1,66336,66640,304
2022-05-21,70053,70047,Blue,0,41419,41712,293
2022-02-09,70053,70041,Blue,0,68790,69532,742
2022-08-04,70051,70838,Blue,0,67022,67789,767
2022-12-06,70051,70043,Blue,0,25283,25828,545
2022-11-08,70055,70047,Blue,0,43985,44400,415
2022-01-14,70046,70056,Blue,1,48546,49051,505
2022-04-05,70059,70053,Blue,0,32958,33175,217
2022-09-12,70057,70043,Blue,0,63515,64279,764
2022-04-02,70038,70042,Blue,1,49627,49795,168
2022-07-04,70047,70838,Blue,0,43916,44506,590
2022-03-29,70059,70057,Blue,0,26993,27030,37
2022-03-15,70049,70045,Blue,0,61869,62129,260
2022-07-04,70044,70056,Blue,1,80308,81000,692
2022-08-03,70057,70041,Blue,0,44947,46337,1390
2022-01-20,70059,70043,Blue,0,62605,63537,932
2022-03-06,70041,70039,Blue,0,71559,71594,35
2022-02-08,70046,70058,Blue,1,30661,31583,922
2022-12-01,70048,70060,Blue,1,43670,44322,652
2022-12-10,70047,70041,Blue,0,51464,51804,340
2022-07-19,70038,70048,Blue,1,43153,43615,462
2022-06-19,70048,70052,Blue,1,79637,79856,219
2022-09-06,70048,70052,Blue,1,39078,39292,214
2022-02-17,70044,70060,Blue,1,86484,87480,996
2022-09-20,70059,70043,Blue,0,66255,67071,816
2022-10-31,70059,70838,Blue,0,38473,39531,1058
2022-10-21,70039,70838,Blue,0,45301,45335,34
2022-05-21,70044,70048,Blue,1,27695,27981,286
2022-04-01,70057,70047,Blue,0,26441,26969,528
2022-11-20,70044,70058,Blue,1,70699,71455,756
2022-09-13,70053,70051,Blue,0,70549,70596,47
2022-02-10,70057,70041,Blue,0,41070,42079,1009
2022-07-18,70046,70058,Blue,1,43989,44743,754
2022-04-10,70057,70055,Blue,0,60948,61016,68
2022-07-09,70055,70049,Blue,0,22991,23261,270
2022-04-20,70057,70047,Blue,0,27053,27559,506
2022-10-14,70057,70051,Blue,0,57815,58058,243
2022-01-10,70059,70838,Blue,0,61999,63219,1220
2022-12-11,70038,70050,Blue,1,40993,41532,539
2022-03-17,70044,70058,Blue,1,32616,33463,847
2022-04-05,70045,70043,Blue,0,27783,27882,99
2022-06-21,70038,70050,Blue,1,36854,37509,655
2022-03-27,70038,70046,Blue,1,33129,33406,277
2022-06-29,70038,70056,Blue,1,44092,45143,1051
2022-07-10,70055,70047,Blue,0,40329,40715,386
2022-01-22,70053,70049,Blue,0,45715,45908,193
2022-03-21,70042,70044,Blue,1,24717,24747,30
2022-01-19,70049,70039,Blue,0,23855,24486,631
2022-12-18,70042,70044,Blue,1,75444,75474,30
2022-12-30,70054,70060,Blue,1,87845,88101,256
2022-11-12,70051,70043,Blue,0,57735,58205,470
2022-06-20,70057,70053,Blue,0,70362,70532,170
2022-04-17,70050,70052,Blue,1,49443,49547,104
2022-03-01,70042,70046,Blue,1,63539,63728,189
2022-03-14,70057,70055,Blue,0,60280,60349,69
2022-04-08,70043,70838,Blue,0,35253,35462,209
2022-01-19,70051,70047,Blue,0,55502,55694,192
2022-12-14,70056,70058,Blue,1,50791,50865,74
2022-09-06,70050,70052,Blue,1,23748,23854,106
2022-03-28,70057,70049,Blue,0,45586,46007,421
2022-12-12,70045,70043,Blue,0,57423,57510,87
2022-05-10,70049,70047,Blue,0,42259,42303,44
2022-10-29,70049,70838,Blue,0,52413,52998,585
2022-03-18,70046,70048,Blue,1,51603,51695,92
2022-10-23,70057,70047,Blue,0,38907,39396,489
2022-11-08,70044,70046,Blue,1,68086,68189,103
2022-03-13,70047,70045,Blue,0,32999,33129,130
2022-08-26,70053,70047,Blue,0,64186,64498,312
2022-12-03,70040,70060,Blue,1,78009,79051,1042
2022-09-19,70059,70041,Blue,0,26357,27481,1124
2022-07-10,70048,70056,Blue,1,54286,54710,424
2022-03-02,70053,70051,Blue,0,37874,37936,62
2022-08-11,70038,70060,Blue,1,68954,70125,1171
2022-06-09,70042,70044,Blue,1,48822,48857,35
2022-06-30,70053,70838,Blue,0,25378,26278,900
2022-07-28,70055,70045,Blue,0,43452,44038,586
2022-03-13,70038,70058,Blue,1,28454,29398,944
2022-07-06,70042,70054,Blue,1,51525,52268,743
2022-01-10,70051,70047,Blue,0,82699,82887,188
2022-02-18,70049,70039,Blue,0,30590,31172,582
2022-12-27,70045,70041,Blue,0,50607,50787,180
2022-02-11,70044,70054,Blue,1,82993,83605,612
2022-06-27,70050,70056,Blue,1,56720,57028,308
2022-01-03,70053,70051,Blue,0,51832,51882,50
2022-03-20,70052,70058,Blue,1,52964,53217,253
2022-10-25,70038,70050,Blue,1,60016,60590,574
2022-10-03,70056,70058,Blue,1,51172,51247,75
2022-01-28,70044,70060,Blue,1,56491,57415,924
2022-02-19,70048,70056,Blue,1,70665,71052,387
2022-06-15,70055,70047,Blue,0,54085,54465,380
2022-09-21,70052,70056,Blue,1,80223,80351,128
2022-04-08,70048,70060,Blue,1,25942,26719,777
2022-08-13,70044,70060,Blue,1,78316,79326,1010
2022-01-24,70053,70047,Blue,0,63782,64075,293
2022-07-03,70048,70054,Blue,1,56490,56808,318
2022-04-17,70048,70052,Blue,1,53715,53919,204
2022-08-20,70053,70051,Blue,0,83490,83545,55
2022-02-08,70059,70043,Blue,0,23060,24019,959
2022-12-06,70042,70048,Blue,1,57741,58059,318
2022-02-04,70040,70046,Blue,1,23109,23360,251
2022-10-15,70042,70044,Blue,1,51406,51434,28
2022-09-21,70052,70058,Blue,1,24160,24407,247
2022-09-06,70054,70056,Blue,1,34308,34357,49
2022-03-17,70040,70050,Blue,1,48229,48831,602
2022-11-24,70045,70041,Blue,0,66483,66643,160
2022-07-18,70056,70060,Blue,1,81636,81901,265
2022-09-16,70040,70044,Blue,1,24614,24731,117
2022-02-07,70059,70051,Blue,0,81733,82092,359
2022-02-09,70057,70045,Blue,0,28833,29475,642
2022-07-29,70044,70058,Blue,1,65569,66433,864
2022-02-06,70046,70054,Blue,1,61656,62084,428
2022-09-28,70040,70048,Blue,1,86585,86944,359
2022-03-29,70053,70041,Blue,0,51000,51689,689
2022-07-15,70042,70060,Blue,1,36024,37156,1132
2022-06-09,70053,70047,Blue,0,37334,37662,328
2022-07-25,70042,70054,Blue,1,63612,64334,722
2022-01-18,70056,70058,Blue,1,53205,53279,74
2022-10-23,70051,70043,Blue,0,55262,55759,497
2022-10-13,70040,70060,Blue,1,74953,76034,1081
2022-10-14,70044,70054,Blue,1,60076,60641,565
2022-07-05,70053,70838,Blue,0,78837,79688,851
2022-03-31,70040,70058,Blue,1,27653,28676,1023
2022-10-25,70042,70058,Blue,1,79595,80412,817
2022-10-07,70050,70058,Blue,1,23844,24295,451
2022-12-09,70047,70838,Blue,0,77036,77504,468
2022-08-03,70042,70058,Blue,1,31720,32615,895
2022-09-22,70042,70048,Blue,1,60320,60667,347
2022-06-26,70059,70049,Blue,0,59967,60445,478
2022-12-31,70048,70056,Blue,1,58467,58864,397
2022-03-04,70040,70050,Blue,1,24325,24843,518
2022-02-26,70046,70048,Blue,1,67820,67919,99
2022-09-19,70047,70041,Blue,0,28435,28842,407
2022-03-31,70059,70053,Blue,0,62893,63115,222
2022-07-20,70040,70046,Blue,1,61915,62222,307
2022-01-03,70048,70058,Blue,1,38289,38870,581
2022-03-12,70053,70047,Blue,0,77443,77788,345
2022-03-27,70050,70056,Blue,1,50550,50846,296
2022-11-08,70059,70049,Blue,0,48371,48829,458
2022-02-13,70045,70041,Blue,0,47144,47351,207
2022-12-21,70040,70044,Blue,1,82310,82429,119
2022-10-24,70057,70039,Blue,0,77087,78014,927
2022-06-17,70039,70838,Blue,0,23137,23182,45
2022-07-21,70048,70060,Blue,1,46655,47287,632
2022-07-01,70040,70044,Blue,1,67074,67196,122
2022-03-18,70040,70056,Blue,1,26827,27619,792
2022-11-14,70050,70052,Blue,1,62779,62885,106
2022-02-25,70059,70041,Blue,0,50714,51647,933
2022-10-12,70046,70050,Blue,1,52749,52930,181
2022-08-31,70040,70058,Blue,1,77591,78606,1015
2022-01-07,70038,70050,Blue,1,61984,62551,567
2022-12-09,70052,70058,Blue,1,35041,35303,262
2022-01-13,70047,70039,Blue,0,53785,54222,437
2022-10-17,70049,70047,Blue,0,56255,56310,55
2022-07-12,70047,70838,Blue,0,63444,63943,499
2022-02-08,70042,70048,Blue,1,38827,39240,413
2022-12-18,70043,70039,Blue,0,26316,26425,109
2022-06-30,70051,70039,Blue,0,81021,81666,645
2022-08-09,70040,70056,Blue,1,62035,62984,949
2022-07-06,70047,70039,Blue,0,49016,49488,472
2022-09-05,70049,70041,Blue,0,63512,63935,423
2022-10-28,70042,70054,Blue,1,61337,62038,701
2022-01-17,70044,70060,Blue,1,63404,64340,936
2022-04-22,70048,70060,Blue,1,31096,31816,720
2022-11-26,70040,70044,Blue,1,84705,84838,133
2022-04-01,70042,70050,Blue,1,51324,51736,412
2022-04-18,70057,70043,Blue,0,77851,78600,749
2022-04-22,70043,70041,Blue,0,80971,81000,29
2022-06-17,70038,70048,Blue,1,65890,66461,571
2022-06-11,70054,70058,Blue,1,54303,54464,161
2022-01-31,70057,70053,Blue,0,87565,87724,159
2022-08-13,70044,70046,Blue,1,34184,34298,114
2022-04-21,70049,70838,Blue,0,38101,38707,606
2022-07-03,70044,70054,Blue,1,78771,79441,670
2022-12-22,70038,70048,Blue,1,52633,53116,483
2022-09-10,70051,70041,Blue,0,23171,23741,570
2022-08-15,70059,70055,Blue,0,30564,30709,145
2022-02-25,70046,70052,Blue,1,62599,62986,387
2022-05-07,70054,70060,Blue,1,26642,26910,268
2022-06-22,70042,70052,Blue,1,75434,76110,676
2022-08-16,70059,70057,Blue,0,86533,86567,34
2022-12-05,70052,70058,Blue,1,62517,62769,252
2022-09-29,70040,70052,Blue,1,62331,63001,670
2022-04-28,70059,70051,Blue,0,71031,71364,333
2022-02-14,70048,70058,Blue,1,77878,78388,510
2022-09-03,70054,70060,Blue,1,83943,84204,261
2022-03-11,70059,70049,Blue,0,80611,81066,455
2022-02-10,70042,70050,Blue,1,57955,58360,405
2022-12-04,70055,70041,Blue,0,62138,62901,763
2022-08-04,70047,70039,Blue,0,25004,25461,457
2022-03-01,70059,70057,Blue,0,26662,26698,36
2022-08-26,70049,70047,Blue,0,52868,52923,55
2022-12-02,70047,70039,Blue,0,64088,64469,381
2022-10-26,70055,70053,Blue,0,53295,53340,45
2022-09-03,70050,70056,Blue,1,68669,68957,288
2022-11-03,70044,70056,Blue,1,24317,25028,711
2022-10-02,70059,70838,Blue,0,40187,41364,1177
2022-09-13,70038,70048,Blue,1,86529,86963,434
2022-05-21,70055,70045,Blue,0,69383,69907,524
2022-08-29,70051,70041,Blue,0,48739,49310,571
2022-04-12,70043,70838,Blue,0,24329,24640,311
2022-10-11,70044,70048,Blue,1,40209,40452,243
2022-02-26,70046,70056,Blue,1,53823,54352,529
2022-01-25,70055,70049,Blue,0,67703,68026,323
2022-04-20,70055,70041,Blue,0,73406,74222,816
2022-07-09,70045,70838,Blue,0,50506,50848,342
2022-05-21,70049,70039,Blue,0,43324,43949,625
2022-04-16,70057,70051,Blue,0,66120,66365,245
2022-01-03,70057,70838,Blue,0,80669,81651,982
2022-01-01,70044,70050,Blue,1,47988,48315,327
2022-07-26,70054,70058,Blue,1,44271,44429,158
2022-02-04,70050,70058,Blue,1,68896,69317,421
2022-02-28,70046,70058,Blue,1,21906,22595,689
2022-11-24,70042,70050,Blue,1,52242,52664,422
2022-03-15,70044,70056,Blue,1,31344,32008,664
2022-02-19,70042,70056,Blue,1,35735,36476,741
2022-08-06,70059,70039,Blue,0,19528,20496,968
2022-02-12,70057,70039,Blue,0,32013,33015,1002
2022-02-17,70059,70039,Blue,0,58095,59159,1064
2022-03-17,70044,70060,Blue,1,58877,59809,932
2022-07-15,70045,70838,Blue,0,61793,62220,427
2022-09-21,70042,70046,Blue,1,27605,27769,164
2022-01-28,70040,70046,Blue,1,69012,69277,265
2022-04-19,70048,70060,Blue,1,58877,59489,612
2022-04-10,70049,70838,Blue,0,37358,37955,597
2022-03-31,70047,70039,Blue,0,56266,56791,525
2022-10-21,70047,70045,Blue,0,67027,67123,96
2022-09-16,70047,70838,Blue,0,78716,79224,508
2022-09-26,70048,70050,Blue,1,37849,37910,61
2022-10-16,70059,70053,Blue,0,44116,44340,224
2022-01-18,70053,70049,Blue,0,69773,69979,206
2022-05-01,70059,70055,Blue,0,24008,24164,156
2022-08-03,70052,70054,Blue,1,78720,78784,64
2022-02-04,70038,70042,Blue,1,51662,51765,103
2022-11-01,70056,70058,Blue,1,36723,36801,78
2022-02-28,70057,70047,Blue,0,65071,65567,496
2022-05-16,70055,70049,Blue,0,20236,20515,279
2022-02-14,70059,70055,Blue,0,65614,65757,143
2022-09-03,70047,70041,Blue,0,50979,51359,380
2022-12-14,70050,70052,Blue,1,36944,37127,183
2022-02-22,70045,70041,Blue,0,53594,53805,211
2022-12-22,70043,70838,Blue,0,25045,25268,223
2022-08-29,70038,70058,Blue,1,45112,46120,1008
2022-09-01,70059,70053,Blue,0,25938,26171,233
2022-04-28,70055,70047,Blue,0,69466,70062,596
2022-03-02,70047,70045,Blue,0,34291,34397,106
2022-11-04,70051,70049,Blue,0,46675,46777,102
2022-12-21,70059,70045,Blue,0,21977,22718,741
2022-09-16,70044,70050,Blue,1,45341,45684,343
2022-12-05,70055,70838,Blue,0,56374,57332,958
2022-12-13,70040,70050,Blue,1,39516,40107,591
2022-07-08,70045,70043,Blue,0,24168,24268,100
2022-06-14,70055,70838,Blue,0,58266,59264,998
2022-11-05,70054,70058,Blue,1,39444,39598,154
2022-04-10,70047,70838,Blue,0,40097,40606,509
2022-06-21,70051,70049,Blue,0,54891,54994,103
2022-11-28,70040,70044,Blue,1,70089,70196,107
2022-12-05,70059,70041,Blue,0,56174,57164,990
2022-10-31,70048,70056,Blue,1,53836,54241,405
2022-02-14,70054,70056,Blue,1,60641,60688,47
2022-02-28,70045,70039,Blue,0,33517,33806,289
2022-01-09,70059,70053,Blue,0,48974,49220,246
2022-05-18,70049,70039,Blue,0,31957,32665,708
2022-06-23,70050,70054,Blue,1,40247,40569,322
2022-06-17,70041,70838,Blue,0,78140,78260,120
2022-10-09,70044,70052,Blue,1,49602,50069,467
2022-12-09,70043,70039,Blue,0,79044,79140,96
2022-09-21,70057,70049,Blue,0,39098,39569,471
2022-11-02,70044,70052,Blue,1,58831,59349,518
2022-08-13,70040,70044,Blue,1,48106,48240,134
2022-06-20,70059,70055,Blue,0,46814,46965,151
2022-04-21,70051,70838,Blue,0,29724,30467,743
2022-05-18,70042,70052,Blue,1,90778,91524,746
2022-09-19,70055,70838,Blue,0,32398,33300,902
2022-09-22,70049,70039,Blue,0,53042,53615,573
2022-07-19,70045,70039,Blue,0,81993,82239,246
2022-03-17,70057,70047,Blue,0,38195,38705,510
2022-10-03,70047,70045,Blue,0,52864,52951,87
2022-06-11,70044,70048,Blue,1,26022,26273,251
2022-08-29,70046,70056,Blue,1,26831,27344,513
2022-11-05,70053,70045,Blue,0,64075,64584,509
2022-02-28,70046,70050,Blue,1,73908,74114,206
2022-06-25,70057,70055,Blue,0,26606,26674,68
2022-03-11,70042,70060,Blue,1,35625,36624,999
2022-03-20,70049,70039,Blue,0,28242,28745,503
2022-06-30,70051,70838,Blue,0,53339,54122,783
2022-03-10,70046,70054,Blue,1,88066,88481,415
2022-08-04,70043,70039,Blue,0,63802,63908,106
2022-08-23,70045,70838,Blue,0,28865,29280,415
2022-11-25,70053,70043,Blue,0,50236,50869,633
2022-07-20,70042,70044,Blue,1,22345,22374,29
2022-09-24,70047,70039,Blue,0,72485,72892,407
2022-12-27,70042,70052,Blue,1,53502,54068,566
2022-10-19,70059,70047,Blue,0,72796,73370,574
2022-12-23,70046,70052,Blue,1,37523,37891,368
2022-08-30,70056,70060,Blue,1,79852,80035,183
2022-10-08,70047,70043,Blue,0,22778,23033,255
2022-08-04,70040,70044,Blue,1,56178,56332,154
2022-01-14,70046,70058,Blue,1,40554,41186,632
2022-01-18,70038,70056,Blue,1,55354,56306,952
2022-08-05,70050,70058,Blue,1,33949,34388,439
2022-10-24,70038,70058,Blue,1,67403,68451,1048
2022-12-11,70044,70060,Blue,1,79360,80427,1067
2022-02-18,70057,70041,Blue,0,75573,76509,936
2022-04-15,70044,70056,Blue,1,27184,27910,726
2022-04-03,70038,70052,Blue,1,81137,81842,705
2022-09-24,70040,70044,Blue,1,31894,32005,111
2022-12-05,70059,70053,Blue,0,29609,29855,246
2022-04-14,70046,70050,Blue,1,59121,59314,193
2022-03-13,70053,70051,Blue,0,34298,34357,59
2022-08-14,70059,70051,Blue,0,74918,75258,340
2022-08-09,70059,70039,Blue,0,73338,74313,975
2022-07-26,70042,70044,Blue,1,40645,40677,32
2022-09-27,70050,70052,Blue,1,32175,32290,115
2022-01-29,70038,70042,Blue,1,21667,21764,97
2022-09-29,70041,70039,Blue,0,49864,49895,31
2022-04-05,70042,70050,Blue,1,87270,87694,424
2022-03-24,70042,70044,Blue,1,86130,86157,27
2022-04-15,70047,70043,Blue,0,36551,36802,251
2022-01-21,70040,70044,Blue,1,21686,21800,114
2022-07-22,70045,70039,Blue,0,21140,21393,253
2022-08-13,70050,70054,Blue,1,76163,76391,228
2022-03-14,70055,70049,Blue,0,75668,75933,265
2022-02-16,70057,70041,Blue,0,53179,54145,966
2022-12-19,70042,70058,Blue,1,47276,48178,902
2022-06-16,70052,70060,Blue,1,71209,71556,347
2022-03-11,70057,70053,Blue,0,50323,50479,156
2022-06-24,70059,70053,Blue,0,53551,53791,240
2022-09-09,70038,70054,Blue,1,41628,42479,851
2022-08-02,70050,70054,Blue,1,53504,53758,254
2022-08-23,70040,70042,Blue,1,87431,87462,31
2022-10-09,70044,70060,Blue,1,81252,82118,866
2022-09-15,70058,70060,Blue,1,34748,34811,63
2022-05-27,70050,70052,Blue,1,44029,44223,194
2022-10-26,70044,70058,Blue,1,31475,32276,801
2022-07-14,70050,70056,Blue,1,41698,42035,337
2022-03-28,70038,70060,Blue,1,55935,57115,1180
2022-02-28,70046,70048,Blue,1,32897,32982,85
2022-08-06,70056,70060,Blue,1,59868,60043,175
2022-01-26,70055,70051,Blue,0,65172,65335,163
2022-09-23,70051,70043,Blue,0,66899,67412,513
2022-01-19,70041,70039,Blue,0,49830,49865,35
2022-11-19,70049,70838,Blue,0,45924,46490,566
2022-09-22,70055,70053,Blue,0,83164,83210,46
2022-06-12,70044,70056,Blue,1,69040,69720,680
2022-10-01,70045,70838,Blue,0,65762,66110,348
2022-01-05,70044,70054,Blue,1,56219,56795,576
2022-08-12,70040,70046,Blue,1,37887,38133,246
2022-12-12,70054,70058,Blue,1,59996,60148,152
2022-11-28,70044,70058,Blue,1,21367,22192,825
2022-10-04,70055,70039,Blue,0,26145,27157,1012
2022-02-17,70047,70045,Blue,0,47288,47388,100
2022-08-12,70051,70043,Blue,0,44553,45063,510
2022-10-20,70057,70051,Blue,0,65753,65995,242
2022-11-05,70047,70041,Blue,0,45519,45855,336
2022-02-15,70048,70052,Blue,1,75714,75911,197
2022-05-25,70048,70050,Blue,1,66624,66686,62
2022-02-15,70059,70039,Blue,0,42078,43071,993
2022-03-22,70055,70043,Blue,0,57253,57879,626
2022-08-13,70042,70060,Blue,1,56279,57279,1000
2022-03-24,70040,70052,Blue,1,58992,59658,666
2022-05-18,70054,70060,Blue,1,59872,60130,258
2022-11-25,70042,70058,Blue,1,29566,30418,852
2022-09-16,70038,70046,Blue,1,61828,62245,417
2022-06-30,70049,70047,Blue,0,52124,52178,54
2022-12-15,70058,70060,Blue,1,87516,87576,60
2022-09-26,70040,70054,Blue,1,83111,83913,802
2022-03-25,70038,70042,Blue,1,53596,53697,101
2022-03-03,70038,70056,Blue,1,25527,26422,895
2022-02-07,70055,70047,Blue,0,42267,42756,489
2022-10-10,70038,70056,Blue,1,36739,37633,894
2022-04-09,70057,70838,Blue,0,49829,50952,1123
2022-04-06,70044,70060,Blue,1,30767,31687,920
2022-02-14,70038,70048,Blue,1,57445,57944,499
2022-09-19,70054,70060,Blue,1,62039,62300,261
2022-12-15,70055,70047,Blue,0,55844,56277,433
2022-01-13,70048,70060,Blue,1,60986,61720,734
2022-11-17,70051,70045,Blue,0,23423,23802,379
2022-03-10,70048,70056,Blue,1,25996,26406,410
2022-07-20,70059,70043,Blue,0,47891,48773,882
2022-06-15,70038,70048,Blue,1,71940,72486,546
2022-04-06,70042,70060,Blue,1,60465,61585,1120
2022-08-20,70048,70060,Blue,1,76618,77287,669
2022-01-03,70040,70052,Blue,1,89223,89827,604
2022-03-26,70059,70051,Blue,0,44936,45283,347
2022-11-25,70059,70057,Blue,0,27200,27236,36
2022-10-13,70038,70046,Blue,1,29731,30046,315
2022-12-02,70053,70838,Blue,0,60029,60812,783
2022-02-17,70055,70053,Blue,0,77363,77425,62
2022-01-26,70048,70050,Blue,1,36692,36751,59
2022-03-14,70038,70056,Blue,1,75260,76161,901
2022-05-15,70052,70056,Blue,1,73192,73338,146
2022-02-20,70045,70043,Blue,0,85341,85472,131
2022-06-20,70057,70043,Blue,0,42321,43169,848
2022-01-07,70056,70058,Blue,1,30621,30702,81
2022-02-03,70046,70060,Blue,1,33966,34695,729
2022-07-26,70049,70039,Blue,0,69355,69856,501
2022-09-07,70045,70043,Blue,0,28613,28718,105
2022-01-13,70038,70054,Blue,1,23947,24729,782
2022-09-25,70046,70058,Blue,1,31164,31788,624
2022-04-12,70059,70041,Blue,0,76682,77543,861
2022-08-03,70050,70054,Blue,1,36055,36291,236
2022-01-14,70045,70041,Blue,0,23527,23718,191
2022-03-20,70059,70053,Blue,0,55455,55678,223
2022-01-24,70051,70039,Blue,0,80444,81095,651
2022-12-06,70038,70060,Blue,1,21412,22857,1445
2022-12-10,70057,70053,Blue,0,69802,69947,145
2022-10-14,70052,70058,Blue,1,73930,74176,246
2022-10-03,70049,70838,Blue,0,86069,86644,575
2022-03-21,70044,70048,Blue,1,84731,85009,278
2022-03-03,70051,70039,Blue,0,69853,70545,692
2022-07-17,70057,70043,Blue,0,72275,73126,851
2022-10-23,70040,70046,Blue,1,52684,52932,248
2022-09-29,70048,70058,Blue,1,44786,45273,487
2022-04-16,70044,70060,Blue,1,61746,62664,918
2022-03-10,70053,70838,Blue,0,28766,29651,885
2022-01-21,70059,70053,Blue,0,26355,26624,269
2022-12-06,70038,70060,Blue,1,54973,56131,1158
2022-09-28,70053,70045,Blue,0,62308,62872,564
2022-04-13,70057,70039,Blue,0,37073,38368,1295
2022-06-22,70048,70050,Blue,1,31171,31227,56
2022-03-27,70040,70050,Blue,1,73751,74252,501
2022-02-24,70059,70051,Blue,0,67515,67833,318
2022-10-24,70051,70039,Blue,0,67459,68144,685
2022-07-27,70054,70060,Blue,1,49574,49846,272
2022-07-11,70059,70041,Blue,0,88303,89180,877
2022-03-11,70047,70045,Blue,0,19020,19145,125
2022-02-04,70038,70058,Blue,1,56538,57589,1051
2022-04-11,70044,70050,Blue,1,27781,28158,377
2022-07-25,70053,70041,Blue,0,69237,69951,714
2022-05-28,70040,70048,Blue,1,41725,42223,498
2022-10-13,70046,70060,Blue,1,32292,33004,712
2022-10-12,70045,70043,Blue,0,67340,67450,110
2022-04-09,70057,70049,Blue,0,46593,46986,393
2022-03-29,70048,70056,Blue,1,59117,59492,375
2022-07-18,70051,70041,Blue,0,32628,33384,756
2022-01-05,70045,70039,Blue,0,76786,77023,237
2022-03-03,70049,70041,Blue,0,60688,61100,412
2022-05-19,70053,70838,Blue,0,68735,69750,1015
2022-12-06,70059,70041,Blue,0,82111,82945,834
2022-11-18,70050,70058,Blue,1,74382,74775,393
2022-03-10,70038,70052,Blue,1,35227,36078,851
2022-01-22,70042,70046,Blue,1,62204,62376,172
2022-10-12,70059,70051,Blue,0,49940,50273,333
2022-08-19,70051,70045,Blue,0,37918,38238,320
2022-11-06,70059,70041,Blue,0,45736,46622,886
2022-10-20,70053,70051,Blue,0,35174,35239,65
2022-03-17,70046,70060,Blue,1,31842,32683,841
2022-10-05,70051,70043,Blue,0,24621,25121,500
2022-06-26,70053,70041,Blue,0,24104,24802,698
2022-12-10,70051,70838,Blue,0,23191,23949,758
2022-03-20,70047,70041,Blue,0,60097,60401,304
2022-07-29,70056,70058,Blue,1,69043,69113,70
2022-08-15,70054,70058,Blue,1,58595,58758,163
2022-11-30,70048,70050,Blue,1,52288,52351,63
2022-01-03,70050,70058,Blue,1,83171,83571,400
2022-06-20,70044,70058,Blue,1,64568,65381,813
2022-06-25,70055,70053,Blue,0,64104,64152,48
2022-01-27,70059,70047,Blue,0,23970,24593,623
2022-04-14,70047,70039,Blue,0,23172,23680,508
2022-04-24,70044,70060,Blue,1,72796,73730,934
2022-01-18,70059,70041,Blue,0,40441,41455,1014
2022-10-29,70049,70045,Blue,0,38951,39145,194
2022-02-24,70046,70060,Blue,1,64470,65223,753
2022-10-15,70051,70838,Blue,0,70646,71453,807
2022-10-14,70038,70048,Blue,1,37347,37802,455
2022-11-15,70051,70049,Blue,0,45574,45678,104
2022-11-06,70052,70060,Blue,1,51795,52156,361
2022-09-27,70044,70048,Blue,1,50975,51224,249
2022-12-28,70044,70056,Blue,1,34674,35362,688
2022-02-01,70049,70045,Blue,0,40687,40914,227
2022-10-06,70052,70056,Blue,1,49014,49172,158
2022-06-23,70048,70060,Blue,1,55412,56091,679
2022-06-09,70040,70058,Blue,1,61492,63113,1621
2022-02-21,70044,70048,Blue,1,39584,39815,231
2022-07-11,70047,70041,Blue,0,63025,63382,357
2022-09-05,70046,70054,Blue,1,74676,75147,471
2022-11-01,70047,70039,Blue,0,86331,86698,367
2022-11-23,70052,70060,Blue,1,42005,42516,511
2022-02-26,70048,70054,Blue,1,37177,37507,330
2022-05-18,70038,70058,Blue,1,55435,56531,1096
2022-12-19,70042,70052,Blue,1,36827,37466,639
2022-11-08,70049,70838,Blue,0,77436,78005,569
2022-06-12,70040,70048,Blue,1,47321,47726,405
2022-03-16,70055,70838,Blue,0,41719,42607,888
2022-01-15,70057,70051,Blue,0,49299,49534,235
2022-06-19,70057,70051,Blue,0,71351,71600,249
2022-12-22,70048,70054,Blue,1,58734,59039,305
2022-01-03,70046,70048,Blue,1,30033,30113,80
2022-03-10,70038,70060,Blue,1,56232,57506,1274
2022-04-18,70051,70043,Blue,0,27089,27546,457
2022-03-30,70045,70039,Blue,0,28338,28599,261
2022-07-07,70059,70053,Blue,0,68014,68251,237
2022-04-30,70053,70051,Blue,0,52944,52998,54
2022-07-28,70044,70052,Blue,1,83875,84378,503
2022-07-03,70039,70838,Blue,0,56164,56200,36
2022-11-29,70045,70838,Blue,0,81204,81549,345
2022-08-21,70045,70043,Blue,0,32386,32479,93
2022-10-13,70055,70041,Blue,0,58898,60031,1133
2022-05-24,70043,70041,Blue,0,52289,52324,35
2022-01-24,70057,70047,Blue,0,55175,55652,477
2022-06-17,70047,70041,Blue,0,61689,62027,338
2022-08-31,70038,70044,Blue,1,35776,35935,159
2022-11-08,70055,70045,Blue,0,21968,22529,561
2022-03-16,70057,70047,Blue,0,83547,84001,454
2022-12-27,70053,70041,Blue,0,34923,35526,603
2022-10-07,70055,70045,Blue,0,24633,25161,528
2022-12-08,70048,70056,Blue,1,50220,50600,380
2022-09-04,70053,70047,Blue,0,57338,57627,289
2022-08-17,70057,70053,Blue,0,20013,20164,151
2022-08-12,70049,70045,Blue,0,20948,21138,190
2022-08-15,70053,70041,Blue,0,22444,23132,688
2022-03-17,70041,70039,Blue,0,32149,32186,37
2022-06-17,70054,70056,Blue,1,45142,45216,74
2022-07-01,70053,70049,Blue,0,67747,67947,200
2022-07-29,70040,70048,Blue,1,86612,87046,434
2022-01-22,70053,70045,Blue,0,70577,70991,414
2022-08-23,70057,70041,Blue,0,22666,23844,1178
2022-07-29,70038,70040,Blue,1,72113,72130,17
2022-09-20,70053,70043,Blue,0,33341,34018,677
2022-09-08,70053,70047,Blue,0,25077,25390,313
2022-01-27,70039,70838,Blue,0,53910,53953,43
2022-10-27,70059,70053,Blue,0,81314,81527,213
2022-08-03,70038,70052,Blue,1,46941,47700,759
2022-10-03,70059,70055,Blue,0,40291,40450,159
2022-08-31,70048,70060,Blue,1,45687,46276,589
2022-12-21,70044,70046,Blue,1,26138,26255,117
2022-02-04,70043,70039,Blue,0,32306,32437,131
2022-01-14,70041,70039,Blue,0,59671,59702,31
2022-06-09,70052,70058,Blue,1,40447,40690,243
2022-01-03,70042,70054,Blue,1,46517,47122,605
2022-04-18,70038,70060,Blue,1,24856,25999,1143
2022-03-18,70057,70045,Blue,0,32735,33382,647
2022-01-11,70042,70046,Blue,1,25580,25784,204
2022-02-04,70053,70045,Blue,0,59890,60311,421
2022-01-27,70059,70838,Blue,0,30866,32052,1186
2022-12-13,70047,70043,Blue,0,54954,55217,263
2022-06-24,70040,70056,Blue,1,55830,56757,927
2022-09-25,70046,70050,Blue,1,40725,40916,191
2022-09-30,70041,70039,Blue,0,55010,55046,36
2022-10-26,70038,70050,Blue,1,26398,26959,561
2022-10-16,70044,70046,Blue,1,78740,78837,97
2022-01-11,70048,70060,Blue,1,55595,56575,980
2022-07-06,70038,70044,Blue,1,68063,68229,166
2022-09-13,70048,70050,Blue,1,24094,24154,60
2022-09-01,70051,70045,Blue,0,43595,44071,476
2022-06-20,70044,70054,Blue,1,66640,67294,654
2022-12-05,70047,70041,Blue,0,48466,48798,332
2022-01-30,70046,70054,Blue,1,87775,88276,501
2022-04-08,70057,70043,Blue,0,61475,62209,734
2022-07-01,70040,70048,Blue,1,35427,35921,494
2022-03-31,70047,70043,Blue,0,58687,58927,240
2022-12-04,70038,70042,Blue,1,38991,39089,98
2022-09-14,70059,70039,Blue,0,48370,49359,989
2022-07-16,70053,70043,Blue,0,64164,64756,592
2022-12-13,70057,70051,Blue,0,74428,74676,248
2022-02-05,70048,70058,Blue,1,28479,28941,462
2022-08-08,70046,70054,Blue,1,43480,43974,494
2022-10-22,70042,70056,Blue,1,42743,43430,687
2022-08-31,70059,70055,Blue,0,57728,57868,140
2022-03-12,70046,70050,Blue,1,65164,65372,208
2022-08-20,70055,70053,Blue,0,23675,23723,48
2022-08-09,70059,70041,Blue,0,53534,54458,924
2022-02-15,70053,70041,Blue,0,68446,69107,661
2022-08-02,70055,70047,Blue,0,27417,27816,399
2022-09-13,70055,70045,Blue,0,66754,67281,527
2022-03-27,70053,70049,Blue,0,36468,36674,206
2022-04-12,70040,70046,Blue,1,66242,66518,276
2022-01-20,70039,70838,Blue,0,49795,49829,34
2022-06-10,70040,70046,Blue,1,67099,67356,257
2022-08-25,70059,70041,Blue,0,79416,80352,936
2022-01-19,70059,70039,Blue,0,21837,23083,1246
2022-03-01,70055,70045,Blue,0,20427,20992,565
2022-12-17,70059,70039,Blue,0,58393,59393,1000
2022-12-15,70053,70041,Blue,0,82203,82943,740
2022-02-21,70051,70045,Blue,0,42604,42976,372
2022-06-17,70055,70041,Blue,0,41726,42532,806
2022-01-13,70056,70058,Blue,1,84182,84256,74
2022-11-28,70038,70042,Blue,1,23532,23624,92
2022-01-19,70057,70045,Blue,0,29443,30205,762
2022-01-18,70038,70042,Blue,1,83780,83881,101
2022-12-12,70046,70054,Blue,1,31010,31436,426
2022-09-18,70038,70054,Blue,1,30820,31599,779
2022-10-01,70042,70058,Blue,1,80748,81657,909
2022-06-15,70038,70046,Blue,1,84253,84627,374
2022-10-11,70053,70051,Blue,0,65258,65327,69
2022-07-21,70059,70053,Blue,0,46816,47052,236
2022-03-22,70047,70045,Blue,0,54206,54297,91
2022-11-13,70038,70052,Blue,1,79090,79752,662
2022-06-16,70057,70049,Blue,0,31894,32298,404
2022-02-27,70059,70057,Blue,0,65174,65210,36
2022-06-15,70043,70039,Blue,0,69449,69571,122
2022-03-07,70055,70838,Blue,0,26546,27595,1049
2022-02-03,70044,70058,Blue,1,51883,52703,820
2022-02-11,70048,70054,Blue,1,76960,77279,319
2022-07-12,70047,70043,Blue,0,44310,44584,274
2022-02-01,70059,70047,Blue,0,27922,28560,638
2022-02-09,70057,70047,Blue,0,27036,27578,542
2022-12-18,70053,70039,Blue,0,62907,63687,780
2022-09-22,70057,70047,Blue,0,70292,70798,506
2022-03-16,70057,70045,Blue,0,38733,39388,655
2022-08-12,70055,70053,Blue,0,31169,31216,47
2022-07-05,70038,70048,Blue,1,34619,35554,935
2022-12-18,70055,70049,Blue,0,72919,73297,378
2022-01-22,70038,70048,Blue,1,65836,66303,467
2022-05-04,70058,70060,Blue,1,80690,80758,68
2022-08-14,70053,70051,Blue,0,78519,78577,58
2022-10-13,70046,70048,Blue,1,31522,31601,79
2022-12-14,70053,70051,Blue,0,66522,66576,54
2022-04-15,70059,70055,Blue,0,81193,81334,141
2022-09-14,70051,70838,Blue,0,82222,82885,663
2022-01-11,70040,70058,Blue,1,22211,23241,1030
2022-06-23,70045,70039,Blue,0,70645,70954,309
2022-10-05,70054,70056,Blue,1,77572,77618,46
2022-03-31,70046,70056,Blue,1,52054,52616,562
2022-11-23,70040,70046,Blue,1,70121,70398,277
2022-09-24,70053,70041,Blue,0,61353,62044,691
2022-04-18,70057,70053,Blue,0,31527,31675,148
2022-10-23,70047,70045,Blue,0,44713,44809,96
2022-06-15,70057,70043,Blue,0,51641,52445,804
2022-04-21,70051,70047,Blue,0,88459,88652,193
2022-11-03,70052,70056,Blue,1,27627,27770,143
2022-01-11,70052,70056,Blue,1,55678,55816,138
2022-02-15,70038,70044,Blue,1,72973,73148,175
2022-10-07,70055,70047,Blue,0,33687,34071,384
2022-01-18,70042,70048,Blue,1,84381,84673,292
2022-08-29,70059,70055,Blue,0,20837,20999,162
2022-06-16,70055,70047,Blue,0,84202,84569,367
2022-02-24,70048,70052,Blue,1,61078,61307,229
2022-07-04,70052,70056,Blue,1,79144,79308,164
2022-03-12,70039,70838,Blue,0,38348,38378,30
2022-07-04,70051,70838,Blue,0,41458,42192,734
2022-08-03,70040,70044,Blue,1,63884,64056,172
2022-09-15,70046,70056,Blue,1,74803,75312,509
2022-08-08,70040,70046,Blue,1,59168,59419,251
2022-02-09,70053,70041,Blue,0,60487,61193,706
2022-07-22,70046,70054,Blue,1,82163,82666,503
2022-10-24,70051,70041,Blue,0,54463,55069,606
2022-11-30,70046,70056,Blue,1,27259,27758,499
2022-10-26,70055,70838,Blue,0,56099,57105,1006
2022-04-08,70054,70058,Blue,1,78371,78536,165
2022-07-16,70038,70040,Blue,1,73392,73407,15
2022-05-20,70048,70050,Blue,1,27546,27605,59
2022-11-07,70048,70054,Blue,1,57436,57775,339
2022-11-26,70051,70041,Blue,0,59286,59846,560
2022-09-24,70040,70046,Blue,1,53506,53798,292
2022-06-16,70042,70058,Blue,1,21079,22002,923
2022-07-29,70051,70049,Blue,0,70955,71059,104
2022-01-14,70059,70057,Blue,0,53120,53160,40
2022-02-26,70040,70058,Blue,1,22569,23613,1044
2022-08-23,70050,70060,Blue,1,34657,35202,545
2022-06-01,70045,70043,Blue,0,71432,71538,106
2022-03-02,70055,70049,Blue,0,54674,54964,290
2022-07-19,70038,70050,Blue,1,23587,24224,637
2022-07-15,70053,70041,Blue,0,63342,63992,650
2022-04-17,70042,70050,Blue,1,45577,45999,422
2022-03-14,70059,70039,Blue,0,26670,27703,1033
2022-01-09,70057,70055,Blue,0,36927,36996,69
2022-11-07,70059,70838,Blue,0,33012,34482,1470
2022-05-02,70059,70057,Blue,0,35717,35757,40
2022-02-01,70042,70044,Blue,1,29812,29847,35
2022-10-14,70042,70046,Blue,1,70193,70389,196
2022-03-03,70044,70052,Blue,1,35337,35901,564
2022-01-11,70053,70047,Blue,0,31803,32104,301
2022-01-20,70040,70054,Blue,1,24363,25225,862
2022-08-14,70040,70056,Blue,1,63505,64367,862
2022-12-26,70052,70054,Blue,1,37078,37189,111
2022-11-28,70050,70052,Blue,1,42501,42612,111
2022-04-14,70057,70047,Blue,0,55767,56236,469
2022-07-18,70038,70044,Blue,1,59316,59499,183
2022-03-12,70038,70044,Blue,1,44234,44404,170
2022-04-02,70042,70058,Blue,1,69755,70619,864
2022-02-28,70044,70056,Blue,1,27932,28665,733
2022-12-27,70055,70043,Blue,0,36285,37014,729
2022-07-01,70046,70056,Blue,1,47141,47657,516
2022-01-31,70044,70052,Blue,1,87413,87896,483
2022-07-15,70049,70041,Blue,0,21921,22361,440
2022-08-09,70052,70058,Blue,1,75998,76247,249
2022-10-09,70049,70043,Blue,0,73301,73635,334
2022-09-23,70051,70047,Blue,0,57792,58023,231
2022-12-07,70059,70047,Blue,0,29615,30213,598
2022-03-04,70038,70060,Blue,1,27557,28791,1234
2022-07-08,70044,70052,Blue,1,31728,32331,603
2022-10-27,70045,70043,Blue,0,74712,74805,93
2022-12-21,70059,70039,Blue,0,50894,51789,895
2022-10-16,70040,70060,Blue,1,66739,67888,1149
2022-03-03,70038,70044,Blue,1,30845,31032,187
2022-08-26,70044,70050,Blue,1,38135,38461,326
2022-10-09,70049,70041,Blue,0,67837,68240,403
2022-01-23,70040,70046,Blue,1,82386,82621,235
2022-05-07,70059,70051,Blue,0,60013,60360,347
2022-05-20,70050,70060,Blue,1,67186,67841,655
2022-11-02,70038,70044,Blue,1,89113,89420,307
2022-08-03,70051,70039,Blue,0,82962,83633,671
2022-08-31,70051,70041,Blue,0,85911,86451,540
2022-11-09,70057,70049,Blue,0,86605,86961,356
2022-09-02,70048,70056,Blue,1,38020,38432,412
2022-02-23,70040,70058,Blue,1,21087,22154,1067
2022-09-26,70040,70052,Blue,1,19977,20634,657
2022-09-13,70048,70054,Blue,1,55221,55511,290
2022-07-08,70055,70051,Blue,0,21263,21408,145
2022-08-07,70058,70060,Blue,1,44161,44221,60
2022-08-30,70050,70060,Blue,1,65108,65687,579
2022-03-10,70046,70058,Blue,1,20498,21262,764
2022-04-15,70038,70044,Blue,1,35208,35390,182
2022-05-11,70059,70057,Blue,0,25119,25154,35
2022-08-11,70048,70060,Blue,1,87083,87724,641
2022-04-12,70052,70058,Blue,1,42896,43187,291
2022-03-17,70038,70060,Blue,1,56228,57498,1270
2022-10-20,70044,70056,Blue,1,49546,50267,721
2022-03-21,70055,70041,Blue,0,23834,24638,804
2022-06-22,70059,70053,Blue,0,80183,80433,250
2022-09-25,70059,70041,Blue,0,33196,34144,948
2022-01-10,70043,70039,Blue,0,64683,64780,97
2022-04-22,70051,70838,Blue,0,68826,69511,685
2022-10-24,70057,70838,Blue,0,23125,24257,1132
2022-07-01,70055,70047,Blue,0,60238,60661,423
2022-06-17,70055,70838,Blue,0,65780,66716,936
2022-03-04,70051,70838,Blue,0,25624,26407,783
2022-02-18,70040,70056,Blue,1,39435,40320,885
2022-04-28,70055,70049,Blue,0,27391,27678,287
2022-07-18,70057,70055,Blue,0,19612,19682,70
2022-03-07,70044,70050,Blue,1,53943,54267,324
2022-05-30,70042,70050,Blue,1,65866,66265,399
2022-08-02,70040,70054,Blue,1,63283,64103,820
2022-02-09,70043,70041,Blue,0,85509,85538,29
2022-08-18,70048,70060,Blue,1,77917,78539,622
2022-02-18,70045,70838,Blue,0,45713,46052,339
2022-10-29,70043,70838,Blue,0,63090,63282,192
2022-02-13,70050,70060,Blue,1,74825,75356,531
2022-10-10,70038,70044,Blue,1,33616,33769,153
2022-03-05,70048,70052,Blue,1,76686,77079,393
2022-10-08,70048,70052,Blue,1,65279,65499,220
2022-11-17,70038,70044,Blue,1,31541,31702,161
2022-03-14,70052,70056,Blue,1,53952,54083,131
2022-09-04,70050,70060,Blue,1,78672,79177,505
2022-09-13,70038,70052,Blue,1,63112,63851,739
2022-07-06,70046,70054,Blue,1,57818,58318,500
2022-08-01,70040,70042,Blue,1,68002,68041,39
2022-04-01,70042,70048,Blue,1,53522,53893,371
2022-03-13,70053,70049,Blue,0,79041,79229,188
2022-09-16,70051,70047,Blue,0,80834,81044,210
2022-04-13,70051,70838,Blue,0,22052,22883,831
2022-07-14,70045,70838,Blue,0,49202,49595,393
2022-12-19,70055,70838,Blue,0,62318,63389,1071
2022-02-11,70038,70056,Blue,1,81987,82937,950
2022-08-24,70051,70047,Blue,0,70130,70320,190
2022-02-22,70048,70056,Blue,1,63971,64386,415
2022-11-10,70051,70049,Blue,0,25819,25924,105
2022-04-07,70057,70041,Blue,0,87572,88395,823
2022-03-14,70045,70041,Blue,0,65454,65638,184
2022-02-11,70042,70046,Blue,1,55201,55375,174
2022-10-21,70059,70045,Blue,0,61877,62550,673
2022-07-09,70042,70044,Blue,1,42777,42814,37
2022-04-11,70055,70049,Blue,0,55270,55614,344
2022-06-22,70055,70041,Blue,0,23624,24472,848
2022-02-14,70057,70047,Blue,0,30938,31425,487
2022-02-03,70055,70043,Blue,0,62500,63213,713
2022-08-31,70040,70052,Blue,1,36412,37120,708
2022-03-22,70058,70060,Blue,1,36036,36157,121
2022-09-13,70048,70054,Blue,1,37944,38253,309
2022-04-15,70040,70044,Blue,1,38104,38235,131
2022-07-04,70038,70050,Blue,1,41037,41677,640
2022-07-12,70057,70053,Blue,0,85047,85202,155
2022-10-04,70038,70052,Blue,1,59108,59881,773
2022-08-22,70042,70060,Blue,1,58169,59233,1064
2022-09-04,70041,70838,Blue,0,51668,51790,122
2022-11-14,70047,70039,Blue,0,58296,58664,368
2022-02-19,70059,70838,Blue,0,78438,79576,1138
2022-10-24,70049,70838,Blue,0,49344,49937,593
2022-12-14,70048,70056,Blue,1,51916,52320,404
2022-06-09,70042,70050,Blue,1,64061,64532,471
2022-03-08,70050,70054,Blue,1,52519,52727,208
2022-01-22,70045,70838,Blue,0,62370,62721,351
2022-01-07,70051,70838,Blue,0,36955,37703,748
2022-09-17,70051,70045,Blue,0,56601,57069,468
2022-12-02,70040,70050,Blue,1,75479,76015,536
2022-12-30,70054,70056,Blue,1,85575,85626,51
2022-01-18,70052,70060,Blue,1,84960,85318,358
2022-07-06,70053,70039,Blue,0,27048,27899,851
2022-06-11,70044,70050,Blue,1,42843,43216,373
2022-04-10,70059,70049,Blue,0,73817,74302,485
2022-03-31,70053,70043,Blue,0,87774,88348,574
2022-04-17,70048,70054,Blue,1,38907,39221,314
2022-12-22,70044,70054,Blue,1,52216,52840,624
2022-11-05,70040,70044,Blue,1,70849,71012,163
2022-07-29,70038,70054,Blue,1,78841,79714,873
2022-02-10,70046,70052,Blue,1,28294,28656,362
2022-10-23,70040,70050,Blue,1,74830,75356,526
2022-10-15,70050,70054,Blue,1,27497,27715,218
2022-06-10,70044,70060,Blue,1,67246,68613,1367
2022-08-15,70045,70043,Blue,0,86316,86420,104
2022-09-07,70044,70060,Blue,1,72923,73839,916
2022-12-24,70059,70838,Blue,0,64335,65397,1062
2022-12-16,70054,70060,Blue,1,45337,45583,246
2022-11-19,70042,70044,Blue,1,42743,42770,27
2022-10-27,70038,70050,Blue,1,67036,67750,714
2022-11-15,70052,70054,Blue,1,37497,37559,62
2022-12-06,70038,70060,Blue,1,33191,34439,1248
2022-09-30,70040,70046,Blue,1,49016,49316,300
2022-09-24,70044,70056,Blue,1,78179,78852,673
2022-08-29,70057,70047,Blue,0,86620,87079,459
2022-02-09,70050,70058,Blue,1,39344,39814,470
2022-02-16,70043,70039,Blue,0,65083,65193,110
2022-08-24,70042,70052,Blue,1,34217,34819,602
2022-01-03,70046,70056,Blue,1,67979,68512,533
2022-11-08,70038,70046,Blue,1,38960,39522,562
2022-12-22,70053,70041,Blue,0,32643,33335,692
2022-04-24,70055,70041,Blue,0,79944,80658,714
2022-01-06,70059,70051,Blue,0,40597,41006,409
2022-06-10,70038,70050,Blue,1,48676,49275,599
2022-04-01,70045,70043,Blue,0,68173,68263,90
2022-09-01,70053,70047,Blue,0,40250,40596,346
2022-02-15,70045,70838,Blue,0,85389,85745,356
2022-11-16,70053,70051,Blue,0,58492,58547,55
2022-03-31,70044,70046,Blue,1,24240,24358,118
2022-11-22,70048,70056,Blue,1,86213,86618,405
2022-10-13,70055,70053,Blue,0,70163,70216,53
2022-07-19,70040,70050,Blue,1,64370,64916,546
2022-10-11,70041,70838,Blue,0,59710,59830,120
2022-02-12,70055,70041,Blue,0,36435,37196,761
2022-07-05,70059,70057,Blue,0,84485,84522,37
2022-10-27,70043,70039,Blue,0,88238,88348,110
2022-10-11,70044,70046,Blue,1,58133,58234,101
2022-06-14,70051,70043,Blue,0,55171,55693,522
2022-04-08,70055,70039,Blue,0,59788,60589,801
2022-06-13,70057,70055,Blue,0,83556,83626,70
2022-12-25,70056,70058,Blue,1,65929,66002,73
2022-12-24,70057,70047,Blue,0,23649,24183,534
2022-01-27,70056,70060,Blue,1,75729,75920,191
2022-03-13,70047,70043,Blue,0,42780,43033,253
2022-09-28,70051,70838,Blue,0,33864,34721,857
2022-12-29,70059,70047,Blue,0,43204,44371,1167
2022-01-18,70055,70039,Blue,0,21141,22008,867
2022-12-30,70044,70054,Blue,1,76010,76581,571
2022-04-07,70059,70053,Blue,0,72072,72298,226
2022-04-08,70038,70054,Blue,1,62231,63007,776
2022-11-25,70045,70041,Blue,0,28773,28948,175
2022-08-13,70052,70058,Blue,1,69286,69565,279
2022-10-02,70054,70060,Blue,1,30819,31069,250
2022-09-15,70040,70058,Blue,1,83414,84355,941
2022-01-18,70038,70056,Blue,1,69909,70841,932
2022-11-04,70040,70060,Blue,1,52848,53948,1100
2022-03-12,70053,70039,Blue,0,70552,71260,708
2022-03-09,70054,70056,Blue,1,68834,68881,47
2022-08-18,70053,70047,Blue,0,62893,63160,267
2022-08-23,70040,70054,Blue,1,76843,77527,684
2022-01-14,70055,70838,Blue,0,62470,63420,950
2022-08-18,70055,70051,Blue,0,22793,22956,163
2022-02-01,70051,70041,Blue,0,49240,49841,601
2022-01-15,70041,70838,Blue,0,38787,38900,113
2022-09-16,70046,70054,Blue,1,52936,53374,438
2022-12-11,70055,70053,Blue,0,64437,64489,52
2022-07-01,70057,70045,Blue,0,58205,58823,618
2022-09-21,70046,70058,Blue,1,45530,46172,642
2022-03-05,70047,70043,Blue,0,47677,47935,258
2022-06-17,70042,70050,Blue,1,55492,55956,464
2022-10-26,70048,70060,Blue,1,66945,67575,630
2022-08-10,70055,70049,Blue,0,84652,84915,263
2022-04-26,70056,70060,Blue,1,49092,49256,164
2022-11-29,70053,70049,Blue,0,21934,22134,200
2022-03-11,70040,70050,Blue,1,27919,28453,534
2022-01-27,70042,70050,Blue,1,29005,29423,418
2022-06-07,70042,70044,Blue,1,48219,48251,32
2022-01-03,70040,70052,Blue,1,35114,35887,773
2022-11-26,70048,70058,Blue,1,70671,71173,502
2022-12-19,70046,70056,Blue,1,59987,60537,550
2022-12-13,70044,70046,Blue,1,43190,43299,109
2022-03-07,70043,70039,Blue,0,71385,71482,97
2022-02-19,70039,70838,Blue,0,63822,63855,33
2022-05-22,70044,70052,Blue,1,38397,39090,693
2022-09-20,70050,70056,Blue,1,43703,44026,323
2022-10-04,70046,70060,Blue,1,86128,86905,777
2022-03-05,70038,70040,Blue,1,57192,57206,14
2022-07-23,70045,70039,Blue,0,60156,60444,288
2022-10-19,70049,70043,Blue,0,52650,52998,348
2022-02-07,70055,70045,Blue,0,70731,71238,507
2022-04-12,70055,70045,Blue,0,31937,32487,550
2022-06-08,70043,70838,Blue,0,35170,35379,209
2022-12-13,70055,70047,Blue,0,83090,83473,383
2022-08-03,70042,70044,Blue,1,20035,20065,30
2022-05-12,70057,70055,Blue,0,19713,19781,68
2022-11-28,70044,70050,Blue,1,22009,22351,342
2022-06-28,70050,70052,Blue,1,52308,52435,127
2022-07-04,70057,70041,Blue,0,75159,76074,915
2022-10-27,70042,70050,Blue,1,73849,74239,390
2022-10-24,70050,70058,Blue,1,66445,66857,412
2022-07-29,70044,70060,Blue,1,60115,61173,1058
2022-02-02,70049,70043,Blue,0,41704,42106,402
2022-05-21,70048,70056,Blue,1,48124,48563,439
2022-09-07,70058,70060,Blue,1,42806,42871,65
2022-12-25,70040,70054,Blue,1,65662,66425,763
2022-01-02,70050,70060,Blue,1,60805,61295,490
2022-06-18,70052,70056,Blue,1,51642,51782,140
2022-10-12,70044,70054,Blue,1,74535,75150,615
2022-01-06,70059,70043,Blue,0,64400,65297,897
2022-02-13,70041,70838,Blue,0,74959,75086,127
2022-12-22,70038,70060,Blue,1,50989,52257,1268
2022-02-01,70045,70043,Blue,0,80285,80422,137
2022-11-15,70050,70054,Blue,1,29584,29806,222
2022-08-11,70051,70041,Blue,0,51328,51890,562
2022-10-20,70059,70045,Blue,0,72881,73570,689
2022-08-22,70049,70039,Blue,0,29410,29959,549
2022-03-23,70040,70046,Blue,1,86095,86362,267
2022-08-03,70047,70045,Blue,0,54695,54785,90
2022-03-04,70048,70050,Blue,1,87612,87672,60
2022-02-24,70051,70049,Blue,0,71362,71464,102
2022-10-14,70052,70060,Blue,1,74928,75293,365
2022-03-25,70040,70050,Blue,1,51762,52340,578
2022-04-04,70044,70060,Blue,1,67001,67957,956
2022-02-18,70047,70838,Blue,0,34246,34818,572
2022-03-07,70044,70054,Blue,1,28079,28705,626
2022-03-17,70049,70041,Blue,0,48678,49084,406
2022-03-04,70044,70048,Blue,1,49970,50195,225
2022-06-09,70051,70049,Blue,0,24125,24241,116
2022-06-29,70045,70041,Blue,0,57581,57760,179
2022-01-24,70053,70039,Blue,0,53387,54153,766
2022-03-30,70056,70058,Blue,1,23757,23835,78
2022-09-23,70043,70838,Blue,0,36625,36840,215
2022-04-19,70051,70043,Blue,0,45318,45832,514
2022-03-24,70042,70052,Blue,1,51327,51896,569
2022-11-05,70055,70838,Blue,0,33876,34838,962
2022-02-23,70053,70039,Blue,0,32010,32746,736
2022-09-02,70046,70050,Blue,1,31052,31249,197
2022-02-03,70049,70041,Blue,0,51764,52282,518
2022-12-22,70047,70041,Blue,0,34540,34863,323
2022-07-20,70059,70049,Blue,0,54535,55052,517
2022-12-30,70059,70039,Blue,0,63729,64787,1058
2022-09-26,70057,70051,Blue,0,63441,63672,231
2022-07-15,70044,70050,Blue,1,41393,41898,505
2022-04-18,70053,70045,Blue,0,26073,26599,526
2022-02-25,70057,70039,Blue,0,50326,51279,953
2022-02-17,70047,70039,Blue,0,47288,47721,433
2022-04-18,70040,70050,Blue,1,34519,35044,525
2022-05-25,70049,70838,Blue,0,49300,50014,714
2022-03-11,70059,70047,Blue,0,48676,49248,572
2022-09-13,70049,70041,Blue,0,71770,72191,421
2022-02-16,70046,70054,Blue,1,30001,30403,402
2022-09-22,70048,70056,Blue,1,65459,65870,411
2022-12-25,70059,70043,Blue,0,46275,47145,870
2022-02-25,70057,70049,Blue,0,72101,72514,413
2022-02-15,70042,70056,Blue,1,37507,38289,782
2022-08-15,70050,70056,Blue,1,52187,52534,347
2022-11-13,70055,70043,Blue,0,79152,79869,717
2022-11-10,70053,70043,Blue,0,44328,44934,606
2022-12-28,70055,70051,Blue,0,29030,29167,137
2022-06-22,70053,70039,Blue,0,72445,73177,732
2022-11-08,70042,70056,Blue,1,75898,76623,725
2022-01-10,70055,70047,Blue,0,70185,70588,403
2022-07-18,70038,70044,Blue,1,50776,50962,186
2022-03-14,70046,70056,Blue,1,37756,38358,602
2022-09-20,70043,70041,Blue,0,40489,40516,27
2022-06-20,70045,70039,Blue,0,19229,19507,278
2022-02-03,70050,70058,Blue,1,45904,46299,395
2022-03-14,70045,70039,Blue,0,21791,22070,279
2022-12-12,70039,70838,Blue,0,38398,38431,33
2022-06-24,70038,70042,Blue,1,60140,60277,137
2022-11-19,70053,70043,Blue,0,27392,27946,554
2022-04-27,70052,70056,Blue,1,31696,31836,140
2022-10-20,70038,70056,Blue,1,72607,73476,869
2022-10-13,70045,70043,Blue,0,73724,73830,106
2022-01-05,70045,70043,Blue,0,21311,21400,89
2022-08-17,70053,70049,Blue,0,44465,44671,206
2022-06-17,70040,70054,Blue,1,68027,68828,801
2022-01-20,70040,70056,Blue,1,76941,77750,809
2022-01-31,70051,70043,Blue,0,29124,29650,526
2022-08-01,70050,70056,Blue,1,59693,59987,294
2022-09-06,70046,70048,Blue,1,37097,37177,80
2022-11-04,70045,70039,Blue,0,57052,57465,413
2022-09-29,70045,70039,Blue,0,21691,21995,304
2022-07-18,70050,70058,Blue,1,66994,67394,400
2022-01-22,70052,70056,Blue,1,60639,60779,140
2022-01-28,70054,70058,Blue,1,25315,25492,177
2022-09-15,70038,70060,Blue,1,84139,85230,1091
2022-03-30,70057,70045,Blue,0,54865,55476,611
2022-09-27,70055,70043,Blue,0,23652,24550,898
2022-01-24,70040,70060,Blue,1,53427,54516,1089
2022-10-10,70044,70058,Blue,1,61628,62426,798
2022-11-21,70049,70043,Blue,0,60289,60634,345
2022-02-22,70038,70060,Blue,1,39256,40468,1212
2022-12-03,70044,70046,Blue,1,44596,44699,103
2022-03-21,70042,70048,Blue,1,36865,37163,298
2022-06-29,70059,70049,Blue,0,33498,34029,531
2022-12-23,70040,70044,Blue,1,68872,68993,121
2022-12-01,70059,70055,Blue,0,30451,30607,156
2022-08-17,70043,70039,Blue,0,19426,19551,125
2022-03-27,70040,70050,Blue,1,41078,41603,525
2022-10-19,70042,70054,Blue,1,42242,42937,695
2022-12-12,70059,70045,Blue,0,54612,55292,680
2022-04-23,70059,70039,Blue,0,58402,59442,1040
2022-03-24,70038,70052,Blue,1,57445,58168,723
2022-06-29,70040,70044,Blue,1,60779,60897,118
2022-01-25,70043,70838,Blue,0,52938,53137,199
2022-03-13,70042,70056,Blue,1,27810,28537,727
2022-09-01,70059,70041,Blue,0,83408,84298,890
2022-03-28,70045,70041,Blue,0,78514,78681,167
2022-10-23,70055,70045,Blue,0,41647,42132,485
2022-08-31,70038,70050,Blue,1,74161,74723,562
2022-07-05,70045,70043,Blue,0,35859,35978,119
2022-04-19,70042,70056,Blue,1,24588,25371,783
2022-09-11,70049,70043,Blue,0,26924,27282,358
2022-03-25,70050,70056,Blue,1,47061,47372,311
2022-08-07,70044,70048,Blue,1,84118,84364,246
2022-04-05,70051,70047,Blue,0,53462,53655,193
2022-02-23,70044,70058,Blue,1,46210,47014,804
2022-02-25,70038,70060,Blue,1,85425,86602,1177
2022-04-12,70046,70052,Blue,1,66568,67021,453
2022-10-28,70038,70042,Blue,1,24435,24544,109
2022-06-29,70059,70057,Blue,0,31398,31433,35
2022-12-10,70057,70838,Blue,0,30401,31474,1073
2022-02-01,70057,70047,Blue,0,33354,33891,537
2022-01-20,70040,70050,Blue,1,67700,68181,481
2022-06-01,70038,70044,Blue,1,57917,58115,198
2022-07-09,70056,70058,Blue,1,49571,49640,69
2022-04-11,70044,70056,Blue,1,73223,73931,708
2022-07-12,70048,70054,Blue,1,70764,71080,316
2022-01-03,70048,70060,Blue,1,61634,62385,751
2022-01-23,70047,70043,Blue,0,22907,23169,262
2022-04-14,70040,70042,Blue,1,52904,52939,35
2022-11-25,70046,70052,Blue,1,33141,33481,340
2022-04-14,70059,70055,Blue,0,22428,22585,157
2022-12-31,70044,70050,Blue,1,69682,69995,313
2022-07-06,70049,70838,Blue,0,87932,88483,551
2022-01-07,70047,70838,Blue,0,19577,20163,586
2022-11-26,70042,70052,Blue,1,55186,55806,620
2022-11-08,70046,70054,Blue,1,46265,46737,472
2022-04-05,70038,70042,Blue,1,89166,89250,84
2022-02-24,70053,70051,Blue,0,53039,53105,66
2022-05-04,70053,70047,Blue,0,37192,37520,328
2022-01-12,70040,70046,Blue,1,64081,64356,275
2022-07-13,70053,70051,Blue,0,42699,42764,65
2022-02-17,70049,70047,Blue,0,75984,76037,53
2022-09-07,70042,70046,Blue,1,49911,50080,169
2022-12-11,70044,70052,Blue,1,50679,51165,486
2022-04-04,70042,70050,Blue,1,54698,55115,417
2022-05-04,70056,70058,Blue,1,37643,37721,78
2022-07-30,70055,70043,Blue,0,53755,54460,705
2022-05-24,70044,70050,Blue,1,24683,25084,401
2022-06-08,70038,70046,Blue,1,67031,67453,422
2022-02-09,70042,70060,Blue,1,76477,77389,912
2022-09-23,70040,70058,Blue,1,69662,70618,956
2022-09-14,70057,70045,Blue,0,68192,68808,616
2022-02-04,70059,70047,Blue,0,54617,55205,588
2022-02-06,70040,70060,Blue,1,36314,37325,1011
2022-02-22,70050,70054,Blue,1,75754,75942,188
2022-01-22,70059,70039,Blue,0,47054,48129,1075
2022-12-05,70047,70039,Blue,0,78934,79314,380
2022-10-20,70048,70058,Blue,1,53903,54422,519
2022-01-21,70051,70047,Blue,0,69825,70016,191
2022-07-15,70055,70039,Blue,0,51677,52563,886
2022-08-18,70053,70049,Blue,0,25926,26149,223
2022-04-05,70055,70051,Blue,0,42859,43005,146
2022-04-05,70055,70049,Blue,0,81378,81669,291
2022-06-17,70044,70046,Blue,1,64270,64411,141
2022-04-20,70056,70060,Blue,1,74028,74212,184
2022-09-28,70038,70050,Blue,1,62881,63526,645
2022-10-27,70042,70044,Blue,1,29558,29588,30
2022-06-13,70040,70052,Blue,1,68652,69307,655
2022-03-15,70042,70048,Blue,1,61802,62141,339
2022-01-31,70040,70044,Blue,1,47939,48063,124
2022-10-26,70043,70039,Blue,0,44148,44259,111
2022-06-27,70053,70043,Blue,0,69519,70143,624
2022-11-09,70051,70049,Blue,0,52869,52972,103
2022-05-23,70042,70048,Blue,1,29330,29694,364
2022-09-09,70049,70045,Blue,0,72730,72924,194
2022-11-16,70050,70054,Blue,1,25785,25991,206
2022-03-15,70038,70042,Blue,1,65533,65627,94
2022-03-22,70053,70051,Blue,0,26017,26070,53
2022-08-16,70049,70041,Blue,0,47323,47851,528
2022-07-26,70047,70045,Blue,0,48472,48605,133
2022-11-25,70052,70058,Blue,1,89015,89272,257
2022-03-15,70040,70052,Blue,1,63504,64266,762
2022-09-20,70045,70043,Blue,0,64203,64301,98
2022-12-22,70053,70051,Blue,0,26666,26733,67
2022-03-05,70045,70041,Blue,0,85615,85774,159
2022-08-29,70059,70047,Blue,0,48374,48928,554
2022-10-17,70059,70838,Blue,0,65234,66342,1108
2022-03-16,70046,70058,Blue,1,64179,64873,694
2022-06-13,70057,70039,Blue,0,34803,35892,1089
2022-04-26,70050,70058,Blue,1,72845,73261,416
2022-07-04,70040,70042,Blue,1,23052,23085,33
2022-09-29,70055,70045,Blue,0,43396,44087,691
2022-02-04,70053,70043,Blue,0,71393,72113,720
2022-01-19,70040,70046,Blue,1,52817,53122,305
2022-03-29,70053,70838,Blue,0,32916,33743,827
2022-06-13,70038,70042,Blue,1,85403,85493,90
2022-06-08,70042,70050,Blue,1,71416,71897,481
2022-03-02,70051,70838,Blue,0,61445,62278,833
2022-06-04,70042,70046,Blue,1,58613,58825,212
2022-06-10,70049,70039,Blue,0,41371,42140,769
2022-09-10,70045,70041,Blue,0,54471,54664,193
2022-11-28,70044,70056,Blue,1,24679,25360,681
2022-02-10,70048,70056,Blue,1,52217,52646,429
2022-09-02,70045,70041,Blue,0,85768,85978,210
2022-07-07,70040,70050,Blue,1,61281,61864,583
2022-11-18,70046,70048,Blue,1,78418,78514,96
2022-07-08,70046,70058,Blue,1,84196,84853,657
2022-01-12,70038,70060,Blue,1,67695,68904,1209
2022-04-06,70049,70045,Blue,0,61158,61353,195
2022-06-30,70055,70043,Blue,0,38173,38992,819
2022-08-03,70057,70047,Blue,0,37530,38004,474
2022-12-28,70040,70044,Blue,1,71832,71953,121
2022-08-31,70055,70041,Blue,0,19737,20594,857
2022-08-04,70051,70041,Blue,0,25468,26070,602
2022-09-02,70057,70049,Blue,0,32541,32979,438
2022-07-19,70053,70039,Blue,0,74329,75112,783
2022-02-06,70057,70051,Blue,0,63675,63930,255
2022-02-10,70057,70039,Blue,0,50335,51319,984
2022-03-09,70044,70050,Blue,1,72839,73339,500
2022-09-08,70056,70060,Blue,1,24118,24399,281
2022-03-31,70044,70056,Blue,1,66356,67047,691
2022-04-06,70052,70058,Blue,1,59903,60140,237
2022-01-10,70057,70051,Blue,0,58765,59009,244
2022-08-03,70039,70838,Blue,0,62378,62410,32
2022-06-15,70047,70045,Blue,0,65315,65422,107
2022-06-15,70054,70058,Blue,1,65279,65457,178
2022-07-17,70044,70046,Blue,1,48622,48721,99
2022-01-18,70044,70056,Blue,1,49524,50482,958
2022-06-21,70038,70054,Blue,1,53493,54375,882
2022-03-20,70046,70058,Blue,1,71345,72022,677
2022-07-19,70042,70050,Blue,1,20029,20447,418
2022-01-25,70042,70058,Blue,1,43650,44582,932
2022-09-30,70050,70060,Blue,1,22911,23431,520
2022-08-28,70047,70838,Blue,0,87895,88376,481
2022-02-05,70049,70041,Blue,0,62707,63146,439
2022-02-08,70046,70050,Blue,1,35628,35828,200
2022-05-25,70038,70048,Blue,1,33435,33921,486
2022-06-21,70044,70048,Blue,1,80922,81176,254
2022-09-14,70055,70041,Blue,0,55619,56358,739
2022-08-03,70059,70047,Blue,0,58214,58766,552
2022-06-25,70059,70838,Blue,0,58681,59901,1220
2022-06-17,70055,70047,Blue,0,56246,56605,359
2022-12-16,70040,70056,Blue,1,60216,61048,832
2022-12-21,70044,70050,Blue,1,33290,33634,344
2022-08-25,70040,70052,Blue,1,61423,62092,669
2022-01-25,70040,70044,Blue,1,23132,23252,120
2022-01-25,70057,70838,Blue,0,58468,59615,1147
2022-03-12,70044,70052,Blue,1,53139,53682,543
2022-07-03,70040,70060,Blue,1,64056,65183,1127
2022-06-11,70047,70041,Blue,0,60141,60462,321
2022-12-20,70047,70043,Blue,0,35134,35400,266
2022-02-11,70055,70045,Blue,0,31929,32439,510
2022-10-13,70042,70050,Blue,1,52240,52619,379
2022-09-10,70053,70047,Blue,0,23081,23362,281
2022-08-01,70053,70045,Blue,0,23692,24148,456
2022-09-27,70048,70056,Blue,1,65378,65763,385
2022-04-08,70042,70046,Blue,1,47071,47242,171
2022-12-17,70056,70060,Blue,1,77108,77332,224
2022-02-20,70059,70053,Blue,0,25405,25634,229
2022-11-06,70055,70039,Blue,0,24029,25058,1029
2022-09-20,70050,70060,Blue,1,29152,29656,504
2022-10-26,70057,70049,Blue,0,85063,85467,404
2022-10-31,70055,70039,Blue,0,55283,56184,901
2022-02-28,70044,70052,Blue,1,25942,26430,488
2022-01-04,70057,70838,Blue,0,80807,81729,922
2022-03-22,70041,70838,Blue,0,41528,41667,139
2022-05-29,70046,70052,Blue,1,87791,88316,525
2022-09-13,70049,70047,Blue,0,55106,55160,54
2022-01-27,70057,70047,Blue,0,55172,55629,457
2022-03-20,70057,70838,Blue,0,62806,63837,1031
2022-07-03,70041,70039,Blue,0,77009,77042,33
2022-05-05,70059,70049,Blue,0,87611,88069,458
2022-02-24,70038,70048,Blue,1,28487,28963,476
2022-11-23,70040,70044,Blue,1,80723,80841,118
2022-07-17,70040,70054,Blue,1,29296,29997,701
2022-10-05,70048,70058,Blue,1,21858,22376,518
2022-02-19,70040,70060,Blue,1,87391,88481,1090
2022-07-13,70049,70039,Blue,0,21324,21846,522
2022-01-06,70053,70838,Blue,0,43434,44741,1307
2022-02-07,70053,70043,Blue,0,51001,51598,597
2022-07-02,70038,70044,Blue,1,63676,63868,192
2022-07-27,70052,70058,Blue,1,34035,34350,315
2022-12-05,70046,70048,Blue,1,61792,61862,70
2022-10-14,70047,70039,Blue,0,22445,22920,475
2022-01-28,70051,70049,Blue,0,59065,59169,104
2022-10-15,70042,70060,Blue,1,24454,25409,955
2022-01-12,70040,70056,Blue,1,29131,29984,853
2022-10-20,70038,70044,Blue,1,29468,29644,176
2022-06-10,70059,70055,Blue,0,65069,65220,151
2022-10-05,70042,70056,Blue,1,63588,64398,810
2022-12-01,70044,70048,Blue,1,34230,34467,237
2022-01-21,70051,70049,Blue,0,67880,67984,104
2022-08-11,70052,70056,Blue,1,81157,81305,148
2022-11-05,70044,70046,Blue,1,82461,82568,107
2022-09-13,70050,70052,Blue,1,52977,53094,117
2022-07-11,70049,70838,Blue,0,61895,62538,643
2022-12-11,70046,70056,Blue,1,42024,42527,503
2022-02-17,70051,70045,Blue,0,82143,82490,347
2022-09-11,70055,70041,Blue,0,30344,31135,791
2022-03-04,70059,70045,Blue,0,84620,85355,735
2022-03-21,70040,70054,Blue,1,64982,65701,719
2022-02-06,70059,70053,Blue,0,37517,37771,254
2022-03-19,70057,70047,Blue,0,75872,76339,467
2022-09-08,70055,70047,Blue,0,58403,58887,484
2022-08-08,70055,70045,Blue,0,30757,31323,566
2022-03-29,70038,70050,Blue,1,76324,76887,563
2022-04-15,70038,70054,Blue,1,58382,59299,917
2022-02-24,70050,70058,Blue,1,34169,34630,461
2022-09-11,70048,70054,Blue,1,71504,71814,310
2022-12-11,70046,70048,Blue,1,39404,39483,79
2022-07-10,70055,70053,Blue,0,56720,56767,47
2022-08-07,70045,70039,Blue,0,64334,64591,257
2022-09-19,70057,70053,Blue,0,68732,68921,189
2022-07-25,70038,70042,Blue,1,63860,63954,94
2022-01-13,70044,70060,Blue,1,82861,83750,889
2022-05-21,70040,70054,Blue,1,48236,49037,801
2022-03-25,70059,70053,Blue,0,84613,84850,237
2022-02-14,70050,70054,Blue,1,65527,65732,205
2022-08-12,70059,70051,Blue,0,76096,76414,318
2022-08-27,70059,70039,Blue,0,41655,42682,1027
2022-01-27,70048,70056,Blue,1,30454,30842,388
2022-10-09,70038,70050,Blue,1,77468,78013,545
2022-04-27,70052,70056,Blue,1,22886,23027,141
2022-09-19,70059,70049,Blue,0,34352,34818,466
2022-10-11,70059,70041,Blue,0,35903,36963,1060
2022-02-04,70040,70058,Blue,1,28988,30155,1167
2022-12-20,70040,70052,Blue,1,57898,58579,681
2022-02-07,70053,70039,Blue,0,22456,23284,828
2022-02-07,70055,70838,Blue,0,50420,51313,893
2022-03-08,70045,70041,Blue,0,77891,78045,154
2022-08-23,70040,70058,Blue,1,25001,25986,985
2022-04-02,70042,70058,Blue,1,19922,20688,766
2022-03-25,70046,70056,Blue,1,72846,73432,586
2022-01-24,70039,70838,Blue,0,58653,58689,36
2022-08-20,70042,70060,Blue,1,35248,36335,1087
2022-10-24,70040,70042,Blue,1,34987,35019,32
2022-09-09,70052,70058,Blue,1,73164,73429,265
2022-10-17,70050,70058,Blue,1,59903,60323,420
2022-03-15,70055,70053,Blue,0,60383,60432,49
2022-03-18,70052,70056,Blue,1,54463,54595,132
2022-09-08,70056,70058,Blue,1,56029,56098,69
2022-09-23,70049,70047,Blue,0,37453,37512,59
2022-04-19,70055,70838,Blue,0,73938,75018,1080
2022-06-26,70050,70060,Blue,1,42360,42893,533
2022-12-03,70051,70045,Blue,0,72299,72681,382
2022-06-03,70042,70048,Blue,1,58119,58429,310
2022-03-30,70043,70041,Blue,0,55930,55958,28
2022-11-02,70045,70043,Blue,0,58435,58523,88
2022-11-12,70047,70045,Blue,0,30967,31058,91
2022-02-10,70055,70053,Blue,0,34046,34109,63
2022-09-29,70041,70039,Blue,0,42623,42658,35
2022-03-31,70046,70048,Blue,1,27315,27418,103
2022-03-20,70040,70058,Blue,1,53991,54961,970
2022-10-18,70040,70058,Blue,1,27175,28178,1003
2022-06-24,70047,70045,Blue,0,64916,65030,114
2022-02-08,70042,70044,Blue,1,65125,65154,29
2022-09-29,70052,70058,Blue,1,50440,50679,239
2022-12-12,70040,70046,Blue,1,48775,49029,254
2022-06-12,70038,70048,Blue,1,60746,61208,462
2022-05-29,70047,70043,Blue,0,42513,42840,327
2022-04-24,70049,70039,Blue,0,67798,68255,457
2022-07-06,70046,70056,Blue,1,50609,51342,733
2022-12-28,70051,70039,Blue,0,22654,23335,681
2022-07-28,70042,70044,Blue,1,80519,80550,31
2022-04-08,70051,70049,Blue,0,67156,67258,102
2022-10-08,70056,70060,Blue,1,50009,50175,166
2022-06-20,70049,70045,Blue,0,84662,84942,280
2022-11-30,70044,70058,Blue,1,27514,28292,778
2022-02-28,70043,70039,Blue,0,41943,42051,108
2022-11-29,70046,70060,Blue,1,35680,36430,750
2022-11-11,70059,70051,Blue,0,37977,38327,350
2022-06-21,70053,70045,Blue,0,53911,54325,414
2022-04-01,70045,70039,Blue,0,68173,68409,236
2022-09-28,70051,70043,Blue,0,85308,85804,496
2022-04-26,70057,70047,Blue,0,87466,87944,478
2022-11-18,70044,70054,Blue,1,45637,46607,970
2022-12-22,70057,70045,Blue,0,35698,36369,671
2022-11-30,70046,70058,Blue,1,56891,57548,657
2022-03-29,70040,70054,Blue,1,27929,28741,812
2022-07-04,70055,70047,Blue,0,45078,45472,394
2022-11-23,70048,70054,Blue,1,50794,51111,317
2022-02-05,70059,70049,Blue,0,36793,37336,543
2022-07-06,70044,70048,Blue,1,83920,84155,235
2022-07-23,70054,70058,Blue,1,65619,65775,156
2022-02-03,70044,70050,Blue,1,24797,25130,333
2022-03-17,70038,70054,Blue,1,70937,71787,850
2022-01-01,70040,70060,Blue,1,24635,25669,1034
2022-12-07,70042,70050,Blue,1,88366,88821,455
2022-03-30,70042,70048,Blue,1,55791,56120,329
2022-04-24,70044,70048,Blue,1,33335,33562,227
2022-05-13,70051,70049,Blue,0,45766,45872,106
2022-02-04,70059,70041,Blue,0,66496,67532,1036
2022-06-15,70059,70838,Blue,0,66794,67919,1125
2022-01-27,70049,70043,Blue,0,67279,67667,388
2022-01-24,70047,70039,Blue,0,72675,73084,409
2022-10-31,70050,70052,Blue,1,38384,38496,112
2022-12-29,70049,70039,Blue,0,75532,76002,470
2022-01-09,70047,70045,Blue,0,58772,58872,100
2022-04-21,70054,70056,Blue,1,60665,60718,53
2022-12-09,70047,70838,Blue,0,40210,40738,528
2022-03-09,70040,70054,Blue,1,67738,68533,795
2022-02-21,70059,70055,Blue,0,76471,76616,145
2022-07-15,70043,70041,Blue,0,23115,23145,30
2022-12-20,70040,70044,Blue,1,38062,38187,125
2022-02-11,70055,70043,Blue,0,69267,69968,701
2022-12-20,70048,70058,Blue,1,56488,56968,480
2022-09-06,70046,70060,Blue,1,72636,73403,767
2022-07-08,70044,70054,Blue,1,33934,34592,658
2022-12-10,70045,70043,Blue,0,44069,44164,95
2022-02-13,70044,70046,Blue,1,67423,67531,108
2022-01-31,70047,70045,Blue,0,74459,74556,97
2022-04-08,70038,70040,Blue,1,21573,21593,20
2022-02-25,70049,70047,Blue,0,67663,67717,54
2022-07-30,70059,70057,Blue,0,26000,26035,35
2022-08-23,70044,70058,Blue,1,70074,70926,852
2022-12-18,70042,70052,Blue,1,74444,75097,653
2022-09-17,70051,70039,Blue,0,63629,64381,752
2022-09-10,70057,70051,Blue,0,26068,26316,248
2022-03-04,70055,70838,Blue,0,86476,87348,872
2022-04-01,70042,70046,Blue,1,70788,70963,175
2022-06-11,70054,70060,Blue,1,76442,76716,274
2022-06-21,70046,70060,Blue,1,33475,34411,936
2022-06-22,70049,70045,Blue,0,78977,79172,195
2022-09-04,70044,70050,Blue,1,35433,35784,351
2022-07-11,70059,70045,Blue,0,32245,32959,714
2022-10-18,70053,70047,Blue,0,82282,82541,259
2022-07-21,70040,70052,Blue,1,43570,44285,715
2022-03-02,70042,70060,Blue,1,56410,57609,1199
2022-12-07,70047,70043,Blue,0,69762,69991,229
2022-02-19,70038,70042,Blue,1,78637,78746,109
2022-02-08,70042,70048,Blue,1,36340,36669,329
2022-03-31,70058,70060,Blue,1,27442,27519,77
2022-02-15,70045,70043,Blue,0,72298,72401,103
2022-09-28,70050,70054,Blue,1,49960,50171,211
2022-06-18,70044,70056,Blue,1,60751,61566,815
2022-04-12,70043,70039,Blue,0,55113,55228,115
2022-07-06,70055,70041,Blue,0,29939,30782,843
2022-05-20,70057,70051,Blue,0,32426,32677,251
2022-05-24,70038,70050,Blue,1,21007,21660,653
2022-04-11,70040,70060,Blue,1,54613,56195,1582
2022-09-28,70045,70041,Blue,0,54891,55071,180
2022-12-07,70057,70051,Blue,0,35378,35622,244
2022-11-16,70057,70049,Blue,0,67653,68025,372
2022-07-26,70040,70054,Blue,1,61919,62774,855
2022-05-10,70059,70053,Blue,0,78676,78912,236
2022-06-20,70057,70049,Blue,0,65431,65832,401
2022-05-18,70057,70055,Blue,0,37495,37565,70
2022-07-21,70049,70045,Blue,0,34965,35200,235
2022-06-04,70038,70042,Blue,1,63260,63397,137
2022-02-18,70051,70838,Blue,0,20647,21424,777
2022-08-11,70040,70052,Blue,1,73707,74351,644
2022-09-08,70045,70039,Blue,0,60560,60849,289
2022-05-28,70043,70039,Blue,0,45343,45459,116
2022-08-14,70045,70039,Blue,0,88958,89628,670
2022-08-20,70044,70048,Blue,1,78846,79086,240
2022-09-10,70052,70056,Blue,1,42360,42503,143
2022-03-15,70052,70056,Blue,1,26929,27056,127
2022-03-15,70057,70049,Blue,0,27935,28315,380
2022-07-07,70045,70041,Blue,0,50478,50688,210
2022-11-03,70042,70054,Blue,1,37433,38198,765
2022-08-21,70057,70049,Blue,0,23156,23529,373
2022-07-22,70044,70054,Blue,1,76170,76806,636
2022-04-19,70042,70052,Blue,1,31996,32623,627
2022-12-09,70038,70054,Blue,1,27468,28325,857
2022-04-12,70047,70045,Blue,0,59651,59758,107
2022-12-28,70046,70058,Blue,1,68219,68904,685
2022-01-18,70042,70060,Blue,1,56184,57235,1051
2022-02-11,70059,70041,Blue,0,62292,63338,1046
2022-01-11,70055,70051,Blue,0,44083,44306,223
2022-09-02,70042,70044,Blue,1,75437,75475,38
2022-07-15,70040,70042,Blue,1,39159,39194,35
2022-01-25,70057,70043,Blue,0,77247,77944,697
2022-02-19,70051,70043,Blue,0,57208,57738,530
2022-08-12,70043,70039,Blue,0,38220,38350,130
2022-12-22,70053,70049,Blue,0,63276,63469,193
2022-10-27,70056,70060,Blue,1,30547,30740,193
2022-01-08,70044,70046,Blue,1,43896,44001,105
2022-10-01,70057,70045,Blue,0,64385,65028,643
2022-06-21,70054,70060,Blue,1,77231,77507,276
2022-05-19,70048,70050,Blue,1,33334,33423,89
2022-06-13,70053,70041,Blue,0,66396,67057,661
2022-09-30,70048,70060,Blue,1,22816,23431,615
2022-09-22,70059,70055,Blue,0,24497,24651,154
2022-05-16,70057,70047,Blue,0,70408,70971,563
2022-06-17,70057,70838,Blue,0,60276,61370,1094
2022-10-13,70044,70048,Blue,1,73832,74052,220
2022-07-14,70059,70053,Blue,0,21751,22011,260
2022-07-10,70057,70838,Blue,0,60409,61477,1068
2022-06-09,70059,70041,Blue,0,77178,78160,982
2022-09-03,70055,70838,Blue,0,61265,62163,898
2022-03-05,70045,70043,Blue,0,62915,63005,90
2022-09-14,70058,70060,Blue,1,25182,25242,60
2022-07-12,70056,70058,Blue,1,41941,42014,73
2022-05-19,70047,70045,Blue,0,72131,72298,167
2022-03-22,70044,70046,Blue,1,65473,65578,105
2022-11-11,70050,70052,Blue,1,70101,70279,178
2022-05-19,70048,70056,Blue,1,66564,66954,390
2022-04-18,70057,70045,Blue,0,65072,65783,711
2022-01-03,70054,70060,Blue,1,47809,48079,270
2022-07-12,70053,70838,Blue,0,19825,20869,1044
2022-12-26,70040,70046,Blue,1,55959,56252,293
2022-10-21,70059,70057,Blue,0,52222,52257,35
2022-06-12,70056,70058,Blue,1,56885,56957,72
2022-03-21,70059,70057,Blue,0,80597,80636,39
2022-02-11,70041,70039,Blue,0,54876,54913,37
2022-10-06,70047,70838,Blue,0,33760,34256,496
2022-02-24,70046,70050,Blue,1,27639,27854,215
2022-05-18,70044,70060,Blue,1,53903,54914,1011
2022-09-08,70047,70045,Blue,0,40823,40922,99
2022-09-28,70038,70054,Blue,1,66064,66951,887
2022-09-24,70057,70047,Blue,0,75211,75696,485
2022-11-27,70046,70048,Blue,1,38679,38748,69
2022-03-06,70040,70060,Blue,1,26960,27949,989
2022-02-05,70047,70039,Blue,0,48814,49273,459
2022-08-16,70040,70046,Blue,1,69158,69410,252
2022-04-20,70055,70053,Blue,0,35404,35451,47
2022-07-15,70051,70041,Blue,0,24242,24843,601
2022-02-03,70045,70041,Blue,0,87702,87948,246
2022-12-09,70040,70042,Blue,1,81450,81482,32
2022-03-14,70042,70046,Blue,1,66916,67099,183
2022-10-10,70046,70060,Blue,1,25210,25973,763
2022-08-11,70055,70051,Blue,0,61517,61652,135
2022-01-27,70038,70060,Blue,1,38069,39265,1196
2022-03-29,70059,70838,Blue,0,40464,41680,1216
2022-10-30,70052,70056,Blue,1,75517,75659,142
2022-11-03,70049,70039,Blue,0,55088,55726,638
2022-12-05,70040,70046,Blue,1,25549,25801,252
2022-11-27,70051,70047,Blue,0,71460,71651,191
2022-06-08,70047,70043,Blue,0,53206,53532,326
2022-11-10,70057,70053,Blue,0,54543,54695,152
2022-11-16,70041,70039,Blue,0,24738,24771,33
2022-08-16,70040,70048,Blue,1,79702,80115,413
2022-01-20,70057,70041,Blue,0,27944,28989,1045
2022-03-28,70057,70047,Blue,0,33027,33563,536
2022-03-14,70042,70048,Blue,1,28289,28613,324
2022-01-07,70055,70838,Blue,0,55055,56091,1036
2022-10-06,70051,70049,Blue,0,44598,44697,99
2022-03-10,70056,70058,Blue,1,43841,43912,71
2022-09-11,70046,70050,Blue,1,26830,27013,183
2022-06-11,70038,70044,Blue,1,24971,25137,166
2022-07-04,70042,70052,Blue,1,29792,30402,610
2022-04-07,70043,70041,Blue,0,26687,26719,32
2022-01-26,70050,70054,Blue,1,66093,66273,180
2022-07-09,70051,70041,Blue,0,26889,27459,570
2022-10-31,70059,70051,Blue,0,60912,61230,318
2022-01-15,70047,70041,Blue,0,71611,72018,407
2022-08-22,70051,70838,Blue,0,36283,37093,810
2022-07-27,70046,70058,Blue,1,55926,56581,655
2022-04-10,70045,70043,Blue,0,67017,67123,106
2022-08-03,70042,70058,Blue,1,38539,41070,2531
2022-02-06,70053,70047,Blue,0,66542,66816,274
2022-12-07,70057,70047,Blue,0,31373,31892,519
2022-03-16,70049,70039,Blue,0,78922,79408,486
2022-11-14,70059,70053,Blue,0,78436,78654,218
2022-06-25,70040,70046,Blue,1,32982,33231,249
2022-08-02,70049,70043,Blue,0,48414,48766,352
2022-12-12,70044,70054,Blue,1,58496,59111,615
2022-11-29,70053,70045,Blue,0,77640,78061,421
2022-03-22,70057,70838,Blue,0,65989,67130,1141
2022-04-11,70049,70041,Blue,0,29336,29809,473
2022-02-25,70046,70058,Blue,1,80151,80802,651
2022-02-10,70044,70050,Blue,1,83343,83684,341
2022-03-02,70049,70045,Blue,0,74898,75111,213
2022-01-14,70039,70838,Blue,0,50969,51012,43
2022-07-13,70048,70058,Blue,1,29277,29818,541
2022-04-21,70038,70044,Blue,1,23057,23219,162
2022-11-03,70055,70041,Blue,0,56004,56848,844
2022-02-27,70043,70039,Blue,0,66063,66161,98
2022-09-26,70054,70060,Blue,1,29853,30105,252
2022-10-15,70059,70051,Blue,0,25449,25762,313
2022-10-19,70053,70049,Blue,0,68930,69135,205
2022-04-08,70055,70049,Blue,0,54380,54652,272
2022-11-11,70055,70043,Blue,0,69881,70625,744
2022-08-07,70049,70041,Blue,0,41334,41779,445
2022-10-11,70053,70838,Blue,0,28341,29263,922
2022-09-10,70044,70060,Blue,1,32026,32886,860
2022-07-12,70053,70043,Blue,0,79781,80437,656
2022-03-10,70054,70058,Blue,1,58033,58188,155
2022-03-22,70048,70050,Blue,1,38507,38565,58
2022-09-01,70057,70053,Blue,0,59373,59528,155
2022-04-09,70046,70058,Blue,1,64049,64673,624
2022-03-11,70048,70054,Blue,1,44101,44487,386
2022-10-26,70044,70052,Blue,1,60540,61017,477
2022-11-06,70038,70048,Blue,1,60726,61183,457
2022-06-09,70054,70056,Blue,1,35708,35794,86
2022-03-07,70040,70054,Blue,1,64118,64909,791
2022-03-22,70053,70047,Blue,0,46879,47168,289
2022-10-19,70051,70041,Blue,0,69977,70554,577
2022-07-07,70059,70051,Blue,0,61599,61936,337
2022-01-18,70059,70053,Blue,0,62894,63162,268
2022-09-23,70048,70050,Blue,1,31951,32007,56
2022-07-16,70054,70058,Blue,1,66714,66869,155
2022-02-18,70052,70056,Blue,1,34330,34476,146
2022-03-18,70055,70039,Blue,0,67428,68217,789
2022-10-04,70053,70049,Blue,0,59560,59762,202
2022-12-23,70055,70039,Blue,0,37826,38937,1111
2022-11-01,70040,70042,Blue,1,51877,51909,32
2022-06-03,70044,70048,Blue,1,62541,62826,285
2022-09-27,70042,70056,Blue,1,58433,59169,736
2022-12-02,70059,70045,Blue,0,60313,61037,724
2022-07-03,70040,70050,Blue,1,46241,46813,572
2022-08-05,70043,70838,Blue,0,28908,29104,196
2022-08-19,70038,70056,Blue,1,55291,56274,983
2022-01-27,70057,70047,Blue,0,26313,26858,545
2022-07-04,70057,70045,Blue,0,78795,79589,794
2022-08-30,70038,70052,Blue,1,31542,32255,713
2022-01-27,70053,70045,Blue,0,85440,85869,429
2022-02-08,70051,70039,Blue,0,35070,35737,667
2022-06-09,70053,70039,Blue,0,36702,37489,787
2022-05-01,70059,70057,Blue,0,44488,44525,37
2022-08-25,70040,70044,Blue,1,34691,34835,144
2022-11-23,70048,70052,Blue,1,40329,40587,258
2022-01-28,70059,70057,Blue,0,82329,82365,36
2022-11-14,70043,70039,Blue,0,26546,26665,119
2022-03-24,70038,70042,Blue,1,22753,22847,94
2022-02-23,70042,70046,Blue,1,69129,69308,179
2022-06-24,70055,70039,Blue,0,52706,53686,980
2022-08-09,70042,70060,Blue,1,24078,25136,1058
2022-11-03,70049,70043,Blue,0,74308,74629,321
2022-10-13,70048,70050,Blue,1,82069,82128,59
2022-03-29,70059,70051,Blue,0,28762,29105,343
2022-03-23,70054,70056,Blue,1,53227,53273,46
2022-12-08,70049,70838,Blue,0,44221,44812,591
2022-03-04,70057,70055,Blue,0,34226,34294,68
2022-04-26,70057,70051,Blue,0,69995,70264,269
2022-06-09,70047,70041,Blue,0,41104,41478,374
2022-12-20,70048,70060,Blue,1,53313,54051,738
2022-11-13,70053,70045,Blue,0,76779,77207,428
2022-08-08,70055,70049,Blue,0,28276,28572,296
2022-03-08,70053,70045,Blue,0,65257,65684,427
2022-12-23,70057,70045,Blue,0,74676,75409,733
2022-03-20,70051,70041,Blue,0,22645,23212,567
2022-10-12,70053,70051,Blue,0,30874,30921,47
2022-04-10,70044,70050,Blue,1,66947,67268,321
2022-05-18,70040,70044,Blue,1,85433,85554,121
2022-07-07,70046,70050,Blue,1,38294,38492,198
2022-03-25,70040,70060,Blue,1,63792,64999,1207
2022-08-25,70059,70053,Blue,0,21402,21636,234
2022-09-24,70048,70058,Blue,1,54453,55028,575
2022-01-15,70038,70050,Blue,1,70737,71664,927
2022-03-10,70050,70052,Blue,1,31487,31608,121
2022-01-04,70042,70050,Blue,1,47760,48169,409
2022-06-16,70058,70060,Blue,1,36904,37010,106
2022-01-29,70055,70047,Blue,0,27772,28409,637
2022-11-16,70059,70047,Blue,0,54614,55212,598
2022-11-06,70047,70045,Blue,0,88894,88976,82
2022-08-30,70045,70039,Blue,0,21708,21974,266
2022-01-10,70057,70055,Blue,0,80148,80217,69
2022-01-27,70042,70050,Blue,1,59713,60172,459
2022-01-04,70047,70045,Blue,0,41257,41352,95
2022-12-07,70038,70050,Blue,1,48672,49208,536
2022-07-09,70055,70838,Blue,0,65057,65982,925
2022-07-08,70044,70050,Blue,1,72397,72750,353
2022-03-15,70049,70838,Blue,0,20767,21562,795
2022-12-12,70052,70058,Blue,1,85065,85319,254
2022-09-06,70055,70051,Blue,0,69517,69672,155
2022-12-16,70057,70045,Blue,0,43792,44436,644
2022-03-02,70041,70838,Blue,0,71433,71540,107
2022-10-13,70059,70057,Blue,0,57760,57794,34
2022-07-01,70042,70058,Blue,1,83518,84510,992
2022-05-21,70053,70045,Blue,0,68563,69166,603
2022-02-22,70044,70052,Blue,1,57505,58042,537
2022-10-25,70055,70039,Blue,0,23629,24574,945
2022-11-16,70040,70050,Blue,1,65426,65961,535
2022-02-01,70053,70045,Blue,0,34467,34941,474
2022-06-02,70048,70052,Blue,1,47375,47655,280
2022-12-21,70048,70052,Blue,1,62260,62464,204
2022-12-17,70038,70054,Blue,1,51257,52050,793
2022-09-30,70053,70039,Blue,0,33349,34120,771
2022-02-02,70050,70054,Blue,1,57949,58184,235
2022-05-22,70049,70043,Blue,0,37679,38161,482
2022-02-07,70038,70050,Blue,1,43616,44212,596
2022-11-13,70038,70052,Blue,1,62893,63589,696
2022-03-17,70055,70051,Blue,0,28958,29097,139
2022-11-11,70049,70043,Blue,0,57141,57469,328
2022-05-18,70042,70060,Blue,1,33686,34848,1162
2022-10-22,70051,70838,Blue,0,53921,54730,809
2022-05-19,70055,70053,Blue,0,54680,54727,47
2022-04-30,70053,70049,Blue,0,24736,24940,204
2022-05-19,70046,70056,Blue,1,29704,30243,539
2022-10-27,70053,70041,Blue,0,77797,78439,642
2022-01-13,70057,70041,Blue,0,72137,72982,845
2022-01-28,70059,70051,Blue,0,21673,22030,357
2022-07-14,70044,70046,Blue,1,59634,59765,131
2022-03-14,70054,70056,Blue,1,31981,32027,46
2022-03-23,70053,70838,Blue,0,83736,84481,745
2022-09-09,70054,70058,Blue,1,38729,38883,154
2022-01-09,70055,70838,Blue,0,48079,48936,857
2022-09-05,70055,70045,Blue,0,67539,68080,541
2022-03-09,70048,70050,Blue,1,81407,81467,60
2022-04-06,70040,70052,Blue,1,39723,40453,730
2022-11-09,70045,70041,Blue,0,74035,74203,168
2022-04-09,70049,70043,Blue,0,41629,42025,396
2022-05-21,70038,70058,Blue,1,50169,51269,1100
2022-07-28,70053,70041,Blue,0,29989,30638,649
2022-04-18,70051,70838,Blue,0,36234,37089,855
2022-01-02,70050,70054,Blue,1,32104,32288,184
2022-02-14,70045,70043,Blue,0,74136,74254,118
2022-06-25,70038,70058,Blue,1,41589,42679,1090
2022-01-15,70059,70055,Blue,0,35719,35865,146
2022-04-18,70052,70060,Blue,1,57304,57768,464
2022-01-21,70052,70054,Blue,1,68078,68123,45
2022-01-03,70045,70838,Blue,0,61716,62480,764
2022-12-26,70042,70054,Blue,1,26252,26871,619
2022-12-29,70041,70039,Blue,0,22195,22231,36
2022-08-24,70055,70051,Blue,0,33678,33820,142
2022-06-10,70044,70060,Blue,1,22060,23245,1185
2022-10-18,70040,70048,Blue,1,24876,25270,394
2022-08-29,70057,70055,Blue,0,52053,52123,70
2022-12-24,70047,70039,Blue,0,38626,39032,406
2022-06-05,70045,70039,Blue,0,66027,66323,296
2022-01-14,70038,70060,Blue,1,33248,34368,1120
2022-10-11,70059,70055,Blue,0,76470,76614,144
2022-05-08,70052,70058,Blue,1,47402,47687,285
2022-04-24,70043,70041,Blue,0,55286,55315,29
2022-11-21,70045,70041,Blue,0,60733,60897,164
2022-07-15,70049,70041,Blue,0,48864,49332,468
2022-01-01,70059,70838,Blue,0,69059,70150,1091
2022-07-15,70044,70048,Blue,1,32725,32980,255
2022-03-23,70059,70049,Blue,0,61996,62452,456
2022-02-05,70040,70056,Blue,1,44292,45094,802
2022-07-13,70046,70048,Blue,1,24011,24106,95
2022-07-02,70038,70044,Blue,1,35592,35753,161
2022-03-18,70055,70053,Blue,0,54832,54877,45
2022-03-26,70038,70058,Blue,1,39402,40459,1057
2022-07-13,70055,70041,Blue,0,31342,32129,787
2022-01-11,70057,70045,Blue,0,32208,32894,686
2022-08-06,70042,70060,Blue,1,28701,29630,929
2022-09-06,70057,70039,Blue,0,39563,40477,914
2022-12-17,70044,70060,Blue,1,61741,62684,943
2022-03-11,70040,70046,Blue,1,43030,43274,244
2022-02-25,70043,70039,Blue,0,63599,63713,114
2022-09-06,70048,70050,Blue,1,55067,55124,57
2022-06-15,70046,70058,Blue,1,21420,22067,647
2022-08-30,70054,70056,Blue,1,29040,29086,46
2022-11-19,70049,70041,Blue,0,63388,63800,412
2022-10-01,70050,70054,Blue,1,49282,49477,195
2022-10-01,70038,70044,Blue,1,64747,64938,191
2022-10-11,70059,70057,Blue,0,33496,33532,36
2022-04-11,70046,70056,Blue,1,33279,33809,530
2022-08-08,70047,70041,Blue,0,23179,23502,323
2022-08-12,70055,70047,Blue,0,84157,84555,398
2022-03-12,70040,70046,Blue,1,63187,63515,328
2022-07-18,70038,70060,Blue,1,27319,28413,1094
2022-12-01,70055,70049,Blue,0,58442,58771,329
2022-11-05,70038,70042,Blue,1,33432,33519,87
2022-01-10,70057,70049,Blue,0,69163,69572,409
2022-07-21,70046,70048,Blue,1,76416,76510,94
2022-01-07,70047,70041,Blue,0,23790,24125,335
2022-07-15,70054,70056,Blue,1,44394,44441,47
2022-05-19,70053,70043,Blue,0,63461,64239,778
2022-06-28,70046,70050,Blue,1,77278,77468,190
2022-05-10,70057,70055,Blue,0,23501,23570,69
2022-11-11,70047,70043,Blue,0,73989,74231,242
2022-02-05,70047,70045,Blue,0,34700,34798,98
2022-11-30,70049,70838,Blue,0,72740,73305,565
2022-05-18,70040,70050,Blue,1,77052,77575,523
2022-10-31,70057,70055,Blue,0,39577,39646,69
2022-02-14,70040,70060,Blue,1,37439,38501,1062
2022-01-23,70051,70041,Blue,0,64496,65116,620
2022-02-07,70051,70043,Blue,0,19905,20404,499
2022-06-16,70038,70056,Blue,1,51314,52218,904
2022-12-05,70048,70054,Blue,1,48777,49097,320
2022-09-25,70044,70046,Blue,1,28793,28892,99
2022-08-08,70059,70047,Blue,0,55714,56388,674
2022-10-03,70042,70048,Blue,1,58244,58570,326
2022-10-17,70053,70047,Blue,0,42909,43233,324
2022-09-16,70042,70044,Blue,1,35430,35460,30
2022-03-16,70046,70058,Blue,1,85225,85824,599
2022-12-08,70053,70838,Blue,0,37241,38194,953
2022-07-19,70053,70838,Blue,0,74329,75192,863
2022-09-26,70040,70046,Blue,1,60770,61085,315
2022-07-23,70048,70056,Blue,1,50296,50724,428
2022-06-12,70059,70051,Blue,0,24714,25049,335
2022-09-30,70055,70049,Blue,0,31165,31472,307
2022-04-03,70059,70053,Blue,0,76597,76826,229
2022-09-13,70057,70047,Blue,0,20016,20583,567
2022-10-26,70050,70058,Blue,1,80755,81155,400
2022-01-03,70049,70045,Blue,0,35255,35451,196
2022-08-21,70056,70058,Blue,1,56814,56906,92
2022-07-14,70053,70051,Blue,0,80229,80286,57
2022-07-14,70040,70060,Blue,1,26595,27834,1239
2022-12-12,70055,70838,Blue,0,83242,84130,888
2022-07-15,70051,70049,Blue,0,69693,69795,102
2022-10-07,70040,70052,Blue,1,29895,30543,648
2022-08-10,70051,70039,Blue,0,36752,37440,688
2022-09-08,70044,70048,Blue,1,34316,34586,270
2022-11-15,70052,70056,Blue,1,72841,72974,133
2022-12-14,70051,70049,Blue,0,24632,24751,119
2022-07-16,70042,70058,Blue,1,83147,84105,958
2022-11-08,70051,70047,Blue,0,24945,25150,205
2022-01-31,70053,70039,Blue,0,63421,64265,844
2022-04-12,70044,70048,Blue,1,71129,71356,227
2022-11-22,70038,70044,Blue,1,59474,59749,275
2022-02-02,70046,70060,Blue,1,34604,35379,775
2022-01-03,70057,70838,Blue,0,21785,22878,1093
2022-09-14,70053,70043,Blue,0,61835,62445,610
2022-04-18,70040,70060,Blue,1,25499,26569,1070
2022-04-07,70038,70056,Blue,1,42967,43865,898
2022-08-19,70046,70048,Blue,1,50719,50803,84
2022-07-11,70057,70039,Blue,0,50676,51817,1141
2022-06-14,70047,70043,Blue,0,18973,19290,317
2022-03-20,70059,70047,Blue,0,42635,43272,637
2022-12-29,70040,70046,Blue,1,33426,33670,244
2022-10-17,70052,70056,Blue,1,49438,49582,144
2022-11-09,70053,70049,Blue,0,29142,29349,207
2022-10-29,70038,70060,Blue,1,29680,30784,1104
2022-08-24,70038,70056,Blue,1,46851,47815,964
2022-02-12,70059,70039,Blue,0,65417,66417,1000
2022-10-20,70044,70052,Blue,1,79275,79758,483
2022-07-06,70041,70039,Blue,0,65172,65205,33
2022-10-29,70057,70045,Blue,0,32018,32622,604
2022-06-27,70059,70045,Blue,0,43883,44578,695
2022-02-20,70038,70056,Blue,1,52091,52973,882
2022-02-18,70059,70043,Blue,0,28755,29765,1010
2022-04-20,70041,70039,Blue,0,70515,70549,34
2022-08-29,70038,70040,Blue,1,59969,59984,15
2022-06-13,70051,70049,Blue,0,28264,28365,101
2022-11-02,70055,70043,Blue,0,59489,60129,640
2022-02-14,70051,70838,Blue,0,44737,45478,741
2022-08-13,70053,70051,Blue,0,42483,42543,60
2022-03-28,70059,70047,Blue,0,27858,28507,649
2022-02-14,70044,70050,Blue,1,33150,33471,321
2022-10-30,70038,70056,Blue,1,38360,39227,867
2022-08-02,70046,70058,Blue,1,58717,59391,674
2022-08-31,70045,70043,Blue,0,39906,40008,102
2022-09-04,70057,70838,Blue,0,78997,80081,1084
2022-03-30,70059,70838,Blue,0,55693,56749,1056
2022-08-04,70057,70838,Blue,0,42700,43779,1079
2022-01-25,70040,70044,Blue,1,30009,30125,116
2022-01-03,70045,70838,Blue,0,61161,61844,683
2022-07-20,70048,70052,Blue,1,41378,41600,222
2022-06-30,70059,70053,Blue,0,47654,47906,252
2022-04-14,70044,70052,Blue,1,52324,52828,504
2022-07-30,70042,70054,Blue,1,70877,71511,634
2022-09-23,70042,70044,Blue,1,64533,64561,28
2022-10-11,70057,70041,Blue,0,53149,54055,906
2022-12-03,70042,70050,Blue,1,39498,39884,386
2022-06-22,70051,70838,Blue,0,69430,70197,767
2022-02-15,70049,70838,Blue,0,46652,47318,666
2022-09-12,70049,70039,Blue,0,23131,23731,600
2022-01-05,70038,70048,Blue,1,32369,32810,441
2022-08-26,70039,70838,Blue,0,75967,76004,37
2022-06-27,70043,70039,Blue,0,63765,63890,125
2022-05-20,70059,70041,Blue,0,69976,71011,1035
2022-05-22,70046,70052,Blue,1,68352,68845,493
2022-09-26,70050,70056,Blue,1,50865,51139,274
2022-07-09,70038,70048,Blue,1,33738,34250,512
2022-07-30,70045,70041,Blue,0,73712,73923,211
2022-06-24,70052,70056,Blue,1,63452,63626,174
2022-03-15,70038,70042,Blue,1,35926,36029,103
2022-11-10,70053,70051,Blue,0,35084,35152,68
2022-07-18,70045,70043,Blue,0,31273,31367,94
2022-02-28,70047,70041,Blue,0,32990,33335,345
2022-08-05,70059,70053,Blue,0,26776,26999,223
2022-04-11,70044,70046,Blue,1,67854,67959,105
2022-01-07,70057,70041,Blue,0,20682,21577,895
2022-03-02,70057,70053,Blue,0,34774,34961,187
2022-11-18,70048,70058,Blue,1,39457,40001,544
2022-03-29,70040,70046,Blue,1,72102,72376,274
2022-09-04,70052,70056,Blue,1,41795,41933,138
2022-12-10,70054,70056,Blue,1,39716,39762,46
2022-02-24,70043,70838,Blue,0,28217,28477,260
2022-09-22,70044,70058,Blue,1,58023,58840,817
2022-07-05,70040,70060,Blue,1,31073,32168,1095
2022-07-28,70057,70838,Blue,0,50018,51477,1459
2022-01-19,70042,70052,Blue,1,56150,56759,609
2022-01-25,70057,70047,Blue,0,71625,72208,583
2022-05-02,70055,70053,Blue,0,27411,27459,48
2022-07-20,70059,70047,Blue,0,71758,72314,556
2022-05-26,70047,70041,Blue,0,32286,32664,378
2022-07-24,70050,70052,Blue,1,52186,52293,107
2022-12-14,70059,70049,Blue,0,81192,81684,492
2022-04-10,70041,70838,Blue,0,79204,79320,116
2022-06-22,70057,70039,Blue,0,41314,42364,1050
2022-09-20,70040,70046,Blue,1,29143,29403,260
2022-03-02,70046,70050,Blue,1,67141,67337,196
2022-12-25,70042,70044,Blue,1,65744,65776,32
2022-07-20,70040,70042,Blue,1,65832,65869,37
2022-10-16,70059,70053,Blue,0,42796,43028,232
2022-03-16,70057,70047,Blue,0,41614,42112,498
2022-08-18,70049,70047,Blue,0,79922,79975,53
2022-04-02,70055,70039,Blue,0,34282,35098,816
2022-03-01,70059,70039,Blue,0,76047,77006,959
2022-01-26,70042,70058,Blue,1,26195,27082,887
2022-12-26,70042,70054,Blue,1,57659,58405,746
2022-09-22,70051,70049,Blue,0,53657,53757,100
2022-06-20,70049,70043,Blue,0,53409,53788,379
2022-02-12,70040,70050,Blue,1,84862,85413,551
2022-08-21,70051,70041,Blue,0,65121,65696,575
2022-06-17,70051,70041,Blue,0,48692,49369,677
2022-12-12,70038,70056,Blue,1,29685,30555,870
2022-03-09,70055,70053,Blue,0,27172,27230,58
2022-11-27,70057,70043,Blue,0,61506,62261,755
2022-08-08,70055,70043,Blue,0,38862,39588,726
2022-08-31,70042,70052,Blue,1,32090,32617,527
2022-02-28,70052,70056,Blue,1,58215,58358,143
2022-01-13,70052,70054,Blue,1,49406,49460,54
2022-03-01,70056,70060,Blue,1,85106,85277,171
2022-05-06,70055,70053,Blue,0,20316,20363,47
2022-03-16,70059,70051,Blue,0,76039,76399,360
2022-08-02,70046,70050,Blue,1,64385,64570,185
2022-12-27,70040,70048,Blue,1,25929,26293,364
2022-02-14,70048,70052,Blue,1,55318,55529,211
2022-09-26,70046,70056,Blue,1,25890,26405,515
2022-04-11,70059,70049,Blue,0,56295,56749,454
2022-09-08,70042,70046,Blue,1,34234,34433,199
2022-05-25,70049,70838,Blue,0,69832,70455,623
2022-09-08,70057,70039,Blue,0,28957,29963,1006
2022-01-02,70040,70058,Blue,1,67872,68827,955
2022-06-23,70059,70041,Blue,0,47592,48521,929
2022-09-15,70053,70043,Blue,0,23301,23920,619
2022-02-24,70053,70049,Blue,0,78599,78847,248
2022-12-07,70057,70053,Blue,0,53163,53324,161
2022-03-07,70044,70052,Blue,1,64276,64804,528
2022-01-18,70052,70056,Blue,1,81198,81341,143
2022-03-09,70054,70060,Blue,1,50165,50441,276
2022-01-25,70046,70058,Blue,1,65713,66390,677
2022-02-01,70057,70051,Blue,0,26345,26648,303
2022-09-30,70053,70043,Blue,0,31246,31893,647
2022-10-24,70053,70043,Blue,0,48165,48846,681
2022-06-27,70059,70838,Blue,0,27631,28813,1182
2022-11-14,70048,70054,Blue,1,61198,61500,302
2022-11-01,70058,70060,Blue,1,67993,68055,62
2022-07-16,70046,70054,Blue,1,50592,51090,498
2022-08-19,70057,70055,Blue,0,42982,43053,71
2022-03-22,70058,70060,Blue,1,39623,39706,83
2022-08-31,70038,70042,Blue,1,35776,35867,91
2022-11-29,70043,70041,Blue,0,79897,79926,29
2022-09-29,70055,70043,Blue,0,60451,61072,621
2022-11-09,70055,70045,Blue,0,45809,46339,530
2022-03-19,70059,70055,Blue,0,22153,22302,149
2022-04-22,70048,70058,Blue,1,68554,69093,539
2022-09-27,70050,70052,Blue,1,66437,66549,112
2022-02-08,70038,70048,Blue,1,54311,54814,503
2022-06-25,70038,70046,Blue,1,50943,51361,418
2022-02-15,70055,70838,Blue,0,60976,61952,976
2022-09-19,70044,70054,Blue,1,51719,52326,607
2022-03-15,70046,70054,Blue,1,46787,47186,399
2022-12-21,70053,70047,Blue,0,66936,67218,282
2022-04-14,70040,70060,Blue,1,44262,45430,1168
2022-06-18,70055,70051,Blue,0,49432,49578,146
2022-06-23,70051,70039,Blue,0,50352,51116,764
2022-03-31,70041,70838,Blue,0,67731,67845,114
2022-11-07,70040,70060,Blue,1,86776,87795,1019
2022-05-20,70045,70041,Blue,0,54481,54715,234
2022-05-07,70055,70051,Blue,0,26599,26745,146
2022-11-15,70040,70052,Blue,1,56413,57169,756
2022-03-22,70052,70060,Blue,1,41922,42259,337
2022-03-02,70042,70058,Blue,1,33689,34524,835
2022-09-09,70040,70042,Blue,1,47182,47216,34
2022-03-14,70044,70058,Blue,1,73208,74023,815
2022-08-15,70041,70838,Blue,0,85672,85790,118
2022-02-28,70043,70041,Blue,0,59059,59087,28
2022-09-14,70046,70048,Blue,1,78258,78332,74
2022-08-20,70040,70060,Blue,1,22418,23403,985
2022-11-07,70044,70048,Blue,1,28409,28643,234
2022-02-25,70046,70054,Blue,1,53163,53614,451
2022-11-18,70040,70046,Blue,1,79721,79970,249
2022-11-21,70040,70048,Blue,1,74859,75220,361
2022-08-08,70038,70042,Blue,1,44505,44598,93
2022-11-29,70057,70047,Blue,0,74969,75458,489
2022-09-05,70040,70056,Blue,1,72191,73048,857
2022-09-07,70046,70058,Blue,1,38293,39024,731
2022-01-18,70040,70042,Blue,1,36343,36375,32
2022-10-18,70055,70053,Blue,0,85146,85191,45
2022-07-08,70053,70043,Blue,0,36192,36839,647
2022-10-05,70047,70041,Blue,0,83711,84024,313
2022-08-16,70059,70039,Blue,0,23415,24497,1082
2022-04-20,70044,70054,Blue,1,36966,37606,640
2022-09-06,70051,70045,Blue,0,30147,30547,400
2022-02-15,70043,70838,Blue,0,65689,65861,172
2022-08-21,70038,70054,Blue,1,60195,61051,856
2022-08-20,70049,70838,Blue,0,78272,78893,621
2022-08-15,70056,70058,Blue,1,57457,57528,71
2022-06-13,70044,70046,Blue,1,55262,55373,111
2022-04-14,70038,70054,Blue,1,52398,53327,929
2022-05-09,70055,70051,Blue,0,41315,41455,140
2022-08-24,70057,70051,Blue,0,56681,56939,258
2022-09-23,70049,70047,Blue,0,67038,67114,76
2022-06-30,70046,70052,Blue,1,67471,67797,326
2022-01-26,70055,70045,Blue,0,58624,59149,525
2022-03-26,70050,70054,Blue,1,71843,72091,248
2022-06-25,70050,70054,Blue,1,81417,81640,223
2022-03-10,70050,70054,Blue,1,52731,52969,238
2022-06-09,70056,70060,Blue,1,41162,41434,272
2022-12-16,70044,70056,Blue,1,30499,31192,693
2022-11-20,70040,70052,Blue,1,32421,33044,623
2022-09-28,70048,70058,Blue,1,58127,58644,517
2022-06-15,70050,70056,Blue,1,49294,49596,302
2022-04-16,70053,70041,Blue,0,21126,21844,718
2022-08-25,70057,70045,Blue,0,63517,64149,632
2022-01-28,70059,70057,Blue,0,25023,25063,40
2022-03-09,70044,70058,Blue,1,50522,51493,971
2022-08-28,70046,70054,Blue,1,73010,73429,419
2022-02-18,70040,70058,Blue,1,57244,58249,1005
2022-04-18,70038,70048,Blue,1,87771,88294,523
2022-10-04,70048,70050,Blue,1,33791,33854,63
2022-05-18,70042,70052,Blue,1,55135,55778,643
2022-07-11,70056,70058,Blue,1,33650,33730,80
2022-06-21,70038,70058,Blue,1,71196,72318,1122
2022-10-21,70044,70048,Blue,1,80901,81143,242
2022-01-27,70044,70054,Blue,1,28847,29452,605
2022-06-17,70059,70055,Blue,0,28460,28653,193
2022-05-05,70054,70060,Blue,1,84784,85103,319
2022-07-31,70053,70049,Blue,0,55727,55927,200
2022-04-22,70043,70041,Blue,0,54227,54256,29
2022-11-21,70044,70058,Blue,1,81561,82345,784
2022-06-29,70051,70039,Blue,0,57146,57836,690
2022-02-02,70047,70045,Blue,0,30647,30746,99
2022-03-25,70057,70053,Blue,0,22858,23022,164
2022-09-03,70044,70056,Blue,1,79503,80193,690
2022-05-27,70047,70039,Blue,0,26188,26679,491
2022-01-04,70040,70060,Blue,1,27687,28778,1091
2022-04-29,70059,70047,Blue,0,28035,28789,754
2022-06-10,70040,70060,Blue,1,31100,32301,1201
2022-07-25,70039,70838,Blue,0,61307,61342,35
2022-11-22,70042,70060,Blue,1,24253,25256,1003
2022-04-21,70059,70043,Blue,0,36374,37322,948
2022-07-04,70050,70058,Blue,1,75640,76081,441
2022-02-08,70043,70838,Blue,0,61498,61701,203
2022-11-09,70040,70060,Blue,1,77358,78361,1003
2022-09-28,70046,70060,Blue,1,75172,75903,731
2022-10-01,70040,70048,Blue,1,73451,73850,399
2022-01-07,70057,70051,Blue,0,40691,40998,307
2022-02-27,70057,70047,Blue,0,31004,31485,481
2022-09-02,70046,70060,Blue,1,57122,57894,772
2022-11-12,70049,70043,Blue,0,58375,58735,360
2022-05-27,70046,70048,Blue,1,79056,79146,90
2022-09-16,70049,70047,Blue,0,29380,29441,61
2022-09-06,70046,70054,Blue,1,79348,79769,421
2022-01-22,70045,70043,Blue,0,44547,44657,110
2022-03-29,70053,70045,Blue,0,32014,32457,443
2022-07-16,70048,70056,Blue,1,86968,87386,418
2022-09-02,70047,70838,Blue,0,49463,49988,525
2022-12-06,70057,70043,Blue,0,72324,73050,726
2022-02-25,70055,70041,Blue,0,28675,29468,793
2022-01-28,70053,70047,Blue,0,28766,29074,308
2022-08-27,70055,70043,Blue,0,57510,58180,670
2022-10-16,70051,70049,Blue,0,75053,75158,105
2022-08-02,70038,70054,Blue,1,21011,21783,772
2022-05-21,70053,70041,Blue,0,86801,87564,763
2022-04-19,70055,70047,Blue,0,41131,41568,437
2022-03-30,70053,70045,Blue,0,78609,79080,471
2022-10-03,70055,70053,Blue,0,58394,58439,45
2022-09-11,70044,70052,Blue,1,70129,70670,541
2022-01-20,70040,70056,Blue,1,66240,67184,944
2022-02-05,70053,70838,Blue,0,22143,22999,856
2022-05-19,70057,70047,Blue,0,30649,31162,513
2022-09-20,70052,70054,Blue,1,46328,46389,61
2022-09-20,70046,70054,Blue,1,30069,30518,449
2022-07-02,70047,70041,Blue,0,35771,36126,355
2022-05-19,70050,70056,Blue,1,26258,26577,319
2022-11-24,70055,70043,Blue,0,68598,69284,686
2022-07-21,70049,70039,Blue,0,64181,64692,511
2022-04-10,70042,70060,Blue,1,82468,83390,922
2022-03-18,70053,70043,Blue,0,84311,84928,617
2022-02-12,70059,70039,Blue,0,57854,58894,1040
2022-08-02,70038,70060,Blue,1,44126,45311,1185
2022-12-21,70055,70041,Blue,0,66197,66938,741
2022-10-02,70053,70039,Blue,0,79497,80260,763
2022-05-23,70038,70050,Blue,1,23858,24447,589
2022-02-10,70056,70060,Blue,1,34830,35018,188
2022-09-18,70044,70052,Blue,1,37246,37750,504
2022-06-11,70046,70054,Blue,1,23381,23830,449
2022-10-16,70057,70041,Blue,0,87388,88245,857
2022-01-02,70051,70049,Blue,0,76946,77052,106
2022-03-03,70044,70054,Blue,1,43739,44395,656
2022-04-22,70038,70048,Blue,1,56233,56701,468
2022-03-28,70054,70060,Blue,1,89977,90214,237
2022-10-23,70044,70060,Blue,1,53956,54894,938
2022-09-23,70053,70051,Blue,0,49196,49248,52
2022-09-14,70044,70052,Blue,1,46967,47462,495
2022-07-10,70056,70058,Blue,1,44628,44700,72
2022-06-10,70053,70049,Blue,0,55379,55573,194
2022-07-15,70051,70049,Blue,0,34511,34627,116
2022-07-26,70059,70041,Blue,0,70695,71626,931
2022-02-25,70057,70039,Blue,0,72702,73750,1048
2022-02-08,70046,70056,Blue,1,27354,27874,520
2022-01-18,70040,70050,Blue,1,85056,85630,574
2022-04-11,70055,70051,Blue,0,86490,86636,146
2022-08-23,70057,70045,Blue,0,55369,56064,695
2022-03-23,70049,70039,Blue,0,38682,39165,483
2022-02-14,70040,70052,Blue,1,49805,50433,628
2022-01-15,70039,70838,Blue,0,25935,25988,53
2022-04-22,70055,70045,Blue,0,68047,68570,523
2022-11-12,70050,70058,Blue,1,57832,58253,421
2022-03-08,70046,70058,Blue,1,25541,26187,646
2022-10-16,70053,70039,Blue,0,85783,86555,772
2022-09-01,70053,70049,Blue,0,33757,33961,204
2022-05-25,70042,70044,Blue,1,85392,85419,27
2022-03-11,70057,70047,Blue,0,57443,57904,461
2022-09-29,70042,70052,Blue,1,86657,87187,530
2022-08-13,70042,70044,Blue,1,76838,76871,33
2022-05-21,70047,70045,Blue,0,61731,61898,167
2022-10-18,70051,70838,Blue,0,40970,41765,795
2022-07-16,70053,70045,Blue,0,85123,85678,555
2022-09-04,70040,70042,Blue,1,79779,79810,31
2022-02-15,70053,70838,Blue,0,32574,33524,950
2022-07-31,70049,70045,Blue,0,57036,57232,196
2022-10-19,70053,70047,Blue,0,31598,31910,312
2022-11-07,70045,70039,Blue,0,38132,38480,348
2022-12-02,70054,70056,Blue,1,62611,62658,47
2022-04-22,70040,70042,Blue,1,25507,25541,34
2022-07-26,70046,70058,Blue,1,62309,62977,668
2022-04-07,70043,70041,Blue,0,28744,28773,29
2022-02-03,70051,70041,Blue,0,80827,81555,728
2022-03-29,70051,70838,Blue,0,64733,65421,688
2022-04-21,70052,70060,Blue,1,80720,81117,397
2022-03-22,70044,70054,Blue,1,86774,87381,607
2022-10-19,70044,70060,Blue,1,80256,81127,871
2022-09-28,70053,70047,Blue,0,33355,33691,336
2022-09-03,70042,70044,Blue,1,84378,84409,31
2022-02-15,70053,70045,Blue,0,51483,51986,503
2022-12-24,70059,70045,Blue,0,77777,78481,704
2022-01-04,70054,70056,Blue,1,31751,31802,51
2022-12-07,70042,70060,Blue,1,46813,47816,1003
2022-02-20,70043,70039,Blue,0,75811,75916,105
2022-12-19,70038,70048,Blue,1,55022,55476,454
2022-10-25,70057,70047,Blue,0,45334,45867,533
2022-10-18,70038,70056,Blue,1,79444,80300,856
2022-04-15,70051,70045,Blue,0,59417,59771,354
2022-04-03,70045,70041,Blue,0,63745,63918,173
2022-06-12,70038,70042,Blue,1,60188,60320,132
2022-06-14,70049,70043,Blue,0,68985,69351,366
2022-08-16,70046,70050,Blue,1,81546,81734,188
2022-03-21,70038,70050,Blue,1,35796,36458,662
2022-02-28,70042,70054,Blue,1,63585,64242,657
2022-09-21,70049,70838,Blue,0,52471,53033,562
2022-01-31,70059,70055,Blue,0,85753,85904,151
2022-07-04,70046,70054,Blue,1,38707,39273,566
2022-04-07,70057,70045,Blue,0,19971,20638,667
2022-07-05,70044,70046,Blue,1,47742,47892,150
2022-02-24,70040,70044,Blue,1,80374,80478,104
2022-08-08,70048,70058,Blue,1,87002,87511,509
2022-10-20,70038,70042,Blue,1,26207,26315,108
2022-08-19,70046,70054,Blue,1,41703,42205,502
2022-03-08,70044,70056,Blue,1,52652,53431,779
2022-09-21,70059,70055,Blue,0,85805,85954,149
2022-11-16,70056,70060,Blue,1,64777,64953,176
2022-12-30,70055,70049,Blue,0,28475,28766,291
2022-07-22,70038,70044,Blue,1,40966,41154,188
2022-11-16,70055,70051,Blue,0,21946,22113,167
2022-03-08,70050,70060,Blue,1,62961,63506,545
2022-03-23,70041,70838,Blue,0,61605,61727,122
2022-08-02,70049,70041,Blue,0,27398,27899,501
2022-07-06,70048,70052,Blue,1,57176,57390,214
2022-05-11,70055,70047,Blue,0,31594,31967,373
2022-11-25,70042,70052,Blue,1,58215,58831,616
2022-02-05,70043,70039,Blue,0,71178,71283,105
2022-08-01,70038,70056,Blue,1,41520,42444,924
2022-08-15,70038,70040,Blue,1,65346,65360,14
2022-10-21,70047,70043,Blue,0,27005,27288,283
2022-01-07,70040,70042,Blue,1,61430,61460,30
2022-03-15,70057,70041,Blue,0,30048,30997,949
2022-03-30,70049,70838,Blue,0,24143,25002,859
2022-01-17,70040,70044,Blue,1,56229,56346,117
2022-04-18,70044,70056,Blue,1,52560,53303,743
2022-08-28,70059,70039,Blue,0,75977,77008,1031
2022-08-29,70054,70058,Blue,1,77529,77681,152
2022-03-12,70052,70058,Blue,1,28209,28449,240
2022-12-24,70038,70040,Blue,1,66978,66992,14
2022-06-23,70052,70056,Blue,1,66524,66682,158
2022-12-03,70057,70045,Blue,0,55325,55984,659
2022-01-21,70040,70044,Blue,1,69503,69619,116
2022-03-23,70051,70838,Blue,0,27651,28408,757
2022-04-28,70057,70055,Blue,0,77260,77329,69
2022-10-07,70057,70039,Blue,0,30631,31557,926
2022-09-02,70051,70049,Blue,0,48736,48835,99
2022-08-28,70038,70042,Blue,1,62349,62461,112
2022-04-15,70057,70049,Blue,0,44006,44508,502
2022-11-12,70049,70047,Blue,0,24640,24695,55
2022-12-03,70046,70054,Blue,1,67292,67733,441
2022-12-26,70056,70058,Blue,1,60116,60188,72
2022-02-28,70048,70060,Blue,1,46356,47119,763
2022-11-19,70050,70056,Blue,1,32346,32621,275
2022-09-03,70053,70039,Blue,0,29514,30295,781
2022-02-25,70053,70043,Blue,0,37562,38221,659
2022-04-24,70051,70043,Blue,0,57415,57886,471
2022-04-07,70039,70838,Blue,0,29306,29341,35
2022-01-25,70057,70047,Blue,0,77854,78370,516
2022-03-17,70040,70052,Blue,1,32454,33157,703
2022-09-01,70043,70838,Blue,0,67153,67333,180
2022-02-06,70055,70045,Blue,0,64270,64801,531
2022-08-30,70047,70041,Blue,0,55654,55979,325
2022-01-27,70045,70041,Blue,0,30778,30993,215
2022-03-03,70051,70039,Blue,0,52213,52885,672
2022-07-26,70044,70048,Blue,1,74480,74731,251
2022-02-02,70054,70058,Blue,1,27487,27671,184
2022-12-12,70059,70039,Blue,0,25944,26985,1041
2022-04-21,70044,70056,Blue,1,61266,61939,673
2022-02-08,70042,70054,Blue,1,76490,77141,651
2022-03-23,70052,70058,Blue,1,83872,84133,261
2022-02-06,70044,70056,Blue,1,39901,40605,704
2022-05-18,70044,70060,Blue,1,44430,45478,1048
2022-07-27,70043,70838,Blue,0,70045,70232,187
2022-05-18,70039,70838,Blue,0,82942,82976,34
2022-03-08,70042,70056,Blue,1,20521,21309,788
2022-06-29,70041,70039,Blue,0,69321,69353,32
2022-04-23,70038,70040,Blue,1,78612,78628,16
2022-01-18,70059,70045,Blue,0,62894,63643,749
2022-02-13,70057,70047,Blue,0,84860,85389,529
2022-07-23,70046,70052,Blue,1,88230,88627,397
2022-09-09,70056,70058,Blue,1,58647,58724,77
2022-12-10,70047,70041,Blue,0,40124,40468,344
2022-03-28,70046,70060,Blue,1,62676,63445,769
2022-02-10,70048,70052,Blue,1,57645,57860,215
2022-12-25,70052,70058,Blue,1,69790,70049,259
2022-11-11,70047,70838,Blue,0,50108,50608,500
2022-05-21,70053,70049,Blue,0,44615,44815,200
2022-02-27,70059,70055,Blue,0,26996,27140,144
2022-11-24,70052,70060,Blue,1,62015,62360,345
2022-12-22,70038,70044,Blue,1,34646,34813,167
2022-12-18,70045,70041,Blue,0,74573,74728,155
2022-01-09,70048,70052,Blue,1,79567,79769,202
2022-01-07,70051,70838,Blue,0,20651,21408,757
2022-01-10,70040,70044,Blue,1,73037,73145,108
2022-09-19,70050,70052,Blue,1,26350,26469,119
2022-03-18,70040,70060,Blue,1,53428,54660,1232
2022-01-03,70052,70056,Blue,1,89860,89988,128
2022-05-03,70059,70057,Blue,0,55149,55184,35
2022-12-04,70051,70043,Blue,0,71471,71951,480
2022-10-22,70038,70040,Blue,1,85517,85533,16
2022-08-14,70055,70047,Blue,0,46457,46828,371
2022-09-25,70057,70039,Blue,0,50672,51582,910
2022-07-11,70051,70047,Blue,0,38610,38812,202
2022-04-21,70051,70045,Blue,0,58982,59384,402
2022-12-29,70048,70060,Blue,1,35687,36304,617
2022-03-14,70038,70048,Blue,1,61035,61542,507
2022-03-07,70059,70047,Blue,0,19874,20505,631
2022-10-20,70051,70039,Blue,0,70034,70947,913
2022-03-04,70043,70838,Blue,0,35106,35310,204
2022-04-18,70049,70041,Blue,0,78262,78672,410
2022-03-12,70045,70039,Blue,0,55952,56214,262
2022-03-31,70038,70046,Blue,1,69927,70277,350
2022-09-27,70040,70056,Blue,1,53796,54616,820
2022-04-05,70057,70047,Blue,0,82407,82888,481
2022-03-16,70038,70058,Blue,1,61036,62128,1092
2022-01-07,70052,70056,Blue,1,24416,24562,146
2022-12-27,70040,70052,Blue,1,28645,29314,669
2022-05-19,70043,70041,Blue,0,67840,67868,28
2022-03-13,70059,70055,Blue,0,55449,55592,143
2022-02-12,70042,70046,Blue,1,64360,64532,172
2022-03-18,70046,70056,Blue,1,86967,87499,532
2022-04-18,70052,70060,Blue,1,49969,50349,380
2022-09-30,70055,70051,Blue,0,81556,81690,134
2022-10-08,70057,70047,Blue,0,66039,66506,467
2022-01-02,70044,70048,Blue,1,65383,65668,285
2022-01-19,70053,70047,Blue,0,78606,78939,333
2022-12-17,70040,70048,Blue,1,51326,51708,382
2022-12-03,70038,70056,Blue,1,33426,34255,829
2022-07-08,70049,70045,Blue,0,67316,67507,191
2022-12-07,70047,70041,Blue,0,40615,40951,336
2022-11-24,70047,70045,Blue,0,73366,73461,95
2022-05-19,70047,70838,Blue,0,35371,35984,613
2022-07-12,70046,70048,Blue,1,25810,25898,88
2022-10-20,70040,70048,Blue,1,81336,81742,406
2022-05-10,70054,70056,Blue,1,36190,36236,46
2022-03-15,70055,70039,Blue,0,22621,23627,1006
2022-03-24,70052,70060,Blue,1,23538,23939,401
2022-10-27,70044,70054,Blue,1,54570,55209,639
2022-12-27,70038,70050,Blue,1,83769,84320,551
2022-07-05,70048,70050,Blue,1,33202,33262,60
2022-11-08,70042,70058,Blue,1,40690,41635,945
2022-07-18,70046,70058,Blue,1,42011,42705,694
2022-09-21,70047,70838,Blue,0,45555,46061,506
2022-10-20,70054,70058,Blue,1,29789,29940,151
2022-10-07,70050,70052,Blue,1,73789,73909,120
2022-04-11,70050,70054,Blue,1,23382,23618,236
2022-03-07,70041,70838,Blue,0,28649,28766,117
2022-11-09,70046,70050,Blue,1,26792,26986,194
2022-10-18,70047,70043,Blue,0,33722,33980,258
2022-12-28,70043,70041,Blue,0,24980,25010,30
2022-05-19,70053,70051,Blue,0,72273,72337,64
2022-08-15,70046,70058,Blue,1,31137,31785,648
2022-12-25,70038,70056,Blue,1,32353,33254,901
2022-04-15,70046,70054,Blue,1,62967,63413,446
2022-03-10,70038,70050,Blue,1,59225,59787,562
2022-09-29,70051,70045,Blue,0,49761,50121,360
2022-02-22,70042,70058,Blue,1,30704,31523,819
2022-10-12,70044,70054,Blue,1,64075,64702,627
2022-07-12,70057,70838,Blue,0,87399,88379,980
2022-12-31,70057,70051,Blue,0,39578,39880,302
2022-04-07,70055,70051,Blue,0,83678,83824,146
2022-12-20,70040,70054,Blue,1,25696,26373,677
2022-10-30,70052,70058,Blue,1,62597,62858,261
2022-03-23,70055,70051,Blue,0,46803,46936,133
2022-06-01,70042,70052,Blue,1,44644,45282,638
2022-03-09,70049,70039,Blue,0,48180,48737,557
2022-02-03,70047,70039,Blue,0,19074,19610,536
2022-11-15,70046,70060,Blue,1,47001,47736,735
2022-08-24,70049,70838,Blue,0,34476,35237,761
2022-01-01,70038,70058,Blue,1,30014,30922,908
2022-01-28,70043,70039,Blue,0,55954,56077,123
2022-01-24,70055,70039,Blue,0,58870,59755,885
2022-10-09,70048,70056,Blue,1,67201,67614,413
2022-12-06,70043,70838,Blue,0,30620,30842,222
2022-10-07,70041,70838,Blue,0,68119,68241,122
2022-03-13,70049,70838,Blue,0,33673,34250,577
2022-02-17,70051,70049,Blue,0,70894,70998,104
2022-12-31,70057,70041,Blue,0,36340,37193,853
2022-01-26,70047,70043,Blue,0,67113,67377,264
2022-06-23,70055,70049,Blue,0,29070,29354,284
2022-02-11,70054,70058,Blue,1,26920,27079,159
2022-12-20,70058,70060,Blue,1,39155,39227,72
2022-04-12,70046,70054,Blue,1,33304,33770,466
2022-04-23,70048,70052,Blue,1,40461,40671,210
2022-08-16,70043,70838,Blue,0,76791,76985,194
2022-04-11,70042,70044,Blue,1,71143,71170,27
2022-07-17,70042,70060,Blue,1,27797,28718,921
2022-02-15,70059,70039,Blue,0,68793,69926,1133
2022-06-14,70047,70838,Blue,0,88593,89064,471
2022-02-26,70059,70838,Blue,0,60019,61202,1183
2022-09-10,70038,70048,Blue,1,65304,65862,558
2022-09-20,70046,70058,Blue,1,52220,52867,647
2022-12-25,70040,70054,Blue,1,44359,45132,773
2022-06-23,70042,70054,Blue,1,24640,25358,718
2022-03-31,70038,70048,Blue,1,26049,26530,481
2022-04-09,70045,70041,Blue,0,44125,44299,174
2022-10-10,70040,70048,Blue,1,50880,51267,387
2022-12-19,70051,70039,Blue,0,29463,30140,677
2022-04-05,70055,70051,Blue,0,73936,74082,146
2022-02-17,70040,70058,Blue,1,69506,70485,979
2022-03-09,70042,70050,Blue,1,49422,49876,454
2022-01-26,70041,70838,Blue,0,78145,78262,117
2022-10-07,70059,70051,Blue,0,52586,52913,327
2022-10-10,70051,70039,Blue,0,50302,50948,646
2022-02-18,70040,70054,Blue,1,57244,58052,808
2022-06-22,70056,70060,Blue,1,69144,69310,166
2022-01-13,70052,70056,Blue,1,35155,35296,141
2022-07-08,70040,70050,Blue,1,77556,78066,510
2022-06-22,70040,70054,Blue,1,50622,51549,927
2022-12-09,70053,70041,Blue,0,39536,40227,691
2022-06-06,70045,70838,Blue,0,75556,75936,380
2022-09-26,70040,70044,Blue,1,27050,27162,112
2022-12-16,70055,70041,Blue,0,34905,35854,949
2022-02-04,70042,70050,Blue,1,22115,22579,464
2022-07-07,70044,70056,Blue,1,48900,49903,1003
2022-07-31,70051,70043,Blue,0,54735,55234,499
2022-06-30,70053,70051,Blue,0,22018,22080,62
2022-04-24,70042,70054,Blue,1,31703,32442,739
2022-01-28,70055,70047,Blue,0,44013,44438,425
2022-02-24,70047,70039,Blue,0,67392,67778,386
2022-03-23,70053,70043,Blue,0,66746,67314,568
2022-10-18,70038,70042,Blue,1,77834,77938,104
2022-10-08,70044,70054,Blue,1,33142,33759,617
2022-12-06,70059,70057,Blue,0,73830,73869,39
2022-02-09,70054,70060,Blue,1,61641,61922,281
2022-11-07,70059,70039,Blue,0,78922,80129,1207
2022-01-06,70055,70838,Blue,0,67717,68591,874
2022-01-25,70045,70838,Blue,0,33140,33527,387
2022-12-12,70046,70056,Blue,1,45501,46087,586
2022-01-31,70044,70048,Blue,1,39580,39927,347
2022-06-29,70053,70047,Blue,0,60285,60583,298
2022-09-16,70044,70048,Blue,1,50759,51013,254
2022-11-12,70049,70045,Blue,0,50281,50511,230
2022-03-12,70054,70056,Blue,1,56602,56648,46
2022-12-23,70044,70048,Blue,1,34189,34431,242
2022-12-08,70043,70041,Blue,0,78991,79017,26
2022-11-30,70057,70838,Blue,0,70330,71640,1310
2022-08-22,70056,70060,Blue,1,43999,44190,191
2022-02-14,70057,70838,Blue,0,85241,86326,1085
2022-12-26,70039,70838,Blue,0,51571,51604,33
2022-02-04,70042,70044,Blue,1,80487,80517,30
2022-08-27,70049,70041,Blue,0,50249,50709,460
2022-08-15,70053,70049,Blue,0,77780,77997,217
2022-09-13,70042,70050,Blue,1,22439,22833,394
2022-01-03,70044,70052,Blue,1,48300,48777,477
2022-04-07,70052,70054,Blue,1,21588,21641,53
2022-03-09,70048,70050,Blue,1,22091,22151,60
2022-11-26,70048,70054,Blue,1,64727,65026,299
2022-09-15,70040,70048,Blue,1,61906,62361,455
2022-08-24,70047,70043,Blue,0,50835,51123,288
2022-06-12,70053,70838,Blue,0,24994,25896,902
2022-10-15,70038,70056,Blue,1,57934,58834,900
2022-07-16,70045,70039,Blue,0,54299,54565,266
2022-10-19,70039,70838,Blue,0,79146,79175,29
2022-07-13,70040,70042,Blue,1,33764,33798,34
2022-11-13,70042,70056,Blue,1,76588,77359,771
2022-03-15,70044,70046,Blue,1,79972,80065,93
2022-03-27,70042,70044,Blue,1,28586,28613,27
2022-07-14,70040,70046,Blue,1,31302,31607,305
2022-06-28,70059,70041,Blue,0,23420,24430,1010
2022-08-26,70048,70052,Blue,1,30741,30935,194
2022-11-25,70042,70052,Blue,1,50929,51467,538
2022-04-02,70052,70054,Blue,1,34170,34216,46
2022-02-05,70052,70058,Blue,1,46021,46256,235
2022-06-12,70048,70052,Blue,1,57022,57243,221
2022-06-09,70051,70047,Blue,0,30622,30825,203
2022-09-18,70044,70048,Blue,1,43201,43438,237
2022-10-13,70050,70054,Blue,1,64204,64437,233
2022-04-10,70043,70838,Blue,0,30318,30551,233
2022-03-08,70057,70838,Blue,0,27347,28512,1165
2022-11-05,70042,70058,Blue,1,50854,51680,826
2022-08-08,70049,70838,Blue,0,68611,69217,606
2022-01-22,70039,70838,Blue,0,58488,58522,34
2022-02-04,70042,70054,Blue,1,21571,22312,741
2022-07-05,70058,70060,Blue,1,68520,68722,202
2022-08-10,70040,70058,Blue,1,39949,41002,1053
2022-01-05,70051,70838,Blue,0,65969,66678,709
2022-06-26,70055,70838,Blue,0,81131,82096,965
2022-09-01,70048,70054,Blue,1,25353,25659,306
2022-05-23,70049,70039,Blue,0,72194,72831,637
2022-02-20,70051,70041,Blue,0,68776,69384,608
2022-12-24,70053,70041,Blue,0,42476,43521,1045
2022-10-17,70051,70047,Blue,0,64804,64988,184
2022-05-24,70040,70046,Blue,1,31093,31383,290
2022-12-15,70051,70041,Blue,0,36235,36832,597
2022-10-26,70056,70060,Blue,1,84906,85192,286
2022-10-29,70043,70838,Blue,0,52802,52998,196
2022-12-27,70051,70039,Blue,0,53230,53834,604
2022-11-01,70051,70838,Blue,0,86102,86772,670
2022-04-12,70038,70040,Blue,1,75787,75805,18
2022-09-01,70050,70058,Blue,1,32510,32891,381
2022-01-05,70047,70041,Blue,0,24071,24407,336
2022-02-01,70040,70048,Blue,1,45947,46360,413
2022-02-22,70044,70056,Blue,1,68520,69277,757
2022-06-12,70059,70047,Blue,0,62487,63078,591
2022-10-25,70044,70054,Blue,1,44258,44877,619
2022-11-09,70053,70838,Blue,0,29880,30788,908
2022-03-18,70054,70058,Blue,1,76672,76831,159
2022-03-01,70054,70058,Blue,1,40404,40555,151
2022-11-06,70042,70058,Blue,1,81354,82511,1157
2022-05-19,70051,70047,Blue,0,29455,29656,201
2022-03-17,70044,70052,Blue,1,37541,38037,496
2022-08-08,70042,70058,Blue,1,41120,42043,923
2022-12-31,70049,70043,Blue,0,39537,39909,372
2022-08-04,70049,70047,Blue,0,63390,63447,57
2022-02-14,70042,70060,Blue,1,52305,53554,1249
2022-04-12,70057,70047,Blue,0,56683,57188,505
2022-11-18,70057,70051,Blue,0,26332,26586,254
2022-06-12,70045,70043,Blue,0,86310,86428,118
2022-04-22,70043,70039,Blue,0,32725,32842,117
2022-08-30,70044,70058,Blue,1,78544,79303,759
2022-04-17,70040,70050,Blue,1,66793,67286,493
2022-07-06,70044,70050,Blue,1,43862,44272,410
2022-10-08,70051,70049,Blue,0,29590,29693,103
2022-02-05,70042,70058,Blue,1,26735,27594,859
2022-06-10,70057,70047,Blue,0,58835,59302,467
2022-07-08,70057,70047,Blue,0,72514,72980,466
2022-08-06,70043,70838,Blue,0,40427,40630,203
2022-09-07,70038,70048,Blue,1,78861,79287,426
2022-02-07,70047,70041,Blue,0,23329,23648,319
2022-07-04,70038,70040,Blue,1,67629,67644,15
2022-01-01,70042,70048,Blue,1,53882,54196,314
2022-04-14,70057,70051,Blue,0,30054,30327,273
2022-09-29,70051,70045,Blue,0,27571,27991,420
2022-02-11,70059,70043,Blue,0,69084,69968,884
2022-04-01,70040,70050,Blue,1,35804,36362,558
2022-11-17,70051,70047,Blue,0,39844,40033,189
2022-04-11,70059,70057,Blue,0,32954,32989,35
2022-01-05,70057,70049,Blue,0,23731,24111,380
2022-08-04,70053,70043,Blue,0,72047,72597,550
2022-01-05,70052,70056,Blue,1,28035,28181,146
2022-09-17,70046,70048,Blue,1,84167,84233,66
2022-01-09,70057,70051,Blue,0,76597,76869,272
2022-02-06,70043,70041,Blue,0,41128,41156,28
2022-03-27,70057,70838,Blue,0,36284,37335,1051
2022-07-08,70038,70054,Blue,1,48789,49871,1082
2022-12-15,70050,70060,Blue,1,45260,45801,541
2022-04-21,70056,70060,Blue,1,82032,82243,211
2022-04-30,70057,70055,Blue,0,31290,31360,70
2022-04-20,70048,70054,Blue,1,36687,37102,415
2022-04-22,70044,70046,Blue,1,23555,23663,108
2022-12-04,70055,70838,Blue,0,72388,73308,920
2022-08-20,70046,70056,Blue,1,57029,57600,571
2022-11-12,70055,70041,Blue,0,53211,53964,753
2022-10-11,70038,70046,Blue,1,85693,86055,362
2022-12-25,70046,70052,Blue,1,65977,66330,353
2022-10-06,70053,70838,Blue,0,80743,81575,832
2022-02-16,70045,70838,Blue,0,50986,51321,335
2022-02-02,70042,70058,Blue,1,71693,72500,807
2022-07-04,70052,70058,Blue,1,69108,69366,258
2022-03-24,70057,70039,Blue,0,50795,51745,950
2022-02-26,70044,70050,Blue,1,35250,35603,353
2022-02-27,70056,70060,Blue,1,63869,64048,179
2022-03-10,70038,70056,Blue,1,67327,68232,905
2022-07-02,70041,70838,Blue,0,86737,86856,119
2022-02-08,70057,70053,Blue,0,63569,63752,183
2022-01-29,70046,70050,Blue,1,30074,30311,237
2022-01-20,70040,70048,Blue,1,63213,63594,381
2022-03-28,70054,70056,Blue,1,86835,86882,47
2022-09-30,70046,70060,Blue,1,26866,27607,741
2022-05-18,70040,70050,Blue,1,50841,51451,610
2022-03-23,70046,70060,Blue,1,35605,36564,959
2022-09-14,70042,70056,Blue,1,58217,59108,891
2022-10-17,70046,70050,Blue,1,47465,47647,182
2022-09-23,70051,70041,Blue,0,72610,73210,600
2022-03-01,70044,70048,Blue,1,82180,82402,222
2022-11-25,70050,70054,Blue,1,63300,63517,217
2022-04-22,70049,70043,Blue,0,58902,59264,362
2022-03-14,70038,70042,Blue,1,88741,88835,94
2022-02-26,70042,70052,Blue,1,67603,68165,562
2022-10-30,70038,70060,Blue,1,70995,72172,1177
2022-07-17,70050,70054,Blue,1,50644,50837,193
2022-02-04,70044,70048,Blue,1,22405,22627,222
2022-06-15,70057,70049,Blue,0,21776,22174,398
2022-02-07,70051,70047,Blue,0,45320,45504,184
2022-03-03,70046,70050,Blue,1,47330,47592,262
2022-05-20,70045,70041,Blue,0,71784,71990,206
2022-05-27,70040,70042,Blue,1,56088,56120,32
2022-08-12,70038,70044,Blue,1,74759,74953,194
2022-01-14,70051,70838,Blue,0,42433,43183,750
2022-02-22,70038,70052,Blue,1,68284,69111,827
2022-04-07,70047,70043,Blue,0,57183,57432,249
2022-07-10,70046,70058,Blue,1,62270,62913,643
2022-02-10,70055,70039,Blue,0,51742,52573,831
2022-09-01,70046,70048,Blue,1,61585,61668,83
2022-01-22,70056,70060,Blue,1,44650,44821,171
2022-06-10,70044,70052,Blue,1,55892,56447,555
2022-09-08,70044,70050,Blue,1,38228,38539,311
2022-09-12,70042,70044,Blue,1,34412,34444,32
2022-02-25,70057,70041,Blue,0,29757,30709,952
2022-12-02,70044,70060,Blue,1,66647,67575,928
2022-06-16,70043,70838,Blue,0,25906,26121,215
2022-10-18,70051,70047,Blue,0,31000,31196,196
2022-05-19,70053,70049,Blue,0,31146,31392,246
2022-12-14,70055,70047,Blue,0,28299,28693,394
2022-03-02,70038,70052,Blue,1,77451,78112,661
2022-09-26,70059,70047,Blue,0,68654,69281,627
2022-03-02,70046,70058,Blue,1,20858,21566,708
2022-03-15,70051,70838,Blue,0,35583,36763,1180
2022-03-31,70038,70050,Blue,1,33252,33935,683
2022-11-04,70057,70045,Blue,0,69464,70456,992
2022-11-01,70053,70051,Blue,0,49685,49747,62
2022-05-05,70059,70051,Blue,0,67382,67692,310
2022-03-21,70057,70051,Blue,0,22847,23116,269
2022-10-09,70046,70048,Blue,1,52461,52539,78
2022-05-15,70054,70058,Blue,1,43778,43939,161
2022-01-27,70053,70838,Blue,0,22069,23004,935
2022-09-14,70038,70052,Blue,1,50506,51293,787
2022-09-07,70048,70050,Blue,1,56337,56391,54
2022-06-15,70057,70047,Blue,0,73292,73797,505
2022-02-21,70044,70052,Blue,1,61234,61764,530
2022-12-18,70050,70058,Blue,1,51096,51497,401
2022-08-26,70042,70046,Blue,1,42635,42817,182
2022-02-10,70057,70053,Blue,0,29132,29313,181
2022-11-13,70052,70054,Blue,1,74941,74989,48
2022-01-24,70056,70060,Blue,1,36207,36426,219
2022-10-16,70044,70056,Blue,1,58805,59488,683
2022-04-11,70055,70047,Blue,0,32847,33221,374
2022-07-04,70038,70040,Blue,1,79489,79506,17
2022-11-26,70044,70052,Blue,1,72511,72988,477
2022-07-11,70044,70052,Blue,1,56490,57024,534
2022-12-12,70049,70045,Blue,0,55108,55292,184
2022-10-13,70042,70056,Blue,1,29132,29845,713
2022-12-12,70047,70045,Blue,0,38893,38996,103
2022-04-13,70059,70041,Blue,0,54785,55682,897
2022-10-20,70047,70045,Blue,0,60921,61022,101
2022-11-26,70045,70043,Blue,0,20476,20565,89
2022-04-14,70048,70060,Blue,1,61889,62509,620
2022-03-15,70056,70058,Blue,1,87481,87557,76
2022-11-21,70052,70058,Blue,1,65569,65816,247
2022-11-21,70053,70045,Blue,0,35273,35802,529
2022-03-09,70059,70045,Blue,0,53592,54430,838
2022-07-21,70057,70053,Blue,0,60392,60548,156
2022-02-23,70041,70039,Blue,0,64516,64547,31
2022-02-15,70055,70051,Blue,0,80236,80390,154
2022-12-31,70047,70039,Blue,0,73703,74098,395
2022-02-04,70048,70058,Blue,1,27092,27933,841
2022-06-22,70057,70041,Blue,0,28981,29928,947
2022-03-03,70042,70060,Blue,1,57269,58431,1162
2022-01-11,70052,70056,Blue,1,79264,79391,127
2022-12-18,70059,70041,Blue,0,37578,38609,1031
2022-12-31,70056,70058,Blue,1,44039,44108,69
2022-09-20,70038,70042,Blue,1,26148,26253,105
2022-07-28,70038,70060,Blue,1,52878,54107,1229
2022-12-17,70042,70058,Blue,1,78130,78969,839
2022-04-24,70040,70054,Blue,1,64578,65362,784
2022-02-19,70050,70058,Blue,1,75615,76020,405
2022-10-01,70058,70060,Blue,1,30146,30230,84
2022-03-11,70050,70056,Blue,1,80424,80724,300
2022-06-07,70038,70040,Blue,1,24796,24816,20
2022-05-28,70045,70041,Blue,0,34755,34963,208
2022-11-28,70042,70060,Blue,1,40723,41726,1003
2022-02-04,70057,70051,Blue,0,49293,49568,275
2022-08-07,70050,70054,Blue,1,26843,27047,204
2022-01-24,70042,70060,Blue,1,23494,24501,1007
2022-08-16,70053,70049,Blue,0,83084,83269,185
2022-12-11,70057,70051,Blue,0,84946,85189,243
2022-09-20,70051,70039,Blue,0,58071,58742,671
2022-11-08,70059,70051,Blue,0,62697,62996,299
2022-03-06,70038,70040,Blue,1,80352,80367,15
2022-03-22,70057,70838,Blue,0,24755,25824,1069
2022-01-21,70049,70043,Blue,0,72562,72886,324
2022-07-22,70038,70044,Blue,1,29063,29236,173
2022-09-18,70059,70041,Blue,0,56003,56923,920
2022-12-12,70054,70058,Blue,1,38089,38284,195
2022-09-13,70045,70043,Blue,0,66615,66717,102
2022-02-17,70049,70838,Blue,0,24772,25457,685
2022-09-24,70052,70054,Blue,1,47821,47875,54
2022-11-08,70053,70049,Blue,0,82359,82534,175
2022-11-01,70047,70838,Blue,0,46891,47392,501
2022-09-03,70051,70838,Blue,0,37170,37940,770
2022-02-15,70044,70054,Blue,1,28741,29399,658
2022-11-01,70050,70054,Blue,1,86322,86535,213
2022-08-08,70057,70043,Blue,0,62976,63724,748
2022-03-24,70047,70045,Blue,0,20906,21023,117
2022-12-21,70044,70050,Blue,1,24140,24516,376
2022-10-03,70049,70043,Blue,0,47832,48210,378
2022-04-07,70038,70052,Blue,1,55631,56368,737
2022-04-06,70057,70041,Blue,0,57447,58299,852
2022-03-02,70038,70046,Blue,1,46947,47286,339
2022-08-17,70051,70838,Blue,0,38872,39705,833
2022-05-13,70054,70056,Blue,1,79289,79336,47
2022-03-14,70047,70838,Blue,0,32656,33219,563
2022-01-27,70057,70049,Blue,0,62083,62478,395
2022-07-10,70040,70052,Blue,1,63779,64495,716
2022-12-07,70044,70048,Blue,1,41638,41879,241
2022-09-09,70040,70060,Blue,1,49827,50856,1029
2022-09-01,70059,70041,Blue,0,78720,79665,945
2022-06-10,70050,70056,Blue,1,64536,64852,316
2022-12-20,70042,70060,Blue,1,35315,36543,1228
2022-01-04,70052,70056,Blue,1,83336,83473,137
2022-06-08,70041,70838,Blue,0,35253,35379,126
2022-02-14,70052,70058,Blue,1,22607,23087,480
2022-03-25,70051,70047,Blue,0,31250,31455,205
2022-11-15,70053,70043,Blue,0,33266,33907,641
2022-11-08,70052,70058,Blue,1,55019,55263,244
2022-06-23,70044,70054,Blue,1,53095,53898,803
2022-01-06,70038,70040,Blue,1,45138,45152,14
2022-03-12,70038,70054,Blue,1,43155,44008,853
2022-07-11,70038,70056,Blue,1,41414,42368,954
2022-03-12,70041,70838,Blue,0,80846,80960,114
2022-12-15,70044,70048,Blue,1,78073,78327,254
2022-05-21,70038,70056,Blue,1,74488,75480,992
2022-01-16,70057,70039,Blue,0,27028,27958,930
2022-03-23,70055,70051,Blue,0,72793,72930,137
2022-03-01,70044,70054,Blue,1,68523,69113,590
2022-10-28,70049,70047,Blue,0,62375,62435,60
2022-09-13,70040,70042,Blue,1,65635,65665,30
2022-12-12,70040,70046,Blue,1,54986,55293,307
2022-02-14,70042,70060,Blue,1,37048,38167,1119
2022-04-02,70055,70041,Blue,0,62357,63047,690
2022-06-09,70055,70053,Blue,0,58286,58334,48
2022-12-21,70049,70838,Blue,0,26773,27429,656
2022-09-23,70048,70054,Blue,1,71507,71810,303
2022-10-08,70059,70053,Blue,0,38957,39179,222
2022-06-26,70059,70051,Blue,0,47899,48239,340
2022-10-04,70044,70046,Blue,1,85973,86078,105
2022-09-25,70049,70043,Blue,0,63871,64216,345
2022-03-22,70052,70060,Blue,1,58791,59150,359
2022-03-09,70046,70056,Blue,1,34516,35039,523
2022-10-05,70042,70048,Blue,1,66013,66303,290
2022-07-29,70056,70060,Blue,1,42850,43033,183
2022-01-24,70042,70054,Blue,1,31597,32362,765
2022-09-03,70048,70060,Blue,1,29606,30204,598
2022-09-27,70059,70047,Blue,0,50025,50621,596
2022-03-16,70038,70042,Blue,1,58021,58123,102
2022-07-25,70041,70838,Blue,0,64359,64483,124
2022-07-23,70040,70042,Blue,1,68066,68098,32
2022-03-07,70044,70054,Blue,1,78215,78845,630
2022-12-31,70059,70041,Blue,0,49234,50179,945
2022-01-16,70053,70043,Blue,0,82520,83089,569
2022-07-10,70055,70051,Blue,0,51321,51458,137
2022-06-15,70056,70060,Blue,1,54120,54595,475
2022-01-21,70055,70053,Blue,0,84810,84868,58
2022-04-19,70038,70056,Blue,1,26745,27725,980
2022-06-19,70056,70058,Blue,1,54222,54296,74
2022-06-30,70042,70048,Blue,1,76981,77348,367
2022-02-12,70059,70043,Blue,0,84021,84882,861
2022-02-10,70047,70838,Blue,0,46146,46652,506
2022-04-08,70059,70049,Blue,0,40572,41114,542
2022-03-28,70042,70046,Blue,1,66561,66723,162
2022-07-31,70054,70056,Blue,1,83205,83253,48
2022-07-05,70042,70056,Blue,1,53447,54243,796
2022-06-18,70055,70051,Blue,0,53472,53603,131
2022-08-28,70042,70052,Blue,1,39177,39758,581
2022-06-03,70040,70044,Blue,1,21491,21602,111
2022-07-17,70038,70058,Blue,1,39669,40675,1006
2022-11-25,70051,70039,Blue,0,51369,52091,722
2022-09-08,70040,70060,Blue,1,61083,62192,1109
2022-12-27,70059,70051,Blue,0,67772,68087,315
2022-09-15,70042,70056,Blue,1,45217,46056,839
2022-10-18,70045,70043,Blue,0,67851,67940,89
2022-02-17,70045,70041,Blue,0,56767,56965,198
2022-06-10,70040,70044,Blue,1,48739,48850,111
2022-12-20,70051,70838,Blue,0,74627,75260,633
2022-10-13,70041,70039,Blue,0,86038,86067,29
2022-09-11,70044,70048,Blue,1,29434,29692,258
2022-03-18,70042,70050,Blue,1,82818,83258,440
2022-11-04,70059,70053,Blue,0,87232,87451,219
2022-08-09,70057,70047,Blue,0,57818,58288,470
2022-07-15,70057,70049,Blue,0,62490,62869,379
2022-11-20,70044,70056,Blue,1,58302,59003,701
2022-12-29,70048,70058,Blue,1,52669,53186,517
2022-02-04,70038,70046,Blue,1,49750,50067,317
2022-07-16,70049,70047,Blue,0,19000,19065,65
2022-10-11,70042,70056,Blue,1,64434,65212,778
2022-09-20,70038,70044,Blue,1,23293,23469,176
2022-09-07,70050,70058,Blue,1,34187,34585,398
2022-01-30,70057,70053,Blue,0,88660,88894,234
2022-11-05,70051,70047,Blue,0,47418,47615,197
2022-04-12,70059,70838,Blue,0,52125,53804,1679
2022-09-26,70042,70060,Blue,1,86209,87183,974
2022-12-22,70059,70051,Blue,0,85460,85803,343
2022-04-26,70057,70047,Blue,0,34093,34715,622
2022-01-18,70044,70056,Blue,1,62286,63089,803
2022-04-24,70044,70058,Blue,1,34900,35709,809
2022-08-03,70053,70838,Blue,0,30005,30990,985
2022-03-22,70040,70054,Blue,1,80990,81834,844
2022-06-28,70053,70049,Blue,0,50203,50398,195
2022-03-25,70043,70838,Blue,0,65092,65282,190
2022-03-18,70053,70039,Blue,0,30236,31038,802
2022-12-26,70048,70050,Blue,1,28888,28945,57
2022-08-20,70049,70041,Blue,0,55120,55570,450
2022-09-02,70043,70041,Blue,0,26433,26462,29
2022-06-21,70038,70042,Blue,1,74721,74817,96
2022-04-22,70050,70054,Blue,1,31455,31667,212
2022-07-30,70040,70054,Blue,1,43228,44004,776
2022-01-26,70048,70054,Blue,1,32793,33064,271
2022-01-12,70040,70046,Blue,1,35100,35384,284
2022-07-06,70055,70041,Blue,0,65129,65882,753
2022-06-03,70042,70044,Blue,1,21570,21602,32
2022-09-16,70040,70054,Blue,1,62383,63281,898
2022-07-23,70048,70060,Blue,1,58267,59058,791
2022-01-07,70045,70043,Blue,0,22601,22691,90
2022-07-31,70048,70058,Blue,1,62355,63072,717
2022-07-02,70040,70048,Blue,1,74009,74484,475
2022-09-15,70053,70047,Blue,0,24524,24819,295
2022-01-06,70038,70044,Blue,1,69429,69616,187
2022-09-07,70058,70060,Blue,1,41921,42028,107
2022-09-13,70055,70043,Blue,0,85347,85983,636
2022-07-17,70044,70052,Blue,1,43281,43820,539
2022-11-10,70049,70039,Blue,0,35349,35863,514
2022-12-28,70050,70052,Blue,1,91674,91790,116
2022-02-09,70049,70838,Blue,0,31680,32295,615
2022-08-12,70047,70043,Blue,0,39811,40090,279
2022-08-27,70047,70043,Blue,0,77341,77652,311
2022-05-28,70042,70048,Blue,1,35201,35590,389
2022-01-09,70040,70050,Blue,1,40452,40980,528
2022-11-08,70047,70043,Blue,0,31473,31722,249
2022-07-27,70048,70060,Blue,1,31030,31713,683
2022-08-20,70051,70049,Blue,0,60916,61018,102
2022-10-24,70041,70039,Blue,0,34916,34951,35
2022-02-05,70044,70056,Blue,1,83983,84654,671
2022-04-22,70052,70054,Blue,1,46520,46570,50
2022-12-01,70049,70838,Blue,0,82840,83410,570
2022-06-19,70042,70044,Blue,1,56272,56301,29
2022-11-11,70038,70050,Blue,1,58579,59218,639
2022-06-16,70040,70044,Blue,1,82070,82188,118
2022-02-07,70055,70053,Blue,0,53853,53900,47
2022-05-11,70050,70060,Blue,1,77849,78385,536
2022-03-25,70048,70058,Blue,1,54862,55412,550
2022-11-28,70059,70039,Blue,0,36767,37771,1004
2022-08-14,70051,70045,Blue,0,24204,24553,349
2022-07-24,70059,70047,Blue,0,59783,60342,559
2022-02-21,70055,70049,Blue,0,54798,55091,293
2022-09-27,70038,70060,Blue,1,87365,88524,1159
2022-11-11,70057,70051,Blue,0,31294,31547,253
2022-04-24,70040,70050,Blue,1,89166,89612,446
2022-06-15,70047,70045,Blue,0,54514,54648,134
2022-11-16,70049,70043,Blue,0,33184,33558,374
2022-07-19,70039,70838,Blue,0,31320,31355,35
2022-01-06,70057,70047,Blue,0,63568,64075,507
2022-04-24,70042,70048,Blue,1,48463,48777,314
2022-08-01,70053,70838,Blue,0,45567,46414,847
2022-06-26,70053,70047,Blue,0,62253,62544,291
2022-07-17,70054,70060,Blue,1,27654,27894,240
2022-08-27,70052,70060,Blue,1,44395,44736,341
2022-08-27,70055,70043,Blue,0,20363,21026,663
2022-09-07,70038,70058,Blue,1,32047,33075,1028
2022-03-30,70051,70045,Blue,0,71885,72239,354
2022-12-21,70040,70052,Blue,1,44551,45215,664
2022-11-09,70046,70050,Blue,1,86922,87091,169
2022-01-17,70040,70044,Blue,1,88261,88374,113
2022-06-18,70040,70056,Blue,1,39981,41047,1066
2022-03-02,70057,70043,Blue,0,28533,29311,778
2022-12-23,70057,70043,Blue,0,26414,27301,887
2022-12-12,70046,70048,Blue,1,62669,62746,77
2022-05-21,70048,70054,Blue,1,67980,68291,311
2022-01-11,70046,70052,Blue,1,28877,29205,328
2022-12-03,70059,70039,Blue,0,44459,45520,1061
2022-12-09,70055,70838,Blue,0,76631,77504,873
2022-08-15,70043,70039,Blue,0,50997,51148,151
2022-03-29,70044,70058,Blue,1,30493,31296,803
2022-12-07,70047,70043,Blue,0,39532,39775,243
2022-07-27,70045,70043,Blue,0,56487,56585,98
2022-12-20,70043,70041,Blue,0,85896,85923,27
2022-02-18,70059,70053,Blue,0,28153,28408,255
2022-12-23,70040,70056,Blue,1,60318,61189,871
2022-01-22,70042,70044,Blue,1,75690,75722,32
2022-10-13,70056,70058,Blue,1,87396,87473,77
2022-04-11,70052,70058,Blue,1,46231,46484,253
2022-12-31,70052,70058,Blue,1,37949,38229,280
2022-04-23,70047,70043,Blue,0,61699,61965,266
2022-03-12,70055,70053,Blue,0,40403,40450,47
2022-01-15,70046,70048,Blue,1,51684,51759,75
2022-05-05,70058,70060,Blue,1,28203,28270,67
2022-10-08,70057,70049,Blue,0,53607,53986,379
2022-03-01,70042,70058,Blue,1,79959,80863,904
2022-02-26,70054,70056,Blue,1,64531,64577,46
2022-06-17,70046,70058,Blue,1,79019,79654,635
2022-09-04,70055,70041,Blue,0,63742,64506,764
2022-06-21,70042,70058,Blue,1,26728,27964,1236
2022-05-24,70042,70050,Blue,1,38615,39067,452
2022-11-04,70044,70054,Blue,1,48888,49570,682
2022-04-13,70053,70039,Blue,0,87147,87793,646
2022-04-01,70044,70058,Blue,1,31742,32786,1044
2022-12-07,70051,70047,Blue,0,86158,86355,197
2022-03-17,70056,70058,Blue,1,47999,48077,78
2022-03-11,70039,70838,Blue,0,75418,75452,34
2022-08-20,70057,70041,Blue,0,60104,61017,913
2022-08-05,70046,70054,Blue,1,84477,84969,492
2022-07-22,70049,70045,Blue,0,79020,79209,189
2022-09-06,70049,70041,Blue,0,84843,85228,385
2022-08-31,70059,70041,Blue,0,44296,45189,893
2022-10-13,70051,70838,Blue,0,32221,32986,765
2022-10-23,70051,70041,Blue,0,50398,50936,538
2022-12-14,70042,70044,Blue,1,58468,58498,30
2022-06-22,70057,70053,Blue,0,33155,33309,154
2022-06-27,70059,70053,Blue,0,73831,74093,262
2022-10-28,70050,70052,Blue,1,35895,36019,124
2022-03-20,70048,70056,Blue,1,57438,57823,385
2022-08-12,70040,70046,Blue,1,39923,40166,243
2022-10-04,70059,70043,Blue,0,40372,41309,937
2022-04-24,70038,70048,Blue,1,54258,54755,497
2022-07-04,70048,70050,Blue,1,58198,58254,56
2022-02-19,70048,70054,Blue,1,50699,51018,319
2022-09-02,70057,70051,Blue,0,20014,20257,243
2022-06-13,70040,70052,Blue,1,23700,24385,685
2022-11-12,70050,70058,Blue,1,65992,66403,411
2022-03-01,70057,70043,Blue,0,77259,78225,966
2022-09-04,70052,70056,Blue,1,60441,60577,136
2022-11-18,70042,70050,Blue,1,23682,24123,441
2022-02-26,70046,70058,Blue,1,48476,49152,676
2022-07-01,70048,70050,Blue,1,74574,74635,61
2022-02-10,70046,70056,Blue,1,67697,68271,574
2022-07-06,70042,70060,Blue,1,56548,57587,1039
2022-06-09,70046,70056,Blue,1,69893,70514,621
2022-08-15,70053,70041,Blue,0,36177,36880,703
2022-01-06,70041,70039,Blue,0,54365,54429,64
2022-01-07,70054,70056,Blue,1,34792,34844,52
2022-11-29,70049,70039,Blue,0,20491,21016,525
2022-04-08,70042,70048,Blue,1,35849,36239,390
2022-12-03,70042,70050,Blue,1,38433,38830,397
2022-03-25,70050,70054,Blue,1,20444,20669,225
2022-02-17,70044,70058,Blue,1,70117,70861,744
2022-01-14,70045,70043,Blue,0,57677,57776,99
2022-11-28,70053,70041,Blue,0,28237,28971,734
2022-12-03,70050,70052,Blue,1,57924,58029,105
2022-08-06,70038,70044,Blue,1,43151,43342,191
2022-09-24,70049,70838,Blue,0,56749,57401,652
2022-01-10,70040,70060,Blue,1,49812,50840,1028
2022-01-23,70059,70041,Blue,0,88226,89315,1089
2022-03-16,70044,70052,Blue,1,37560,38117,557
2022-07-27,70038,70048,Blue,1,40900,41346,446
2022-02-07,70052,70060,Blue,1,60078,60466,388
2022-12-12,70046,70054,Blue,1,45036,45516,480
2022-09-24,70059,70051,Blue,0,26001,26350,349
2022-02-02,70051,70047,Blue,0,65947,66147,200
2022-12-03,70044,70054,Blue,1,30947,31552,605
2022-12-23,70047,70039,Blue,0,59611,60056,445
2022-03-06,70055,70041,Blue,0,69131,69884,753
2022-02-18,70058,70060,Blue,1,80881,80951,70
2022-08-03,70049,70045,Blue,0,31500,31707,207
2022-10-06,70043,70838,Blue,0,19444,19680,236
2022-07-23,70044,70052,Blue,1,49988,50509,521
2022-11-09,70056,70058,Blue,1,61595,61668,73
2022-02-18,70057,70049,Blue,0,58171,58559,388
2022-10-13,70050,70054,Blue,1,64874,65092,218
2022-11-09,70038,70050,Blue,1,78363,78912,549
2022-02-13,70055,70045,Blue,0,45566,46094,528
2022-09-05,70040,70044,Blue,1,28513,28616,103
2022-10-20,70039,70838,Blue,0,43731,43778,47
2022-03-29,70044,70058,Blue,1,46012,46771,759
2022-08-11,70038,70050,Blue,1,55200,55756,556
2022-07-14,70043,70041,Blue,0,27381,27417,36
2022-03-14,70043,70838,Blue,0,54432,54658,226
2022-09-18,70051,70041,Blue,0,63511,64442,931
2022-08-05,70048,70056,Blue,1,49191,49601,410
2022-04-22,70059,70057,Blue,0,20958,20996,38
2022-11-18,70057,70039,Blue,0,72887,73857,970
2022-07-23,70055,70049,Blue,0,27265,27550,285
2022-01-21,70049,70039,Blue,0,32700,33338,638
2022-12-05,70045,70838,Blue,0,73528,73854,326
2022-06-10,70053,70838,Blue,0,37981,38948,967
2022-10-04,70042,70050,Blue,1,60372,60796,424
2022-08-01,70050,70054,Blue,1,73740,74005,265
2022-10-25,70057,70047,Blue,0,24906,25438,532
2022-10-09,70059,70041,Blue,0,53289,54184,895
2022-08-12,70038,70056,Blue,1,41066,42019,953
2022-02-08,70059,70053,Blue,0,58108,58357,249
2022-09-22,70043,70838,Blue,0,61283,61492,209
2022-11-07,70057,70049,Blue,0,88308,88693,385
2022-08-13,70042,70050,Blue,1,64363,64818,455
2022-01-29,70048,70054,Blue,1,48261,49044,783
2022-12-16,70047,70045,Blue,0,29581,29681,100
2022-01-20,70042,70060,Blue,1,73736,74693,957
2022-10-08,70042,70060,Blue,1,28251,29219,968
2022-01-23,70046,70048,Blue,1,61623,61707,84
2022-08-23,70053,70041,Blue,0,44021,44757,736
2022-07-17,70051,70047,Blue,0,42498,42688,190
2022-09-06,70044,70046,Blue,1,73604,73709,105
2022-06-05,70045,70039,Blue,0,33174,33463,289
2022-12-27,70046,70058,Blue,1,48503,49126,623
2022-06-28,70059,70041,Blue,0,83606,84572,966
2022-09-02,70039,70838,Blue,0,54912,54947,35
2022-03-31,70053,70045,Blue,0,59279,59727,448
2022-04-03,70059,70055,Blue,0,77601,77739,138
2022-07-06,70053,70045,Blue,0,21094,21521,427
2022-10-27,70049,70838,Blue,0,25579,26192,613
2022-10-12,70057,70041,Blue,0,66638,67540,902
2022-10-02,70057,70055,Blue,0,42872,42941,69
2022-10-08,70049,70039,Blue,0,24032,24555,523
2022-02-07,70046,70050,Blue,1,39961,40125,164
2022-12-09,70051,70049,Blue,0,78538,78640,102
2022-03-28,70046,70058,Blue,1,59336,60044,708
2022-11-08,70050,70056,Blue,1,23495,23782,287
2022-03-13,70059,70047,Blue,0,52216,52786,570
2022-10-28,70047,70043,Blue,0,73412,73669,257
2022-01-26,70052,70054,Blue,1,69061,69114,53
2022-01-18,70042,70048,Blue,1,83930,84258,328
2022-01-06,70038,70046,Blue,1,55058,55429,371
2022-02-22,70049,70039,Blue,0,83379,83958,579
2022-02-25,70038,70044,Blue,1,64930,65123,193
2022-02-03,70044,70054,Blue,1,38355,39004,649
2022-04-15,70057,70838,Blue,0,27630,28838,1208
2022-04-21,70053,70049,Blue,0,31407,31625,218
2022-03-11,70055,70043,Blue,0,27733,28407,674
2022-06-23,70042,70060,Blue,1,79241,80351,1110
2022-03-12,70057,70047,Blue,0,27150,27665,515
2022-03-11,70047,70045,Blue,0,23760,23873,113
2022-01-26,70044,70060,Blue,1,27472,28440,968
2022-01-16,70041,70838,Blue,0,63993,64118,125
2022-07-19,70057,70053,Blue,0,20908,21056,148
2022-09-23,70053,70039,Blue,0,35878,36744,866
2022-03-06,70038,70060,Blue,1,31577,32579,1002
2022-01-31,70059,70043,Blue,0,47552,48478,926
2022-12-24,70053,70049,Blue,0,59204,59398,194
2022-02-18,70057,70043,Blue,0,67945,68762,817
2022-10-05,70042,70048,Blue,1,20031,20352,321
2022-08-03,70045,70039,Blue,0,71586,71833,247
2022-10-25,70040,70044,Blue,1,34248,34351,103
2022-11-05,70049,70043,Blue,0,29174,29490,316
2022-01-12,70042,70052,Blue,1,21533,22072,539
2022-05-16,70050,70056,Blue,1,56599,56904,305
2022-01-13,70059,70039,Blue,0,19528,20644,1116
2022-03-16,70042,70058,Blue,1,39735,40570,835
2022-10-01,70044,70058,Blue,1,37972,38769,797
2022-04-10,70042,70054,Blue,1,60901,61556,655
2022-10-20,70055,70049,Blue,0,32727,33060,333
2022-04-29,70052,70054,Blue,1,21758,21814,56
2022-01-01,70057,70055,Blue,0,33399,33468,69
2022-02-10,70042,70054,Blue,1,66163,66837,674
2022-04-13,70050,70060,Blue,1,23343,23885,542
2022-09-23,70059,70045,Blue,0,63009,63707,698
2022-05-18,70044,70048,Blue,1,54348,54667,319
2022-12-31,70059,70045,Blue,0,39500,40255,755
2022-12-27,70047,70838,Blue,0,67885,68349,464
2022-10-06,70042,70056,Blue,1,64412,65170,758
2022-08-01,70055,70041,Blue,0,34569,35319,750
2022-01-03,70044,70058,Blue,1,61633,62396,763
2022-06-17,70059,70049,Blue,0,80055,80511,456
2022-10-11,70050,70052,Blue,1,73753,73871,118
2022-10-17,70046,70060,Blue,1,69891,70686,795
2022-02-05,70042,70048,Blue,1,68149,68452,303
2022-02-01,70055,70838,Blue,0,57378,58282,904
2022-01-23,70054,70058,Blue,1,40541,40688,147
2022-01-04,70049,70041,Blue,0,25119,25528,409
2022-01-03,70056,70060,Blue,1,83499,83673,174
2022-06-09,70045,70043,Blue,0,30558,30690,132
2022-07-24,70059,70838,Blue,0,30075,31215,1140
2022-06-29,70048,70054,Blue,1,22800,23125,325
2022-06-14,70058,70060,Blue,1,65843,65922,79
2022-01-31,70050,70052,Blue,1,30569,30703,134
2022-12-01,70045,70041,Blue,0,60646,60832,186
2022-03-18,70058,70060,Blue,1,54743,55094,351
2022-12-07,70038,70052,Blue,1,43511,44296,785
2022-08-31,70056,70060,Blue,1,78532,78713,181
2022-04-20,70051,70043,Blue,0,54631,55096,465
2022-02-17,70049,70043,Blue,0,68398,68781,383
2022-01-06,70057,70055,Blue,0,62979,63049,70
2022-06-09,70038,70046,Blue,1,30001,30381,380
2022-06-18,70042,70046,Blue,1,46548,46778,230
2022-08-03,70053,70047,Blue,0,48095,48396,301
2022-12-16,70044,70058,Blue,1,48487,49279,792
2022-11-16,70046,70048,Blue,1,61067,61147,80
2022-03-20,70049,70039,Blue,0,48412,49051,639
2022-03-10,70042,70048,Blue,1,54248,54579,331
2022-12-03,70045,70838,Blue,0,87315,87646,331
2022-07-21,70045,70039,Blue,0,33941,34197,256
2022-03-15,70052,70056,Blue,1,45357,45494,137
2022-07-11,70048,70060,Blue,1,28438,29106,668
2022-10-09,70053,70045,Blue,0,53547,53957,410
2022-06-06,70049,70047,Blue,0,42194,42254,60
2022-02-01,70040,70050,Blue,1,30906,31442,536
2022-04-07,70051,70039,Blue,0,58486,59123,637
2022-08-14,70040,70050,Blue,1,59737,60289,552
2022-10-03,70038,70040,Blue,1,29943,29959,16
2022-08-10,70052,70058,Blue,1,45501,45769,268
2022-09-23,70057,70047,Blue,0,28532,29026,494
2022-02-07,70038,70052,Blue,1,28754,29437,683
2022-01-27,70040,70060,Blue,1,58407,59495,1088
2022-07-01,70059,70838,Blue,0,69396,70703,1307
2022-02-28,70043,70039,Blue,0,47067,47182,115
2022-03-15,70043,70838,Blue,0,24141,24578,437
2022-07-12,70057,70043,Blue,0,63110,63905,795
2022-02-12,70050,70060,Blue,1,76156,76650,494
2022-08-11,70059,70043,Blue,0,19518,20483,965
2022-12-10,70038,70058,Blue,1,72314,73410,1096
2022-03-08,70041,70039,Blue,0,56062,56090,28
2022-12-18,70042,70048,Blue,1,86556,86865,309
2022-10-18,70052,70056,Blue,1,86469,86609,140
2022-04-23,70056,70058,Blue,1,78196,78267,71
2022-07-21,70042,70044,Blue,1,54692,54725,33
2022-08-11,70040,70046,Blue,1,57248,57530,282
2022-11-29,70049,70838,Blue,0,65492,66080,588
2022-06-24,70040,70052,Blue,1,58062,58829,767
2022-02-21,70046,70050,Blue,1,45169,45360,191
2022-06-17,70051,70049,Blue,0,78262,78364,102
2022-02-04,70038,70054,Blue,1,27619,28358,739
2022-12-01,70040,70042,Blue,1,78438,78471,33
2022-08-12,70057,70053,Blue,0,78495,78645,150
2022-09-14,70038,70058,Blue,1,30431,31507,1076
2022-11-01,70044,70058,Blue,1,72304,73092,788
2022-11-04,70057,70045,Blue,0,52779,53473,694
2022-09-12,70054,70058,Blue,1,89095,89252,157
2022-09-20,70053,70043,Blue,0,39822,40442,620
2022-08-13,70038,70044,Blue,1,44235,44435,200
2022-10-10,70050,70052,Blue,1,47680,47798,118
2022-10-17,70053,70051,Blue,0,26194,26253,59
2022-10-09,70057,70838,Blue,0,59320,60408,1088
2022-01-23,70059,70838,Blue,0,37515,38652,1137
2022-02-02,70042,70048,Blue,1,77550,77841,291
2022-02-14,70054,70060,Blue,1,68452,68737,285
2022-11-29,70041,70039,Blue,0,55040,55123,83
2022-05-24,70044,70046,Blue,1,22995,23140,145
2022-12-26,70048,70056,Blue,1,54773,55188,415
2022-12-12,70038,70044,Blue,1,42640,42824,184
2022-12-21,70038,70040,Blue,1,31870,31886,16
2022-03-16,70042,70048,Blue,1,87262,87591,329
2022-11-11,70055,70045,Blue,0,21880,22467,587
2022-04-18,70042,70048,Blue,1,34898,35215,317
2022-12-06,70046,70058,Blue,1,31882,32533,651
2022-11-04,70038,70058,Blue,1,31729,33594,1865
2022-07-02,70040,70056,Blue,1,72407,73304,897
2022-09-24,70052,70054,Blue,1,43880,43933,53
2022-10-25,70045,70838,Blue,0,67631,67932,301
2022-09-17,70040,70048,Blue,1,45421,45800,379
2022-08-31,70040,70056,Blue,1,31748,32637,889
2022-09-28,70047,70838,Blue,0,60964,61480,516
2022-02-25,70044,70050,Blue,1,85168,85525,357
2022-11-07,70059,70057,Blue,0,44366,44401,35
2022-04-15,70046,70048,Blue,1,24890,24973,83
2022-07-02,70042,70048,Blue,1,35198,35511,313
2022-09-29,70040,70052,Blue,1,26160,26830,670
2022-04-01,70043,70039,Blue,0,31235,31356,121
2022-12-30,70046,70058,Blue,1,87388,87998,610
2022-03-02,70042,70046,Blue,1,44281,44459,178
2022-07-29,70057,70053,Blue,0,86908,87111,203
2022-06-19,70051,70049,Blue,0,64432,64533,101
2022-05-18,70057,70051,Blue,0,23920,24160,240
2022-06-27,70051,70045,Blue,0,28383,28723,340
2022-11-15,70055,70039,Blue,0,41800,42722,922
2022-04-24,70057,70051,Blue,0,47971,48217,246
2022-12-30,70038,70056,Blue,1,22848,23666,818
2022-07-01,70058,70060,Blue,1,70691,70757,66
2022-07-01,70048,70056,Blue,1,83925,84398,473
2022-06-01,70048,70052,Blue,1,84499,84861,362
2022-05-21,70046,70052,Blue,1,42084,42424,340
2022-11-11,70055,70053,Blue,0,27385,27432,47
2022-12-25,70042,70044,Blue,1,50633,50665,32
2022-07-09,70053,70047,Blue,0,32312,32648,336
2022-04-07,70038,70060,Blue,1,22148,23299,1151
2022-08-01,70042,70046,Blue,1,31694,31868,174
2022-12-15,70055,70043,Blue,0,31485,32200,715
2022-01-24,70053,70838,Blue,0,71250,72110,860
2022-01-17,70047,70039,Blue,0,88855,89409,554
2022-01-15,70038,70046,Blue,1,60651,61039,388
2022-12-05,70054,70056,Blue,1,43483,43531,48
2022-02-26,70057,70051,Blue,0,38508,38794,286
2022-01-15,70053,70049,Blue,0,68390,68641,251
2022-11-19,70052,70054,Blue,1,43294,43342,48
2022-03-19,70050,70056,Blue,1,39441,39723,282
2022-03-27,70046,70058,Blue,1,24191,24780,589
2022-07-30,70057,70047,Blue,0,21568,22097,529
2022-11-20,70055,70838,Blue,0,80418,81302,884
2022-03-03,70051,70045,Blue,0,86695,87033,338
2022-01-07,70042,70044,Blue,1,58109,58139,30
2022-03-23,70055,70039,Blue,0,50900,51735,835
2022-11-29,70038,70052,Blue,1,89106,89796,690
2022-10-14,70047,70039,Blue,0,75513,75918,405
2022-07-15,70051,70043,Blue,0,78742,79245,503
2022-09-21,70055,70039,Blue,0,39204,40158,954
2022-07-23,70044,70058,Blue,1,66614,67460,846
2022-06-05,70038,70050,Blue,1,85107,85744,637
2022-03-07,70054,70060,Blue,1,68143,68411,268
2022-12-13,70038,70054,Blue,1,25242,26026,784
2022-02-24,70046,70060,Blue,1,67447,68225,778
2022-12-04,70059,70045,Blue,0,78261,78954,693
2022-08-21,70045,70041,Blue,0,61606,61788,182
2022-11-28,70048,70056,Blue,1,56528,56896,368
2022-09-07,70057,70041,Blue,0,32312,33165,853
2022-04-04,70052,70058,Blue,1,66561,66811,250
2022-04-24,70045,70838,Blue,0,57313,57657,344
2022-03-26,70059,70045,Blue,0,65968,66690,722
2022-11-12,70059,70055,Blue,0,42202,42348,146
2022-04-13,70045,70039,Blue,0,34477,34762,285
2022-02-09,70038,70052,Blue,1,71947,72668,721
2022-08-04,70042,70058,Blue,1,32279,33202,923
2022-12-16,70053,70041,Blue,0,22656,23421,765
2022-06-22,70053,70838,Blue,0,60260,61141,881
2022-05-12,70059,70047,Blue,0,33492,34150,658
2022-02-27,70048,70056,Blue,1,87824,88278,454
2022-06-14,70038,70048,Blue,1,58366,58879,513
2022-10-29,70040,70044,Blue,1,32407,32520,113
2022-09-04,70053,70043,Blue,0,36279,37222,943
2022-08-23,70057,70053,Blue,0,41060,41295,235
2022-01-25,70056,70060,Blue,1,85184,85385,201
2022-05-08,70057,70053,Blue,0,46290,46443,153
2022-04-14,70041,70039,Blue,0,34155,34193,38
2022-04-06,70051,70041,Blue,0,28897,29559,662
2022-06-06,70040,70046,Blue,1,56549,56835,286
2022-02-02,70058,70060,Blue,1,30080,30176,96
2022-07-26,70059,70053,Blue,0,60921,61144,223
2022-01-08,70049,70039,Blue,0,68659,69193,534
2022-09-12,70040,70058,Blue,1,40981,41866,885
2022-11-05,70050,70058,Blue,1,73369,73793,424
2022-01-03,70054,70056,Blue,1,33489,33537,48
2022-12-02,70040,70050,Blue,1,21850,22309,459
2022-05-28,70041,70039,Blue,0,64409,64444,35
2022-10-18,70055,70051,Blue,0,78321,78450,129
2022-03-07,70053,70838,Blue,0,20848,21616,768
2022-09-01,70047,70045,Blue,0,88734,88821,87
2022-05-12,70059,70055,Blue,0,45320,45463,143
2022-04-20,70051,70043,Blue,0,18735,19316,581
2022-12-01,70044,70048,Blue,1,43377,43628,251
2022-10-06,70042,70054,Blue,1,24955,25653,698
2022-01-14,70052,70058,Blue,1,42582,42830,248
2022-04-12,70059,70051,Blue,0,29360,29698,338
2022-08-28,70059,70057,Blue,0,42797,42832,35
2022-09-07,70051,70039,Blue,0,84541,85195,654
2022-04-08,70055,70838,Blue,0,59788,60675,887
2022-12-04,70055,70045,Blue,0,46232,46775,543
2022-03-21,70055,70045,Blue,0,65785,66335,550
2022-08-31,70042,70060,Blue,1,25862,26789,927
2022-01-20,70053,70047,Blue,0,20547,20887,340
2022-10-20,70038,70052,Blue,1,60817,61612,795
2022-05-29,70044,70052,Blue,1,23355,23989,634
2022-05-19,70052,70054,Blue,1,79616,79692,76
2022-01-05,70055,70045,Blue,0,25121,25775,654
2022-09-28,70053,70039,Blue,0,46550,47315,765
2022-07-25,70040,70060,Blue,1,22273,23277,1004
2022-02-07,70040,70042,Blue,1,56996,57031,35
2022-09-12,70053,70041,Blue,0,63467,64086,619
2022-10-31,70053,70041,Blue,0,82331,82939,608
2022-07-01,70042,70058,Blue,1,27452,28346,894
2022-12-21,70053,70043,Blue,0,34378,34933,555
2022-03-02,70058,70060,Blue,1,51905,51977,72
2022-09-07,70055,70045,Blue,0,58410,58951,541
2022-12-30,70047,70045,Blue,0,46140,46236,96
2022-01-16,70059,70838,Blue,0,82994,84112,1118
2022-12-27,70038,70058,Blue,1,55875,56854,979
2022-04-14,70059,70051,Blue,0,76041,76403,362
2022-09-16,70040,70052,Blue,1,72154,72792,638
2022-02-18,70047,70045,Blue,0,74371,74479,108
2022-06-24,70053,70043,Blue,0,58585,59168,583
2022-09-04,70054,70056,Blue,1,38043,38089,46
2022-08-15,70049,70039,Blue,0,44774,45301,527
2022-07-26,70057,70041,Blue,0,79475,80325,850
2022-08-23,70056,70060,Blue,1,67792,67984,192
2022-02-22,70049,70039,Blue,0,47251,47774,523
2022-10-18,70046,70052,Blue,1,42642,42978,336
2022-10-16,70057,70049,Blue,0,71733,72162,429
2022-12-08,70057,70039,Blue,0,26357,27380,1023
2022-08-21,70057,70045,Blue,0,65249,65865,616
2022-03-28,70052,70058,Blue,1,34365,34627,262
2022-10-25,70047,70039,Blue,0,32507,32976,469
2022-01-06,70045,70041,Blue,0,66392,66558,166
2022-09-20,70046,70050,Blue,1,58993,59174,181
2022-05-01,70059,70053,Blue,0,40222,40454,232
2022-02-25,70049,70838,Blue,0,51232,51815,583
2022-07-05,70045,70838,Blue,0,26860,27243,383
2022-08-31,70047,70838,Blue,0,44402,44887,485
2022-10-25,70042,70054,Blue,1,43653,44344,691
2022-10-25,70042,70060,Blue,1,55074,56117,1043
2022-09-20,70038,70040,Blue,1,73212,73227,15
2022-01-18,70052,70058,Blue,1,73863,74125,262
2022-03-06,70046,70058,Blue,1,64345,64994,649
2022-07-14,70047,70838,Blue,0,80562,81098,536
2022-09-03,70045,70039,Blue,0,30003,30295,292
2022-07-28,70059,70041,Blue,0,19517,20500,983
2022-08-09,70059,70049,Blue,0,57197,57678,481
2022-09-02,70055,70053,Blue,0,53245,53291,46
2022-05-18,70040,70056,Blue,1,25455,26508,1053
2022-02-05,70044,70058,Blue,1,53620,54377,757
2022-09-13,70051,70043,Blue,0,33884,34447,563
2022-04-24,70051,70047,Blue,0,62877,63069,192
2022-11-24,70051,70045,Blue,0,74195,74560,365
2022-11-05,70049,70039,Blue,0,81230,81748,518
2022-01-19,70046,70054,Blue,1,43481,43979,498
2022-09-03,70040,70052,Blue,1,85598,86310,712
2022-07-10,70046,70052,Blue,1,42052,42370,318
2022-03-31,70038,70042,Blue,1,59235,59341,106
2022-10-24,70038,70056,Blue,1,39936,40985,1049
2022-07-25,70055,70049,Blue,0,32841,33128,287
2022-07-02,70057,70041,Blue,0,78513,79362,849
2022-09-10,70044,70058,Blue,1,64459,65237,778
2022-07-12,70046,70056,Blue,1,24352,24873,521
2022-12-07,70051,70041,Blue,0,63905,64438,533
2022-03-08,70053,70049,Blue,0,39562,39812,250
2022-07-02,70057,70041,Blue,0,20925,21804,879
2022-09-30,70053,70043,Blue,0,54232,54868,636
2022-03-05,70059,70045,Blue,0,79095,79778,683
2022-08-01,70056,70060,Blue,1,85212,85380,168
2022-08-11,70055,70039,Blue,0,81514,82334,820
2022-07-14,70057,70055,Blue,0,62452,62522,70
2022-11-18,70049,70047,Blue,0,41215,41288,73
2022-03-19,70040,70052,Blue,1,25036,25745,709
2022-03-20,70038,70046,Blue,1,37703,38029,326
2022-01-05,70038,70048,Blue,1,29055,29483,428
2022-03-18,70059,70051,Blue,0,61994,62315,321
2022-12-31,70050,70058,Blue,1,92310,92732,422
2022-08-07,70042,70056,Blue,1,87570,88356,786
2022-02-19,70057,70055,Blue,0,81612,81682,70
2022-04-06,70059,70047,Blue,0,34161,34748,587
2022-06-05,70038,70044,Blue,1,80113,80296,183
2022-01-11,70057,70051,Blue,0,22844,23147,303
2022-11-24,70051,70047,Blue,0,86810,87003,193
2022-08-31,70059,70039,Blue,0,29615,30724,1109
2022-03-02,70040,70054,Blue,1,53132,53970,838
2022-11-11,70043,70041,Blue,0,52009,52040,31
2022-09-12,70042,70046,Blue,1,43317,43502,185
2022-04-08,70052,70060,Blue,1,85160,85557,397
2022-04-06,70053,70039,Blue,0,41247,42083,836
2022-08-03,70047,70043,Blue,0,62994,63256,262
2022-03-24,70044,70050,Blue,1,57978,58364,386
2022-03-14,70050,70052,Blue,1,72537,72651,114
2022-11-16,70043,70041,Blue,0,31411,31440,29
2022-04-22,70045,70838,Blue,0,51471,51870,399
2022-12-22,70042,70048,Blue,1,53366,53684,318
2022-09-08,70055,70041,Blue,0,50592,51332,740
2022-04-11,70050,70054,Blue,1,66405,66598,193
2022-10-30,70055,70043,Blue,0,83169,83793,624
2022-01-12,70051,70838,Blue,0,22264,23034,770
2022-03-17,70046,70060,Blue,1,43353,44036,683
2022-07-24,70042,70050,Blue,1,30928,31321,393
2022-11-14,70042,70048,Blue,1,55759,56135,376
2022-11-11,70055,70039,Blue,0,80222,81054,832
2022-01-14,70057,70055,Blue,0,45042,45111,69
2022-01-15,70057,70053,Blue,0,82408,82593,185
2022-11-26,70059,70838,Blue,0,88219,89606,1387
2022-10-01,70040,70042,Blue,1,47018,47051,33
2022-04-04,70059,70057,Blue,0,40399,40434,35
2022-03-14,70038,70044,Blue,1,45796,45962,166
2022-01-11,70057,70047,Blue,0,76114,76644,530
2022-06-25,70042,70054,Blue,1,36277,36999,722
2022-04-14,70044,70054,Blue,1,66984,67562,578
2022-07-29,70055,70049,Blue,0,55821,56097,276
2022-11-28,70050,70056,Blue,1,74181,74461,280
2022-07-07,70050,70058,Blue,1,58893,59341,448
2022-10-17,70055,70049,Blue,0,37179,37562,383
2022-04-11,70057,70041,Blue,0,28237,29218,981
2022-04-16,70038,70056,Blue,1,64208,65138,930
2022-07-06,70040,70048,Blue,1,53698,54230,532
2022-07-12,70044,70046,Blue,1,31596,31784,188
2022-02-23,70047,70838,Blue,0,56303,56962,659
2022-10-07,70038,70052,Blue,1,31123,31833,710
2022-10-17,70059,70053,Blue,0,44033,44303,270
2022-10-22,70048,70050,Blue,1,77822,77882,60
2022-08-01,70049,70045,Blue,0,59798,59985,187
2022-11-01,70044,70046,Blue,1,85524,85635,111
2022-11-12,70046,70048,Blue,1,77673,77752,79
2022-03-10,70059,70043,Blue,0,24252,25127,875
2022-03-26,70057,70043,Blue,0,65502,66242,740
2022-01-19,70049,70039,Blue,0,54385,54900,515
2022-02-19,70039,70838,Blue,0,84271,84305,34
2022-08-23,70043,70041,Blue,0,38522,38552,30
2022-12-06,70038,70054,Blue,1,78315,79117,802
2022-01-20,70049,70047,Blue,0,76587,76646,59
2022-09-08,70051,70045,Blue,0,70056,70397,341
2022-06-21,70057,70041,Blue,0,64497,65378,881
2022-12-23,70040,70060,Blue,1,27376,28555,1179
2022-09-04,70052,70054,Blue,1,88952,89008,56
2022-03-20,70050,70056,Blue,1,25202,25498,296
2022-09-30,70042,70056,Blue,1,77647,78441,794
2022-02-12,70052,70060,Blue,1,29308,29648,340
2022-06-16,70044,70056,Blue,1,64636,65449,813
2022-04-12,70055,70041,Blue,0,30461,31263,802
2022-01-25,70051,70047,Blue,0,55176,55413,237
2022-04-20,70055,70039,Blue,0,22231,23143,912
2022-03-11,70051,70045,Blue,0,50721,51060,339
2022-08-25,70057,70049,Blue,0,84861,85245,384
2022-04-11,70043,70039,Blue,0,25842,25971,129
2022-07-26,70038,70058,Blue,1,59182,60310,1128
2022-10-30,70052,70054,Blue,1,61585,61642,57
2022-02-02,70056,70058,Blue,1,35207,35277,70
2022-02-04,70038,70042,Blue,1,44719,44822,103
2022-02-15,70057,70053,Blue,0,29074,29250,176
2022-08-06,70040,70052,Blue,1,37268,37903,635
2022-11-03,70053,70049,Blue,0,62736,62933,197
2022-01-14,70048,70058,Blue,1,34114,34641,527
2022-01-10,70046,70060,Blue,1,80137,80872,735
2022-01-08,70047,70838,Blue,0,40923,41393,470
2022-07-16,70042,70050,Blue,1,70447,70880,433
2022-08-29,70045,70039,Blue,0,25120,25404,284
2022-12-25,70040,70056,Blue,1,33184,33925,741
2022-11-22,70046,70050,Blue,1,88576,88755,179
2022-07-02,70051,70039,Blue,0,34436,35045,609
2022-10-16,70046,70058,Blue,1,81412,82025,613
2022-12-16,70043,70039,Blue,0,78433,78549,116
2022-03-01,70040,70042,Blue,1,32719,32753,34
2022-10-29,70051,70049,Blue,0,49014,49115,101
2022-05-18,70041,70838,Blue,0,77784,77907,123
2022-01-24,70055,70039,Blue,0,50987,51865,878
2022-11-10,70053,70045,Blue,0,28272,28768,496
2022-10-14,70038,70040,Blue,1,84423,84437,14
2022-08-22,70059,70045,Blue,0,36390,37133,743
2022-05-21,70047,70043,Blue,0,84702,85059,357
2022-12-18,70059,70049,Blue,0,40154,40633,479
2022-08-10,70059,70838,Blue,0,34397,35549,1152
2022-02-04,70055,70043,Blue,0,54398,55061,663
2022-09-23,70055,70838,Blue,0,69324,70323,999
2022-04-06,70042,70056,Blue,1,50926,51806,880
2022-03-11,70048,70052,Blue,1,44694,44939,245
2022-02-20,70056,70058,Blue,1,80143,80215,72
2022-09-29,70044,70050,Blue,1,44891,45223,332
2022-10-16,70048,70060,Blue,1,35186,35787,601
2022-11-06,70042,70058,Blue,1,27062,27893,831
2022-11-24,70055,70047,Blue,0,45932,46306,374
2022-01-07,70042,70060,Blue,1,23484,24689,1205
2022-12-15,70050,70052,Blue,1,52548,52664,116
2022-04-20,70055,70045,Blue,0,46808,47319,511
2022-04-09,70040,70060,Blue,1,47548,48628,1080
2022-10-03,70059,70045,Blue,0,76453,77178,725
2022-01-30,70042,70048,Blue,1,80568,80917,349
2022-07-06,70048,70050,Blue,1,53381,53439,58
2022-10-16,70038,70056,Blue,1,65052,65969,917
2022-03-09,70052,70058,Blue,1,29519,29758,239
2022-04-16,70059,70049,Blue,0,29238,29716,478
2022-01-28,70053,70838,Blue,0,26704,27660,956
2022-03-25,70042,70054,Blue,1,60581,61434,853
2022-10-16,70051,70045,Blue,0,77564,77903,339
2022-02-02,70054,70056,Blue,1,81204,81251,47
2022-02-10,70046,70052,Blue,1,54736,55078,342
2022-10-30,70042,70058,Blue,1,51219,52110,891
2022-03-03,70042,70044,Blue,1,82857,82888,31
2022-06-13,70051,70045,Blue,0,56670,57005,335
2022-02-15,70048,70054,Blue,1,33413,33685,272
2022-04-13,70057,70055,Blue,0,47194,47263,69
2022-09-29,70042,70058,Blue,1,50852,51726,874
2022-04-05,70054,70058,Blue,1,30165,30313,148
2022-07-05,70044,70050,Blue,1,56323,56692,369
2022-11-01,70058,70060,Blue,1,24667,24742,75
2022-09-19,70049,70045,Blue,0,71151,71362,211
2022-06-17,70044,70054,Blue,1,67276,67905,629
2022-09-12,70055,70053,Blue,0,75651,75697,46
2022-04-24,70042,70060,Blue,1,73266,74260,994
2022-02-01,70044,70046,Blue,1,28986,29091,105
2022-08-16,70057,70039,Blue,0,53682,54676,994
2022-11-15,70043,70838,Blue,0,47017,47213,196
2022-12-28,70048,70054,Blue,1,56583,56879,296
2022-12-24,70055,70053,Blue,0,33777,33822,45
2022-02-19,70044,70054,Blue,1,76359,76975,616
2022-03-03,70053,70043,Blue,0,70782,71352,570
2022-10-23,70042,70044,Blue,1,39145,39175,30
2022-01-14,70038,70052,Blue,1,57127,57822,695
2022-06-05,70038,70052,Blue,1,50115,50956,841
2022-11-01,70038,70042,Blue,1,26434,26527,93
2022-08-16,70038,70058,Blue,1,81114,82189,1075
2022-05-02,70049,70047,Blue,0,53132,53218,86
2022-03-13,70059,70043,Blue,0,78659,79604,945
2022-12-06,70052,70056,Blue,1,49545,49688,143
2022-09-01,70040,70052,Blue,1,57252,57948,696
2022-11-01,70059,70838,Blue,0,49954,51067,1113
2022-08-01,70045,70039,Blue,0,84541,84813,272
2022-09-14,70049,70041,Blue,0,39979,40379,400
2022-05-25,70042,70046,Blue,1,81750,81923,173
2022-12-11,70059,70049,Blue,0,75437,75976,539
2022-07-29,70049,70047,Blue,0,63157,63212,55
2022-08-25,70053,70051,Blue,0,86897,86953,56
2022-06-25,70059,70043,Blue,0,40650,41533,883
2022-08-31,70057,70053,Blue,0,68193,68343,150
2022-11-10,70038,70056,Blue,1,60724,62067,1343
2022-11-04,70046,70060,Blue,1,62109,63301,1192
2022-04-29,70050,70058,Blue,1,59860,60264,404
2022-04-06,70044,70048,Blue,1,67570,67829,259
2022-01-18,70038,70040,Blue,1,42549,42565,16
2022-03-25,70039,70838,Blue,0,37127,37162,35
2022-05-19,70053,70039,Blue,0,60239,61132,893
2022-10-01,70046,70060,Blue,1,67284,68070,786
2022-09-29,70044,70050,Blue,1,26698,27057,359
2022-07-05,70049,70039,Blue,0,66339,66870,531
2022-10-31,70044,70058,Blue,1,28079,28879,800
2022-07-25,70050,70056,Blue,1,79624,80021,397
2022-10-03,70048,70050,Blue,1,72619,72675,56
2022-09-20,70042,70056,Blue,1,82895,83715,820
2022-04-08,70049,70047,Blue,0,31091,31146,55
2022-02-12,70041,70039,Blue,0,39502,39540,38
2022-01-13,70040,70050,Blue,1,26412,26980,568
2022-02-18,70042,70050,Blue,1,60624,61026,402
2022-01-05,70059,70838,Blue,0,67875,69039,1164
2022-01-04,70053,70041,Blue,0,78060,78701,641
2022-03-10,70045,70043,Blue,0,76787,76892,105
2022-09-28,70045,70039,Blue,0,76655,76912,257
2022-02-16,70047,70045,Blue,0,77318,77440,122
2022-12-27,70049,70039,Blue,0,58962,59452,490
2022-05-19,70044,70046,Blue,1,58308,58446,138
2022-06-19,70055,70039,Blue,0,72980,73792,812
2022-07-15,70057,70049,Blue,0,76300,76678,378
2022-01-31,70041,70039,Blue,0,60594,60633,39
2022-04-10,70045,70041,Blue,0,82962,83129,167
2022-11-05,70053,70047,Blue,0,50051,50396,345
2022-01-07,70046,70058,Blue,1,26202,26874,672
2022-11-15,70051,70045,Blue,0,20791,21141,350
2022-09-05,70054,70058,Blue,1,52639,52795,156
2022-12-31,70040,70058,Blue,1,58297,59212,915
2022-05-26,70049,70045,Blue,0,25177,25381,204
2022-02-20,70051,70041,Blue,0,23467,24096,629
2022-08-04,70059,70045,Blue,0,33087,33934,847
2022-10-02,70059,70055,Blue,0,68433,68575,142
2022-11-08,70039,70838,Blue,0,64670,64707,37
2022-09-30,70044,70060,Blue,1,26712,27607,895
2022-04-24,70048,70050,Blue,1,56463,56519,56
2022-06-06,70050,70052,Blue,1,59140,59325,185
2022-04-01,70040,70060,Blue,1,72617,73728,1111
2022-02-03,70040,70050,Blue,1,76401,76885,484
2022-01-21,70049,70041,Blue,0,73110,73541,431
2022-07-03,70057,70053,Blue,0,73917,74069,152
2022-06-26,70049,70838,Blue,0,43287,43897,610
2022-08-04,70050,70054,Blue,1,59276,59507,231
2022-09-23,70057,70041,Blue,0,43258,44250,992
2022-08-17,70042,70044,Blue,1,35680,35711,31
2022-12-08,70046,70054,Blue,1,84912,85408,496
2022-02-21,70049,70047,Blue,0,69161,69213,52
2022-06-12,70059,70039,Blue,0,69645,70701,1056
2022-09-18,70055,70838,Blue,0,70825,71702,877
2022-07-23,70055,70838,Blue,0,46727,47643,916
2022-08-04,70042,70058,Blue,1,29888,30807,919
2022-04-06,70048,70056,Blue,1,66868,67297,429
2022-02-10,70038,70046,Blue,1,31154,31475,321
2022-08-28,70051,70045,Blue,0,49315,49636,321
2022-12-24,70040,70060,Blue,1,52395,53459,1064
2022-08-23,70050,70054,Blue,1,63508,63726,218
2022-11-04,70038,70046,Blue,1,37699,38115,416
2022-09-01,70054,70060,Blue,1,32072,32336,264
2022-11-14,70055,70039,Blue,0,25286,26157,871
2022-04-07,70049,70039,Blue,0,36345,36865,520
2022-07-12,70057,70051,Blue,0,67025,67266,241
2022-05-30,70038,70048,Blue,1,74708,75210,502
2022-01-27,70048,70060,Blue,1,54850,55535,685
2022-12-06,70044,70056,Blue,1,62057,62709,652
2022-04-08,70046,70054,Blue,1,52859,53303,444
2022-11-29,70050,70056,Blue,1,72661,72964,303
2022-03-20,70052,70054,Blue,1,47550,47603,53
2022-01-31,70055,70053,Blue,0,37496,37595,99
2022-10-12,70046,70060,Blue,1,54420,55196,776
2022-06-17,70049,70838,Blue,0,28545,29182,637
2022-03-09,70044,70060,Blue,1,37648,38582,934
2022-08-06,70040,70046,Blue,1,79347,79606,259
2022-10-28,70053,70047,Blue,0,52782,53097,315
2022-08-04,70046,70060,Blue,1,67795,68544,749
2022-10-20,70057,70053,Blue,0,56737,56897,160
2022-10-28,70059,70055,Blue,0,20416,20567,151
2022-11-08,70055,70838,Blue,0,27400,28356,956
2022-06-25,70038,70046,Blue,1,78736,79119,383
2022-08-22,70048,70058,Blue,1,50908,51470,562
2022-03-28,70044,70048,Blue,1,61894,62127,233
2022-11-25,70055,70053,Blue,0,45929,45975,46
2022-02-28,70046,70050,Blue,1,89506,89691,185
2022-03-07,70053,70045,Blue,0,63464,63887,423
2022-02-11,70044,70058,Blue,1,48266,48998,732
2022-09-06,70057,70053,Blue,0,67653,67812,159
2022-08-30,70057,70838,Blue,0,67656,68659,1003
2022-07-02,70043,70041,Blue,0,45888,45922,34
2022-06-12,70057,70053,Blue,0,30953,31109,156
2022-09-27,70044,70052,Blue,1,45954,46474,520
2022-10-04,70059,70053,Blue,0,19938,20165,227
2022-10-02,70040,70058,Blue,1,35544,36505,961
2022-09-01,70047,70039,Blue,0,74459,74887,428
2022-06-14,70048,70058,Blue,1,55403,56095,692
2022-12-12,70055,70049,Blue,0,29089,29393,304
2022-05-19,70040,70046,Blue,1,75430,75725,295
2022-03-09,70051,70045,Blue,0,28231,28544,313
2022-03-24,70042,70052,Blue,1,28974,29593,619
2022-02-09,70038,70052,Blue,1,54827,55555,728
2022-10-03,70048,70052,Blue,1,81348,81550,202
2022-01-25,70046,70050,Blue,1,90967,91182,215
2022-02-05,70048,70050,Blue,1,57158,57216,58
2022-01-19,70040,70044,Blue,1,29121,29228,107
2022-08-26,70059,70057,Blue,0,47370,47405,35
2022-10-19,70051,70838,Blue,0,28444,29233,789
2022-09-16,70038,70040,Blue,1,32022,32039,17
2022-12-21,70048,70050,Blue,1,66611,66671,60
2022-02-19,70051,70047,Blue,0,69027,69221,194
2022-11-01,70055,70047,Blue,0,64639,65000,361
2022-03-20,70051,70041,Blue,0,59081,59667,586
2022-03-27,70038,70060,Blue,1,85514,86578,1064
2022-05-18,70046,70050,Blue,1,25304,25571,267
2022-01-26,70040,70056,Blue,1,59901,60719,818
2022-01-22,70055,70838,Blue,0,42404,43399,995
2022-12-22,70059,70055,Blue,0,47616,47762,146
2022-10-28,70042,70050,Blue,1,57194,57606,412
2022-12-13,70043,70039,Blue,0,30140,30252,112
2022-08-27,70054,70060,Blue,1,71050,71354,304
2022-11-29,70053,70039,Blue,0,51784,52502,718
2022-09-22,70039,70838,Blue,0,59834,59866,32
2022-03-21,70046,70058,Blue,1,21025,21803,778
2022-01-13,70059,70043,Blue,0,65617,66533,916
2022-01-12,70057,70055,Blue,0,55761,55830,69
2022-01-11,70044,70054,Blue,1,62464,63103,639
2022-11-22,70048,70060,Blue,1,46609,47184,575
2022-09-11,70044,70058,Blue,1,25858,26738,880
2022-06-14,70052,70056,Blue,1,75530,75667,137
2022-03-25,70054,70060,Blue,1,31136,31408,272
2022-07-20,70053,70049,Blue,0,30003,30219,216
2022-05-18,70057,70039,Blue,0,61778,62822,1044
2022-06-09,70057,70041,Blue,0,26735,27636,901
2022-10-19,70040,70050,Blue,1,24927,25419,492
2022-11-22,70042,70048,Blue,1,30394,30703,309
2022-09-15,70048,70058,Blue,1,79704,80213,509
2022-06-20,70055,70043,Blue,0,63583,64235,652
2022-07-19,70049,70047,Blue,0,77713,77769,56
2022-06-10,70057,70047,Blue,0,50824,51324,500
2022-03-15,70055,70041,Blue,0,62490,63321,831
2022-12-02,70057,70049,Blue,0,73416,73827,411
2022-08-11,70042,70044,Blue,1,61444,61474,30
2022-10-10,70054,70056,Blue,1,29007,29053,46
2022-11-12,70040,70052,Blue,1,29170,29805,635
2022-07-20,70040,70042,Blue,1,28253,28287,34
2022-09-23,70055,70838,Blue,0,43889,44827,938
2022-02-02,70046,70052,Blue,1,21155,21520,365
2022-07-11,70041,70838,Blue,0,53262,53394,132
2022-11-23,70049,70043,Blue,0,27993,28332,339
2022-02-01,70043,70041,Blue,0,35198,35230,32
2022-04-08,70046,70050,Blue,1,61424,61608,184
2022-11-15,70042,70046,Blue,1,29557,29735,178
2022-11-08,70057,70051,Blue,0,49469,49708,239
2022-07-31,70041,70039,Blue,0,39236,39274,38
2022-11-22,70044,70050,Blue,1,62599,62955,356
2022-11-15,70040,70044,Blue,1,26951,27056,105
2022-08-03,70049,70838,Blue,0,72314,72869,555
2022-06-18,70057,70053,Blue,0,87469,87622,153
2022-03-04,70038,70058,Blue,1,54589,55692,1103
2022-03-23,70046,70056,Blue,1,67986,68459,473
2022-08-13,70055,70051,Blue,0,53738,53875,137
2022-11-05,70054,70056,Blue,1,72507,72554,47
2022-07-30,70048,70054,Blue,1,77798,78121,323
2022-12-28,70051,70041,Blue,0,64317,64822,505
2022-04-01,70054,70056,Blue,1,64285,64333,48
2022-01-19,70055,70047,Blue,0,63981,64327,346
2022-04-15,70055,70051,Blue,0,36084,36240,156
2022-09-22,70049,70838,Blue,0,28586,29262,676
2022-07-02,70041,70039,Blue,0,25146,25181,35
2022-11-17,70042,70054,Blue,1,71743,72355,612
2022-04-12,70044,70060,Blue,1,62179,63115,936
2022-10-05,70056,70060,Blue,1,42716,42901,185
2022-06-14,70059,70047,Blue,0,62594,63170,576
2022-01-28,70059,70041,Blue,0,49747,50785,1038
2022-12-02,70057,70041,Blue,0,41306,42200,894
2022-01-24,70059,70051,Blue,0,33908,34270,362
2022-04-23,70038,70042,Blue,1,63129,63228,99
2022-09-03,70048,70056,Blue,1,80452,80852,400
2022-07-18,70049,70039,Blue,0,84036,84551,515
2022-08-05,70050,70058,Blue,1,38427,38858,431
2022-03-17,70038,70054,Blue,1,23648,24446,798
2022-04-15,70047,70045,Blue,0,66162,66257,95
2022-09-15,70044,70058,Blue,1,76751,77620,869
2022-12-17,70055,70053,Blue,0,52690,52738,48
2022-09-05,70046,70052,Blue,1,78389,78770,381
2022-08-01,70040,70060,Blue,1,51483,52580,1097
2022-08-09,70043,70041,Blue,0,58096,58150,54
2022-09-30,70049,70838,Blue,0,53023,53735,712
2022-04-26,70052,70054,Blue,1,59792,59857,65
2022-10-23,70044,70048,Blue,1,81226,81458,232
2022-09-06,70055,70039,Blue,0,21977,22856,879
2022-10-08,70040,70042,Blue,1,40514,40544,30
2022-10-11,70048,70050,Blue,1,63550,63603,53
2022-01-06,70055,70053,Blue,0,62767,62827,60
2022-08-22,70050,70058,Blue,1,86390,86810,420
2022-07-07,70052,70060,Blue,1,47700,48052,352
2022-08-14,70040,70052,Blue,1,29286,29927,641
2022-09-18,70045,70039,Blue,0,71366,71619,253
2022-01-03,70053,70051,Blue,0,22384,22449,65
2022-01-19,70046,70056,Blue,1,84113,84588,475
2022-10-30,70054,70056,Blue,1,64390,64437,47
2022-08-07,70049,70838,Blue,0,56007,56650,643
2022-08-20,70049,70838,Blue,0,72966,73598,632
2022-08-30,70051,70838,Blue,0,22182,23033,851
2022-01-25,70046,70052,Blue,1,67264,67622,358
2022-01-02,70048,70056,Blue,1,54746,55131,385
2022-12-02,70053,70838,Blue,0,30848,31682,834
2022-09-27,70044,70048,Blue,1,23690,23942,252
2022-09-21,70044,70050,Blue,1,28869,29210,341
2022-09-05,70053,70051,Blue,0,41088,41143,55
2022-01-22,70038,70060,Blue,1,51799,52968,1169
2022-02-16,70052,70058,Blue,1,67026,67280,254
2022-09-19,70059,70051,Blue,0,45256,45586,330
2022-06-28,70048,70058,Blue,1,47344,47827,483
2022-03-15,70056,70058,Blue,1,69567,69653,86
2022-10-17,70057,70838,Blue,0,53719,54782,1063
2022-08-25,70042,70056,Blue,1,68098,68834,736
2022-03-05,70038,70040,Blue,1,36321,36339,18
2022-04-14,70057,70051,Blue,0,69148,69373,225
2022-04-23,70042,70044,Blue,1,63291,63329,38
2022-10-07,70044,70056,Blue,1,76961,77641,680
2022-08-03,70057,70047,Blue,0,46881,47406,525
2022-08-03,70049,70039,Blue,0,48900,49413,513
2022-06-14,70057,70838,Blue,0,40559,42170,1611
2022-09-03,70044,70050,Blue,1,71545,71898,353
2022-03-07,70051,70041,Blue,0,50628,51191,563
2022-08-04,70044,70046,Blue,1,62978,63082,104
2022-06-19,70046,70058,Blue,1,48705,49278,573
2022-03-18,70057,70047,Blue,0,42755,43325,570
2022-08-15,70038,70058,Blue,1,27413,28429,1016
2022-09-05,70047,70045,Blue,0,56629,56729,100
2022-09-11,70051,70047,Blue,0,65532,65728,196
2022-12-06,70050,70052,Blue,1,48347,48458,111
2022-03-17,70053,70045,Blue,0,53391,53838,447
2022-10-19,70045,70041,Blue,0,54518,54683,165
2022-09-14,70056,70058,Blue,1,53858,53928,70
2022-03-02,70046,70052,Blue,1,54366,54678,312
2022-01-03,70042,70048,Blue,1,42586,42915,329
2022-07-30,70041,70039,Blue,0,34572,34611,39
2022-09-03,70054,70058,Blue,1,83032,83188,156
2022-02-09,70038,70042,Blue,1,28578,28702,124
2022-02-04,70038,70052,Blue,1,39737,40559,822
2022-04-06,70040,70042,Blue,1,77606,77640,34
2022-06-10,70042,70052,Blue,1,69288,70191,903
2022-10-05,70051,70049,Blue,0,58886,58990,104
2022-09-29,70042,70056,Blue,1,30039,30811,772
2022-12-30,70048,70054,Blue,1,59266,59596,330
2022-07-11,70055,70053,Blue,0,50782,50828,46
2022-04-07,70046,70054,Blue,1,62021,62428,407
2022-01-29,70056,70060,Blue,1,41555,41894,339
2022-12-20,70042,70050,Blue,1,23552,23964,412
2022-01-01,70059,70039,Blue,0,22273,23290,1017
2022-05-21,70040,70046,Blue,1,70466,70739,273
2022-07-21,70042,70054,Blue,1,66151,66870,719
2022-12-17,70049,70043,Blue,0,59435,59767,332
2022-02-22,70049,70039,Blue,0,77706,78172,466
2022-11-25,70059,70043,Blue,0,34396,35210,814
2022-04-10,70054,70056,Blue,1,86324,86372,48
2022-06-28,70041,70039,Blue,0,39166,39204,38
2022-03-19,70042,70050,Blue,1,39550,40001,451
2022-11-02,70049,70043,Blue,0,44675,44998,323
2022-11-09,70046,70048,Blue,1,77101,77176,75
2022-03-25,70051,70047,Blue,0,50111,50307,196
2022-02-16,70040,70046,Blue,1,45365,45630,265
2022-08-19,70051,70045,Blue,0,22523,22874,351
2022-07-04,70044,70060,Blue,1,60630,61658,1028
2022-11-08,70059,70039,Blue,0,88157,89522,1365
2022-09-04,70059,70055,Blue,0,55997,56144,147
2022-11-11,70057,70053,Blue,0,39561,39715,154
2022-04-23,70059,70039,Blue,0,57352,58416,1064
2022-08-30,70039,70838,Blue,0,51197,51232,35
2022-09-14,70047,70041,Blue,0,58323,58632,309
2022-01-08,70042,70052,Blue,1,33569,34106,537
2022-07-30,70044,70054,Blue,1,27694,28269,575
2022-01-06,70052,70056,Blue,1,20606,20774,168
2022-07-06,70057,70045,Blue,0,31048,31667,619
2022-10-08,70047,70045,Blue,0,28187,28305,118
2022-09-15,70051,70838,Blue,0,69461,70161,700
2022-01-22,70040,70058,Blue,1,72375,73326,951
2022-11-02,70044,70052,Blue,1,37668,38218,550
2022-03-21,70040,70048,Blue,1,79319,79754,435
2022-11-11,70051,70045,Blue,0,71636,71996,360
2022-12-13,70055,70049,Blue,0,24040,24315,275
2022-07-31,70053,70041,Blue,0,62757,63403,646
2022-08-24,70054,70056,Blue,1,31220,31268,48
2022-04-19,70051,70045,Blue,0,64695,65063,368
2022-04-06,70055,70041,Blue,0,85332,86043,711
2022-03-01,70051,70049,Blue,0,55690,55791,101
2022-11-14,70059,70053,Blue,0,58275,58501,226
2022-10-04,70059,70039,Blue,0,38489,39730,1241
2022-09-22,70055,70049,Blue,0,81490,81785,295
2022-04-16,70052,70054,Blue,1,51506,51557,51
2022-09-01,70038,70056,Blue,1,29472,30395,923
2022-03-31,70048,70052,Blue,1,66674,66880,206
2022-04-05,70052,70054,Blue,1,40915,40970,55
2022-01-02,70044,70060,Blue,1,34125,35039,914
2022-10-18,70056,70060,Blue,1,89158,89352,194
2022-03-14,70057,70053,Blue,0,33025,33172,147
2022-01-24,70039,70838,Blue,0,33301,33344,43
2022-07-03,70049,70039,Blue,0,40656,41191,535
2022-01-01,70042,70046,Blue,1,65927,66130,203
2022-01-12,70055,70039,Blue,0,84799,85740,941
2022-07-28,70042,70052,Blue,1,77446,78033,587
2022-01-03,70041,70039,Blue,0,62359,62385,26
2022-10-11,70040,70044,Blue,1,30438,30545,107
2022-10-13,70053,70838,Blue,0,47158,47965,807
2022-04-22,70040,70052,Blue,1,50824,51451,627
2022-05-28,70049,70043,Blue,0,65869,66238,369
2022-06-24,70044,70054,Blue,1,27954,28607,653
2022-03-23,70053,70049,Blue,0,77443,77651,208
2022-12-04,70052,70056,Blue,1,86286,86433,147
2022-04-04,70044,70048,Blue,1,44008,44257,249
2022-08-08,70057,70049,Blue,0,88374,88767,393
2022-12-05,70047,70043,Blue,0,53111,53333,222
2022-03-10,70046,70048,Blue,1,34308,34407,99
2022-01-22,70055,70053,Blue,0,25032,25099,67
2022-07-11,70038,70054,Blue,1,71802,72629,827
2022-04-20,70046,70048,Blue,1,65037,65129,92
2022-02-04,70044,70050,Blue,1,63664,64206,542
2022-01-28,70040,70058,Blue,1,47604,48567,963
2022-12-12,70058,70060,Blue,1,57554,57617,63
2022-04-06,70050,70060,Blue,1,72025,72550,525
2022-01-12,70059,70045,Blue,0,62894,63635,741
2022-08-04,70044,70046,Blue,1,20110,20215,105
2022-03-14,70055,70039,Blue,0,39446,40400,954
2022-10-25,70042,70060,Blue,1,58995,60064,1069
2022-07-10,70045,70039,Blue,0,66158,66448,290
2022-09-05,70046,70048,Blue,1,38744,38843,99
2022-08-29,70040,70054,Blue,1,33834,34590,756
2022-04-21,70048,70060,Blue,1,29010,29648,638
2022-04-20,70043,70041,Blue,0,75256,75285,29
2022-06-11,70040,70056,Blue,1,50273,51167,894
2022-01-15,70051,70049,Blue,0,62260,62368,108
2022-03-24,70059,70049,Blue,0,86893,87343,450
2022-09-28,70055,70045,Blue,0,79483,79979,496
2022-05-20,70040,70044,Blue,1,53150,53272,122
2022-05-18,70051,70041,Blue,0,25292,26040,748
2022-01-14,70055,70043,Blue,0,23278,24110,832
2022-03-24,70038,70042,Blue,1,21573,21682,109
2022-01-07,70040,70058,Blue,1,61430,62335,905
2022-02-07,70038,70050,Blue,1,49223,49773,550
2022-09-25,70044,70046,Blue,1,67422,67526,104
2022-08-31,70053,70051,Blue,0,73602,73649,47
2022-10-25,70055,70041,Blue,0,44943,45806,863
2022-02-15,70040,70056,Blue,1,25516,26389,873
2022-07-10,70054,70060,Blue,1,70912,71181,269
2022-05-19,70041,70838,Blue,0,54503,55336,833
2022-12-02,70038,70042,Blue,1,37266,37360,94
2022-06-09,70038,70046,Blue,1,61903,62765,862
2022-05-18,70059,70051,Blue,0,54196,54534,338
2022-01-21,70051,70043,Blue,0,49583,50131,548
2022-08-18,70049,70838,Blue,0,36548,37224,676
2022-03-16,70042,70056,Blue,1,64540,65360,820
2022-04-24,70047,70039,Blue,0,72274,72650,376
2022-03-12,70045,70043,Blue,0,55952,56048,96
2022-04-23,70055,70039,Blue,0,53726,54679,953
2022-09-06,70039,70838,Blue,0,78671,78704,33
2022-11-27,70051,70043,Blue,0,30343,30808,465
2022-04-08,70038,70054,Blue,1,22755,23610,855
2022-02-09,70048,70052,Blue,1,76805,77013,208
2022-12-20,70039,70838,Blue,0,54845,54876,31
2022-09-27,70042,70052,Blue,1,83793,84382,589
2022-02-06,70043,70838,Blue,0,34041,34232,191
2022-10-01,70047,70838,Blue,0,43386,43901,515
2022-10-18,70038,70042,Blue,1,38846,38933,87
2022-12-16,70051,70039,Blue,0,38842,39491,649
2022-01-27,70047,70041,Blue,0,85774,86106,332
2022-03-20,70038,70052,Blue,1,77482,78136,654
2022-02-15,70045,70043,Blue,0,78529,78639,110
2022-12-29,70053,70049,Blue,0,87034,87215,181
2022-12-04,70042,70056,Blue,1,67986,68793,807
2022-09-11,70045,70838,Blue,0,46193,46557,364
2022-04-15,70048,70054,Blue,1,22164,22513,349
2022-01-26,70049,70838,Blue,0,60778,61397,619
2022-01-05,70059,70838,Blue,0,69566,70756,1190
2022-12-04,70050,70054,Blue,1,89741,89942,201
2022-01-18,70056,70060,Blue,1,37250,37466,216
2022-04-08,70043,70039,Blue,0,82133,82245,112
2022-06-13,70051,70041,Blue,0,59063,59650,587
2022-08-01,70038,70058,Blue,1,24017,25115,1098
2022-09-09,70052,70056,Blue,1,27116,27255,139
2022-04-14,70055,70053,Blue,0,63676,63722,46
2022-11-16,70048,70056,Blue,1,65904,66284,380
2022-09-29,70057,70047,Blue,0,29381,29904,523
2022-05-22,70042,70044,Blue,1,62837,62876,39
2022-01-21,70044,70054,Blue,1,57369,57976,607
2022-03-19,70055,70053,Blue,0,78626,78662,36
2022-04-08,70048,70052,Blue,1,67539,67733,194
2022-09-30,70054,70056,Blue,1,30306,30359,53
2022-03-06,70040,70054,Blue,1,53793,54534,741
2022-07-12,70047,70039,Blue,0,72886,73263,377
2022-07-10,70042,70056,Blue,1,63867,64685,818
2022-03-03,70055,70049,Blue,0,46282,46641,359
2022-04-07,70053,70041,Blue,0,87167,87810,643
2022-01-26,70049,70838,Blue,0,52662,53240,578
2022-08-27,70053,70049,Blue,0,53273,53475,202
2022-01-31,70057,70838,Blue,0,29077,30389,1312
2022-07-30,70053,70047,Blue,0,47921,48232,311
2022-07-19,70056,70058,Blue,1,26536,26612,76
2022-09-08,70046,70054,Blue,1,52322,52739,417
2022-12-06,70042,70056,Blue,1,34768,35531,763
2022-01-31,70038,70042,Blue,1,69028,69121,93
2022-06-26,70050,70056,Blue,1,83628,83918,290
2022-04-20,70057,70045,Blue,0,23163,23869,706
2022-07-11,70059,70049,Blue,0,58754,59281,527
2022-08-31,70040,70058,Blue,1,55749,56658,909
2022-05-18,70057,70053,Blue,0,30045,30206,161
2022-06-27,70059,70057,Blue,0,74897,74932,35
2022-06-21,70046,70058,Blue,1,31694,32476,782
2022-04-20,70046,70060,Blue,1,26080,26901,821
2022-09-18,70042,70048,Blue,1,51160,51485,325
2022-08-06,70053,70041,Blue,0,39773,40454,681
2022-08-17,70046,70058,Blue,1,39864,40493,629
2022-07-29,70040,70052,Blue,1,84433,85221,788
2022-10-10,70038,70056,Blue,1,42976,43890,914
2022-07-27,70057,70043,Blue,0,39590,40361,771
2022-02-03,70051,70045,Blue,0,56797,57410,613
2022-12-19,70053,70045,Blue,0,25317,25777,460
2022-02-15,70052,70054,Blue,1,33065,33114,49
2022-12-09,70059,70049,Blue,0,19939,20448,509
2022-06-23,70040,70042,Blue,1,44733,44768,35
2022-04-01,70042,70060,Blue,1,70304,71447,1143
2022-10-10,70059,70045,Blue,0,36921,37731,810
2022-06-14,70039,70838,Blue,0,77762,77797,35
2022-07-21,70045,70838,Blue,0,33941,34286,345
2022-06-20,70055,70041,Blue,0,78689,79495,806
2022-04-15,70040,70054,Blue,1,27922,28668,746
2022-11-07,70049,70047,Blue,0,24542,24611,69
2022-05-18,70042,70052,Blue,1,28336,29063,727
2022-07-17,70059,70041,Blue,0,55456,56424,968
2022-09-30,70042,70048,Blue,1,67103,67445,342
2022-12-11,70042,70058,Blue,1,41135,41964,829
2022-01-16,70042,70044,Blue,1,60888,60919,31
2022-11-17,70049,70043,Blue,0,46115,46464,349
2022-01-15,70049,70045,Blue,0,37386,37582,196
2022-10-27,70049,70039,Blue,0,68070,68558,488
2022-03-01,70051,70047,Blue,0,23775,23977,202
2022-12-27,70044,70054,Blue,1,79813,80424,611
2022-09-30,70052,70054,Blue,1,22087,22135,48
2022-06-17,70052,70060,Blue,1,25713,26096,383
2022-02-15,70051,70838,Blue,0,66585,67399,814
2022-04-12,70042,70052,Blue,1,64180,64771,591
2022-03-08,70053,70043,Blue,0,50527,51105,578
2022-10-07,70055,70045,Blue,0,24986,25542,556
2022-09-12,70040,70052,Blue,1,32117,32811,694
2022-11-25,70042,70050,Blue,1,52819,53199,380
2022-02-18,70038,70058,Blue,1,75212,76228,1016
2022-10-21,70040,70042,Blue,1,81382,81417,35
2022-12-12,70040,70044,Blue,1,27371,27482,111
2022-03-09,70043,70838,Blue,0,81475,81668,193
2022-07-15,70049,70039,Blue,0,72691,73211,520
2022-03-18,70049,70043,Blue,0,59792,60166,374
2022-02-17,70038,70050,Blue,1,74652,75238,586
2022-05-21,70042,70046,Blue,1,21179,21392,213
2022-04-23,70041,70838,Blue,0,42722,42847,125
2022-08-01,70057,70055,Blue,0,62484,62552,68
2022-02-24,70040,70052,Blue,1,60488,61198,710
2022-03-01,70045,70838,Blue,0,63320,63712,392
2022-06-29,70043,70039,Blue,0,58798,58903,105
2022-01-10,70050,70056,Blue,1,87210,87519,309
2022-10-17,70059,70049,Blue,0,45742,46189,447
2022-02-16,70052,70054,Blue,1,73631,73685,54
2022-11-18,70055,70838,Blue,0,86305,87169,864
2022-10-28,70057,70053,Blue,0,23497,23649,152
2022-08-10,70051,70838,Blue,0,40566,41497,931
2022-01-25,70050,70060,Blue,1,22510,23075,565
2022-10-17,70041,70838,Blue,0,44376,44504,128
2022-04-24,70038,70056,Blue,1,54258,55185,927
2022-07-06,70048,70058,Blue,1,80328,80827,499
2022-01-18,70059,70055,Blue,0,50233,50376,143
2022-02-06,70044,70050,Blue,1,31071,31403,332
2022-08-22,70057,70049,Blue,0,23613,24013,400
2022-07-11,70055,70045,Blue,0,64906,65392,486
2022-11-11,70054,70060,Blue,1,28235,28516,281
2022-06-24,70053,70049,Blue,0,77817,78020,203
2022-07-25,70057,70053,Blue,0,41527,41676,149
2022-12-19,70052,70060,Blue,1,34681,35020,339
2022-01-10,70040,70046,Blue,1,50347,50619,272
2022-04-28,70056,70060,Blue,1,62999,63173,174
2022-09-16,70048,70050,Blue,1,81722,81786,64
2022-04-05,70057,70039,Blue,0,80132,80988,856
2022-11-20,70038,70056,Blue,1,54808,55703,895
2022-04-08,70046,70056,Blue,1,77239,77714,475
2022-01-04,70039,70838,Blue,0,80077,80115,38
2022-04-09,70044,70046,Blue,1,41219,41328,109
2022-02-25,70038,70058,Blue,1,26423,27451,1028
2022-04-24,70045,70043,Blue,0,71332,71435,103
2022-06-15,70053,70051,Blue,0,87161,87207,46
2022-06-09,70046,70052,Blue,1,33661,34039,378
2022-08-15,70057,70045,Blue,0,52192,52869,677
2022-06-28,70044,70060,Blue,1,70227,71233,1006
2022-02-24,70057,70051,Blue,0,85237,85598,361
2022-03-25,70046,70060,Blue,1,23763,24588,825
2022-01-31,70059,70039,Blue,0,67916,69026,1110
2022-04-13,70047,70045,Blue,0,59648,59770,122
2022-02-20,70040,70048,Blue,1,69981,70378,397
2022-08-12,70048,70058,Blue,1,69642,70166,524
2022-12-11,70038,70040,Blue,1,55875,55890,15
2022-11-01,70038,70040,Blue,1,74710,74723,13
2022-03-10,70055,70838,Blue,0,35416,36308,892
2022-03-07,70044,70054,Blue,1,48971,49591,620
2022-03-23,70040,70058,Blue,1,39672,40706,1034
2022-03-24,70046,70056,Blue,1,25823,26389,566
2022-02-04,70050,70056,Blue,1,21592,21925,333
2022-09-23,70040,70050,Blue,1,68039,68544,505
2022-06-10,70047,70039,Blue,0,86360,86813,453
2022-08-25,70054,70060,Blue,1,46426,46689,263
2022-06-29,70050,70058,Blue,1,34414,34866,452
2022-03-01,70040,70054,Blue,1,52242,52984,742
2022-12-16,70059,70049,Blue,0,40576,41086,510
2022-09-16,70058,70060,Blue,1,36330,36392,62
2022-11-17,70043,70838,Blue,0,26166,26389,223
2022-01-26,70042,70054,Blue,1,30117,30812,695
2022-05-30,70049,70838,Blue,0,48998,49661,663
2022-06-11,70052,70058,Blue,1,42654,42913,259
2022-07-01,70038,70056,Blue,1,73313,74436,1123
2022-09-30,70040,70050,Blue,1,57627,58157,530
2022-08-04,70056,70058,Blue,1,47220,47294,74
2022-06-10,70053,70047,Blue,0,22314,22610,296
2022-11-01,70051,70049,Blue,0,87664,87770,106
2022-01-28,70047,70045,Blue,0,54480,54579,99
2022-08-01,70038,70044,Blue,1,31107,31268,161
2022-08-15,70059,70057,Blue,0,55691,55728,37
2022-11-23,70053,70039,Blue,0,49138,49942,804
2022-03-29,70059,70041,Blue,0,27860,28841,981
2022-08-01,70043,70039,Blue,0,68987,69088,101
2022-04-24,70048,70056,Blue,1,75825,76202,377
2022-07-16,70049,70047,Blue,0,40546,40601,55
2022-10-17,70059,70049,Blue,0,24682,25264,582
2022-10-26,70053,70051,Blue,0,77753,77808,55
2022-02-18,70038,70050,Blue,1,82024,82661,637
2022-10-12,70042,70050,Blue,1,30910,31327,417
2022-05-18,70052,70054,Blue,1,62621,62704,83
2022-09-20,70055,70043,Blue,0,42330,43064,734
2022-06-08,70038,70048,Blue,1,30555,31028,473
2022-03-23,70059,70049,Blue,0,79454,79964,510
2022-06-27,70055,70838,Blue,0,56152,57234,1082
2022-02-14,70050,70056,Blue,1,85477,85789,312
2022-12-20,70042,70060,Blue,1,65021,65987,966
2022-10-07,70052,70054,Blue,1,59929,59993,64
2022-04-14,70053,70045,Blue,0,68742,69220,478
2022-01-23,70038,70042,Blue,1,59113,59223,110
2022-12-19,70039,70838,Blue,0,74834,74866,32
2022-02-08,70042,70054,Blue,1,74807,75456,649
2022-07-06,70049,70039,Blue,0,88664,89644,980
2022-03-06,70053,70041,Blue,0,64375,65023,648
2022-08-05,70038,70048,Blue,1,44540,45010,470
2022-03-28,70054,70058,Blue,1,49661,49822,161
2022-02-19,70049,70838,Blue,0,61079,61686,607
2022-04-16,70048,70058,Blue,1,78437,78957,520
2022-11-18,70038,70042,Blue,1,87496,87643,147
2022-07-23,70048,70050,Blue,1,72695,72753,58
2022-03-10,70042,70056,Blue,1,78741,79492,751
2022-02-10,70057,70047,Blue,0,62097,62572,475
2022-04-07,70057,70055,Blue,0,81810,81880,70
2022-12-19,70038,70052,Blue,1,60267,61025,758
2022-07-21,70059,70043,Blue,0,73168,74080,912
2022-01-05,70049,70838,Blue,0,21862,22604,742
2022-10-16,70051,70043,Blue,0,67178,67661,483
2022-11-08,70049,70047,Blue,0,27720,27777,57
2022-01-08,70038,70040,Blue,1,31266,31283,17
2022-02-08,70038,70042,Blue,1,49206,49296,90
2022-07-06,70046,70060,Blue,1,64596,65353,757
2022-03-14,70059,70051,Blue,0,64396,64711,315
2022-01-04,70038,70058,Blue,1,34479,35410,931
2022-08-31,70041,70039,Blue,0,73810,73840,30
2022-10-15,70057,70053,Blue,0,76349,76507,158
2022-11-01,70045,70041,Blue,0,27988,28169,181
2022-04-11,70047,70045,Blue,0,33262,33371,109
2022-08-09,70055,70045,Blue,0,74538,75084,546
2022-04-11,70055,70047,Blue,0,25934,26296,362
2022-07-03,70057,70047,Blue,0,48627,49095,468
2022-08-28,70038,70046,Blue,1,76934,77262,328
2022-09-28,70048,70058,Blue,1,55565,56074,509
2022-11-05,70057,70053,Blue,0,19687,19968,281
2022-02-08,70044,70058,Blue,1,24656,25516,860
2022-12-30,70053,70838,Blue,0,48378,49338,960
2022-02-24,70043,70039,Blue,0,63002,63113,111
2022-12-30,70038,70046,Blue,1,24179,24475,296
2022-07-28,70044,70056,Blue,1,51137,51925,788
2022-03-17,70052,70054,Blue,1,67838,67889,51
2022-06-28,70042,70046,Blue,1,69304,69467,163
2022-03-21,70053,70838,Blue,0,31712,32535,823
2022-03-24,70042,70054,Blue,1,72642,73306,664
2022-07-16,70040,70042,Blue,1,54600,54634,34
2022-04-11,70043,70838,Blue,0,22694,22945,251
2022-06-29,70055,70049,Blue,0,80649,80922,273
2022-10-24,70053,70838,Blue,0,32522,33478,956
2022-12-15,70057,70045,Blue,0,60928,61656,728
2022-12-04,70051,70039,Blue,0,56273,57043,770
2022-05-31,70040,70044,Blue,1,75681,75815,134
2022-03-21,70051,70039,Blue,0,27049,27701,652
2022-09-12,70052,70054,Blue,1,26938,26995,57
2022-02-17,70055,70049,Blue,0,34994,35311,317
2022-11-02,70059,70838,Blue,0,45263,46422,1159
2022-06-09,70048,70052,Blue,1,25536,25755,219
2022-05-14,70054,70058,Blue,1,79490,79653,163
2022-11-24,70046,70050,Blue,1,63815,63996,181
2022-03-22,70053,70039,Blue,0,81990,82717,727
2022-02-16,70053,70047,Blue,0,25162,25465,303
2022-12-01,70047,70043,Blue,0,25416,25672,256
2022-12-06,70050,70052,Blue,1,36998,37127,129
2022-07-20,70053,70041,Blue,0,28741,29437,696
2022-02-22,70055,70045,Blue,0,25981,26558,577
2022-11-17,70057,70053,Blue,0,64530,64683,153
2022-03-21,70050,70054,Blue,1,47566,47807,241
2022-02-16,70040,70054,Blue,1,61094,61822,728
2022-09-01,70038,70048,Blue,1,74266,74727,461
2022-03-01,70055,70051,Blue,0,33143,33344,201
2022-10-31,70040,70058,Blue,1,66988,67968,980
2022-02-11,70056,70058,Blue,1,27891,27961,70
2022-07-14,70059,70057,Blue,0,22164,22202,38
2022-08-04,70040,70060,Blue,1,49941,51118,1177
2022-11-22,70047,70041,Blue,0,28172,28521,349
2022-07-09,70038,70058,Blue,1,42076,43104,1028
2022-03-21,70059,70838,Blue,0,61097,62222,1125
2022-09-21,70042,70060,Blue,1,21317,22320,1003
2022-01-01,70055,70045,Blue,0,49219,49784,565
2022-08-03,70048,70050,Blue,1,57417,57474,57
2022-03-04,70057,70047,Blue,0,71068,71571,503
2022-06-23,70041,70838,Blue,0,75656,75782,126
2022-08-13,70045,70041,Blue,0,56460,56637,177
2022-01-02,70038,70048,Blue,1,52123,52593,470
2022-04-25,70057,70053,Blue,0,21931,22078,147
2022-04-17,70042,70046,Blue,1,51692,51866,174
2022-03-30,70051,70049,Blue,0,56037,56141,104
2022-05-17,70055,70049,Blue,0,26565,26876,311
2022-03-15,70045,70039,Blue,0,30147,30710,563
2022-06-26,70040,70044,Blue,1,61079,61195,116
2022-06-06,70040,70042,Blue,1,85892,85927,35
2022-09-30,70038,70042,Blue,1,59954,60046,92
2022-11-28,70050,70056,Blue,1,21914,22226,312
2022-10-19,70055,70047,Blue,0,37650,38019,369
2022-07-25,70055,70051,Blue,0,77114,77251,137
2022-04-09,70054,70056,Blue,1,62920,62967,47
2022-12-22,70053,70043,Blue,0,65412,66101,689
2022-10-15,70049,70047,Blue,0,25935,25989,54
2022-08-04,70038,70048,Blue,1,29752,30203,451
2022-10-31,70050,70056,Blue,1,41502,41794,292
2022-04-19,70059,70053,Blue,0,61635,61866,231
2022-10-29,70055,70043,Blue,0,38066,38804,738
2022-03-07,70058,70060,Blue,1,25407,25636,229
2022-12-15,70049,70838,Blue,0,51120,51706,586
2022-07-08,70053,70043,Blue,0,57279,57914,635
2022-11-28,70040,70052,Blue,1,36908,37509,601
2022-03-26,70056,70060,Blue,1,34873,35050,177
2022-06-27,70044,70048,Blue,1,39271,39531,260
2022-12-19,70038,70056,Blue,1,90061,91751,1690
2022-04-08,70038,70042,Blue,1,63439,63559,120
2022-08-04,70038,70044,Blue,1,86538,86742,204
2022-04-05,70055,70045,Blue,0,25648,26191,543
2022-02-04,70052,70058,Blue,1,75009,75278,269
2022-10-01,70044,70056,Blue,1,53066,53703,637
2022-03-16,70042,70046,Blue,1,43650,43824,174
2022-04-06,70053,70051,Blue,0,55877,55942,65
2022-03-01,70046,70052,Blue,1,62734,63134,400
2022-04-26,70057,70053,Blue,0,30629,30797,168
2022-03-28,70041,70838,Blue,0,45178,45321,143
2022-01-07,70040,70042,Blue,1,37772,37802,30
2022-06-09,70055,70043,Blue,0,55296,55968,672
2022-08-25,70045,70043,Blue,0,57395,57482,87
2022-12-18,70055,70045,Blue,0,68063,68602,539
2022-07-22,70052,70056,Blue,1,61876,62036,160
2022-03-21,70055,70049,Blue,0,80247,80535,288
2022-04-10,70057,70047,Blue,0,65823,66288,465
2022-09-14,70047,70041,Blue,0,41229,41580,351
2022-04-17,70052,70060,Blue,1,63139,63516,377
2022-07-23,70052,70056,Blue,1,46097,46248,151
2022-02-28,70057,70049,Blue,0,53182,53632,450
2022-12-13,70053,70051,Blue,0,57654,57698,44
2022-06-02,70045,70041,Blue,0,48389,48595,206
2022-07-24,70051,70041,Blue,0,85904,86471,567
2022-09-25,70044,70056,Blue,1,24773,25444,671
2022-10-03,70045,70041,Blue,0,40264,40449,185
2022-05-21,70051,70047,Blue,0,34454,34649,195
2022-02-17,70041,70039,Blue,0,56704,56737,33
2022-08-30,70053,70045,Blue,0,22849,23287,438
2022-06-15,70059,70838,Blue,0,69069,70303,1234
2022-02-13,70056,70060,Blue,1,60050,60223,173
2022-04-05,70038,70040,Blue,1,54806,54825,19
2022-11-21,70047,70039,Blue,0,27343,27838,495
2022-08-30,70057,70053,Blue,0,63533,63695,162
2022-05-28,70043,70041,Blue,0,61508,61537,29
2022-03-04,70057,70055,Blue,0,56075,56144,69
2022-01-30,70050,70052,Blue,1,85957,86073,116
2022-06-17,70044,70056,Blue,1,23546,24267,721
2022-10-23,70042,70058,Blue,1,43105,43902,797
2022-06-18,70048,70058,Blue,1,27879,28424,545
2022-11-09,70038,70054,Blue,1,76746,77503,757
2022-12-12,70042,70060,Blue,1,76785,77849,1064
2022-08-31,70053,70039,Blue,0,50204,50936,732
2022-11-15,70057,70041,Blue,0,27163,28035,872
2022-02-18,70051,70043,Blue,0,71923,72461,538
2022-09-19,70042,70060,Blue,1,56848,57853,1005
2022-01-22,70046,70048,Blue,1,27836,27922,86
2022-10-16,70044,70054,Blue,1,39888,40419,531
2022-03-08,70042,70048,Blue,1,68098,68430,332
2022-01-12,70042,70046,Blue,1,38609,38807,198
2022-06-15,70050,70060,Blue,1,58226,58772,546
2022-12-19,70040,70060,Blue,1,56937,58095,1158
2022-06-17,70047,70041,Blue,0,39980,40347,367
2022-08-08,70038,70052,Blue,1,27836,28575,739
2022-05-01,70057,70055,Blue,0,56493,56561,68
2022-11-05,70059,70039,Blue,0,69420,70424,1004
2022-10-13,70059,70057,Blue,0,39492,39526,34
2022-12-27,70053,70051,Blue,0,32499,32559,60
2022-10-11,70053,70049,Blue,0,27067,27278,211
2022-12-21,70055,70049,Blue,0,20256,20539,283
2022-06-21,70049,70043,Blue,0,24965,25403,438
2022-07-20,70049,70838,Blue,0,60508,61101,593
2022-02-01,70054,70058,Blue,1,36156,36343,187
2022-09-20,70057,70049,Blue,0,49463,49841,378
2022-04-13,70050,70060,Blue,1,63410,64024,614
2022-07-25,70057,70051,Blue,0,26023,26274,251
2022-04-23,70043,70039,Blue,0,50174,50294,120
2022-12-12,70059,70045,Blue,0,25514,26283,769
2022-06-11,70055,70039,Blue,0,48398,49350,952
2022-01-11,70051,70049,Blue,0,24956,25062,106
2022-09-10,70040,70052,Blue,1,69672,70335,663
2022-09-08,70038,70048,Blue,1,36006,36474,468
2022-05-19,70056,70058,Blue,1,35050,35126,76
2022-01-24,70044,70050,Blue,1,86789,87189,400
2022-11-27,70046,70050,Blue,1,56796,56974,178
2022-08-02,70046,70048,Blue,1,56508,56585,77
2022-07-25,70040,70046,Blue,1,37355,37609,254
2022-01-13,70044,70056,Blue,1,74285,74985,700
2022-02-15,70052,70054,Blue,1,77052,77110,58
2022-08-28,70044,70058,Blue,1,50681,51532,851
2022-08-27,70055,70051,Blue,0,79279,79424,145
2022-07-03,70049,70041,Blue,0,61920,62366,446
2022-04-07,70038,70056,Blue,1,31750,32626,876
2022-12-14,70050,70056,Blue,1,80620,80909,289
2022-02-23,70047,70043,Blue,0,59096,59348,252
2022-07-05,70053,70039,Blue,0,19992,20844,852
2022-03-09,70053,70041,Blue,0,32687,33372,685
2022-10-25,70042,70056,Blue,1,62034,62859,825
2022-11-14,70040,70060,Blue,1,58865,59994,1129
2022-03-02,70058,70060,Blue,1,59876,60245,369
2022-11-07,70042,70056,Blue,1,31878,32630,752
2022-09-23,70038,70056,Blue,1,21801,22655,854
2022-12-24,70048,70058,Blue,1,87860,88360,500
2022-08-21,70059,70057,Blue,0,27729,27767,38
2022-12-24,70048,70052,Blue,1,49405,49623,218
2022-04-08,70049,70039,Blue,0,87365,87869,504
2022-03-23,70049,70039,Blue,0,55005,55569,564
2022-08-17,70057,70041,Blue,0,73410,74418,1008
2022-03-08,70054,70056,Blue,1,36141,36188,47
2022-01-28,70055,70838,Blue,0,54989,56026,1037
2022-11-11,70047,70041,Blue,0,68178,68485,307
2022-11-20,70047,70838,Blue,0,82819,83285,466
2022-01-20,70049,70041,Blue,0,84495,84887,392
2022-01-05,70052,70054,Blue,1,74853,74908,55
2022-08-29,70038,70044,Blue,1,76715,76871,156
2022-08-30,70038,70048,Blue,1,23545,24003,458
2022-08-27,70055,70047,Blue,0,33199,33576,377
2022-10-18,70045,70039,Blue,0,20404,20687,283
2022-07-24,70055,70051,Blue,0,86775,86915,140
2022-04-30,70052,70054,Blue,1,81074,81124,50
2022-02-01,70045,70039,Blue,0,21565,21889,324
2022-08-17,70039,70838,Blue,0,61525,61558,33
2022-01-03,70042,70044,Blue,1,20807,20843,36
2022-09-20,70049,70043,Blue,0,67594,67919,325
2022-06-25,70053,70838,Blue,0,50161,51023,862
2022-02-21,70055,70051,Blue,0,61277,61401,124
2022-09-13,70038,70054,Blue,1,58246,59112,866
2022-07-27,70056,70060,Blue,1,26969,27150,181
2022-01-27,70046,70058,Blue,1,75606,76236,630
2022-06-12,70047,70039,Blue,0,57687,58099,412
2022-09-25,70048,70056,Blue,1,28164,28551,387
2022-02-15,70059,70051,Blue,0,36985,37367,382
2022-06-09,70051,70049,Blue,0,68051,68152,101
2022-12-31,70038,70058,Blue,1,90049,91244,1195
2022-03-29,70051,70039,Blue,0,23410,24154,744
2022-09-22,70059,70051,Blue,0,84372,84696,324
2022-02-22,70059,70838,Blue,0,63496,64645,1149
2022-01-13,70046,70052,Blue,1,42195,42521,326
2022-07-07,70049,70838,Blue,0,42719,43403,684
2022-02-27,70038,70056,Blue,1,42967,43848,881
2022-12-23,70041,70838,Blue,0,53960,54081,121
2022-06-22,70038,70056,Blue,1,25800,26753,953
2022-03-02,70050,70056,Blue,1,60023,60493,470
2022-03-07,70053,70039,Blue,0,54484,55262,778
2022-11-11,70046,70056,Blue,1,25173,25659,486
2022-08-11,70047,70838,Blue,0,41261,41844,583
2022-03-28,70040,70046,Blue,1,28021,28305,284
2022-08-11,70053,70043,Blue,0,46549,47138,589
2022-03-25,70046,70052,Blue,1,34205,34600,395
2022-09-28,70043,70039,Blue,0,60274,60375,101
2022-08-11,70057,70047,Blue,0,29799,30337,538
2022-11-30,70038,70054,Blue,1,34878,35668,790
2022-02-12,70038,70054,Blue,1,85521,86388,867
2022-10-10,70038,70054,Blue,1,66928,67813,885
2022-04-06,70038,70054,Blue,1,34004,34801,797
2022-04-17,70049,70043,Blue,0,52735,53087,352
2022-12-31,70053,70043,Blue,0,49504,50096,592
2022-06-29,70054,70058,Blue,1,89914,90063,149
2022-04-19,70053,70047,Blue,0,56552,56867,315
2022-05-20,70043,70838,Blue,0,19967,20181,214
2022-08-23,70057,70047,Blue,0,41741,42302,561
2022-03-20,70038,70056,Blue,1,80354,81261,907
2022-04-22,70045,70838,Blue,0,22264,22635,371
2022-11-17,70059,70039,Blue,0,35909,36941,1032
2022-03-11,70048,70050,Blue,1,65527,65588,61
2022-11-17,70044,70060,Blue,1,61631,62510,879
2022-06-18,70042,70054,Blue,1,76251,76931,680
2022-07-30,70046,70052,Blue,1,30013,30331,318
2022-09-22,70038,70056,Blue,1,70527,71392,865
2022-02-23,70038,70052,Blue,1,44112,44858,746
2022-01-24,70059,70055,Blue,0,71536,71689,153
2022-11-21,70040,70056,Blue,1,39689,40626,937
2022-03-16,70057,70041,Blue,0,60558,61387,829
2022-04-18,70052,70060,Blue,1,75216,75602,386
2022-09-04,70057,70039,Blue,0,53733,54713,980
2022-11-28,70040,70050,Blue,1,54975,55475,500
2022-11-12,70048,70052,Blue,1,79426,79629,203
2022-11-07,70050,70052,Blue,1,79525,79633,108
2022-05-02,70052,70060,Blue,1,61773,62133,360
2022-02-22,70044,70056,Blue,1,45527,46225,698
2022-06-27,70040,70042,Blue,1,21560,21594,34
2022-11-22,70051,70049,Blue,0,47121,47223,102
2022-06-21,70038,70046,Blue,1,85727,86064,337
2022-07-16,70040,70056,Blue,1,79337,80233,896
2022-03-18,70053,70045,Blue,0,49487,49947,460
2022-10-15,70038,70046,Blue,1,28589,28897,308
2022-02-12,70052,70058,Blue,1,76894,77152,258
2022-02-26,70049,70047,Blue,0,30252,30310,58
2022-12-17,70049,70039,Blue,0,27067,27556,489
2022-11-30,70038,70050,Blue,1,35293,35823,530
2022-04-16,70056,70058,Blue,1,48418,48488,70
2022-01-18,70057,70053,Blue,0,70045,70217,172
2022-01-28,70042,70056,Blue,1,19942,20718,776
2022-11-17,70046,70050,Blue,1,38824,39014,190
2022-06-22,70051,70043,Blue,0,24867,25377,510
2022-07-12,70053,70045,Blue,0,69514,69942,428
2022-03-10,70050,70052,Blue,1,89698,89817,119
2022-09-16,70042,70056,Blue,1,68178,69048,870
2022-12-28,70055,70043,Blue,0,56208,56870,662
2022-08-18,70038,70048,Blue,1,70881,71349,468
2022-11-25,70048,70054,Blue,1,34926,35210,284
2022-09-13,70046,70058,Blue,1,89448,90024,576
2022-04-03,70052,70060,Blue,1,63198,63569,371
2022-08-24,70055,70047,Blue,0,76635,76996,361
2022-06-25,70059,70041,Blue,0,68880,69825,945
2022-07-14,70043,70041,Blue,0,72814,72845,31
2022-03-29,70059,70041,Blue,0,65595,66528,933
2022-01-24,70051,70041,Blue,0,84409,84987,578
2022-02-18,70040,70048,Blue,1,39788,40157,369
2022-04-19,70038,70042,Blue,1,80921,81039,118
2022-11-23,70044,70050,Blue,1,44936,45298,362
2022-10-23,70054,70056,Blue,1,26128,26175,47
2022-11-05,70059,70043,Blue,0,55693,56506,813
2022-08-19,70042,70060,Blue,1,44699,45760,1061
2022-06-25,70040,70058,Blue,1,59432,60524,1092
2022-12-19,70057,70043,Blue,0,51345,52168,823
2022-11-09,70040,70054,Blue,1,51390,52121,731
2022-06-13,70040,70050,Blue,1,26116,26788,672
2022-05-21,70044,70054,Blue,1,21940,22652,712
2022-09-12,70038,70056,Blue,1,77332,78204,872
2022-07-11,70054,70056,Blue,1,51653,51702,49
2022-11-27,70052,70058,Blue,1,64245,64518,273
2022-09-04,70051,70838,Blue,0,55088,55924,836
2022-10-06,70048,70060,Blue,1,26622,27279,657
2022-07-30,70046,70054,Blue,1,28382,28798,416
2022-11-14,70049,70838,Blue,0,24260,24868,608
2022-03-15,70059,70045,Blue,0,35843,36626,783
2022-03-19,70038,70056,Blue,1,55037,55928,891
2022-10-19,70053,70043,Blue,0,53943,54608,665
2022-10-07,70051,70041,Blue,0,36288,36887,599
2022-08-22,70059,70047,Blue,0,23008,23588,580
2022-03-08,70055,70049,Blue,0,47844,48129,285
2022-09-29,70059,70041,Blue,0,37457,38541,1084
2022-04-07,70059,70838,Blue,0,66494,67633,1139
2022-03-09,70048,70054,Blue,1,63457,63842,385
2022-11-10,70057,70045,Blue,0,71844,72490,646
2022-05-17,70058,70060,Blue,1,60306,60366,60
2022-01-22,70055,70043,Blue,0,77976,78676,700
2022-03-24,70038,70056,Blue,1,82068,83145,1077
2022-02-28,70038,70042,Blue,1,37413,37548,135
2022-03-20,70059,70041,Blue,0,62733,63654,921
2022-02-12,70056,70058,Blue,1,70595,70666,71
2022-10-20,70057,70053,Blue,0,75449,75596,147
2022-11-29,70052,70060,Blue,1,39772,40144,372
2022-02-09,70050,70052,Blue,1,64061,64195,134
2022-04-11,70048,70056,Blue,1,35618,36022,404
2022-10-27,70057,70041,Blue,0,34928,35937,1009
2022-06-24,70044,70060,Blue,1,63053,64049,996
2022-08-12,70053,70045,Blue,0,41024,41515,491
2022-09-02,70055,70051,Blue,0,64148,64290,142
2022-08-19,70049,70047,Blue,0,34013,34072,59
2022-08-29,70040,70052,Blue,1,21938,22703,765
2022-12-03,70046,70050,Blue,1,71057,71238,181
2022-05-18,70046,70056,Blue,1,33710,34292,582
2022-08-26,70047,70039,Blue,0,30389,30865,476
2022-02-16,70040,70050,Blue,1,52853,53505,652
2022-04-18,70059,70045,Blue,0,64111,64755,644
2022-03-01,70056,70060,Blue,1,55580,55910,330
2022-03-22,70053,70041,Blue,0,57076,57811,735
2022-08-15,70047,70041,Blue,0,52766,53141,375
2022-12-29,70049,70045,Blue,0,30826,31042,216
2022-01-09,70054,70060,Blue,1,53454,53721,267
2022-08-04,70050,70056,Blue,1,81337,81651,314
2022-04-27,70051,70047,Blue,0,66030,66232,202
2022-05-07,70059,70053,Blue,0,51616,51847,231
2022-09-28,70045,70043,Blue,0,61127,61224,97
2022-03-22,70049,70045,Blue,0,60928,61149,221
2022-12-20,70059,70047,Blue,0,52154,52704,550
2022-07-28,70042,70046,Blue,1,79850,80038,188
2022-07-30,70048,70056,Blue,1,23093,23503,410
2022-10-06,70059,70838,Blue,0,78949,80060,1111
2022-04-16,70039,70838,Blue,0,53004,53038,34
2022-01-15,70049,70045,Blue,0,65702,65912,210
2022-06-11,70055,70838,Blue,0,64004,65006,1002
2022-02-01,70042,70058,Blue,1,34312,35317,1005
2022-01-10,70055,70043,Blue,0,21867,22562,695
2022-03-25,70051,70039,Blue,0,77531,78163,632
2022-12-10,70040,70046,Blue,1,30790,31063,273
2022-01-06,70038,70042,Blue,1,59864,59976,112
2022-04-12,70057,70043,Blue,0,38211,39193,982
2022-01-06,70044,70050,Blue,1,21604,21990,386
2022-02-06,70038,70042,Blue,1,65123,65238,115
2022-06-18,70047,70838,Blue,0,42815,43329,514
2022-08-04,70053,70045,Blue,0,34723,35228,505
2022-03-08,70056,70058,Blue,1,56864,56935,71
2022-12-22,70057,70838,Blue,0,41786,44064,2278
2022-05-27,70043,70041,Blue,0,42870,42900,30
2022-06-27,70057,70047,Blue,0,34288,34813,525
2022-11-03,70047,70041,Blue,0,45513,45862,349
2022-02-11,70053,70041,Blue,0,24857,25585,728
2022-06-17,70057,70049,Blue,0,44486,44879,393
2022-04-14,70048,70060,Blue,1,57434,58070,636
2022-04-05,70040,70042,Blue,1,32398,32429,31
2022-12-02,70044,70052,Blue,1,41891,42377,486
2022-10-02,70055,70041,Blue,0,48612,49359,747
2022-08-09,70059,70055,Blue,0,63947,64135,188
2022-02-25,70050,70056,Blue,1,54933,55231,298
2022-08-30,70038,70046,Blue,1,50532,51044,512
2022-02-15,70040,70060,Blue,1,38710,39932,1222
2022-04-20,70038,70042,Blue,1,51255,51364,109
2022-02-17,70048,70060,Blue,1,68816,69511,695
2022-01-12,70057,70049,Blue,0,61794,62212,418
2022-10-07,70056,70058,Blue,1,36194,36267,73
2022-02-14,70041,70039,Blue,0,50270,50303,33
2022-06-27,70044,70058,Blue,1,26370,27259,889
2022-03-12,70052,70060,Blue,1,36295,36627,332
2022-07-29,70044,70050,Blue,1,72684,73034,350
2022-08-17,70042,70046,Blue,1,27572,27741,169
2022-03-30,70053,70049,Blue,0,25443,25641,198
2022-09-21,70038,70048,Blue,1,89114,89602,488
2022-01-24,70045,70838,Blue,0,54993,55346,353
2022-07-05,70053,70043,Blue,0,59596,60255,659
2022-09-02,70048,70054,Blue,1,60430,60745,315
2022-04-11,70057,70047,Blue,0,82967,83488,521
2022-02-01,70038,70060,Blue,1,39315,40541,1226
2022-11-09,70051,70047,Blue,0,32107,32333,226
2022-11-22,70057,70049,Blue,0,55720,56118,398
2022-03-01,70056,70058,Blue,1,60481,60579,98
2022-12-20,70051,70047,Blue,0,21674,21902,228
2022-04-18,70056,70058,Blue,1,29592,29661,69
2022-10-12,70040,70056,Blue,1,82737,83642,905
2022-03-01,70057,70043,Blue,0,57766,58548,782
2022-10-31,70040,70046,Blue,1,62449,62763,314
2022-02-10,70046,70052,Blue,1,53403,53768,365
2022-04-10,70056,70058,Blue,1,62241,62317,76
2022-03-31,70053,70051,Blue,0,30258,30319,61
2022-11-25,70047,70039,Blue,0,54122,54508,386
2022-03-28,70057,70055,Blue,0,59671,59739,68
2022-07-08,70042,70054,Blue,1,24785,25516,731
2022-09-13,70038,70040,Blue,1,79074,79088,14
2022-07-08,70042,70046,Blue,1,60621,60821,200
2022-11-13,70051,70838,Blue,0,46143,46859,716
2022-02-22,70048,70058,Blue,1,62790,63361,571
2022-02-24,70059,70043,Blue,0,32059,32954,895
2022-09-02,70047,70838,Blue,0,59364,59843,479
2022-09-23,70044,70046,Blue,1,36503,36610,107
2022-10-01,70051,70043,Blue,0,68503,68988,485
2022-12-24,70045,70043,Blue,0,35010,35141,131
2022-01-22,70042,70050,Blue,1,28170,28545,375
2022-07-18,70044,70056,Blue,1,59948,60837,889
2022-03-06,70054,70056,Blue,1,84614,84661,47
2022-07-12,70047,70039,Blue,0,48453,48876,423
2022-02-26,70051,70049,Blue,0,29579,29681,102
2022-07-07,70050,70054,Blue,1,37564,37830,266
2022-12-17,70040,70042,Blue,1,74561,74626,65
2022-04-11,70046,70058,Blue,1,50112,50713,601
2022-09-08,70053,70047,Blue,0,57984,58272,288
2022-09-20,70053,70045,Blue,0,61102,61546,444
2022-06-29,70039,70838,Blue,0,75446,75477,31
2022-10-04,70052,70060,Blue,1,58857,59233,376
2022-02-15,70052,70056,Blue,1,64135,64289,154
2022-01-14,70040,70050,Blue,1,50843,51392,549
2022-12-21,70048,70056,Blue,1,31463,31853,390
2022-01-06,70057,70838,Blue,0,50341,51817,1476
2022-08-28,70059,70039,Blue,0,21498,22610,1112
2022-07-10,70038,70044,Blue,1,43657,43852,195
2022-07-02,70038,70050,Blue,1,88205,88741,536
2022-11-14,70049,70838,Blue,0,41524,42118,594
2022-03-30,70044,70050,Blue,1,20062,20442,380
2022-11-26,70038,70060,Blue,1,38297,39407,1110
2022-02-18,70055,70049,Blue,0,65798,66103,305
2022-11-06,70052,70056,Blue,1,44406,44546,140
2022-03-02,70046,70056,Blue,1,56375,57012,637
2022-02-15,70051,70041,Blue,0,66585,67248,663
2022-12-12,70052,70054,Blue,1,21847,21892,45
2022-02-06,70041,70039,Blue,0,63508,63540,32
2022-10-15,70040,70042,Blue,1,49794,49829,35
2022-03-23,70048,70056,Blue,1,56148,56544,396
2022-11-24,70044,70060,Blue,1,71220,72114,894
2022-12-24,70051,70049,Blue,0,86908,87009,101
2022-07-02,70041,70039,Blue,0,64281,64318,37
2022-11-30,70042,70060,Blue,1,61415,62463,1048
2022-01-26,70040,70050,Blue,1,36795,37299,504
2022-11-18,70047,70041,Blue,0,52669,53007,338
2022-01-03,70040,70058,Blue,1,78139,79102,963
2022-12-30,70040,70054,Blue,1,56889,57639,750
2022-07-07,70048,70052,Blue,1,48532,48745,213
2022-07-04,70038,70058,Blue,1,71710,72736,1026
2022-03-01,70053,70039,Blue,0,29355,30168,813
2022-11-04,70051,70041,Blue,0,68903,69642,739
2022-07-30,70044,70052,Blue,1,67135,67640,505
2022-11-26,70050,70052,Blue,1,28252,28369,117
2022-11-20,70053,70051,Blue,0,29595,29660,65
2022-01-21,70059,70051,Blue,0,22394,22806,412
2022-09-28,70038,70042,Blue,1,37752,37838,86
2022-11-28,70046,70060,Blue,1,34368,35076,708
2022-11-30,70059,70055,Blue,0,84196,84335,139
2022-03-13,70050,70060,Blue,1,35514,35989,475
2022-08-29,70038,70044,Blue,1,25728,25920,192
2022-03-11,70043,70039,Blue,0,78658,78774,116
2022-12-04,70048,70052,Blue,1,62936,63154,218
2022-04-10,70059,70039,Blue,0,31635,32663,1028
2022-09-28,70045,70041,Blue,0,88913,89101,188
2022-08-06,70055,70043,Blue,0,79287,79970,683
2022-07-05,70040,70042,Blue,1,36645,36686,41
2022-05-26,70049,70045,Blue,0,74545,74780,235
2022-01-31,70051,70039,Blue,0,68596,69288,692
2022-01-02,70050,70054,Blue,1,81107,81321,214
2022-09-22,70057,70055,Blue,0,53612,53681,69
2022-01-01,70050,70052,Blue,1,62881,62986,105
2022-01-13,70040,70044,Blue,1,30675,30782,107
2022-01-24,70047,70039,Blue,0,65011,65451,440
2022-09-18,70044,70056,Blue,1,33336,33960,624
2022-04-11,70057,70045,Blue,0,83550,84145,595
2022-10-08,70050,70058,Blue,1,43865,44305,440
2022-12-31,70047,70039,Blue,0,40165,40573,408
2022-03-24,70059,70057,Blue,0,54496,54532,36
2022-12-28,70049,70838,Blue,0,51102,51748,646
2022-06-15,70044,70052,Blue,1,54271,54837,566
2022-02-06,70038,70058,Blue,1,76937,77883,946
2022-01-28,70052,70060,Blue,1,55115,55483,368
2022-09-29,70042,70046,Blue,1,21374,21572,198
2022-11-30,70056,70058,Blue,1,49166,49240,74
2022-07-13,70059,70041,Blue,0,83800,84714,914
2022-02-02,70040,70058,Blue,1,39184,40548,1364
2022-11-27,70041,70838,Blue,0,39719,39839,120
2022-10-26,70049,70041,Blue,0,30706,31172,466
2022-06-23,70042,70052,Blue,1,28897,29493,596
2022-06-26,70051,70045,Blue,0,59884,60217,333
2022-11-03,70047,70039,Blue,0,43269,43678,409
2022-05-14,70055,70053,Blue,0,41005,41052,47
2022-02-21,70044,70054,Blue,1,68870,69509,639
2022-02-18,70058,70060,Blue,1,58892,59061,169
2022-12-21,70051,70049,Blue,0,57909,58011,102
2022-07-13,70049,70043,Blue,0,29884,30306,422
2022-03-05,70049,70045,Blue,0,80388,80602,214
2022-07-12,70050,70060,Blue,1,20523,21050,527
2022-07-17,70041,70838,Blue,0,49984,50116,132
2022-09-08,70047,70045,Blue,0,79500,79593,93
2022-08-16,70048,70050,Blue,1,79438,79493,55
2022-12-16,70053,70051,Blue,0,53786,53844,58
2022-08-04,70046,70054,Blue,1,72447,72908,461
2022-01-21,70053,70051,Blue,0,33285,33346,61
2022-10-20,70040,70054,Blue,1,20068,20929,861
2022-06-28,70048,70054,Blue,1,60711,61040,329
2022-12-11,70047,70045,Blue,0,36801,36895,94
2022-04-02,70048,70050,Blue,1,46384,46442,58
2022-10-05,70053,70838,Blue,0,35151,36045,894
2022-06-28,70040,70054,Blue,1,87419,88113,694
2022-01-16,70039,70838,Blue,0,34191,34223,32
2022-01-13,70040,70056,Blue,1,46458,47321,863
2022-08-30,70043,70041,Blue,0,61682,61708,26
2022-11-09,70040,70048,Blue,1,51104,51490,386
2022-01-12,70051,70047,Blue,0,36989,37194,205
2022-09-12,70059,70039,Blue,0,23018,24095,1077
2022-04-15,70053,70045,Blue,0,23312,23739,427
2022-09-15,70048,70054,Blue,1,78439,78840,401
2022-12-16,70045,70041,Blue,0,60186,60360,174
2022-10-29,70054,70058,Blue,1,30534,30687,153
2022-07-14,70051,70039,Blue,0,35711,36468,757
2022-06-20,70053,70049,Blue,0,84435,84630,195
2022-05-18,70050,70054,Blue,1,65143,65371,228
2022-09-15,70051,70039,Blue,0,67890,68606,716
2022-10-11,70040,70050,Blue,1,43079,43590,511
2022-03-08,70056,70058,Blue,1,35209,35281,72
2022-12-25,70055,70039,Blue,0,81749,82612,863
2022-02-04,70038,70058,Blue,1,76900,78016,1116
2022-03-29,70038,70040,Blue,1,28478,28493,15
2022-03-02,70046,70060,Blue,1,33594,34424,830
2022-09-28,70046,70052,Blue,1,45539,45868,329
2022-07-07,70041,70039,Blue,0,72619,72650,31
2022-07-12,70038,70056,Blue,1,47144,48146,1002
2022-06-09,70042,70050,Blue,1,45434,45896,462
2022-02-02,70050,70056,Blue,1,58051,58401,350
2022-06-14,70051,70838,Blue,0,70882,71603,721
2022-06-21,70059,70041,Blue,0,52566,53632,1066
2022-08-26,70042,70060,Blue,1,86655,87672,1017
2022-10-16,70049,70045,Blue,0,39984,40178,194
2022-01-18,70048,70058,Blue,1,25754,26264,510
2022-11-23,70053,70049,Blue,0,70506,70706,200
2022-02-27,70059,70045,Blue,0,44654,45313,659
2022-03-04,70057,70055,Blue,0,45059,45127,68
2022-02-02,70057,70045,Blue,0,24702,25423,721
2022-10-28,70041,70838,Blue,0,56381,56500,119
2022-01-17,70053,70039,Blue,0,63013,63786,773
2022-12-17,70057,70838,Blue,0,69809,70832,1023
2022-07-05,70059,70053,Blue,0,38081,38446,365
2022-02-07,70043,70838,Blue,0,87286,87473,187
2022-01-19,70042,70044,Blue,1,22301,22331,30
2022-02-20,70049,70047,Blue,0,45878,45931,53
2022-06-04,70047,70043,Blue,0,85717,86014,297
2022-11-24,70052,70060,Blue,1,51697,52043,346
2022-08-06,70040,70048,Blue,1,57874,58285,411
2022-09-22,70056,70058,Blue,1,52704,52796,92
2022-12-07,70051,70838,Blue,0,28735,29484,749
2022-04-10,70047,70039,Blue,0,35353,35762,409
2022-03-23,70044,70050,Blue,1,29544,29867,323
2022-08-03,70059,70057,Blue,0,80474,80508,34
2022-01-20,70059,70055,Blue,0,64987,65130,143
2022-01-01,70040,70060,Blue,1,56503,57572,1069
2022-09-04,70044,70052,Blue,1,79318,79804,486
2022-02-14,70040,70042,Blue,1,26410,26442,32
2022-01-31,70053,70039,Blue,0,65655,66453,798
2022-11-21,70039,70838,Blue,0,76071,76105,34
2022-11-11,70052,70058,Blue,1,31436,31696,260
2022-09-15,70047,70039,Blue,0,57013,57432,419
2022-11-22,70051,70039,Blue,0,27458,28123,665
2022-07-21,70044,70058,Blue,1,48520,49357,837
2022-08-16,70045,70039,Blue,0,74545,74782,237
2022-03-22,70057,70051,Blue,0,66873,67142,269
2022-08-16,70038,70048,Blue,1,43675,44180,505
2022-12-16,70048,70060,Blue,1,29530,30172,642
2022-02-19,70048,70050,Blue,1,41482,41537,55
2022-03-06,70059,70055,Blue,0,72735,72879,144
2022-04-11,70038,70048,Blue,1,74126,74571,445
2022-12-16,70038,70050,Blue,1,63807,64405,598
2022-06-17,70040,70060,Blue,1,29431,30540,1109
2022-06-15,70047,70039,Blue,0,25623,26094,471
2022-10-18,70042,70050,Blue,1,43060,43448,388
2022-09-08,70059,70055,Blue,0,22575,22727,152
2022-07-11,70038,70050,Blue,1,66975,67602,627
2022-09-23,70053,70047,Blue,0,40328,40681,353
2022-04-24,70049,70043,Blue,0,82086,82458,372
2022-02-02,70039,70838,Blue,0,34212,34254,42
2022-04-10,70059,70049,Blue,0,80894,81335,441
2022-01-09,70044,70052,Blue,1,69032,69604,572
2022-01-19,70050,70052,Blue,1,34416,34526,110
2022-03-07,70050,70054,Blue,1,39750,39988,238
2022-11-24,70057,70045,Blue,0,21573,22204,631
2022-07-16,70057,70051,Blue,0,56318,56565,247
2022-06-27,70040,70050,Blue,1,23879,24467,588
2022-04-28,70049,70047,Blue,0,67231,67284,53
2022-01-19,70038,70048,Blue,1,57435,57900,465
2022-08-02,70044,70050,Blue,1,25826,26155,329
2022-12-07,70044,70048,Blue,1,44247,44495,248
2022-10-05,70048,70050,Blue,1,27908,27966,58
2022-08-02,70038,70042,Blue,1,74732,74828,96
2022-08-29,70057,70043,Blue,0,88347,89194,847
2022-05-29,70046,70052,Blue,1,33100,33543,443
2022-07-05,70042,70056,Blue,1,47060,47990,930
2022-07-06,70046,70054,Blue,1,86444,86879,435
2022-10-22,70046,70048,Blue,1,50593,50677,84
2022-03-18,70044,70046,Blue,1,87988,88090,102
2022-07-25,70050,70056,Blue,1,47387,47737,350
2022-12-30,70052,70054,Blue,1,65645,65695,50
2022-07-05,70055,70041,Blue,0,53360,54162,802
2022-06-29,70049,70047,Blue,0,63477,63531,54
2022-02-11,70038,70044,Blue,1,29969,30139,170
2022-01-24,70059,70051,Blue,0,59896,60254,358
2022-12-14,70059,70838,Blue,0,74894,76004,1110
2022-06-27,70048,70058,Blue,1,78423,78930,507
2022-03-11,70049,70047,Blue,0,21463,21519,56
2022-02-12,70056,70060,Blue,1,39740,39994,254
2022-04-24,70050,70052,Blue,1,72591,72704,113
2022-01-21,70055,70043,Blue,0,26852,27649,797
2022-08-05,70042,70054,Blue,1,68398,69110,712
2022-04-03,70038,70050,Blue,1,52087,52664,577
2022-06-18,70054,70056,Blue,1,63673,63720,47
2022-08-22,70048,70060,Blue,1,57323,57975,652
2022-04-22,70053,70041,Blue,0,66801,67545,744
2022-06-20,70057,70039,Blue,0,58017,59015,998
2022-03-27,70043,70039,Blue,0,34970,35088,118
2022-11-07,70057,70041,Blue,0,43629,44538,909
2022-06-21,70051,70045,Blue,0,82650,82980,330
2022-09-20,70056,70060,Blue,1,69958,70137,179
2022-09-30,70052,70056,Blue,1,60729,60856,127
2022-01-25,70046,70048,Blue,1,21495,21640,145
2022-03-26,70045,70039,Blue,0,55373,55627,254
2022-03-03,70044,70048,Blue,1,71189,71415,226
2022-02-12,70042,70044,Blue,1,66603,66633,30
2022-09-19,70038,70048,Blue,1,50312,50816,504
2022-09-03,70043,70039,Blue,0,47468,47591,123
2022-05-04,70052,70058,Blue,1,59909,60148,239
2022-10-29,70053,70045,Blue,0,57570,58002,432
2022-08-13,70045,70039,Blue,0,20461,20702,241
2022-03-02,70044,70056,Blue,1,32552,33174,622
2022-10-08,70046,70054,Blue,1,59725,60175,450
2022-07-02,70052,70054,Blue,1,42797,42862,65
2022-12-31,70041,70838,Blue,0,85090,85204,114
2022-08-15,70057,70043,Blue,0,69231,69970,739
2022-09-22,70050,70058,Blue,1,53689,54071,382
2022-07-12,70050,70052,Blue,1,70858,70967,109
2022-07-29,70040,70060,Blue,1,34594,35717,1123
2022-03-03,70038,70058,Blue,1,19881,21085,1204
2022-01-20,70045,70039,Blue,0,75113,75413,300
2022-01-29,70044,70058,Blue,1,33294,34643,1349
2022-11-10,70049,70041,Blue,0,37525,38044,519
2022-04-05,70043,70039,Blue,0,20239,20359,120
2022-01-09,70059,70047,Blue,0,31638,32191,553
2022-12-06,70057,70053,Blue,0,83960,84118,158
2022-10-01,70055,70047,Blue,0,63874,64257,383
2022-07-06,70051,70045,Blue,0,36948,37348,400
2022-08-19,70040,70060,Blue,1,74918,75942,1024
2022-11-01,70038,70044,Blue,1,31930,32105,175
2022-02-26,70052,70058,Blue,1,26521,26787,266
2022-02-15,70044,70058,Blue,1,44874,45679,805
2022-09-13,70053,70039,Blue,0,61593,62320,727
2022-04-05,70040,70048,Blue,1,45337,45745,408
2022-08-11,70056,70060,Blue,1,71521,71689,168
2022-11-24,70059,70043,Blue,0,23092,24059,967
2022-11-11,70040,70060,Blue,1,51450,52525,1075
2022-04-06,70049,70039,Blue,0,53082,53646,564
2022-01-19,70046,70060,Blue,1,90824,91637,813
2022-11-29,70052,70060,Blue,1,45266,45613,347
2022-07-06,70044,70054,Blue,1,55030,55670,640
2022-06-09,70038,70048,Blue,1,24996,25489,493
2022-11-06,70045,70043,Blue,0,70784,70873,89
2022-03-05,70048,70056,Blue,1,57738,58111,373
2022-08-01,70040,70058,Blue,1,26565,27527,962
2022-08-18,70051,70041,Blue,0,49278,49862,584
2022-04-04,70046,70056,Blue,1,45755,46301,546
2022-03-22,70059,70045,Blue,0,63076,63803,727
2022-09-20,70038,70042,Blue,1,51410,51505,95
2022-07-08,70057,70047,Blue,0,74570,75067,497
2022-01-05,70053,70049,Blue,0,41244,41460,216
2022-10-20,70057,70047,Blue,0,69750,70228,478
2022-04-07,70040,70054,Blue,1,73035,73893,858
2022-06-24,70055,70045,Blue,0,56088,56609,521
2022-09-26,70056,70060,Blue,1,50322,50506,184
2022-12-29,70040,70052,Blue,1,58635,59270,635
2022-09-19,70057,70039,Blue,0,33211,34240,1029
2022-08-22,70052,70054,Blue,1,91689,91748,59
2022-03-24,70038,70060,Blue,1,80318,81447,1129
2022-10-26,70048,70052,Blue,1,91379,91566,187
2022-01-17,70053,70051,Blue,0,29045,29104,59
2022-11-09,70042,70050,Blue,1,76878,77273,395
2022-07-30,70050,70052,Blue,1,49158,49267,109
2022-04-07,70053,70047,Blue,0,57156,57448,292
2022-09-27,70038,70056,Blue,1,63903,64860,957
2022-12-19,70042,70050,Blue,1,68895,69298,403
2022-09-05,70053,70838,Blue,0,45460,46436,976
2022-10-07,70059,70055,Blue,0,55094,55240,146
2022-04-23,70047,70838,Blue,0,67074,67553,479
2022-03-10,70046,70050,Blue,1,40489,40678,189
2022-06-27,70057,70043,Blue,0,50036,50842,806
2022-01-24,70045,70838,Blue,0,25964,26376,412
2022-01-26,70049,70047,Blue,0,66391,66445,54
2022-07-03,70040,70042,Blue,1,24609,24642,33
2022-09-01,70044,70048,Blue,1,56271,56497,226
2022-03-25,70040,70056,Blue,1,54380,55300,920
2022-11-22,70048,70050,Blue,1,74088,74141,53
2022-03-12,70048,70050,Blue,1,68478,68539,61
2022-01-05,70051,70838,Blue,0,41902,42587,685
2022-01-17,70044,70058,Blue,1,53116,53923,807
2022-08-24,70038,70050,Blue,1,53563,54202,639
2022-03-10,70038,70042,Blue,1,67933,68033,100
2022-03-25,70059,70838,Blue,0,57497,58593,1096
2022-03-25,70047,70045,Blue,0,53975,54106,131
2022-12-10,70045,70043,Blue,0,50561,50660,99
2022-07-21,70055,70838,Blue,0,74492,75706,1214
2022-10-05,70043,70838,Blue,0,85837,86019,182
2022-02-04,70059,70043,Blue,0,29412,30504,1092
2022-12-03,70059,70039,Blue,0,58933,59967,1034
2022-03-07,70047,70045,Blue,0,22299,22395,96
2022-08-24,70040,70044,Blue,1,39133,39234,101
2022-03-27,70041,70039,Blue,0,58604,58639,35
2022-05-30,70042,70050,Blue,1,35868,36345,477
2022-12-20,70040,70046,Blue,1,69670,69925,255
2022-12-04,70046,70052,Blue,1,35841,36241,400
2022-01-14,70038,70060,Blue,1,51907,53120,1213
2022-01-31,70038,70056,Blue,1,68188,69163,975
2022-10-27,70046,70048,Blue,1,40356,40437,81
2022-08-08,70059,70053,Blue,0,74353,74619,266
2022-04-13,70040,70060,Blue,1,85129,86190,1061
2022-07-08,70050,70058,Blue,1,27991,28438,447
2022-07-17,70038,70040,Blue,1,48369,48388,19
2022-07-12,70041,70838,Blue,0,56134,56259,125
2022-03-21,70046,70048,Blue,1,38942,39024,82
2022-08-31,70038,70050,Blue,1,72621,73188,567
2022-06-21,70040,70052,Blue,1,68612,69290,678
2022-04-15,70038,70044,Blue,1,61405,61588,183
2022-12-31,70040,70048,Blue,1,40506,40897,391
2022-09-16,70054,70056,Blue,1,55471,55518,47
2022-05-06,70056,70058,Blue,1,75812,75883,71
2022-09-26,70048,70056,Blue,1,62423,62801,378
2022-03-08,70040,70058,Blue,1,62898,63833,935
2022-02-03,70059,70053,Blue,0,66496,66756,260
2022-01-06,70041,70039,Blue,0,47207,47238,31
2022-02-23,70046,70054,Blue,1,60870,61320,450
2022-10-04,70038,70042,Blue,1,33680,33789,109
2022-01-23,70052,70054,Blue,1,76153,76215,62
2022-08-20,70053,70045,Blue,0,69992,70437,445
2022-12-01,70053,70049,Blue,0,37699,37896,197
2022-03-03,70044,70046,Blue,1,76590,76699,109
2022-10-23,70046,70056,Blue,1,60040,60617,577
2022-04-14,70038,70046,Blue,1,35266,35595,329
2022-04-01,70057,70047,Blue,0,59681,60156,475
2022-12-20,70045,70838,Blue,0,33757,34078,321
2022-11-16,70054,70058,Blue,1,29391,29551,160
2022-02-21,70050,70060,Blue,1,47044,47580,536
2022-07-09,70042,70046,Blue,1,46565,46770,205
2022-10-20,70059,70051,Blue,0,20416,20730,314
2022-03-20,70052,70056,Blue,1,67029,67168,139
2022-01-06,70056,70060,Blue,1,38335,38519,184
2022-07-08,70049,70039,Blue,0,52849,53401,552
2022-02-14,70044,70052,Blue,1,80507,81002,495
2022-12-06,70042,70048,Blue,1,81401,81706,305
2022-03-16,70047,70041,Blue,0,65565,65888,323
2022-10-24,70043,70838,Blue,0,36796,36981,185
2022-09-12,70053,70049,Blue,0,75151,75346,195
2022-08-12,70044,70048,Blue,1,60716,60984,268
2022-03-03,70048,70052,Blue,1,22860,23072,212
2022-10-31,70055,70043,Blue,0,69337,69988,651
2022-08-19,70043,70039,Blue,0,71215,71321,106
2022-11-08,70042,70056,Blue,1,49895,50653,758
2022-01-24,70050,70056,Blue,1,80943,81237,294
2022-05-02,70052,70056,Blue,1,70958,71086,128
2022-11-05,70051,70039,Blue,0,49047,49702,655
2022-02-16,70051,70043,Blue,0,67140,67616,476
2022-06-22,70044,70052,Blue,1,50787,51418,631
2022-12-20,70038,70048,Blue,1,83776,84544,768
2022-11-25,70039,70838,Blue,0,43292,43328,36
2022-03-22,70057,70055,Blue,0,20952,21029,77
2022-02-05,70040,70060,Blue,1,22644,23780,1136
2022-10-10,70055,70041,Blue,0,26566,27343,777
2022-03-12,70043,70838,Blue,0,75604,75807,203
2022-01-28,70045,70838,Blue,0,51501,51990,489
2022-02-07,70047,70041,Blue,0,82951,83281,330
2022-02-06,70059,70043,Blue,0,33197,33994,797
2022-06-10,70055,70838,Blue,0,21525,22551,1026
2022-11-26,70042,70058,Blue,1,30929,31796,867
2022-05-20,70051,70838,Blue,0,33999,34929,930
2022-08-23,70057,70043,Blue,0,66922,67728,806
2022-08-09,70042,70058,Blue,1,59481,60353,872
2022-01-09,70038,70040,Blue,1,59663,59678,15
2022-06-29,70040,70058,Blue,1,31667,32670,1003
2022-06-17,70045,70039,Blue,0,53588,53879,291
2022-04-12,70049,70041,Blue,0,37659,38205,546
2022-07-29,70044,70046,Blue,1,47638,47746,108
2022-03-17,70043,70039,Blue,0,79238,79344,106
2022-12-05,70046,70060,Blue,1,33961,34668,707
2022-07-21,70040,70060,Blue,1,52690,53766,1076
2022-04-04,70046,70050,Blue,1,23433,23638,205
2022-01-28,70055,70051,Blue,0,55269,55402,133
2022-03-10,70038,70060,Blue,1,25746,26913,1167
2022-08-09,70044,70060,Blue,1,40836,41761,925
2022-06-22,70053,70051,Blue,0,24236,24302,66
2022-07-04,70041,70838,Blue,0,60039,60153,114
2022-08-18,70058,70060,Blue,1,25742,25809,67
2022-10-30,70038,70050,Blue,1,33148,33715,567
2022-01-17,70046,70058,Blue,1,33309,34031,722
2022-06-20,70039,70838,Blue,0,33758,33793,35
2022-01-20,70046,70058,Blue,1,58427,59046,619
2022-02-10,70053,70039,Blue,0,83780,84588,808
2022-10-14,70041,70838,Blue,0,75884,76007,123
2022-03-18,70046,70050,Blue,1,36054,36247,193
2022-09-23,70040,70042,Blue,1,42942,42979,37
2022-06-17,70055,70838,Blue,0,81399,82343,944
2022-04-22,70040,70050,Blue,1,78149,78670,521
2022-08-10,70051,70049,Blue,0,38856,38964,108
2022-05-10,70059,70053,Blue,0,85876,86112,236
2022-11-17,70053,70838,Blue,0,59759,60549,790
2022-12-09,70057,70049,Blue,0,22677,23106,429
2022-01-23,70053,70838,Blue,0,61671,62526,855
2022-10-28,70050,70052,Blue,1,31882,32023,141
2022-02-10,70042,70058,Blue,1,69098,70010,912
2022-08-05,70048,70050,Blue,1,67317,67375,58
2022-02-06,70038,70044,Blue,1,84616,84781,165
2022-10-03,70044,70060,Blue,1,36693,37599,906
2022-03-03,70038,70040,Blue,1,33548,33567,19
2022-11-17,70048,70058,Blue,1,56014,56519,505
2022-01-05,70055,70838,Blue,0,75667,76501,834
2022-06-17,70038,70048,Blue,1,51710,52244,534
2022-03-24,70046,70060,Blue,1,51544,52289,745
2022-01-28,70042,70056,Blue,1,33396,34112,716
2022-06-17,70049,70039,Blue,0,56549,57075,526
2022-03-23,70056,70060,Blue,1,30577,30773,196
2022-09-13,70038,70042,Blue,1,42988,43096,108
2022-12-10,70059,70041,Blue,0,43839,44767,928
2022-08-11,70044,70046,Blue,1,64014,64115,101
2022-09-03,70055,70051,Blue,0,57496,57643,147
2022-04-24,70057,70055,Blue,0,47444,47514,70
2022-06-13,70050,70056,Blue,1,57570,57943,373
2022-03-28,70049,70041,Blue,0,54094,54513,419
2022-03-28,70049,70041,Blue,0,68965,69366,401
2022-03-16,70057,70838,Blue,0,30309,31409,1100
2022-02-21,70057,70047,Blue,0,38496,39015,519
2022-04-11,70054,70060,Blue,1,52485,52731,246
2022-03-18,70048,70054,Blue,1,35828,36170,342
2022-11-05,70049,70045,Blue,0,58361,58549,188
2022-08-24,70048,70056,Blue,1,21889,22344,455
2022-02-03,70051,70039,Blue,0,68305,69081,776
2022-09-02,70044,70046,Blue,1,56811,56917,106
2022-11-02,70053,70043,Blue,0,22278,22871,593
2022-11-03,70042,70046,Blue,1,64478,64647,169
2022-11-05,70048,70060,Blue,1,72181,72813,632
2022-09-29,70055,70039,Blue,0,25296,26213,917
2022-12-19,70047,70043,Blue,0,80634,80864,230
2022-08-16,70055,70043,Blue,0,73989,74635,646
2022-09-12,70046,70050,Blue,1,58857,59068,211
2022-12-06,70043,70041,Blue,0,58913,58942,29
2022-07-28,70040,70042,Blue,1,39925,39958,33
2022-04-15,70059,70047,Blue,0,29360,29974,614
2022-07-16,70040,70060,Blue,1,50792,51891,1099
2022-07-08,70058,70060,Blue,1,89257,89315,58
2022-09-05,70038,70056,Blue,1,75332,76233,901
2022-09-09,70048,70054,Blue,1,47170,47467,297
2022-11-19,70057,70838,Blue,0,88290,89595,1305
2022-05-26,70039,70838,Blue,0,31996,32029,33
2022-12-14,70040,70054,Blue,1,49274,50066,792
2022-12-30,70048,70052,Blue,1,58958,59159,201
2022-04-20,70042,70044,Blue,1,60344,60373,29
2022-11-04,70057,70049,Blue,0,47812,48190,378
2022-07-28,70057,70055,Blue,0,67647,67716,69
2022-08-27,70055,70039,Blue,0,26752,27564,812
2022-01-10,70047,70043,Blue,0,41609,41848,239
2022-12-27,70056,70058,Blue,1,24919,24990,71
2022-08-30,70040,70056,Blue,1,72671,73518,847
2022-01-31,70038,70052,Blue,1,68188,68954,766
2022-01-08,70040,70054,Blue,1,76696,77504,808
2022-01-04,70048,70054,Blue,1,54490,54798,308
2022-09-13,70048,70054,Blue,1,69483,69786,303
2022-07-14,70038,70050,Blue,1,28791,29387,596
2022-12-22,70040,70042,Blue,1,80831,80863,32
2022-10-22,70057,70041,Blue,0,62260,63166,906
2022-10-16,70042,70052,Blue,1,78140,78765,625
2022-07-13,70049,70043,Blue,0,69618,69971,353
2022-03-12,70047,70041,Blue,0,57940,58268,328
2022-01-28,70040,70056,Blue,1,27670,28627,957
2022-12-21,70046,70052,Blue,1,67801,68134,333
2022-06-17,70059,70041,Blue,0,46640,47660,1020
2022-12-23,70059,70055,Blue,0,70474,70665,191
2022-09-17,70059,70055,Blue,0,65414,65560,146
2022-04-06,70042,70048,Blue,1,36385,36723,338
2022-12-09,70047,70045,Blue,0,22236,22350,114
2022-02-18,70040,70046,Blue,1,34505,34776,271
2022-08-01,70045,70838,Blue,0,75604,75933,329
2022-06-17,70046,70054,Blue,1,73483,73968,485
2022-08-24,70045,70041,Blue,0,69985,70168,183
2022-03-18,70052,70054,Blue,1,30465,30519,54
2022-01-20,70046,70058,Blue,1,25637,26343,706
2022-09-02,70042,70060,Blue,1,30405,31396,991
2022-06-23,70057,70045,Blue,0,55283,55910,627
2022-01-26,70053,70045,Blue,0,65557,65978,421
2022-05-30,70040,70050,Blue,1,58015,58601,586
2022-12-11,70050,70052,Blue,1,66764,66882,118
2022-11-18,70049,70039,Blue,0,50784,51309,525
2022-02-11,70048,70058,Blue,1,33725,34188,463
2022-10-09,70045,70838,Blue,0,63864,64191,327
2022-06-19,70044,70058,Blue,1,62593,63390,797
2022-10-24,70040,70060,Blue,1,82705,83811,1106
2022-04-04,70046,70058,Blue,1,29420,30022,602
2022-11-01,70044,70054,Blue,1,62238,62860,622
2022-11-11,70047,70041,Blue,0,23773,24116,343
2022-10-03,70038,70040,Blue,1,27771,27789,18
2022-09-29,70042,70044,Blue,1,74578,74605,27
2022-05-20,70055,70049,Blue,0,25049,25350,301
2022-06-15,70041,70039,Blue,0,31678,31710,32
2022-09-06,70051,70041,Blue,0,58601,59161,560
2022-07-04,70057,70055,Blue,0,33083,33151,68
2022-06-19,70046,70058,Blue,1,88543,89114,571
2022-08-21,70042,70052,Blue,1,61408,61955,547
2022-07-18,70057,70039,Blue,0,47914,48855,941
2022-04-16,70049,70838,Blue,0,58884,59481,597
2022-02-10,70046,70048,Blue,1,21965,22046,81
2022-07-30,70057,70041,Blue,0,32560,33451,891
2022-11-02,70055,70049,Blue,0,29863,30166,303
2022-09-30,70054,70058,Blue,1,33507,33660,153
2022-09-10,70059,70053,Blue,0,81501,81722,221
2022-10-01,70055,70053,Blue,0,24315,24366,51
2022-04-12,70056,70060,Blue,1,82993,83160,167
2022-12-16,70054,70056,Blue,1,87457,87504,47
2022-01-07,70042,70054,Blue,1,27730,28430,700
2022-08-11,70052,70058,Blue,1,46903,47166,263
2022-12-20,70059,70055,Blue,0,38554,38704,150
2022-04-04,70052,70056,Blue,1,45368,45497,129
2022-07-18,70049,70039,Blue,0,63312,63835,523
2022-07-22,70055,70049,Blue,0,30976,31241,265
2022-11-17,70059,70057,Blue,0,21606,21646,40
2022-08-20,70048,70060,Blue,1,65266,65927,661
2022-06-27,70038,70060,Blue,1,44088,45368,1280
2022-12-24,70040,70044,Blue,1,50949,51059,110
2022-01-15,70038,70048,Blue,1,32348,32813,465
2022-07-05,70057,70047,Blue,0,47835,48377,542
2022-07-06,70053,70039,Blue,0,41506,42292,786
2022-04-12,70038,70052,Blue,1,61021,61847,826
2022-08-06,70044,70060,Blue,1,89337,90252,915
2022-09-25,70040,70058,Blue,1,46232,47138,906
2022-06-29,70048,70060,Blue,1,42552,43228,676
2022-01-02,70048,70052,Blue,1,77541,77757,216
2022-02-07,70038,70044,Blue,1,76884,77054,170
2022-02-14,70053,70047,Blue,0,54755,55046,291
2022-05-25,70038,70046,Blue,1,24340,24635,295
2022-01-12,70059,70043,Blue,0,18796,19701,905
2022-10-10,70052,70054,Blue,1,56260,56326,66
2022-03-07,70047,70045,Blue,0,63237,63342,105
2022-07-24,70059,70043,Blue,0,75437,76322,885
2022-05-07,70049,70047,Blue,0,48579,48621,42
2022-08-07,70042,70050,Blue,1,61155,61565,410
2022-12-21,70051,70041,Blue,0,80946,81712,766
2022-10-12,70053,70838,Blue,0,39728,41481,1753
2022-04-04,70040,70056,Blue,1,61114,61979,865
2022-10-07,70040,70046,Blue,1,91365,91787,422
2022-03-02,70038,70042,Blue,1,20458,20565,107
2022-01-23,70059,70057,Blue,0,43454,43488,34
2022-04-14,70040,70054,Blue,1,81000,81915,915
2022-06-07,70038,70042,Blue,1,81015,81138,123
2022-11-30,70049,70039,Blue,0,33890,34426,536
2022-01-03,70053,70045,Blue,0,52387,52783,396
2022-02-23,70044,70056,Blue,1,59183,60052,869
2022-09-07,70059,70039,Blue,0,73816,74767,951
2022-09-01,70055,70047,Blue,0,49037,49416,379
2022-07-19,70059,70045,Blue,0,74475,75239,764
2022-08-28,70046,70056,Blue,1,60608,61145,537
2022-08-25,70057,70049,Blue,0,85695,86059,364
2022-02-15,70048,70052,Blue,1,25634,25844,210
2022-07-03,70038,70060,Blue,1,31576,32686,1110
2022-08-22,70044,70058,Blue,1,61908,62711,803
2022-01-01,70054,70056,Blue,1,72057,72105,48
2022-10-24,70038,70058,Blue,1,69497,70627,1130
2022-07-09,70053,70049,Blue,0,51689,51897,208
2022-10-29,70045,70039,Blue,0,20967,21226,259
2022-08-20,70059,70057,Blue,0,19515,19551,36
2022-11-03,70057,70051,Blue,0,69751,70014,263
2022-07-22,70057,70055,Blue,0,20008,20075,67
2022-07-09,70044,70060,Blue,1,31485,32444,959
2022-02-23,70049,70039,Blue,0,64620,65189,569
2022-06-14,70046,70052,Blue,1,65632,65971,339
2022-01-17,70053,70051,Blue,0,59791,59850,59
2022-12-19,70038,70058,Blue,1,63365,64544,1179
2022-06-03,70049,70838,Blue,0,30399,31052,653
2022-04-01,70057,70053,Blue,0,62969,63121,152
2022-05-29,70043,70039,Blue,0,36902,37015,113
2022-09-16,70055,70047,Blue,0,30353,30755,402
2022-03-30,70054,70060,Blue,1,67132,67394,262
2022-12-21,70044,70058,Blue,1,82490,83335,845
2022-01-14,70038,70050,Blue,1,29351,29858,507
2022-08-22,70048,70060,Blue,1,39017,39688,671
2022-07-22,70048,70056,Blue,1,44569,44968,399
2022-02-10,70042,70052,Blue,1,70046,70567,521
2022-01-25,70049,70047,Blue,0,67252,67304,52
2022-12-15,70038,70060,Blue,1,44663,45801,1138
2022-01-18,70053,70045,Blue,0,28962,29435,473
2022-07-12,70038,70054,Blue,1,56473,57418,945
2022-01-11,70038,70054,Blue,1,48695,49553,858
2022-09-26,70051,70045,Blue,0,64421,64750,329
2022-01-26,70040,70042,Blue,1,82059,82094,35
2022-11-29,70053,70047,Blue,0,79665,79950,285
2022-09-20,70053,70041,Blue,0,30413,31216,803
2022-01-06,70038,70048,Blue,1,19813,20305,492
2022-06-14,70041,70039,Blue,0,35974,36007,33
2022-12-27,70059,70053,Blue,0,43575,43807,232
2022-03-03,70050,70060,Blue,1,67357,68012,655
2022-11-25,70040,70058,Blue,1,28212,29175,963
2022-02-28,70057,70051,Blue,0,81273,81532,259
2022-07-22,70052,70054,Blue,1,62905,62961,56
2022-07-05,70050,70060,Blue,1,28083,28889,806
2022-11-28,70043,70838,Blue,0,74226,74412,186
2022-03-17,70045,70043,Blue,0,86477,86567,90
2022-03-07,70051,70039,Blue,0,66250,66885,635
2022-12-30,70047,70838,Blue,0,85037,85521,484
2022-08-25,70059,70057,Blue,0,70214,70250,36
2022-05-21,70041,70039,Blue,0,85180,85219,39
2022-09-28,70050,70058,Blue,1,54591,54999,408
2022-01-25,70057,70047,Blue,0,24337,24846,509
2022-03-13,70042,70058,Blue,1,79832,80729,897
2022-07-05,70042,70060,Blue,1,51594,52758,1164
2022-11-24,70046,70054,Blue,1,75147,75569,422
2022-01-16,70059,70047,Blue,0,79665,80228,563
2022-06-07,70040,70048,Blue,1,41008,41477,469
2022-11-08,70055,70041,Blue,0,50121,50868,747
2022-03-04,70038,70052,Blue,1,32380,33141,761
2022-06-26,70042,70048,Blue,1,57936,58346,410
2022-08-16,70057,70041,Blue,0,20528,21470,942
2022-09-12,70040,70054,Blue,1,26175,26995,820
2022-01-10,70051,70838,Blue,0,25537,26329,792
2022-09-29,70049,70039,Blue,0,43243,43781,538
2022-08-12,70053,70041,Blue,0,33758,34443,685
2022-04-15,70053,70051,Blue,0,42361,42424,63
2022-01-16,70054,70058,Blue,1,67055,67228,173
2022-03-02,70040,70048,Blue,1,54073,54436,363
2022-09-13,70049,70041,Blue,0,75936,76357,421
2022-02-25,70042,70052,Blue,1,44306,45015,709
2022-11-01,70039,70838,Blue,0,55594,55629,35
2022-11-30,70040,70052,Blue,1,50059,50688,629
2022-12-21,70059,70049,Blue,0,44834,45276,442
2022-01-06,70038,70054,Blue,1,73609,74419,810
2022-12-13,70052,70054,Blue,1,75504,75609,105
2022-02-02,70055,70047,Blue,0,25651,26053,402
2022-02-09,70042,70060,Blue,1,23810,24924,1114
2022-04-16,70057,70838,Blue,0,57941,59219,1278
2022-12-08,70049,70039,Blue,0,69178,69675,497
2022-05-02,70055,70051,Blue,0,64589,64757,168
2022-01-29,70048,70058,Blue,1,48261,49289,1028
2022-09-25,70059,70053,Blue,0,61591,61816,225
2022-03-03,70048,70054,Blue,1,33510,33817,307
2022-11-08,70046,70052,Blue,1,57752,58106,354
2022-04-25,70059,70051,Blue,0,48322,48641,319
2022-01-23,70046,70058,Blue,1,39397,40013,616
2022-12-05,70051,70049,Blue,0,86106,86207,101
2022-09-10,70050,70060,Blue,1,62886,63425,539
2022-03-19,70055,70043,Blue,0,31637,32325,688
2022-03-28,70047,70838,Blue,0,55426,55947,521
2022-06-13,70042,70046,Blue,1,87288,87475,187
2022-09-08,70046,70052,Blue,1,48034,48377,343
2022-07-08,70052,70060,Blue,1,42130,42494,364
2022-05-03,70054,70058,Blue,1,31354,31514,160
2022-03-22,70057,70041,Blue,0,54752,55620,868
2022-07-11,70053,70039,Blue,0,32929,33684,755
2022-03-01,70051,70838,Blue,0,39062,39781,719
2022-06-13,70047,70043,Blue,0,71593,71891,298
2022-04-28,70059,70047,Blue,0,55827,56471,644
2022-11-26,70041,70039,Blue,0,47105,47140,35
2022-12-28,70051,70047,Blue,0,44020,44220,200
2022-04-08,70047,70039,Blue,0,57740,58119,379
2022-02-10,70059,70045,Blue,0,29656,30410,754
2022-08-11,70057,70047,Blue,0,60389,60868,479
2022-02-28,70047,70041,Blue,0,41609,41972,363
2022-01-09,70052,70060,Blue,1,88960,89300,340
2022-06-15,70040,70048,Blue,1,58683,59196,513
2022-12-01,70047,70045,Blue,0,63770,63868,98
2022-02-24,70058,70060,Blue,1,36782,36849,67
2022-03-31,70046,70060,Blue,1,20213,20993,780
2022-12-13,70055,70045,Blue,0,71953,72504,551
2022-01-27,70053,70039,Blue,0,71280,72129,849
2022-01-18,70049,70041,Blue,0,88627,89070,443
2022-07-12,70049,70045,Blue,0,59802,60005,203
2022-01-31,70059,70055,Blue,0,46351,46504,153
2022-02-22,70040,70058,Blue,1,53461,54501,1040
2022-11-17,70056,70060,Blue,1,60599,60772,173
2022-08-05,70040,70042,Blue,1,46249,46281,32
2022-02-08,70040,70056,Blue,1,55420,56209,789
2022-06-14,70043,70041,Blue,0,72464,72492,28
2022-06-10,70044,70052,Blue,1,77631,78134,503
2022-10-17,70046,70054,Blue,1,32852,33339,487
2022-02-23,70052,70058,Blue,1,53837,54075,238
2022-08-08,70050,70054,Blue,1,69092,69336,244
2022-09-26,70042,70056,Blue,1,64001,64765,764
2022-02-09,70042,70056,Blue,1,77696,78473,777
2022-07-29,70047,70838,Blue,0,47936,48466,530
2022-03-11,70051,70041,Blue,0,33993,34634,641
2022-12-15,70051,70039,Blue,0,56555,57280,725
2022-06-29,70040,70042,Blue,1,42083,42118,35
2022-02-03,70046,70060,Blue,1,28037,28930,893
2022-03-23,70051,70045,Blue,0,83815,84135,320
2022-06-23,70038,70044,Blue,1,71379,71584,205
2022-10-06,70059,70041,Blue,0,64125,65022,897
2022-03-29,70057,70051,Blue,0,48342,48573,231
2022-08-16,70046,70056,Blue,1,65728,66240,512
2022-07-19,70043,70838,Blue,0,28101,28298,197
2022-12-29,70055,70049,Blue,0,33640,33958,318
2022-05-29,70046,70048,Blue,1,50022,50125,103
2022-12-15,70055,70049,Blue,0,77850,78189,339
2022-01-21,70040,70046,Blue,1,39375,39643,268
2022-05-26,70047,70838,Blue,0,28437,28998,561
2022-11-03,70040,70046,Blue,1,44280,44537,257
2022-03-13,70047,70039,Blue,0,60893,61299,406
2022-08-18,70047,70838,Blue,0,28048,28655,607
2022-11-06,70040,70054,Blue,1,60258,61073,815
2022-09-04,70044,70056,Blue,1,86623,87273,650
2022-12-25,70055,70045,Blue,0,68056,68637,581
2022-11-11,70059,70051,Blue,0,72794,73145,351
2022-09-16,70043,70041,Blue,0,55756,55784,28
2022-12-21,70055,70043,Blue,0,64551,65231,680
2022-09-05,70040,70050,Blue,1,69975,70466,491
2022-03-13,70055,70049,Blue,0,63728,64016,288
2022-01-11,70051,70047,Blue,0,78715,78918,203
2022-04-04,70043,70041,Blue,0,28465,28494,29
2022-02-02,70046,70058,Blue,1,23415,24280,865
2022-09-14,70059,70053,Blue,0,50413,50640,227
2022-11-04,70046,70058,Blue,1,30314,30960,646
2022-12-12,70040,70048,Blue,1,70215,70622,407
2022-07-27,70056,70058,Blue,1,72661,72731,70
2022-04-07,70044,70054,Blue,1,54786,55421,635
2022-07-09,70056,70058,Blue,1,53333,53402,69
2022-12-06,70048,70058,Blue,1,65299,65792,493
2022-03-16,70059,70049,Blue,0,41543,42025,482
2022-03-17,70045,70039,Blue,0,87592,87823,231
2022-04-22,70053,70039,Blue,0,26642,27382,740
2022-02-07,70041,70039,Blue,0,26924,26954,30
2022-11-22,70042,70058,Blue,1,57745,58684,939
2022-03-09,70045,70039,Blue,0,28110,28386,276
2022-10-11,70048,70056,Blue,1,67590,67999,409
2022-10-19,70042,70050,Blue,1,87502,87873,371
2022-09-25,70038,70046,Blue,1,60310,60714,404
2022-06-13,70047,70039,Blue,0,71593,72063,470
2022-02-18,70042,70050,Blue,1,63895,64323,428
2022-03-07,70043,70039,Blue,0,88315,88410,95
2022-10-26,70051,70047,Blue,0,30191,30393,202
2022-10-14,70047,70041,Blue,0,25735,26085,350
2022-08-22,70048,70060,Blue,1,55994,56613,619
2022-11-12,70051,70043,Blue,0,32863,33362,499
2022-09-28,70040,70048,Blue,1,45731,46133,402
2022-01-31,70054,70058,Blue,1,85166,85331,165
2022-09-16,70049,70043,Blue,0,26451,26802,351
2022-05-20,70044,70050,Blue,1,81117,81475,358
2022-04-23,70055,70049,Blue,0,51070,51350,280
2022-04-03,70042,70056,Blue,1,39824,40608,784
2022-11-05,70040,70046,Blue,1,51884,52178,294
2022-02-15,70059,70838,Blue,0,55994,57029,1035
2022-02-01,70055,70047,Blue,0,31657,32082,425
2022-12-13,70040,70054,Blue,1,58671,59485,814
2022-01-18,70051,70039,Blue,0,53653,54371,718
2022-07-05,70052,70058,Blue,1,29324,29585,261
2022-01-12,70042,70044,Blue,1,58485,58515,30
2022-06-29,70042,70060,Blue,1,60546,61649,1103
2022-07-16,70043,70039,Blue,0,37573,37699,126
2022-02-24,70043,70838,Blue,0,33270,33477,207
2022-10-17,70050,70054,Blue,1,35688,35901,213
2022-02-23,70046,70048,Blue,1,37709,37783,74
2022-03-03,70055,70838,Blue,0,28356,29278,922
2022-04-16,70059,70039,Blue,0,30313,31391,1078
2022-06-14,70042,70044,Blue,1,54537,54569,32
2022-05-19,70050,70060,Blue,1,58077,58662,585
2022-05-23,70038,70048,Blue,1,67550,68127,577
2022-02-24,70059,70041,Blue,0,21685,22733,1048
2022-06-14,70054,70060,Blue,1,83605,83920,315
2022-11-29,70044,70052,Blue,1,35077,35588,511
2022-08-28,70038,70042,Blue,1,27670,27758,88
2022-03-22,70038,70058,Blue,1,34219,36164,1945
2022-02-28,70048,70050,Blue,1,32182,32237,55
2022-02-02,70043,70039,Blue,0,55036,55143,107
2022-02-25,70045,70039,Blue,0,85947,86181,234
2022-09-11,70049,70039,Blue,0,58667,59158,491
2022-11-26,70044,70052,Blue,1,86655,87157,502
2022-04-04,70057,70043,Blue,0,52169,52957,788
2022-07-27,70042,70056,Blue,1,25764,26532,768
2022-10-10,70040,70048,Blue,1,30724,31117,393
2022-02-03,70038,70046,Blue,1,64096,64410,314
2022-09-11,70059,70051,Blue,0,53297,53622,325
2022-12-01,70042,70046,Blue,1,63957,64144,187
2022-06-25,70046,70054,Blue,1,58458,58954,496
2022-07-19,70049,70047,Blue,0,65508,65563,55
2022-01-23,70038,70052,Blue,1,69372,70110,738
2022-06-28,70057,70049,Blue,0,28717,29129,412
2022-08-19,70053,70039,Blue,0,24532,25320,788
2022-02-28,70052,70056,Blue,1,24797,24942,145
2022-03-05,70040,70056,Blue,1,42132,42921,789
2022-08-27,70042,70052,Blue,1,22474,23029,555
2022-03-28,70044,70060,Blue,1,70749,71654,905
2022-02-18,70051,70049,Blue,0,59433,59537,104
2022-02-23,70042,70046,Blue,1,60303,60491,188
2022-08-16,70059,70053,Blue,0,52814,53072,258
2022-08-09,70040,70056,Blue,1,67054,67975,921
2022-10-28,70050,70054,Blue,1,70647,70856,209
2022-02-16,70046,70060,Blue,1,25721,26488,767
2022-02-15,70053,70039,Blue,0,28973,29763,790
2022-09-20,70045,70041,Blue,0,21207,21376,169
2022-03-30,70048,70054,Blue,1,87618,87940,322
2022-12-26,70047,70045,Blue,0,58217,58310,93
2022-02-19,70049,70039,Blue,0,29723,30289,566
2022-05-28,70038,70040,Blue,1,76460,76475,15
2022-10-20,70051,70039,Blue,0,59167,59788,621
2022-11-11,70045,70043,Blue,0,57969,58065,96
2022-03-27,70059,70053,Blue,0,55995,56226,231
2022-04-15,70049,70838,Blue,0,67293,67880,587
2022-03-09,70054,70060,Blue,1,76738,77007,269
2022-07-06,70044,70046,Blue,1,24199,24337,138
2022-02-10,70055,70045,Blue,0,40583,41208,625
2022-06-19,70055,70051,Blue,0,59415,59553,138
2022-10-12,70059,70057,Blue,0,22328,22368,40
2022-03-14,70054,70058,Blue,1,72413,72569,156
2022-11-24,70041,70039,Blue,0,40384,40414,30
2022-04-06,70056,70060,Blue,1,66192,66447,255
2022-10-10,70055,70039,Blue,0,78360,79143,783
2022-12-05,70057,70047,Blue,0,27156,27620,464
2022-03-28,70048,70052,Blue,1,55056,55263,207
2022-08-28,70057,70041,Blue,0,59852,60710,858
2022-03-08,70045,70838,Blue,0,74069,74420,351
2022-12-18,70049,70047,Blue,0,44644,44699,55
2022-11-06,70044,70058,Blue,1,80839,81924,1085
2022-06-28,70046,70060,Blue,1,36150,36934,784
2022-08-17,70059,70051,Blue,0,65353,65682,329
2022-11-26,70047,70045,Blue,0,67632,67727,95
2022-03-21,70042,70044,Blue,1,21668,21696,28
2022-01-30,70042,70044,Blue,1,79738,79776,38
2022-12-13,70055,70049,Blue,0,49580,49894,314
2022-02-17,70046,70060,Blue,1,32152,32989,837
2022-10-31,70040,70058,Blue,1,26189,27137,948
2022-12-01,70046,70060,Blue,1,36123,36873,750
2022-04-19,70047,70838,Blue,0,23207,23920,713
2022-09-27,70055,70051,Blue,0,86725,86872,147
2022-12-26,70047,70043,Blue,0,88861,89101,240
2022-04-23,70045,70039,Blue,0,83109,83347,238
2022-02-28,70057,70051,Blue,0,29853,30178,325
2022-01-10,70053,70039,Blue,0,50491,51194,703
2022-08-23,70047,70039,Blue,0,69159,69550,391
2022-11-18,70040,70052,Blue,1,52051,52665,614
2022-06-26,70051,70049,Blue,0,78812,78917,105
2022-03-08,70044,70054,Blue,1,68847,69452,605
2022-11-09,70053,70838,Blue,0,82308,83056,748
2022-02-17,70055,70838,Blue,0,62469,63453,984
2022-11-24,70050,70056,Blue,1,69922,70237,315
2022-10-26,70047,70838,Blue,0,48919,49452,533
2022-05-28,70049,70039,Blue,0,31099,31670,571
2022-03-02,70038,70054,Blue,1,54542,55549,1007
2022-07-16,70046,70048,Blue,1,70696,70775,79
2022-03-10,70044,70050,Blue,1,53002,53358,356
2022-04-10,70046,70060,Blue,1,28791,29518,727
2022-11-11,70047,70838,Blue,0,36227,36780,553
2022-02-17,70051,70838,Blue,0,62442,63255,813
2022-01-16,70042,70050,Blue,1,51685,52169,484
2022-11-14,70053,70039,Blue,0,68399,69170,771
2022-01-04,70039,70838,Blue,0,61927,61963,36
2022-12-09,70052,70058,Blue,1,41313,41565,252
2022-03-15,70052,70058,Blue,1,40428,40724,296
2022-09-26,70038,70060,Blue,1,25682,26806,1124
2022-12-29,70042,70056,Blue,1,20434,21169,735
2022-10-01,70038,70048,Blue,1,41527,42508,981
2022-08-14,70042,70046,Blue,1,45779,45956,177
2022-02-19,70045,70039,Blue,0,37031,37300,269
2022-07-04,70057,70053,Blue,0,57585,57736,151
2022-07-24,70057,70055,Blue,0,48517,48585,68
2022-01-12,70048,70052,Blue,1,33741,33948,207
2022-09-12,70054,70058,Blue,1,68698,68876,178
2022-11-29,70058,70060,Blue,1,35060,35128,68
2022-12-26,70053,70043,Blue,0,28003,28551,548
2022-02-07,70040,70048,Blue,1,38100,38491,391
2022-03-05,70053,70047,Blue,0,44642,44912,270
2022-01-07,70057,70043,Blue,0,21053,21804,751
2022-02-16,70059,70045,Blue,0,68474,69175,701
2022-07-18,70057,70053,Blue,0,59239,59402,163
2022-04-09,70054,70058,Blue,1,55321,55475,154
2022-10-12,70038,70048,Blue,1,81362,81883,521
2022-01-26,70048,70056,Blue,1,59182,59578,396
2022-07-08,70038,70044,Blue,1,43522,43709,187
2022-02-14,70059,70053,Blue,0,54206,54431,225
2022-07-21,70048,70054,Blue,1,21739,22070,331
2022-09-02,70042,70056,Blue,1,54115,54995,880
2022-12-26,70055,70041,Blue,0,79837,80567,730
2022-08-03,70040,70052,Blue,1,47005,47700,695
2022-09-17,70049,70043,Blue,0,30848,31206,358
2022-12-21,70057,70043,Blue,0,24864,25623,759
2022-11-22,70041,70838,Blue,0,56629,56753,124
2022-11-13,70040,70050,Blue,1,87375,87923,548
2022-03-18,70038,70054,Blue,1,60157,60960,803
2022-04-06,70057,70041,Blue,0,18921,19902,981
2022-03-03,70041,70838,Blue,0,51707,51846,139
2022-02-07,70059,70045,Blue,0,50723,51419,696
2022-11-26,70059,70057,Blue,0,67576,67612,36
2022-08-27,70055,70049,Blue,0,73170,73448,278
2022-02-27,70040,70046,Blue,1,26292,26561,269
2022-04-21,70040,70046,Blue,1,28832,29117,285
2022-07-13,70040,70048,Blue,1,26111,26534,423
2022-04-12,70045,70041,Blue,0,31577,31738,161
2022-11-03,70038,70054,Blue,1,43290,44151,861
2022-11-26,70054,70058,Blue,1,30532,30685,153
2022-01-18,70048,70050,Blue,1,73607,73665,58
2022-01-26,70053,70045,Blue,0,55901,56369,468
2022-08-05,70051,70047,Blue,0,75340,75537,197
2022-01-28,70059,70041,Blue,0,51554,52507,953
2022-08-24,70042,70060,Blue,1,38082,39323,1241
2022-10-17,70042,70056,Blue,1,55723,56556,833
2022-10-20,70042,70054,Blue,1,75336,75989,653
2022-01-22,70047,70838,Blue,0,28288,28864,576
2022-10-05,70043,70838,Blue,0,43058,43265,207
2022-02-04,70052,70056,Blue,1,73379,73546,167
2022-10-09,70059,70045,Blue,0,61399,62342,943
2022-10-03,70053,70838,Blue,0,23272,24196,924
2022-11-30,70057,70039,Blue,0,64170,65134,964
2022-05-28,70042,70046,Blue,1,57489,57701,212
2022-06-21,70055,70047,Blue,0,64884,65265,381
2022-06-29,70057,70051,Blue,0,86610,86847,237
2022-02-08,70053,70838,Blue,0,31530,32677,1147
2022-02-08,70042,70048,Blue,1,25353,25636,283
2022-09-13,70055,70051,Blue,0,83774,83914,140
2022-10-16,70055,70047,Blue,0,58918,59286,368
2022-06-20,70047,70838,Blue,0,65079,65615,536
2022-01-20,70053,70045,Blue,0,80877,81297,420
2022-06-11,70056,70058,Blue,1,61379,61449,70
2022-12-19,70038,70060,Blue,1,83800,84927,1127
2022-02-05,70042,70054,Blue,1,63266,63953,687
2022-10-25,70040,70054,Blue,1,54989,55794,805
2022-03-18,70053,70047,Blue,0,65852,66127,275
2022-09-07,70042,70050,Blue,1,57886,58352,466
2022-12-09,70055,70051,Blue,0,86823,86953,130
2022-12-12,70045,70043,Blue,0,81813,81899,86
2022-07-03,70052,70058,Blue,1,47601,47858,257
2022-07-24,70050,70056,Blue,1,32927,33217,290
2022-11-18,70038,70058,Blue,1,22881,23887,1006
2022-12-06,70038,70054,Blue,1,28201,29013,812
2022-07-20,70044,70054,Blue,1,35167,35845,678
2022-01-14,70059,70049,Blue,0,60192,60653,461
2022-04-08,70055,70051,Blue,0,19694,19825,131
2022-02-01,70054,70056,Blue,1,28735,28784,49
2022-08-15,70044,70054,Blue,1,76156,76758,602
2022-12-17,70048,70058,Blue,1,30134,30632,498
2022-11-10,70059,70051,Blue,0,78883,79175,292
2022-04-08,70046,70056,Blue,1,80110,80630,520
2022-08-07,70057,70045,Blue,0,45810,46429,619
2022-01-03,70055,70045,Blue,0,57984,58511,527
2022-04-07,70051,70043,Blue,0,58173,58669,496
2022-05-19,70057,70043,Blue,0,45573,46545,972
2022-01-18,70054,70060,Blue,1,27858,28211,353
2022-09-11,70051,70045,Blue,0,43163,43490,327
2022-06-17,70059,70045,Blue,0,20587,21712,1125
2022-03-23,70057,70055,Blue,0,56670,56738,68
2022-10-19,70042,70058,Blue,1,31359,32255,896
2022-04-16,70042,70052,Blue,1,50319,50901,582
2022-03-16,70054,70058,Blue,1,32013,32167,154
2022-01-22,70048,70052,Blue,1,55503,55708,205
2022-09-13,70040,70046,Blue,1,67008,67269,261
2022-03-16,70038,70060,Blue,1,88326,89338,1012
2022-12-20,70059,70043,Blue,0,62160,63014,854
2022-04-22,70044,70052,Blue,1,88603,89120,517
2022-04-14,70057,70047,Blue,0,57276,57763,487
2022-09-11,70049,70047,Blue,0,43297,43351,54
2022-05-05,70053,70051,Blue,0,66285,66338,53
2022-03-14,70042,70052,Blue,1,25647,26261,614
2022-06-29,70046,70048,Blue,1,59382,59477,95
2022-09-03,70049,70041,Blue,0,62149,62615,466
2022-04-04,70048,70060,Blue,1,31041,31691,650
2022-02-14,70051,70045,Blue,0,48691,49002,311
2022-01-24,70055,70039,Blue,0,26561,27567,1006
2022-09-13,70042,70056,Blue,1,25056,25813,757
2022-04-10,70042,70056,Blue,1,67894,68675,781
2022-07-29,70053,70041,Blue,0,75278,75930,652
2022-03-19,70047,70039,Blue,0,58987,59389,402
2022-04-19,70041,70039,Blue,0,56088,56118,30
2022-11-25,70040,70060,Blue,1,37400,38429,1029
2022-04-16,70042,70050,Blue,1,31393,31808,415
2022-03-01,70040,70056,Blue,1,23432,24277,845
2022-08-14,70042,70054,Blue,1,37191,37918,727
2022-11-17,70052,70060,Blue,1,65056,65410,354
2022-03-10,70058,70060,Blue,1,34282,34368,86
2022-11-12,70053,70041,Blue,0,31677,32365,688
2022-10-11,70056,70060,Blue,1,75641,75846,205
2022-11-18,70050,70054,Blue,1,21849,22044,195
2022-09-08,70055,70041,Blue,0,41367,42268,901
2022-09-13,70045,70039,Blue,0,24691,24953,262
2022-06-17,70049,70043,Blue,0,74861,75264,403
2022-09-09,70044,70046,Blue,1,77120,77225,105
2022-04-12,70038,70044,Blue,1,42967,43129,162
2022-12-18,70051,70045,Blue,0,75250,75611,361
2022-06-28,70055,70043,Blue,0,37187,38044,857
2022-10-29,70041,70039,Blue,0,47490,47529,39
2022-02-17,70048,70056,Blue,1,68567,68959,392
2022-07-25,70049,70045,Blue,0,81015,81209,194
2022-09-28,70052,70054,Blue,1,36070,36130,60
2022-09-28,70042,70052,Blue,1,21610,22176,566
2022-09-14,70053,70051,Blue,0,35671,35725,54
2022-07-22,70045,70043,Blue,0,33001,33105,104
2022-08-28,70038,70046,Blue,1,62349,62684,335
2022-07-12,70048,70060,Blue,1,33408,34085,677
2022-10-03,70040,70056,Blue,1,47824,48658,834
2022-07-16,70046,70052,Blue,1,37089,37401,312
2022-04-16,70053,70043,Blue,0,80156,80738,582
2022-06-30,70059,70051,Blue,0,67917,68286,369
2022-03-21,70059,70049,Blue,0,25454,25951,497
2022-12-04,70051,70041,Blue,0,56690,57228,538
2022-06-28,70047,70041,Blue,0,86292,86604,312
2022-08-15,70052,70056,Blue,1,45558,45720,162
2022-05-18,70055,70049,Blue,0,42128,42458,330
2022-03-31,70050,70060,Blue,1,23335,23879,544
2022-08-25,70046,70050,Blue,1,52753,52943,190
2022-03-09,70057,70047,Blue,0,86972,87557,585
2022-04-20,70051,70047,Blue,0,51892,52114,222
2022-08-31,70038,70058,Blue,1,25010,26110,1100
2022-08-31,70040,70052,Blue,1,60202,60844,642
2022-10-17,70057,70055,Blue,0,42705,42775,70
2022-02-15,70040,70044,Blue,1,82877,82989,112
2022-10-25,70043,70041,Blue,0,47723,47751,28
2022-03-24,70050,70060,Blue,1,45344,45882,538
2022-04-08,70048,70060,Blue,1,66685,67642,957
2022-09-10,70053,70045,Blue,0,70014,70460,446
2022-02-25,70053,70039,Blue,0,33523,34766,1243
2022-01-25,70050,70060,Blue,1,35336,35880,544
2022-07-07,70042,70048,Blue,1,54713,55076,363
2022-10-01,70040,70054,Blue,1,55095,55803,708
2022-11-02,70057,70039,Blue,0,27273,28258,985
2022-07-02,70046,70050,Blue,1,45677,45842,165
2022-02-19,70050,70058,Blue,1,77211,77614,403
2022-07-29,70040,70056,Blue,1,50301,51200,899
2022-03-27,70055,70053,Blue,0,36387,36433,46
2022-01-22,70044,70048,Blue,1,23925,24208,283
2022-11-10,70041,70039,Blue,0,41081,41117,36
2022-09-06,70049,70039,Blue,0,29173,29811,638
2022-01-04,70051,70043,Blue,0,67141,67594,453
2022-10-02,70044,70054,Blue,1,71745,72332,587
2022-01-31,70049,70045,Blue,0,53946,54196,250
2022-12-29,70047,70045,Blue,0,35550,35645,95
2022-03-11,70040,70054,Blue,1,61356,62181,825
2022-05-21,70042,70044,Blue,1,32648,32675,27
2022-02-13,70057,70049,Blue,0,53918,54330,412
2022-12-25,70041,70838,Blue,0,52077,52195,118
2022-07-07,70045,70041,Blue,0,23414,23600,186
2022-07-24,70056,70058,Blue,1,29402,29478,76
2022-02-09,70042,70050,Blue,1,25884,26267,383
2022-07-08,70051,70045,Blue,0,72207,72543,336
2022-11-20,70047,70838,Blue,0,78853,79356,503
2022-10-25,70044,70048,Blue,1,82908,83154,246
2022-08-05,70051,70047,Blue,0,86174,86371,197
2022-09-02,70054,70056,Blue,1,46988,47035,47
2022-07-16,70050,70054,Blue,1,62145,62378,233
2022-01-06,70055,70049,Blue,0,75070,75382,312
2022-03-15,70040,70048,Blue,1,20243,20656,413
2022-12-10,70047,70041,Blue,0,62785,63116,331
2022-06-29,70053,70041,Blue,0,69124,69819,695
2022-07-04,70046,70052,Blue,1,22046,22404,358
2022-05-03,70059,70057,Blue,0,80419,80454,35
2022-11-03,70038,70044,Blue,1,66446,66639,193
2022-07-04,70050,70052,Blue,1,88123,88468,345
2022-03-10,70057,70051,Blue,0,73833,74093,260
2022-05-20,70049,70039,Blue,0,40012,40666,654
2022-06-30,70059,70045,Blue,0,80430,81142,712
2022-08-25,70046,70058,Blue,1,28604,29294,690
2022-10-24,70052,70054,Blue,1,82733,82788,55
2022-11-25,70057,70045,Blue,0,49501,50125,624
2022-07-31,70040,70056,Blue,1,55415,56272,857
2022-03-04,70045,70041,Blue,0,27194,27377,183
2022-08-03,70049,70047,Blue,0,56677,56734,57
2022-08-18,70044,70052,Blue,1,34936,35472,536
2022-03-14,70047,70045,Blue,0,45005,45104,99
2022-02-07,70040,70048,Blue,1,79873,80273,400
2022-06-11,70047,70041,Blue,0,21518,21886,368
2022-10-27,70053,70838,Blue,0,88392,89612,1220
2022-12-26,70038,70040,Blue,1,40994,41009,15
2022-08-24,70057,70838,Blue,0,30654,31823,1169
2022-06-24,70038,70056,Blue,1,54460,55473,1013
2022-01-05,70043,70041,Blue,0,26123,26182,59
2022-12-16,70043,70041,Blue,0,67411,67438,27
2022-02-27,70049,70045,Blue,0,87855,88092,237
2022-10-22,70038,70052,Blue,1,35588,36293,705
2022-12-07,70049,70045,Blue,0,66216,66425,209
2022-01-23,70057,70049,Blue,0,31711,32096,385
2022-02-17,70055,70045,Blue,0,37265,37910,645
2022-05-23,70049,70043,Blue,0,54903,55350,447
2022-10-26,70040,70054,Blue,1,56854,57626,772
2022-03-04,70052,70056,Blue,1,65117,65256,139
2022-12-24,70057,70039,Blue,0,50371,51311,940
2022-10-19,70048,70052,Blue,1,62750,62955,205
2022-03-30,70038,70040,Blue,1,24553,24570,17
2022-11-12,70053,70043,Blue,0,28970,29560,590
2022-01-24,70056,70058,Blue,1,82962,83040,78
2022-03-20,70038,70048,Blue,1,25322,25815,493
2022-11-18,70043,70041,Blue,0,82184,82213,29
2022-08-26,70047,70039,Blue,0,50554,51031,477
2022-04-13,70046,70052,Blue,1,67442,67828,386
2022-02-21,70048,70050,Blue,1,26232,26289,57
2022-11-03,70042,70052,Blue,1,81776,82356,580
2022-07-31,70049,70041,Blue,0,61356,61811,455
2022-08-07,70048,70052,Blue,1,44260,44465,205
2022-03-25,70051,70041,Blue,0,50924,51494,570
2022-10-16,70055,70838,Blue,0,67543,68388,845
2022-07-22,70059,70041,Blue,0,78537,79470,933
2022-01-04,70055,70047,Blue,0,42252,42625,373
2022-11-24,70049,70039,Blue,0,49513,50014,501
2022-03-02,70038,70044,Blue,1,75197,75382,185
2022-04-19,70038,70054,Blue,1,24222,25132,910
2022-08-12,70057,70045,Blue,0,27706,28358,652
2022-06-13,70053,70041,Blue,0,40715,41449,734
2022-12-30,70042,70050,Blue,1,30023,30394,371
2022-11-22,70051,70041,Blue,0,56016,56581,565
2022-10-09,70046,70058,Blue,1,86780,87421,641
2022-11-25,70052,70054,Blue,1,83598,83654,56
2022-11-27,70049,70041,Blue,0,40574,41026,452
2022-04-25,70057,70047,Blue,0,54568,55176,608
2022-11-01,70040,70050,Blue,1,25014,25517,503
2022-02-13,70038,70052,Blue,1,86960,87658,698
2022-08-24,70051,70041,Blue,0,28866,29473,607
2022-08-31,70059,70838,Blue,0,43775,44887,1112
2022-01-18,70045,70838,Blue,0,21026,21380,354
2022-06-30,70046,70056,Blue,1,27686,28197,511
2022-03-05,70052,70060,Blue,1,61195,61529,334
2022-07-16,70044,70060,Blue,1,53211,54151,940
2022-03-20,70040,70050,Blue,1,37770,38280,510
2022-07-23,70040,70046,Blue,1,55702,56005,303
2022-02-02,70055,70041,Blue,0,24678,25516,838
2022-07-13,70048,70052,Blue,1,33805,34011,206
2022-02-15,70042,70058,Blue,1,90548,91430,882
2022-08-28,70056,70058,Blue,1,48011,48080,69
2022-06-24,70053,70051,Blue,0,75220,75272,52
2022-02-22,70039,70838,Blue,0,74787,74819,32
2022-07-16,70044,70056,Blue,1,80184,80868,684
2022-04-23,70042,70044,Blue,1,26427,26457,30
2022-04-04,70057,70838,Blue,0,51269,52407,1138
2022-01-26,70054,70056,Blue,1,73841,73888,47
2022-06-30,70050,70058,Blue,1,30534,30959,425
2022-11-19,70049,70838,Blue,0,72368,72911,543
2022-12-14,70044,70058,Blue,1,79762,80489,727
2022-10-08,70047,70838,Blue,0,26067,26538,471
2022-07-28,70051,70047,Blue,0,33073,33297,224
2022-09-22,70038,70060,Blue,1,67316,68479,1163
2022-10-22,70046,70054,Blue,1,64096,64540,444
2022-10-17,70041,70838,Blue,0,50941,51083,142
2022-11-08,70038,70056,Blue,1,86541,87415,874
2022-07-24,70045,70838,Blue,0,85407,85723,316
2022-02-21,70046,70060,Blue,1,70002,70759,757
2022-12-21,70047,70838,Blue,0,62364,62851,487
2022-10-14,70042,70058,Blue,1,66518,67362,844
2022-07-25,70055,70051,Blue,0,39712,39855,143
2022-03-18,70038,70050,Blue,1,60157,60726,569
2022-09-12,70043,70039,Blue,0,41661,41765,104
2022-04-10,70057,70051,Blue,0,80360,80622,262
2022-11-28,70057,70049,Blue,0,25054,25458,404
2022-06-06,70040,70052,Blue,1,84688,85524,836
2022-10-08,70059,70838,Blue,0,50843,51894,1051
2022-10-20,70049,70041,Blue,0,35490,35954,464
2022-11-22,70051,70049,Blue,0,29128,29232,104
2022-04-01,70044,70058,Blue,1,80673,81453,780
2022-06-13,70042,70058,Blue,1,23778,24672,894
2022-03-21,70042,70050,Blue,1,60696,61118,422
2022-07-15,70050,70058,Blue,1,53229,53667,438
2022-01-21,70057,70041,Blue,0,30333,31319,986
2022-10-18,70054,70056,Blue,1,45452,45498,46
2022-09-21,70042,70060,Blue,1,76472,77454,982
2022-07-30,70059,70047,Blue,0,30316,30876,560
2022-10-30,70053,70047,Blue,0,74648,74938,290
2022-03-13,70059,70043,Blue,0,31633,32419,786
2022-12-04,70057,70053,Blue,0,87399,87547,148
2022-02-06,70051,70039,Blue,0,75822,76447,625
2022-02-27,70048,70060,Blue,1,67720,68308,588
2022-02-12,70047,70045,Blue,0,46587,46678,91
2022-12-11,70046,70056,Blue,1,55746,56264,518
2022-02-26,70042,70060,Blue,1,37382,38410,1028
2022-08-07,70044,70048,Blue,1,57228,57462,234
2022-01-27,70044,70054,Blue,1,25185,25834,649
2022-04-20,70052,70054,Blue,1,91536,91585,49
2022-08-08,70055,70041,Blue,0,49643,50405,762
2022-10-17,70042,70044,Blue,1,27146,27172,26
2022-09-18,70052,70054,Blue,1,32244,32291,47
2022-02-17,70055,70051,Blue,0,67348,67503,155
2022-10-23,70055,70043,Blue,0,59421,60068,647
2022-08-16,70055,70043,Blue,0,23215,23950,735
2022-06-22,70049,70039,Blue,0,45268,45837,569
2022-07-06,70046,70048,Blue,1,66817,66901,84
2022-09-13,70051,70838,Blue,0,66956,67659,703
2022-10-14,70048,70052,Blue,1,31207,31419,212
2022-04-16,70040,70058,Blue,1,34612,35616,1004
2022-12-02,70051,70041,Blue,0,63576,64151,575
2022-12-08,70045,70039,Blue,0,42936,43182,246
2022-02-26,70045,70041,Blue,0,43468,43642,174
2022-01-10,70040,70054,Blue,1,50839,51679,840
2022-01-18,70040,70056,Blue,1,51345,52361,1016
2022-08-08,70038,70044,Blue,1,47217,47385,168
2022-07-26,70038,70052,Blue,1,82896,83716,820
2022-03-01,70044,70056,Blue,1,80040,80749,709
2022-03-11,70055,70051,Blue,0,54968,55094,126
2022-12-06,70055,70049,Blue,0,26212,26515,303
2022-02-23,70059,70055,Blue,0,43814,43966,152
2022-07-07,70051,70047,Blue,0,63340,63557,217
2022-03-23,70042,70058,Blue,1,50941,51873,932
2022-06-11,70039,70838,Blue,0,32525,32556,31
2022-09-21,70050,70054,Blue,1,58888,59088,200
2022-01-10,70054,70056,Blue,1,58325,58382,57
2022-02-14,70059,70051,Blue,0,57203,57511,308
2022-12-12,70042,70050,Blue,1,81729,82159,430
2022-09-28,70053,70039,Blue,0,64925,65669,744
2022-12-15,70050,70060,Blue,1,78471,79018,547
2022-05-30,70048,70050,Blue,1,69888,69949,61
2022-06-20,70059,70047,Blue,0,47294,47847,553
2022-01-31,70044,70048,Blue,1,87952,88191,239
2022-03-07,70044,70052,Blue,1,27878,28427,549
2022-03-12,70046,70048,Blue,1,64076,64153,77
2022-12-27,70059,70051,Blue,0,85004,85326,322
2022-12-27,70043,70039,Blue,0,35804,35912,108
2022-01-11,70053,70039,Blue,0,64999,65721,722
2022-04-23,70040,70058,Blue,1,29276,30202,926
2022-10-23,70052,70060,Blue,1,82460,82825,365
2022-06-26,70049,70043,Blue,0,26661,27012,351
2022-09-15,70050,70052,Blue,1,24694,24847,153
2022-12-24,70057,70053,Blue,0,75869,76022,153
2022-12-23,70043,70041,Blue,0,59747,59777,30
2022-02-17,70057,70039,Blue,0,42142,43080,938
2022-12-15,70057,70039,Blue,0,38574,39555,981
2022-01-14,70059,70053,Blue,0,67505,67733,228
2022-01-25,70051,70838,Blue,0,75840,76594,754
2022-08-09,70053,70043,Blue,0,38370,39018,648
2022-10-11,70047,70043,Blue,0,56071,56311,240
2022-07-05,70040,70050,Blue,1,40051,40592,541
2022-03-22,70038,70048,Blue,1,45796,46256,460
2022-01-26,70055,70045,Blue,0,41719,42366,647
2022-02-16,70040,70048,Blue,1,75259,75624,365
2022-03-12,70042,70050,Blue,1,38961,39359,398
2022-02-24,70057,70045,Blue,0,55225,55914,689
2022-05-26,70049,70047,Blue,0,81724,81778,54
2022-05-08,70053,70049,Blue,0,71721,71923,202
2022-09-29,70051,70049,Blue,0,59109,59214,105
2022-09-24,70057,70043,Blue,0,30398,31244,846
2022-12-10,70055,70047,Blue,0,48897,49257,360
2022-07-30,70048,70056,Blue,1,70147,70548,401
2022-03-17,70050,70056,Blue,1,59580,59869,289
2022-07-29,70040,70056,Blue,1,46730,47543,813
2022-01-22,70046,70056,Blue,1,41393,41916,523
2022-03-13,70047,70039,Blue,0,77682,78110,428
2022-12-21,70051,70039,Blue,0,71280,71895,615
2022-12-22,70038,70058,Blue,1,70469,71548,1079
2022-11-21,70053,70049,Blue,0,56483,56703,220
2022-01-13,70059,70045,Blue,0,32355,33119,764
2022-04-23,70057,70055,Blue,0,54709,54777,68
2022-08-30,70052,70056,Blue,1,68520,68681,161
2022-08-19,70055,70045,Blue,0,68886,69376,490
2022-09-30,70054,70058,Blue,1,47455,47603,148
2022-09-15,70057,70039,Blue,0,52592,53540,948
2022-10-06,70046,70050,Blue,1,29319,29492,173
2022-12-20,70040,70054,Blue,1,57898,58701,803
2022-04-11,70050,70052,Blue,1,78627,78735,108
2022-10-07,70041,70838,Blue,0,31219,31349,130
2022-07-28,70059,70051,Blue,0,34905,35260,355
2022-10-11,70049,70043,Blue,0,62892,63224,332
2022-04-20,70044,70048,Blue,1,72688,72923,235
2022-04-22,70055,70049,Blue,0,49387,49665,278
2022-08-03,70042,70060,Blue,1,71777,72789,1012
2022-06-20,70047,70041,Blue,0,63985,64316,331
2022-03-05,70038,70050,Blue,1,29652,30198,546
2022-03-22,70053,70047,Blue,0,35994,36303,309
2022-10-01,70059,70051,Blue,0,84013,84336,323
2022-02-04,70053,70045,Blue,0,86585,87036,451
2022-09-17,70042,70056,Blue,1,76778,77546,768
2022-09-16,70057,70045,Blue,0,20920,21592,672
2022-07-09,70059,70047,Blue,0,27076,27632,556
2022-02-16,70053,70041,Blue,0,72246,72849,603
2022-07-14,70054,70056,Blue,1,23150,23196,46
2022-11-01,70051,70039,Blue,0,31785,32484,699
2022-07-08,70046,70050,Blue,1,75563,75760,197
2022-04-14,70053,70838,Blue,0,63757,64592,835
2022-11-17,70046,70048,Blue,1,56915,56984,69
2022-02-27,70042,70044,Blue,1,80510,80541,31
2022-03-27,70040,70060,Blue,1,71046,72089,1043
2022-04-10,70053,70838,Blue,0,76230,77037,807
2022-07-26,70055,70047,Blue,0,35694,36120,426
2022-02-09,70054,70058,Blue,1,38891,39048,157
2022-11-22,70050,70058,Blue,1,57731,58151,420
2022-05-19,70051,70045,Blue,0,63564,64045,481
2022-08-23,70040,70060,Blue,1,29052,30101,1049
2022-09-09,70051,70041,Blue,0,41084,41664,580
2022-11-04,70051,70049,Blue,0,30686,30791,105
2022-12-26,70059,70047,Blue,0,30073,30612,539
2022-04-22,70044,70046,Blue,1,54770,54870,100
2022-10-04,70047,70043,Blue,0,21541,21801,260
2022-02-17,70046,70054,Blue,1,46746,47302,556
2022-08-17,70053,70045,Blue,0,65786,66255,469
2022-03-23,70051,70838,Blue,0,31264,32065,801
2022-07-20,70040,70044,Blue,1,21152,21283,131
2022-11-05,70044,70046,Blue,1,72957,73076,119
2022-10-29,70050,70058,Blue,1,72406,72814,408
2022-01-13,70038,70046,Blue,1,71131,71504,373
2022-12-13,70046,70054,Blue,1,40805,41307,502
2022-03-09,70050,70058,Blue,1,40138,40513,375
2022-07-19,70059,70045,Blue,0,45262,46006,744
2022-09-10,70044,70048,Blue,1,63405,63657,252
2022-06-29,70038,70056,Blue,1,63303,64384,1081
2022-03-23,70038,70060,Blue,1,79698,80847,1149
2022-03-18,70047,70838,Blue,0,41079,41629,550
2022-10-10,70057,70041,Blue,0,22649,23484,835
2022-10-23,70044,70048,Blue,1,41276,41518,242
2022-04-25,70050,70054,Blue,1,48869,49071,202
2022-10-15,70047,70041,Blue,0,44408,44717,309
2022-12-15,70059,70049,Blue,0,49603,50116,513
2022-12-19,70052,70058,Blue,1,53134,53390,256
2022-03-17,70058,70060,Blue,1,58495,58636,141
2022-11-12,70050,70054,Blue,1,35652,35894,242
2022-08-24,70057,70047,Blue,0,41677,42230,553
2022-09-12,70050,70058,Blue,1,20716,21130,414
2022-07-04,70040,70050,Blue,1,72760,73437,677
2022-07-19,70044,70048,Blue,1,49552,49789,237
2022-08-16,70057,70053,Blue,0,33166,33324,158
2022-05-23,70044,70046,Blue,1,66804,66923,119
2022-03-24,70048,70052,Blue,1,63795,64027,232
2022-05-28,70043,70039,Blue,0,20160,20260,100
2022-12-19,70053,70838,Blue,0,30819,31989,1170
2022-01-28,70042,70058,Blue,1,47684,48567,883
2022-07-04,70049,70045,Blue,0,50263,50472,209
2022-09-23,70059,70055,Blue,0,29715,29864,149
2022-05-19,70047,70838,Blue,0,26821,27519,698
2022-03-21,70055,70039,Blue,0,60070,60859,789
2022-12-20,70050,70052,Blue,1,43159,43289,130
2022-04-04,70051,70039,Blue,0,70898,71536,638
2022-04-20,70038,70042,Blue,1,56526,56620,94
2022-01-13,70055,70051,Blue,0,41721,41906,185
2022-01-10,70040,70044,Blue,1,66222,66335,113
2022-07-14,70051,70041,Blue,0,24806,25466,660
2022-04-14,70045,70838,Blue,0,33950,34284,334
2022-04-26,70049,70047,Blue,0,69257,69305,48
2022-10-07,70055,70047,Blue,0,38698,39075,377
2022-06-12,70042,70050,Blue,1,67944,68424,480
2022-07-22,70040,70050,Blue,1,58478,59054,576
2022-12-01,70046,70054,Blue,1,54813,55678,865
2022-06-16,70056,70058,Blue,1,67794,67918,124
2022-02-09,70048,70052,Blue,1,57391,57604,213
2022-01-18,70050,70054,Blue,1,27612,27921,309
2022-06-02,70049,70039,Blue,0,61565,62099,534
2022-09-20,70044,70060,Blue,1,47882,48724,842
2022-08-23,70054,70060,Blue,1,48712,48981,269
2022-05-07,70059,70047,Blue,0,69015,69566,551
2022-11-25,70042,70052,Blue,1,27893,28457,564
2022-09-26,70044,70052,Blue,1,29777,30300,523
2022-02-28,70040,70046,Blue,1,67720,67970,250
2022-01-04,70056,70060,Blue,1,36311,36805,494
2022-08-05,70046,70060,Blue,1,30648,31376,728
2022-03-13,70049,70043,Blue,0,24336,24685,349
2022-03-16,70046,70058,Blue,1,34787,35410,623
2022-09-17,70046,70050,Blue,1,85158,85354,196
2022-03-30,70042,70048,Blue,1,30406,30727,321
2022-12-16,70042,70044,Blue,1,48804,48832,28
2022-01-10,70059,70043,Blue,0,48192,48983,791
2022-08-23,70039,70838,Blue,0,46787,46822,35
2022-01-15,70050,70054,Blue,1,82452,82669,217
2022-11-06,70049,70047,Blue,0,78123,78182,59
2022-07-27,70040,70050,Blue,1,64412,64988,576
2022-10-17,70055,70051,Blue,0,43439,43605,166
2022-09-21,70049,70047,Blue,0,87043,87106,63
2022-01-03,70044,70048,Blue,1,75360,75592,232
2022-03-23,70042,70050,Blue,1,24169,24667,498
2022-10-09,70051,70049,Blue,0,54207,54309,102
2022-01-04,70053,70041,Blue,0,35024,35670,646
2022-08-12,70055,70047,Blue,0,69853,70212,359
2022-01-28,70053,70049,Blue,0,28460,28688,228
2022-09-30,70046,70058,Blue,1,65959,66619,660
2022-02-09,70057,70045,Blue,0,66876,67710,834
2022-11-10,70045,70041,Blue,0,21187,21348,161
2022-03-06,70051,70039,Blue,0,81970,82591,621
2022-06-15,70044,70050,Blue,1,44968,45350,382
2022-09-30,70052,70060,Blue,1,51522,51875,353
2022-02-09,70057,70039,Blue,0,33643,34746,1103
2022-04-15,70044,70048,Blue,1,41498,41784,286
2022-09-18,70059,70049,Blue,0,43459,43955,496
2022-12-30,70050,70056,Blue,1,45073,45367,294
2022-06-11,70050,70060,Blue,1,35162,35718,556
2022-10-20,70044,70054,Blue,1,81498,82094,596
2022-03-15,70057,70041,Blue,0,58160,59059,899
2022-07-07,70053,70049,Blue,0,35185,35424,239
2022-10-18,70059,70045,Blue,0,55649,56361,712
2022-06-16,70052,70054,Blue,1,44483,44539,56
2022-10-16,70044,70058,Blue,1,54470,55284,814
2022-06-24,70051,70041,Blue,0,62233,62794,561
2022-01-26,70053,70838,Blue,0,60540,61397,857
2022-05-14,70057,70053,Blue,0,81919,82102,183
2022-11-18,70040,70044,Blue,1,21847,21959,112
2022-02-01,70059,70049,Blue,0,80596,81041,445
2022-10-21,70050,70052,Blue,1,68376,68488,112
2022-08-01,70055,70043,Blue,0,30759,31479,720
2022-12-24,70056,70060,Blue,1,25605,25794,189
2022-03-22,70041,70039,Blue,0,71598,71639,41
2022-10-24,70050,70054,Blue,1,42795,43004,209
2022-06-30,70051,70043,Blue,0,31359,31913,554
2022-10-07,70057,70051,Blue,0,50483,50721,238
2022-09-13,70051,70049,Blue,0,23808,23956,148
2022-07-26,70040,70054,Blue,1,45791,46543,752
2022-02-28,70044,70048,Blue,1,47745,48009,264
2022-12-07,70046,70048,Blue,1,40752,40848,96
2022-10-22,70047,70043,Blue,0,68796,69125,329
2022-05-19,70059,70838,Blue,0,46092,47399,1307
2022-11-07,70047,70039,Blue,0,46459,46882,423
2022-03-24,70057,70053,Blue,0,27929,28082,153
2022-01-31,70048,70058,Blue,1,71973,72610,637
2022-12-09,70049,70041,Blue,0,63590,64028,438
2022-04-07,70051,70045,Blue,0,43075,43448,373
2022-09-09,70052,70060,Blue,1,83836,84180,344
2022-01-31,70057,70838,Blue,0,66025,67118,1093
2022-03-31,70059,70053,Blue,0,25160,25394,234
2022-09-26,70047,70045,Blue,0,36576,36677,101
2022-06-28,70038,70048,Blue,1,89106,89536,430
2022-06-14,70045,70039,Blue,0,70828,71106,278
2022-02-01,70059,70838,Blue,0,29960,31204,1244
2022-12-01,70049,70045,Blue,0,67352,67549,197
2022-06-27,70056,70060,Blue,1,65793,66229,436
2022-01-11,70051,70039,Blue,0,60893,61471,578
2022-07-04,70050,70052,Blue,1,80881,80988,107
2022-06-10,70038,70052,Blue,1,51944,52749,805
2022-12-24,70055,70049,Blue,0,43459,43813,354
2022-11-18,70042,70048,Blue,1,58422,58748,326
2022-09-22,70048,70058,Blue,1,71016,71499,483
2022-10-19,70046,70052,Blue,1,64642,64981,339
2022-09-07,70053,70838,Blue,0,41279,42919,1640
2022-10-04,70050,70052,Blue,1,79772,79887,115
2022-07-19,70059,70055,Blue,0,25541,25693,152
2022-12-17,70056,70060,Blue,1,31054,31223,169
2022-08-11,70057,70043,Blue,0,46893,47711,818
2022-11-14,70040,70042,Blue,1,40457,40490,33
2022-05-30,70049,70039,Blue,0,59790,60308,518
2022-01-05,70046,70050,Blue,1,61372,61538,166
2022-10-28,70055,70047,Blue,0,43414,43869,455
2022-11-14,70057,70043,Blue,0,36882,37756,874
2022-12-19,70051,70041,Blue,0,62997,63666,669
2022-12-26,70042,70058,Blue,1,29365,30179,814
2022-01-23,70051,70049,Blue,0,51495,51600,105
2022-01-03,70057,70041,Blue,0,43296,44109,813
2022-09-02,70057,70051,Blue,0,72221,72472,251
2022-10-08,70054,70060,Blue,1,85646,85934,288
2022-12-02,70053,70051,Blue,0,24495,24554,59
2022-06-21,70047,70045,Blue,0,42530,42634,104
2022-10-26,70046,70058,Blue,1,54066,54673,607
2022-09-19,70059,70051,Blue,0,56179,56505,326
2022-01-05,70055,70047,Blue,0,20437,20847,410
2022-04-13,70057,70039,Blue,0,57272,58153,881
2022-02-08,70049,70039,Blue,0,86799,87309,510
2022-10-28,70043,70041,Blue,0,86944,86972,28
2022-01-09,70047,70838,Blue,0,66855,67352,497
2022-08-10,70044,70056,Blue,1,75417,76064,647
2022-03-06,70047,70039,Blue,0,41464,41884,420
2022-01-10,70042,70052,Blue,1,68725,69341,616
2022-01-19,70048,70058,Blue,1,61288,61789,501
2022-04-22,70058,70060,Blue,1,24730,24985,255
2022-08-25,70044,70054,Blue,1,68738,69294,556
2022-05-25,70047,70043,Blue,0,56906,57234,328
2022-02-24,70038,70056,Blue,1,47682,48732,1050
2022-09-29,70059,70053,Blue,0,44760,45031,271
2022-10-15,70057,70039,Blue,0,30944,32475,1531
2022-03-26,70059,70053,Blue,0,35183,35417,234
2022-02-10,70040,70054,Blue,1,55703,56407,704
2022-04-22,70056,70060,Blue,1,62012,62303,291
2022-07-03,70051,70049,Blue,0,21935,22045,110
2022-08-10,70047,70041,Blue,0,38706,39089,383
2022-11-15,70038,70058,Blue,1,37765,38711,946
2022-10-28,70052,70056,Blue,1,75430,75569,139
2022-05-18,70038,70058,Blue,1,58343,59444,1101
2022-07-15,70040,70050,Blue,1,45624,46171,547
2022-07-14,70038,70040,Blue,1,68965,68982,17
2022-10-09,70045,70041,Blue,0,36948,37123,175
2022-03-14,70048,70060,Blue,1,64566,65338,772
2022-04-15,70038,70044,Blue,1,23062,23217,155
2022-07-24,70055,70053,Blue,0,66023,66070,47
2022-06-28,70038,70050,Blue,1,21370,21983,613
2022-04-02,70055,70043,Blue,0,54263,54938,675
2022-02-15,70051,70043,Blue,0,82128,82640,512
2022-02-16,70046,70050,Blue,1,61138,61342,204
2022-08-08,70057,70055,Blue,0,44797,44866,69
2022-01-26,70059,70045,Blue,0,26661,27437,776
2022-11-29,70042,70054,Blue,1,25785,26444,659
2022-11-04,70059,70039,Blue,0,35360,36410,1050
2022-12-18,70043,70838,Blue,0,56953,57156,203
2022-01-13,70049,70041,Blue,0,29318,29771,453
2022-09-16,70059,70041,Blue,0,27201,28119,918
2022-06-13,70044,70052,Blue,1,53033,53692,659
2022-12-24,70040,70060,Blue,1,76719,77796,1077
2022-09-02,70040,70054,Blue,1,69864,70773,909
2022-11-11,70040,70060,Blue,1,83111,84259,1148
2022-10-30,70051,70049,Blue,0,26566,26669,103
2022-12-04,70057,70041,Blue,0,32969,33848,879
2022-12-20,70057,70049,Blue,0,55208,55593,385
2022-08-23,70051,70039,Blue,0,74378,75015,637
2022-10-13,70038,70058,Blue,1,62834,63927,1093
2022-07-29,70057,70055,Blue,0,43836,43903,67
2022-02-28,70048,70052,Blue,1,61890,62106,216
2022-01-04,70038,70050,Blue,1,58629,59159,530
2022-09-27,70040,70048,Blue,1,80351,80778,427
2022-11-15,70059,70045,Blue,0,36264,36958,694
2022-11-13,70054,70058,Blue,1,50756,50907,151
2022-09-15,70059,70051,Blue,0,64149,64494,345
2022-07-10,70051,70045,Blue,0,31971,32287,316
2022-07-26,70051,70049,Blue,0,82695,82799,104
2022-02-28,70038,70046,Blue,1,76336,76677,341
2022-07-13,70044,70060,Blue,1,64072,65074,1002
2022-11-24,70045,70039,Blue,0,68599,68829,230
2022-02-22,70043,70039,Blue,0,56906,57015,109
2022-12-05,70045,70039,Blue,0,58449,58682,233
2022-01-05,70040,70044,Blue,1,72608,72722,114
2022-06-17,70048,70054,Blue,1,82551,82917,366
2022-02-14,70052,70056,Blue,1,45997,46139,142
2022-05-07,70059,70051,Blue,0,81616,81937,321
2022-08-27,70057,70051,Blue,0,84094,84336,242
2022-07-28,70038,70048,Blue,1,58275,58767,492
2022-11-04,70038,70052,Blue,1,86607,87306,699
2022-09-28,70042,70052,Blue,1,49901,50454,553
2022-09-04,70057,70043,Blue,0,67406,68147,741
2022-12-23,70057,70047,Blue,0,27869,28430,561
2022-10-16,70045,70043,Blue,0,68069,68163,94
2022-02-03,70040,70042,Blue,1,36261,36297,36
2022-04-12,70053,70045,Blue,0,21268,21739,471
2022-01-29,70040,70048,Blue,1,22631,23065,434
2022-05-21,70053,70045,Blue,0,79366,79903,537
2022-01-21,70038,70046,Blue,1,34154,34492,338
2022-08-23,70053,70045,Blue,0,33700,34153,453
2022-08-03,70042,70060,Blue,1,78651,79578,927
2022-05-17,70052,70058,Blue,1,72644,72911,267
2022-09-25,70057,70041,Blue,0,35630,36750,1120
2022-11-05,70042,70050,Blue,1,82369,82819,450
2022-08-02,70042,70044,Blue,1,33853,33882,29
2022-12-04,70040,70060,Blue,1,73756,74846,1090
2022-08-08,70040,70056,Blue,1,56495,57330,835
2022-11-21,70046,70060,Blue,1,60647,61400,753
2022-10-08,70044,70056,Blue,1,89360,90059,699
2022-03-03,70044,70050,Blue,1,57083,57446,363
2022-04-20,70041,70838,Blue,0,54937,55131,194
2022-10-30,70053,70051,Blue,0,88504,88552,48
2022-05-18,70040,70058,Blue,1,79600,80825,1225
2022-07-22,70055,70838,Blue,0,68666,69588,922
2022-09-27,70055,70051,Blue,0,80123,80260,137
2022-12-20,70044,70058,Blue,1,49867,50717,850
2022-04-22,70041,70838,Blue,0,52191,52396,205
2022-08-27,70050,70060,Blue,1,31275,31806,531
2022-02-26,70047,70039,Blue,0,48785,49223,438
2022-06-22,70044,70046,Blue,1,23814,23950,136
2022-11-06,70044,70056,Blue,1,71175,71790,615
2022-04-06,70057,70047,Blue,0,84693,85205,512
2022-10-18,70055,70049,Blue,0,49596,49883,287
2022-01-04,70049,70039,Blue,0,78300,78775,475
2022-11-26,70057,70041,Blue,0,68232,69213,981
2022-03-22,70051,70043,Blue,0,55033,55546,513
2022-04-11,70044,70058,Blue,1,61876,62680,804
2022-01-31,70053,70045,Blue,0,48367,48815,448
2022-11-19,70042,70060,Blue,1,50308,51227,919
2022-11-02,70050,70054,Blue,1,54069,54306,237
2022-11-30,70040,70060,Blue,1,51861,52985,1124
2022-03-06,70055,70047,Blue,0,58882,59257,375
2022-03-25,70052,70054,Blue,1,59505,59547,42
2022-07-16,70042,70046,Blue,1,40004,40206,202
2022-04-23,70047,70041,Blue,0,54151,54590,439
2022-11-11,70059,70055,Blue,0,82167,82411,244
2022-07-04,70038,70056,Blue,1,34516,35591,1075
2022-08-27,70059,70039,Blue,0,38956,39971,1015
2022-09-10,70053,70041,Blue,0,88482,89253,771
2022-08-24,70040,70048,Blue,1,33671,34049,378
2022-06-23,70042,70058,Blue,1,26624,27507,883
2022-08-15,70044,70048,Blue,1,31770,32008,238
2022-01-14,70059,70047,Blue,0,82328,82881,553
2022-02-15,70042,70056,Blue,1,55197,55897,700
2022-12-19,70044,70054,Blue,1,87236,87845,609
2022-12-06,70044,70058,Blue,1,48519,49311,792
2022-12-27,70052,70060,Blue,1,77333,77693,360
2022-11-08,70057,70039,Blue,0,32641,33647,1006
2022-09-11,70055,70039,Blue,0,84795,85575,780
2022-02-02,70059,70055,Blue,0,24031,24185,154
2022-09-27,70049,70838,Blue,0,25877,26607,730
2022-01-10,70048,70054,Blue,1,71945,72248,303
2022-10-27,70040,70048,Blue,1,26952,27361,409
2022-06-28,70038,70040,Blue,1,23751,23768,17
2022-07-20,70055,70043,Blue,0,54726,55469,743
2022-08-09,70038,70050,Blue,1,40585,41191,606
2022-06-29,70038,70054,Blue,1,50487,51435,948
2022-09-28,70043,70039,Blue,0,59704,59811,107
2022-04-03,70057,70053,Blue,0,70109,70257,148
2022-11-07,70049,70838,Blue,0,31943,32603,660
2022-05-20,70055,70053,Blue,0,25641,25688,47
2022-02-08,70056,70058,Blue,1,63755,63832,77
2022-09-21,70038,70048,Blue,1,47162,47608,446
2022-10-28,70044,70056,Blue,1,56926,57562,636
2022-08-29,70048,70058,Blue,1,41355,41847,492
2022-11-20,70040,70056,Blue,1,78071,78939,868
2022-01-08,70046,70048,Blue,1,71056,71138,82
2022-01-07,70042,70050,Blue,1,58815,59228,413
2022-04-01,70058,70060,Blue,1,32824,32909,85
2022-09-14,70051,70041,Blue,0,37819,38391,572
2022-12-21,70048,70050,Blue,1,76289,76346,57
2022-05-23,70042,70046,Blue,1,69115,69297,182
2022-10-07,70038,70044,Blue,1,34455,34615,160
2022-12-09,70047,70045,Blue,0,62214,62308,94
2022-01-14,70040,70048,Blue,1,89219,89605,386
2022-03-24,70038,70042,Blue,1,20640,20731,91
2022-07-07,70049,70043,Blue,0,42719,43144,425
2022-03-21,70048,70052,Blue,1,79802,80106,304
2022-07-05,70050,70056,Blue,1,58823,59137,314
2022-06-15,70052,70054,Blue,1,83987,84045,58
2022-06-11,70048,70058,Blue,1,63701,64208,507
2022-06-26,70055,70047,Blue,0,74602,74969,367
2022-07-14,70053,70045,Blue,0,63271,63694,423
2022-09-12,70038,70056,Blue,1,30252,31095,843
2022-07-07,70046,70052,Blue,1,51864,52208,344
2022-07-08,70059,70053,Blue,0,79410,79629,219
2022-04-04,70057,70041,Blue,0,20668,21498,830
2022-02-24,70054,70060,Blue,1,73862,74124,262
2022-06-30,70045,70041,Blue,0,59960,60138,178
2022-09-27,70043,70041,Blue,0,24871,24902,31
2022-06-26,70059,70838,Blue,0,51136,52324,1188
2022-10-25,70045,70041,Blue,0,74081,74248,167
2022-03-10,70059,70055,Blue,0,40933,41080,147
2022-07-07,70053,70045,Blue,0,27661,28183,522
2022-08-16,70053,70049,Blue,0,69939,70138,199
2022-08-31,70055,70043,Blue,0,79249,79893,644
2022-03-02,70038,70058,Blue,1,28157,29220,1063
2022-02-05,70059,70045,Blue,0,36265,37008,743
2022-02-02,70045,70039,Blue,0,27810,28132,322
2022-03-23,70050,70052,Blue,1,66781,66895,114
2022-08-15,70042,70044,Blue,1,29194,29224,30
2022-02-27,70041,70838,Blue,0,47288,47403,115
2022-02-12,70050,70058,Blue,1,89830,90421,591
2022-11-01,70044,70052,Blue,1,34323,34817,494
2022-11-22,70043,70039,Blue,0,48758,48896,138
2022-08-02,70054,70058,Blue,1,58619,58781,162
2022-03-10,70058,70060,Blue,1,56050,56134,84
2022-12-07,70050,70052,Blue,1,69570,69687,117
2022-11-27,70053,70043,Blue,0,56352,56973,621
2022-03-07,70046,70054,Blue,1,27331,27747,416
2022-05-20,70051,70047,Blue,0,79794,79981,187
2022-09-30,70047,70838,Blue,0,46902,47384,482
2022-12-05,70059,70055,Blue,0,87314,87457,143
2022-11-28,70041,70039,Blue,0,31112,31142,30
2022-12-16,70053,70045,Blue,0,60734,61188,454
2022-09-08,70058,70060,Blue,1,51989,52055,66
2022-11-22,70051,70047,Blue,0,30819,31010,191
2022-04-21,70040,70046,Blue,1,68688,68960,272
2022-01-04,70051,70045,Blue,0,26779,27152,373
2022-08-18,70049,70045,Blue,0,72502,72699,197
2022-08-11,70044,70048,Blue,1,48427,48674,247
2022-04-12,70059,70838,Blue,0,28167,29344,1177
2022-10-27,70040,70052,Blue,1,22265,22874,609
2022-01-13,70057,70055,Blue,0,38736,38803,67
2022-06-01,70047,70043,Blue,0,38705,39027,322
2022-01-26,70050,70058,Blue,1,60179,60602,423
2022-07-16,70051,70045,Blue,0,59871,60197,326
2022-04-01,70059,70045,Blue,0,87498,88249,751
2022-10-22,70042,70046,Blue,1,68878,69084,206
2022-03-16,70055,70039,Blue,0,61882,62703,821
2022-08-18,70054,70060,Blue,1,61717,62147,430
2022-04-23,70040,70050,Blue,1,78677,79187,510
2022-02-08,70038,70058,Blue,1,25747,26836,1089
2022-11-17,70049,70838,Blue,0,33128,33897,769
2022-06-18,70057,70053,Blue,0,56853,57009,156
2022-03-30,70040,70046,Blue,1,65282,65553,271
2022-01-23,70044,70046,Blue,1,76043,76146,103
2022-07-19,70046,70050,Blue,1,49019,49198,179
2022-02-27,70042,70056,Blue,1,23923,24649,726
2022-03-11,70049,70039,Blue,0,51669,52157,488
2022-08-13,70047,70045,Blue,0,79040,79132,92
2022-12-01,70046,70060,Blue,1,39184,39966,782
2022-07-02,70047,70043,Blue,0,39538,39785,247
2022-04-13,70051,70039,Blue,0,57864,58543,679
2022-01-24,70048,70056,Blue,1,57945,58341,396
2022-12-22,70044,70060,Blue,1,36480,37409,929
2022-04-29,70054,70060,Blue,1,68831,69087,256
2022-04-04,70059,70039,Blue,0,76034,77173,1139
2022-10-04,70038,70046,Blue,1,63355,63678,323
2022-03-09,70039,70838,Blue,0,66359,66397,38
2022-02-02,70045,70039,Blue,0,29522,29771,249
2022-11-13,70046,70050,Blue,1,50817,50989,172
2022-11-28,70040,70060,Blue,1,28635,29702,1067
2022-08-04,70042,70044,Blue,1,36529,36563,34
2022-12-09,70049,70043,Blue,0,20488,20866,378
2022-08-24,70051,70049,Blue,0,23400,23503,103
2022-03-12,70051,70838,Blue,0,82679,83360,681
2022-09-17,70047,70838,Blue,0,29261,29726,465
2022-12-25,70043,70039,Blue,0,29351,29446,95
2022-01-10,70044,70046,Blue,1,63108,63262,154
2022-06-11,70048,70052,Blue,1,35067,35300,233
2022-07-11,70058,70060,Blue,1,69209,69281,72
2022-12-30,70042,70056,Blue,1,64637,65447,810
2022-09-19,70055,70041,Blue,0,47072,47979,907
2022-10-25,70050,70060,Blue,1,46944,47470,526
2022-07-11,70042,70052,Blue,1,24101,24686,585
2022-01-31,70059,70039,Blue,0,38240,39466,1226
2022-03-30,70059,70043,Blue,0,56602,57530,928
2022-07-22,70046,70054,Blue,1,40305,40789,484
2022-09-06,70052,70060,Blue,1,53643,54077,434
2022-10-04,70048,70060,Blue,1,42700,43330,630
2022-02-05,70057,70055,Blue,0,69273,69343,70
2022-07-05,70047,70045,Blue,0,76045,76150,105
2022-03-01,70048,70060,Blue,1,62407,63577,1170
2022-03-09,70040,70044,Blue,1,51675,51794,119
2022-06-13,70052,70058,Blue,1,82323,82594,271
2022-01-23,70054,70058,Blue,1,77791,77948,157
2022-08-18,70042,70058,Blue,1,27936,28847,911
2022-10-14,70055,70053,Blue,0,24033,24079,46
2022-03-19,70048,70050,Blue,1,63645,63704,59
2022-03-13,70044,70048,Blue,1,77688,77931,243
2022-08-04,70057,70051,Blue,0,35989,36253,264
2022-07-29,70049,70041,Blue,0,30204,30639,435
2022-11-01,70044,70052,Blue,1,59078,59611,533
2022-02-02,70057,70838,Blue,0,20356,21396,1040
2022-06-29,70048,70060,Blue,1,24095,24752,657
2022-10-19,70050,70056,Blue,1,29132,29406,274
2022-03-25,70038,70056,Blue,1,35106,36221,1115
2022-11-13,70038,70044,Blue,1,26933,27111,178
2022-12-17,70046,70050,Blue,1,49470,49640,170
2022-11-25,70044,70058,Blue,1,70260,71070,810
2022-09-25,70038,70044,Blue,1,47776,47943,167
2022-02-09,70045,70041,Blue,0,63694,63887,193
2022-10-19,70059,70047,Blue,0,69557,70170,613
2022-02-03,70042,70054,Blue,1,61974,62889,915
2022-11-30,70046,70058,Blue,1,28925,29505,580
2022-08-24,70046,70050,Blue,1,37839,38027,188
2022-11-22,70047,70041,Blue,0,85684,85989,305
2022-10-17,70054,70060,Blue,1,67786,68053,267
2022-06-29,70050,70058,Blue,1,83288,83738,450
2022-03-05,70043,70041,Blue,0,59836,59863,27
2022-04-22,70044,70048,Blue,1,23854,24109,255
2022-11-01,70046,70054,Blue,1,57999,58521,522
2022-07-08,70038,70056,Blue,1,40002,40932,930
2022-08-27,70041,70838,Blue,0,69319,69442,123
2022-11-19,70038,70060,Blue,1,71226,72295,1069
2022-06-16,70041,70838,Blue,0,20956,21096,140
2022-07-19,70057,70041,Blue,0,31534,32472,938
2022-12-18,70051,70049,Blue,0,47706,47837,131
2022-11-04,70049,70039,Blue,0,54156,54657,501
2022-12-12,70044,70052,Blue,1,37094,37621,527
2022-09-23,70048,70052,Blue,1,46810,47043,233
2022-09-02,70048,70060,Blue,1,31196,31813,617
2022-09-01,70042,70044,Blue,1,36481,36517,36
2022-12-27,70042,70054,Blue,1,74056,74674,618
2022-12-25,70056,70058,Blue,1,27021,27090,69
2022-03-18,70059,70039,Blue,0,27181,28171,990
2022-01-13,70059,70055,Blue,0,20954,21107,153
2022-11-26,70052,70060,Blue,1,30125,30480,355
2022-02-28,70043,70838,Blue,0,35394,35599,205
2022-02-11,70046,70058,Blue,1,84130,84736,606
2022-08-17,70044,70054,Blue,1,34959,35730,771
2022-06-16,70051,70838,Blue,0,82103,82852,749
2022-04-08,70053,70047,Blue,0,28435,28768,333
2022-04-12,70047,70041,Blue,0,83551,83908,357
2022-09-30,70043,70838,Blue,0,32843,33047,204
2022-09-22,70049,70838,Blue,0,75399,76077,678
2022-07-18,70051,70838,Blue,0,69144,69849,705
2022-03-03,70057,70053,Blue,0,56680,56847,167
2022-09-08,70038,70048,Blue,1,58020,58495,475
2022-07-31,70051,70043,Blue,0,46099,46595,496
2022-07-16,70038,70056,Blue,1,86406,87386,980
2022-10-28,70045,70043,Blue,0,34224,34305,81
2022-02-16,70041,70039,Blue,0,56206,56237,31
2022-06-13,70053,70043,Blue,0,36657,37306,649
2022-02-26,70052,70058,Blue,1,59615,59867,252
2022-08-26,70041,70838,Blue,0,46746,46868,122
2022-12-30,70055,70838,Blue,0,37302,38270,968
2022-05-18,70038,70046,Blue,1,53472,53855,383
2022-02-10,70059,70055,Blue,0,59897,60041,144
2022-03-30,70042,70044,Blue,1,60574,60601,27
2022-10-10,70055,70049,Blue,0,50602,50894,292
2022-04-04,70043,70041,Blue,0,88331,88359,28
2022-10-10,70040,70060,Blue,1,44963,46082,1119
2022-06-14,70044,70056,Blue,1,56507,57209,702
2022-02-04,70059,70041,Blue,0,30909,31959,1050
2022-07-19,70040,70060,Blue,1,53988,55040,1052
2022-04-21,70038,70048,Blue,1,33258,33687,429
2022-12-06,70038,70042,Blue,1,31934,32024,90
2022-01-10,70053,70838,Blue,0,34863,35751,888
2022-09-30,70051,70039,Blue,0,59133,59789,656
2022-07-05,70054,70056,Blue,1,32091,32138,47
2022-08-27,70049,70041,Blue,0,84511,84965,454
2022-10-25,70059,70047,Blue,0,44208,44793,585
2022-02-16,70045,70041,Blue,0,63926,64089,163
2022-12-19,70046,70054,Blue,1,38821,39335,514
2022-02-15,70055,70838,Blue,0,60071,60992,921
2022-02-03,70059,70043,Blue,0,32062,33026,964
2022-12-05,70059,70039,Blue,0,51486,52448,962
2022-06-09,70047,70838,Blue,0,69475,70036,561
2022-06-21,70059,70047,Blue,0,63690,64272,582
2022-11-13,70057,70051,Blue,0,51211,51446,235
2022-03-16,70044,70046,Blue,1,24894,25001,107
2022-07-16,70052,70060,Blue,1,52105,52455,350
2022-05-22,70038,70046,Blue,1,42314,42683,369
2022-11-30,70057,70053,Blue,0,57926,58082,156
2022-10-02,70055,70039,Blue,0,81831,82753,922
2022-02-27,70047,70838,Blue,0,68525,69019,494
2022-06-10,70047,70039,Blue,0,24570,25010,440
2022-02-28,70039,70838,Blue,0,77027,77060,33
2022-04-15,70059,70049,Blue,0,75491,76375,884
2022-04-10,70059,70043,Blue,0,66787,67581,794
2022-11-23,70057,70043,Blue,0,50046,50827,781
2022-10-18,70048,70052,Blue,1,61696,61899,203
2022-10-05,70042,70056,Blue,1,53907,54699,792
2022-08-27,70053,70047,Blue,0,25700,25982,282
2022-07-29,70040,70060,Blue,1,54485,55728,1243
2022-06-11,70057,70043,Blue,0,22253,23097,844
2022-07-31,70057,70039,Blue,0,45483,46440,957
2022-06-30,70043,70039,Blue,0,76141,76239,98
2022-11-26,70057,70041,Blue,0,37408,38233,825
2022-03-26,70050,70056,Blue,1,76643,76979,336
2022-01-12,70045,70039,Blue,0,64292,64538,246
2022-03-09,70042,70060,Blue,1,21699,22846,1147
2022-01-24,70055,70043,Blue,0,34351,35097,746
2022-03-07,70040,70050,Blue,1,41298,41756,458
2022-06-01,70047,70045,Blue,0,20435,20539,104
2022-01-23,70040,70042,Blue,1,60784,60813,29
2022-08-17,70040,70042,Blue,1,22168,22211,43
2022-05-15,70059,70051,Blue,0,24608,24971,363
2022-10-13,70055,70045,Blue,0,59182,60030,848
2022-04-13,70040,70042,Blue,1,32725,32758,33
2022-04-09,70048,70056,Blue,1,81109,81601,492
2022-04-14,70058,70060,Blue,1,26545,26655,110
2022-11-29,70044,70050,Blue,1,27089,27420,331
2022-01-24,70040,70056,Blue,1,31516,32459,943
2022-04-13,70049,70041,Blue,0,39219,39679,460
2022-08-21,70040,70052,Blue,1,58103,58743,640
2022-12-14,70059,70047,Blue,0,23425,24065,640
2022-12-27,70059,70047,Blue,0,18794,19373,579
2022-01-21,70042,70044,Blue,1,24148,24183,35
2022-01-28,70054,70060,Blue,1,73418,73681,263
2022-01-06,70038,70052,Blue,1,41829,42499,670
2022-03-22,70059,70053,Blue,0,61272,61494,222
2022-01-12,70057,70051,Blue,0,59974,60259,285
2022-02-25,70053,70041,Blue,0,78053,78703,650
2022-10-20,70059,70053,Blue,0,65076,65304,228
2022-09-06,70049,70047,Blue,0,33260,33331,71
2022-07-04,70043,70838,Blue,0,69688,69865,177
2022-01-19,70048,70050,Blue,1,47459,47519,60
2022-08-02,70051,70047,Blue,0,29718,29930,212
2022-12-03,70050,70060,Blue,1,30242,30755,513
2022-01-12,70040,70050,Blue,1,58698,59244,546
2022-04-08,70044,70052,Blue,1,29549,30005,456
2022-08-22,70053,70051,Blue,0,86026,86081,55
2022-01-22,70059,70049,Blue,0,59080,59553,473
2022-07-10,70056,70058,Blue,1,24688,24757,69
2022-09-22,70046,70052,Blue,1,56432,56756,324
2022-07-31,70052,70054,Blue,1,60456,60521,65
2022-08-08,70052,70060,Blue,1,47975,48364,389
2022-05-30,70040,70042,Blue,1,65783,65813,30
2022-02-24,70048,70060,Blue,1,53496,54408,912
2022-05-19,70044,70050,Blue,1,30496,31305,809
2022-05-31,70049,70045,Blue,0,54875,55098,223
2022-03-11,70059,70051,Blue,0,20234,20565,331
2022-09-10,70055,70045,Blue,0,56989,57523,534
2022-04-09,70038,70044,Blue,1,39383,39553,170
2022-11-12,70045,70838,Blue,0,64033,64347,314
2022-09-19,70057,70838,Blue,0,33211,34327,1116
2022-07-24,70044,70052,Blue,1,62044,62546,502
2022-10-31,70045,70039,Blue,0,53276,53528,252
2022-11-14,70052,70054,Blue,1,41178,41223,45
2022-10-07,70059,70041,Blue,0,27208,28136,928
2022-09-03,70040,70042,Blue,1,89178,89210,32
2022-04-08,70048,70052,Blue,1,33803,34022,219
2022-01-11,70057,70039,Blue,0,46171,47208,1037
2022-07-03,70050,70054,Blue,1,60847,61053,206
2022-08-30,70059,70039,Blue,0,88106,89321,1215
2022-11-20,70051,70047,Blue,0,54217,54411,194
2022-12-25,70053,70838,Blue,0,70287,71120,833
2022-09-22,70049,70039,Blue,0,26891,27509,618
2022-02-15,70042,70052,Blue,1,52360,52996,636
2022-02-04,70053,70047,Blue,0,67520,67819,299
2022-10-21,70040,70058,Blue,1,77898,78922,1024
2022-10-05,70042,70050,Blue,1,85838,86265,427
2022-01-28,70053,70047,Blue,0,58689,59019,330
2022-05-20,70051,70045,Blue,0,41802,42230,428
2022-02-04,70053,70043,Blue,0,44209,44963,754
2022-10-03,70039,70838,Blue,0,74059,74093,34
2022-02-03,70044,70052,Blue,1,63054,63735,681
2022-02-02,70044,70056,Blue,1,67910,68692,782
2022-03-28,70038,70058,Blue,1,22146,23076,930
2022-02-19,70044,70052,Blue,1,59055,59555,500
2022-07-08,70055,70045,Blue,0,77137,77654,517
2022-01-17,70053,70047,Blue,0,49517,49812,295
2022-11-15,70041,70039,Blue,0,39396,39427,31
2022-04-05,70044,70048,Blue,1,42184,42459,275
2022-06-11,70047,70041,Blue,0,43413,43802,389
2022-02-16,70042,70058,Blue,1,53595,54583,988
2022-12-19,70050,70054,Blue,1,63319,63527,208
2022-07-05,70040,70046,Blue,1,48664,48985,321
2022-12-04,70047,70045,Blue,0,54420,54510,90
2022-03-17,70049,70041,Blue,0,19414,19887,473
2022-08-22,70051,70838,Blue,0,49935,50779,844
2022-01-25,70044,70054,Blue,1,43229,43874,645
2022-06-26,70053,70039,Blue,0,85870,86657,787
2022-06-14,70051,70047,Blue,0,32147,32344,197
2022-08-11,70058,70060,Blue,1,90078,90137,59
2022-05-28,70044,70052,Blue,1,63505,64115,610
2022-12-18,70054,70060,Blue,1,27738,27986,248
2022-08-21,70052,70056,Blue,1,65829,65991,162
2022-05-01,70057,70055,Blue,0,27086,27153,67
2022-08-13,70051,70041,Blue,0,32287,32857,570
2022-07-08,70055,70049,Blue,0,36108,36398,290
2022-01-21,70059,70043,Blue,0,28159,29107,948
2022-07-20,70051,70049,Blue,0,36955,37055,100
2022-12-07,70059,70051,Blue,0,42500,42847,347
2022-02-25,70044,70060,Blue,1,88555,89465,910
2022-10-05,70044,70056,Blue,1,56772,57451,679
2022-09-16,70046,70054,Blue,1,32370,32851,481
2022-09-15,70044,70052,Blue,1,30462,30979,517
2022-04-05,70055,70838,Blue,0,38884,39820,936
2022-01-08,70043,70039,Blue,0,74969,75097,128
2022-03-07,70040,70058,Blue,1,25017,26000,983
2022-01-19,70051,70039,Blue,0,55502,56140,638
2022-06-22,70057,70053,Blue,0,26010,26173,163
2022-08-06,70046,70054,Blue,1,27289,27713,424
2022-03-23,70053,70045,Blue,0,83736,84135,399
2022-02-22,70046,70052,Blue,1,73864,74184,320
2022-05-01,70051,70047,Blue,0,50762,51119,357
2022-09-10,70040,70056,Blue,1,29720,30523,803
2022-02-09,70059,70053,Blue,0,20600,20821,221
2022-03-16,70051,70041,Blue,0,87831,88374,543
2022-01-31,70044,70046,Blue,1,60971,61081,110
2022-07-04,70038,70042,Blue,1,46393,46503,110
2022-06-16,70038,70040,Blue,1,26980,26995,15
2022-06-21,70057,70051,Blue,0,84429,84663,234
2022-12-09,70059,70053,Blue,0,86030,86254,224
2022-04-16,70049,70043,Blue,0,43825,44194,369
2022-06-20,70057,70051,Blue,0,27293,27592,299
2022-03-12,70040,70044,Blue,1,72369,72478,109
2022-01-05,70054,70056,Blue,1,85049,85095,46
2022-10-30,70048,70050,Blue,1,52082,52137,55
2022-05-18,70038,70060,Blue,1,61935,63287,1352
2022-01-04,70042,70044,Blue,1,24500,24533,33
2022-04-12,70051,70039,Blue,0,33989,34739,750
2022-09-03,70048,70056,Blue,1,39317,39684,367
2022-08-16,70040,70052,Blue,1,54283,54944,661
2022-11-18,70056,70060,Blue,1,71123,71316,193
2022-07-31,70051,70045,Blue,0,81250,81588,338
2022-09-02,70046,70054,Blue,1,31052,31509,457
2022-03-09,70048,70050,Blue,1,26567,26626,59
2022-03-25,70044,70060,Blue,1,28671,29620,949
2022-07-06,70040,70052,Blue,1,27075,27747,672
2022-04-08,70053,70039,Blue,0,23670,24461,791
2022-02-15,70040,70042,Blue,1,82877,82908,31
2022-08-30,70040,70056,Blue,1,57018,57847,829
2022-12-27,70057,70039,Blue,0,31417,32434,1017
2022-01-24,70040,70052,Blue,1,62599,63291,692
2022-08-16,70059,70053,Blue,0,54103,54331,228
2022-09-30,70051,70039,Blue,0,48710,49332,622
2022-02-18,70040,70058,Blue,1,36457,37487,1030
2022-03-26,70047,70045,Blue,0,52038,52127,89
2022-02-13,70055,70051,Blue,0,80016,80190,174
2022-02-16,70042,70060,Blue,1,51427,52468,1041
2022-09-15,70040,70056,Blue,1,30320,31176,856
2022-08-06,70057,70039,Blue,0,79177,80145,968
2022-02-12,70041,70838,Blue,0,48131,48261,130
2022-03-19,70056,70060,Blue,1,42460,42641,181
2022-06-09,70059,70053,Blue,0,67394,67631,237
2022-11-08,70043,70039,Blue,0,58526,58627,101
2022-04-06,70055,70047,Blue,0,46274,46692,418
2022-10-19,70046,70054,Blue,1,77113,77506,393
2022-06-03,70043,70039,Blue,0,76118,76224,106
2022-03-04,70054,70060,Blue,1,46098,46343,245
2022-07-18,70040,70048,Blue,1,47198,47611,413
2022-02-09,70059,70057,Blue,0,67154,67189,35
2022-11-21,70053,70043,Blue,0,41768,42381,613
2022-06-21,70041,70039,Blue,0,52725,52758,33
2022-07-30,70052,70058,Blue,1,37474,37719,245
2022-01-23,70038,70048,Blue,1,28446,28856,410
2022-01-21,70051,70043,Blue,0,19203,19719,516
2022-12-29,70049,70043,Blue,0,35743,36063,320
2022-06-30,70046,70058,Blue,1,27686,28334,648
2022-01-03,70059,70057,Blue,0,23955,24004,49
2022-07-04,70044,70052,Blue,1,84896,85548,652
2022-11-01,70042,70056,Blue,1,50446,51201,755
2022-01-19,70057,70051,Blue,0,62971,63251,280
2022-03-16,70053,70043,Blue,0,46900,47448,548
2022-01-08,70040,70044,Blue,1,70217,70329,112
2022-05-26,70041,70838,Blue,0,62669,62805,136
2022-05-01,70057,70051,Blue,0,79256,79508,252
2022-11-10,70055,70838,Blue,0,40257,41208,951
2022-11-01,70044,70046,Blue,1,26076,26182,106
2022-03-29,70040,70046,Blue,1,59935,60206,271
2022-01-13,70038,70058,Blue,1,71412,72501,1089
2022-05-20,70049,70041,Blue,0,59814,60392,578
2022-04-01,70053,70043,Blue,0,28748,29418,670
2022-01-18,70049,70039,Blue,0,31621,32192,571
2022-06-18,70055,70039,Blue,0,66705,67546,841
2022-11-26,70048,70050,Blue,1,86947,87008,61
2022-01-17,70042,70054,Blue,1,21173,21924,751
2022-11-20,70051,70047,Blue,0,33521,33709,188
2022-02-16,70053,70043,Blue,0,19501,20157,656
2022-02-05,70051,70041,Blue,0,55555,56147,592
2022-01-18,70053,70039,Blue,0,43664,44400,736
2022-01-19,70051,70049,Blue,0,39890,39997,107
2022-08-30,70048,70052,Blue,1,45728,45928,200
2022-10-02,70038,70058,Blue,1,62351,63354,1003
2022-11-29,70053,70047,Blue,0,27784,28092,308
2022-06-15,70059,70043,Blue,0,25766,26701,935
2022-06-27,70055,70041,Blue,0,73232,74166,934
2022-04-13,70042,70056,Blue,1,32208,33064,856
2022-10-28,70055,70049,Blue,0,61759,62027,268
2022-03-19,70052,70060,Blue,1,47169,47518,349
2022-06-06,70038,70050,Blue,1,69925,70565,640
2022-02-23,70057,70051,Blue,0,26538,26867,329
2022-12-29,70045,70043,Blue,0,60016,60101,85
2022-06-21,70057,70047,Blue,0,33185,33785,600
2022-01-16,70057,70047,Blue,0,64188,64736,548
2022-08-30,70057,70041,Blue,0,68230,69066,836
2022-11-22,70059,70053,Blue,0,22901,23147,246
2022-07-03,70059,70043,Blue,0,71158,72006,848
2022-03-02,70050,70056,Blue,1,28807,29110,303
2022-03-30,70047,70838,Blue,0,42124,42579,455
2022-02-18,70059,70041,Blue,0,19891,20870,979
2022-08-04,70042,70054,Blue,1,54070,54766,696
2022-09-14,70044,70052,Blue,1,45764,46268,504
2022-12-02,70038,70052,Blue,1,86533,87280,747
2022-11-28,70041,70039,Blue,0,22563,22597,34
2022-12-09,70043,70838,Blue,0,31465,32098,633
2022-03-12,70059,70053,Blue,0,65959,66179,220
2022-11-08,70053,70838,Blue,0,67933,68731,798
2022-03-30,70040,70046,Blue,1,30031,30298,267
2022-09-12,70059,70043,Blue,0,59394,60243,849
2022-09-07,70042,70044,Blue,1,26660,26690,30
2022-03-01,70053,70049,Blue,0,50070,50276,206
2022-06-29,70046,70048,Blue,1,58613,58704,91
2022-07-20,70055,70045,Blue,0,68800,69367,567
2022-12-06,70045,70838,Blue,0,44986,45320,334
2022-05-26,70040,70042,Blue,1,82304,82337,33
2022-03-13,70044,70048,Blue,1,73375,73626,251
2022-04-24,70055,70041,Blue,0,51869,52649,780
2022-06-24,70045,70838,Blue,0,68864,69274,410
2022-10-29,70051,70045,Blue,0,28530,28872,342
2022-03-12,70044,70056,Blue,1,62877,63559,682
2022-01-24,70049,70047,Blue,0,45501,45553,52
2022-03-20,70057,70039,Blue,0,30111,31118,1007
2022-03-11,70041,70838,Blue,0,50801,50930,129
2022-08-19,70050,70056,Blue,1,80857,81181,324
2022-12-14,70045,70043,Blue,0,69868,69959,91
2022-08-23,70042,70044,Blue,1,75993,76019,26
2022-10-22,70055,70047,Blue,0,46259,46640,381
2022-03-29,70046,70052,Blue,1,43310,43631,321
2022-06-19,70053,70051,Blue,0,60364,60419,55
2022-10-17,70050,70058,Blue,1,68553,68964,411
2022-07-05,70044,70050,Blue,1,55809,56240,431
2022-02-22,70038,70044,Blue,1,32955,33135,180
2022-01-02,70057,70041,Blue,0,60931,61769,838
2022-10-08,70046,70052,Blue,1,24727,25069,342
2022-07-06,70051,70838,Blue,0,65306,66045,739
2022-08-09,70040,70044,Blue,1,84193,84297,104
2022-08-02,70059,70047,Blue,0,74905,75438,533
2022-11-13,70059,70838,Blue,0,73813,74826,1013
2022-07-20,70055,70043,Blue,0,76645,77317,672
2022-07-02,70057,70047,Blue,0,28231,28725,494
2022-03-01,70051,70047,Blue,0,65796,66010,214
2022-10-25,70038,70040,Blue,1,52032,52046,14
2022-07-23,70055,70043,Blue,0,33215,33919,704
2022-06-10,70038,70048,Blue,1,42465,42972,507
2022-06-02,70038,70048,Blue,1,75621,76221,600
2022-08-31,70044,70054,Blue,1,21346,22002,656
2022-04-08,70059,70043,Blue,0,33254,34184,930
2022-06-30,70057,70043,Blue,0,58645,59459,814
2022-03-28,70042,70044,Blue,1,33078,33106,28
2022-02-02,70038,70056,Blue,1,31460,32396,936
2022-08-17,70059,70047,Blue,0,66015,66548,533
2022-08-06,70044,70060,Blue,1,69831,70734,903
2022-07-16,70051,70043,Blue,0,61583,62083,500
2022-03-16,70056,70060,Blue,1,55210,55392,182
2022-08-10,70049,70045,Blue,0,45894,46110,216
2022-10-31,70059,70057,Blue,0,34855,34892,37
2022-01-23,70040,70054,Blue,1,80449,81208,759
2022-07-02,70040,70042,Blue,1,55688,55722,34
2022-01-27,70040,70058,Blue,1,35570,36882,1312
2022-07-11,70042,70044,Blue,1,49145,49178,33
2022-09-06,70044,70060,Blue,1,53142,54077,935
2022-08-22,70038,70052,Blue,1,82359,83068,709
2022-01-28,70059,70047,Blue,0,27853,28418,565
2022-01-06,70049,70838,Blue,0,52119,52888,769
2022-07-12,70038,70042,Blue,1,23621,23715,94
2022-07-26,70045,70043,Blue,0,64691,64785,94
2022-10-20,70048,70060,Blue,1,54225,54933,708
2022-06-13,70045,70041,Blue,0,52039,52240,201
2022-11-20,70057,70049,Blue,0,26183,26579,396
2022-11-03,70059,70047,Blue,0,78206,78962,756
2022-02-18,70044,70046,Blue,1,20177,20283,106
2022-03-22,70042,70046,Blue,1,62873,63040,167
2022-05-01,70051,70049,Blue,0,54381,54484,103
2022-12-28,70053,70051,Blue,0,87723,87775,52
2022-04-18,70044,70046,Blue,1,55951,56060,109
2022-03-19,70052,70058,Blue,1,81403,81657,254
2022-11-29,70042,70054,Blue,1,85062,85709,647
2022-03-05,70044,70054,Blue,1,23190,23764,574
2022-12-05,70038,70056,Blue,1,65834,66759,925
2022-03-13,70053,70045,Blue,0,64377,64837,460
2022-02-25,70057,70041,Blue,0,56675,57515,840
2022-08-30,70059,70051,Blue,0,74295,74639,344
2022-08-19,70049,70045,Blue,0,38679,38903,224
2022-03-04,70050,70054,Blue,1,67086,67425,339
2022-01-10,70059,70039,Blue,0,62894,63907,1013
2022-04-24,70051,70041,Blue,0,72568,73124,556
2022-02-02,70048,70054,Blue,1,39914,40345,431
2022-04-15,70049,70838,Blue,0,19740,20369,629
2022-07-30,70059,70051,Blue,0,69207,69524,317
2022-06-20,70055,70043,Blue,0,26781,27503,722
2022-12-02,70045,70838,Blue,0,37615,37954,339
2022-12-12,70042,70054,Blue,1,48493,49252,759
2022-09-30,70044,70054,Blue,1,32613,33192,579
2022-03-07,70055,70043,Blue,0,46809,47440,631
2022-09-27,70048,70050,Blue,1,84175,84231,56
2022-04-28,70052,70056,Blue,1,59061,59205,144
2022-03-16,70041,70039,Blue,0,65070,65109,39
2022-03-28,70046,70050,Blue,1,69318,69505,187
2022-04-08,70047,70043,Blue,0,26133,26414,281
2022-07-13,70048,70058,Blue,1,28111,28627,516
2022-12-07,70044,70060,Blue,1,28408,29336,928
2022-03-31,70046,70050,Blue,1,27025,27216,191
2022-11-13,70044,70058,Blue,1,70695,71467,772
2022-01-12,70046,70050,Blue,1,70880,71064,184
2022-03-27,70051,70043,Blue,0,52597,53120,523
2022-10-01,70044,70046,Blue,1,64424,64529,105
2022-08-13,70049,70041,Blue,0,33573,34008,435
2022-11-08,70042,70060,Blue,1,21556,22572,1016
2022-02-23,70057,70045,Blue,0,43312,43918,606
2022-08-26,70046,70054,Blue,1,69209,69709,500
2022-08-08,70053,70838,Blue,0,61443,62271,828
2022-02-03,70042,70052,Blue,1,66240,66862,622
2022-03-15,70052,70054,Blue,1,51602,51660,58
2022-08-08,70049,70039,Blue,0,45833,46365,532
2022-11-16,70057,70041,Blue,0,38430,39233,803
2022-09-09,70055,70838,Blue,0,42319,43280,961
2022-05-24,70040,70042,Blue,1,70938,70979,41
2022-12-12,70057,70838,Blue,0,82352,83268,916
2022-01-07,70048,70058,Blue,1,35856,36476,620
2022-10-07,70059,70057,Blue,0,49537,49573,36
2022-10-29,70043,70838,Blue,0,72301,72498,197
2022-01-31,70057,70055,Blue,0,70194,70269,75
2022-04-01,70059,70045,Blue,0,37562,38322,760
2022-09-15,70051,70043,Blue,0,28182,28744,562
2022-01-24,70038,70040,Blue,1,50774,50791,17
2022-10-06,70053,70039,Blue,0,49212,49965,753
2022-08-20,70042,70060,Blue,1,75757,76737,980
2022-04-14,70048,70050,Blue,1,52620,52681,61
2022-10-12,70048,70050,Blue,1,43240,43296,56
2022-11-12,70049,70041,Blue,0,75637,76061,424
2022-06-16,70059,70838,Blue,0,69210,70329,1119
2022-03-08,70049,70039,Blue,0,41595,42113,518
2022-08-25,70042,70060,Blue,1,39729,40778,1049
2022-12-14,70052,70056,Blue,1,88171,88316,145
2022-03-31,70053,70047,Blue,0,83160,83476,316
2022-01-10,70048,70060,Blue,1,68473,69136,663
2022-04-18,70038,70042,Blue,1,71998,72095,97
2022-03-20,70057,70041,Blue,0,21593,22484,891
2022-10-07,70049,70838,Blue,0,86238,86815,577
2022-01-20,70059,70838,Blue,0,62605,63778,1173
2022-03-01,70059,70838,Blue,0,79453,80465,1012
2022-02-04,70038,70056,Blue,1,24611,25562,951
2022-09-24,70051,70039,Blue,0,46342,47015,673
2022-06-21,70047,70045,Blue,0,84933,85029,96
2022-11-06,70044,70060,Blue,1,25612,26518,906
2022-02-04,70050,70052,Blue,1,20512,20704,192
2022-10-11,70052,70058,Blue,1,78562,78813,251
2022-03-30,70043,70039,Blue,0,38511,38635,124
2022-09-04,70053,70049,Blue,0,47611,47916,305
2022-07-14,70053,70041,Blue,0,29155,29845,690
2022-05-12,70057,70051,Blue,0,68612,68857,245
2022-07-12,70044,70054,Blue,1,31815,32506,691
2022-08-21,70047,70039,Blue,0,73322,73730,408
2022-11-29,70058,70060,Blue,1,66893,66956,63
2022-09-13,70040,70058,Blue,1,30104,31060,956
2022-02-27,70054,70056,Blue,1,37082,37128,46
2022-02-24,70044,70054,Blue,1,87346,87910,564
2022-06-17,70053,70051,Blue,0,61056,61102,46
2022-04-05,70051,70043,Blue,0,58438,58938,500
2022-07-08,70057,70053,Blue,0,25189,25361,172
2022-12-11,70056,70058,Blue,1,39275,39345,70
2022-06-19,70047,70045,Blue,0,26122,26231,109
2022-04-18,70050,70060,Blue,1,69177,69688,511
2022-07-07,70057,70049,Blue,0,68646,69035,389
2022-03-06,70050,70052,Blue,1,48348,48458,110
2022-01-18,70051,70039,Blue,0,69867,70514,647
2022-03-05,70053,70838,Blue,0,25745,26594,849
2022-03-24,70053,70049,Blue,0,56559,56758,199
2022-09-05,70045,70838,Blue,0,80476,80810,334
2022-01-01,70059,70045,Blue,0,86421,87089,668
2022-02-15,70048,70056,Blue,1,80424,80821,397
2022-08-18,70059,70039,Blue,0,65943,67106,1163
2022-12-16,70045,70043,Blue,0,39956,40048,92
2022-08-19,70053,70838,Blue,0,62754,63646,892
2022-01-27,70045,70039,Blue,0,51521,51799,278
2022-09-23,70051,70041,Blue,0,32941,33628,687
2022-12-30,70057,70043,Blue,0,41075,41854,779
2022-08-09,70044,70050,Blue,1,25593,25915,322
2022-04-06,70057,70047,Blue,0,21409,21905,496
2022-01-01,70042,70054,Blue,1,56586,57247,661
2022-07-15,70057,70838,Blue,0,37410,38868,1458
2022-12-13,70051,70041,Blue,0,51964,52584,620
2022-07-29,70042,70044,Blue,1,44194,44226,32
2022-10-28,70051,70047,Blue,0,23007,23217,210
2022-10-23,70050,70052,Blue,1,55444,55554,110
2022-03-09,70044,70052,Blue,1,71188,71741,553
2022-02-25,70055,70039,Blue,0,64909,65791,882
2022-07-26,70054,70060,Blue,1,62306,62580,274
2022-10-25,70057,70051,Blue,0,33576,33831,255
2022-04-20,70059,70057,Blue,0,63196,63231,35
2022-07-23,70040,70060,Blue,1,39981,41080,1099
2022-08-04,70038,70044,Blue,1,67711,67885,174
2022-10-06,70040,70048,Blue,1,34510,34862,352
2022-11-28,70041,70838,Blue,0,50201,50315,114
2022-04-12,70038,70040,Blue,1,84353,84371,18
2022-09-29,70059,70047,Blue,0,23421,24030,609
2022-12-05,70057,70053,Blue,0,71871,72026,155
2022-05-19,70054,70060,Blue,1,63020,63283,263
2022-09-19,70050,70056,Blue,1,32252,32546,294
2022-06-23,70049,70039,Blue,0,65946,66486,540
2022-06-20,70055,70039,Blue,0,31158,31996,838
2022-04-24,70051,70041,Blue,0,49345,49956,611
2022-04-14,70051,70049,Blue,0,28932,29054,122
2022-03-08,70045,70838,Blue,0,32198,32555,357
2022-12-30,70055,70838,Blue,0,47599,48560,961
2022-03-20,70053,70045,Blue,0,87582,88039,457
2022-06-16,70044,70060,Blue,1,39326,41366,2040
2022-09-05,70038,70052,Blue,1,75332,76038,706
2022-12-19,70045,70043,Blue,0,35388,35578,190
2022-11-24,70056,70058,Blue,1,76801,76876,75
2022-10-28,70038,70056,Blue,1,52399,53582,1183
2022-08-09,70059,70039,Blue,0,29720,30851,1131
2022-11-10,70045,70041,Blue,0,53863,54034,171
2022-03-25,70042,70056,Blue,1,65708,66562,854
2022-08-04,70046,70052,Blue,1,64780,65110,330
2022-02-27,70038,70052,Blue,1,68826,69511,685
2022-04-04,70038,70052,Blue,1,45793,46494,701
2022-01-22,70059,70051,Blue,0,60560,60919,359
2022-07-11,70047,70043,Blue,0,59949,60187,238
2022-06-21,70038,70052,Blue,1,21301,22113,812
2022-05-09,70055,70051,Blue,0,32434,32573,139
2022-09-12,70040,70058,Blue,1,75264,76192,928
2022-06-15,70044,70048,Blue,1,23864,24154,290
2022-05-20,70050,70060,Blue,1,81512,82005,493
2022-10-28,70042,70058,Blue,1,57803,58727,924
2022-10-30,70057,70041,Blue,0,54449,55365,916
2022-12-12,70040,70050,Blue,1,80819,81281,462
2022-08-26,70053,70043,Blue,0,33969,34557,588
2022-02-14,70038,70056,Blue,1,46387,47223,836
2022-10-20,70053,70049,Blue,0,44032,44231,199
2022-06-20,70042,70052,Blue,1,74361,74949,588
2022-12-28,70057,70043,Blue,0,35137,36179,1042
2022-03-24,70053,70047,Blue,0,75157,75450,293
2022-09-07,70053,70838,Blue,0,46043,46971,928
2022-02-14,70043,70041,Blue,0,83242,83270,28
2022-07-11,70046,70060,Blue,1,44464,45282,818
2022-10-22,70046,70048,Blue,1,81008,81089,81
2022-09-14,70038,70052,Blue,1,29290,30052,762
2022-11-24,70055,70045,Blue,0,47009,47481,472
2022-08-11,70057,70043,Blue,0,63517,64345,828
2022-06-10,70046,70050,Blue,1,69866,70181,315
2022-11-19,70044,70046,Blue,1,74140,74245,105
2022-09-08,70055,70049,Blue,0,28643,28940,297
2022-07-03,70038,70048,Blue,1,64501,65033,532
2022-07-07,70044,70054,Blue,1,61635,62304,669
2022-01-01,70038,70056,Blue,1,33136,33948,812
2022-02-25,70043,70041,Blue,0,79851,79879,28
2022-01-08,70044,70052,Blue,1,85763,86265,502
2022-12-13,70056,70060,Blue,1,84388,84555,167
2022-09-25,70055,70838,Blue,0,51315,52258,943
2022-11-17,70038,70046,Blue,1,52329,52738,409
2022-12-21,70038,70046,Blue,1,19815,20149,334
2022-03-19,70038,70044,Blue,1,69607,69776,169
2022-03-20,70058,70060,Blue,1,65065,65152,87
2022-01-05,70052,70056,Blue,1,59392,59557,165
2022-03-17,70047,70045,Blue,0,88105,88226,121
2022-10-22,70051,70043,Blue,0,81838,82330,492
2022-11-22,70040,70044,Blue,1,31588,31704,116
2022-10-24,70044,70046,Blue,1,81446,81554,108
2022-05-06,70057,70053,Blue,0,29788,29945,157
2022-03-02,70053,70045,Blue,0,67115,67576,461
2022-04-05,70049,70838,Blue,0,47647,48320,673
2022-01-19,70057,70051,Blue,0,22832,23138,306
2022-06-18,70050,70056,Blue,1,27051,27357,306
2022-04-02,70059,70039,Blue,0,37342,38319,977
2022-04-02,70052,70060,Blue,1,60738,61101,363
2022-02-01,70051,70043,Blue,0,21392,22037,645
2022-07-02,70044,70052,Blue,1,55274,55784,510
2022-08-24,70038,70050,Blue,1,36840,37385,545
2022-09-15,70059,70051,Blue,0,25525,25855,330
2022-08-29,70048,70058,Blue,1,45081,45565,484
2022-10-03,70056,70060,Blue,1,33326,33501,175
2022-06-28,70048,70056,Blue,1,27674,28087,413
2022-03-14,70042,70058,Blue,1,28010,28913,903
2022-11-20,70059,70043,Blue,0,70080,70916,836
2022-02-04,70054,70060,Blue,1,39840,40103,263
2022-10-26,70056,70060,Blue,1,72367,72536,169
2022-11-21,70044,70048,Blue,1,89311,89557,246
2022-04-06,70049,70045,Blue,0,67978,68218,240
2022-03-15,70055,70039,Blue,0,40767,41671,904
2022-06-22,70044,70050,Blue,1,36372,36736,364
2022-12-28,70047,70045,Blue,0,53485,53589,104
2022-07-11,70044,70046,Blue,1,57258,57376,118
2022-07-31,70059,70049,Blue,0,68970,69438,468
2022-04-24,70054,70056,Blue,1,88985,89032,47
2022-05-03,70050,70058,Blue,1,76744,77177,433
2022-12-06,70038,70056,Blue,1,37287,38210,923
2022-03-27,70057,70055,Blue,0,51219,51287,68
2022-07-24,70053,70051,Blue,0,43089,43138,49
2022-02-27,70040,70052,Blue,1,54902,55672,770
2022-04-20,70055,70039,Blue,0,60404,61472,1068
2022-09-26,70049,70047,Blue,0,35462,35555,93
2022-04-12,70057,70051,Blue,0,47739,48031,292
2022-07-16,70051,70838,Blue,0,84358,85115,757
2022-10-01,70048,70060,Blue,1,71780,72396,616
2022-09-01,70050,70054,Blue,1,27945,28163,218
2022-06-05,70038,70042,Blue,1,44743,44857,114
2022-03-21,70040,70060,Blue,1,37471,38624,1153
2022-10-08,70049,70838,Blue,0,48643,49281,638
2022-07-09,70055,70053,Blue,0,57519,57565,46
2022-08-23,70051,70045,Blue,0,55032,55374,342
2022-08-10,70055,70045,Blue,0,26975,27521,546
2022-07-07,70042,70046,Blue,1,35962,36167,205
2022-09-14,70051,70049,Blue,0,18799,18908,109
2022-02-23,70038,70058,Blue,1,68226,69167,941
2022-07-27,70059,70045,Blue,0,45748,46512,764
2022-03-31,70059,70838,Blue,0,33570,34794,1224
2022-12-19,70055,70049,Blue,0,40316,40628,312
2022-02-13,70043,70039,Blue,0,82665,82789,124
2022-02-07,70053,70047,Blue,0,65003,65290,287
2022-12-30,70050,70054,Blue,1,68982,69180,198
2022-02-15,70040,70058,Blue,1,48761,49733,972
2022-10-11,70048,70060,Blue,1,21662,22287,625
2022-03-03,70050,70052,Blue,1,86677,86792,115
2022-02-05,70050,70052,Blue,1,46960,47076,116
2022-10-09,70059,70053,Blue,0,67872,68092,220
2022-08-19,70053,70045,Blue,0,45112,45569,457
2022-08-14,70050,70054,Blue,1,86977,87200,223
2022-12-03,70049,70039,Blue,0,57299,57995,696
2022-04-01,70044,70048,Blue,1,87954,88189,235
2022-10-08,70059,70057,Blue,0,55698,55733,35
2022-09-13,70054,70056,Blue,1,85031,85080,49
2022-01-26,70042,70060,Blue,1,58465,59685,1220
2022-03-11,70046,70050,Blue,1,60547,60753,206
2022-04-12,70057,70041,Blue,0,55788,56653,865
2022-07-09,70058,70060,Blue,1,68149,68206,57
2022-04-15,70038,70060,Blue,1,22753,23903,1150
2022-04-05,70042,70048,Blue,1,61800,62124,324
2022-01-27,70040,70056,Blue,1,35879,36997,1118
2022-09-18,70044,70046,Blue,1,88423,88529,106
2022-08-23,70043,70838,Blue,0,51360,51558,198
2022-03-08,70050,70058,Blue,1,58263,58659,396
2022-06-05,70042,70044,Blue,1,58168,58211,43
2022-08-14,70059,70051,Blue,0,53296,53621,325
2022-09-15,70053,70045,Blue,0,20687,21105,418
2022-09-03,70055,70047,Blue,0,24322,24705,383
2022-10-02,70057,70039,Blue,0,61465,62394,929
2022-06-25,70059,70047,Blue,0,47103,47656,553
2022-09-27,70038,70044,Blue,1,23714,23900,186
2022-11-14,70040,70042,Blue,1,72701,72735,34
2022-07-17,70048,70054,Blue,1,29712,29997,285
2022-10-24,70038,70048,Blue,1,29855,30311,456
2022-07-25,70049,70838,Blue,0,26052,26717,665
2022-06-09,70053,70045,Blue,0,42396,42846,450
2022-06-21,70043,70041,Blue,0,32056,32084,28
2022-11-03,70057,70838,Blue,0,61054,61989,935
2022-07-08,70052,70056,Blue,1,57354,57514,160
2022-06-20,70056,70058,Blue,1,32180,32250,70
2022-07-17,70056,70058,Blue,1,57379,57449,70
2022-09-08,70038,70056,Blue,1,31557,32525,968
2022-04-09,70047,70043,Blue,0,28222,28468,246
2022-04-22,70040,70056,Blue,1,65292,66119,827
2022-04-24,70053,70838,Blue,0,73546,74381,835
2022-11-21,70058,70060,Blue,1,49253,49313,60
2022-04-20,70056,70058,Blue,1,76220,76293,73
2022-11-08,70045,70041,Blue,0,21599,21778,179
2022-08-06,70042,70044,Blue,1,78104,78132,28
2022-10-30,70057,70047,Blue,0,83070,83525,455
2022-06-13,70055,70043,Blue,0,71179,71891,712
2022-07-28,70044,70056,Blue,1,65662,66326,664
2022-06-20,70057,70047,Blue,0,74430,74910,480
2022-02-20,70053,70041,Blue,0,28213,28894,681
2022-10-19,70055,70049,Blue,0,42785,43102,317
2022-02-10,70042,70054,Blue,1,19974,20640,666
2022-03-01,70038,70056,Blue,1,54318,55275,957
2022-03-08,70049,70045,Blue,0,29653,29868,215
2022-05-18,70038,70058,Blue,1,62594,63742,1148
2022-10-28,70051,70049,Blue,0,24603,24705,102
2022-02-27,70048,70050,Blue,1,87824,87882,58
2022-10-28,70057,70051,Blue,0,24768,25032,264
2022-07-19,70042,70056,Blue,1,74345,75158,813
2022-08-04,70054,70056,Blue,1,77235,77281,46
2022-03-08,70055,70045,Blue,0,50411,50955,544
2022-03-24,70055,70043,Blue,0,66843,67460,617
2022-08-03,70059,70045,Blue,0,65372,66055,683
2022-05-09,70057,70047,Blue,0,55115,55685,570
2022-11-01,70051,70047,Blue,0,32210,32406,196
2022-01-11,70055,70041,Blue,0,61586,62372,786
2022-02-25,70045,70039,Blue,0,20437,20799,362
2022-10-04,70057,70041,Blue,0,85078,85924,846
2022-12-28,70046,70056,Blue,1,88235,88754,519
2022-01-24,70059,70039,Blue,0,34173,35259,1086
2022-07-13,70044,70056,Blue,1,65695,66565,870
2022-03-11,70053,70043,Blue,0,22463,23126,663
2022-03-31,70044,70050,Blue,1,70164,70564,400
2022-08-02,70055,70041,Blue,0,71548,72307,759
2022-11-08,70059,70047,Blue,0,51488,52034,546
2022-01-08,70047,70039,Blue,0,53083,53498,415
2022-03-22,70053,70045,Blue,0,59446,59890,444
2022-05-18,70045,70039,Blue,0,45221,45513,292
2022-09-05,70048,70056,Blue,1,56471,56863,392
2022-04-15,70047,70041,Blue,0,65008,65334,326
2022-05-23,70050,70052,Blue,1,62576,62790,214
2022-07-16,70057,70051,Blue,0,81573,81807,234
2022-02-01,70050,70058,Blue,1,78572,78950,378
2022-10-02,70057,70043,Blue,0,61465,62223,758
2022-02-04,70051,70045,Blue,0,28931,29303,372
2022-05-05,70059,70053,Blue,0,60217,60444,227
2022-03-19,70047,70045,Blue,0,70361,70472,111
2022-03-07,70042,70052,Blue,1,71101,71678,577
2022-12-13,70055,70047,Blue,0,63075,63444,369
2022-01-08,70043,70838,Blue,0,53391,53595,204
2022-11-20,70052,70058,Blue,1,67419,67674,255
2022-01-31,70052,70056,Blue,1,47681,47828,147
2022-09-14,70042,70054,Blue,1,57741,58472,731
2022-03-19,70049,70045,Blue,0,25307,25521,214
2022-12-01,70059,70057,Blue,0,43178,43214,36
2022-09-22,70059,70838,Blue,0,23416,24670,1254
2022-03-15,70049,70045,Blue,0,42614,42821,207
2022-04-15,70053,70051,Blue,0,26922,26975,53
2022-03-23,70038,70050,Blue,1,64927,65527,600
2022-06-27,70057,70041,Blue,0,63343,64252,909
2022-03-31,70038,70050,Blue,1,44647,45182,535
2022-10-16,70040,70042,Blue,1,55940,55974,34
2022-07-04,70038,70050,Blue,1,73580,74168,588
2022-04-02,70055,70047,Blue,0,22995,23356,361
2022-09-07,70059,70055,Blue,0,72252,72392,140
2022-10-21,70051,70047,Blue,0,82387,82581,194
2022-09-25,70048,70054,Blue,1,49302,49597,295
2022-08-29,70040,70048,Blue,1,31676,32063,387
2022-08-12,70040,70056,Blue,1,64049,65058,1009
2022-06-15,70045,70043,Blue,0,52996,53103,107
2022-10-06,70057,70053,Blue,0,36628,36779,151
2022-12-30,70059,70049,Blue,0,59719,60161,442
2022-06-28,70057,70041,Blue,0,64101,65006,905
2022-08-19,70047,70041,Blue,0,39942,40278,336
2022-04-18,70040,70046,Blue,1,66800,67074,274
2022-01-07,70051,70045,Blue,0,47026,47408,382
2022-02-02,70055,70047,Blue,0,63461,63847,386
2022-10-15,70059,70049,Blue,0,37872,38332,460
2022-08-18,70055,70049,Blue,0,54321,54613,292
2022-08-18,70053,70039,Blue,0,66209,67106,897
2022-12-16,70053,70049,Blue,0,68925,69144,219
2022-07-04,70049,70838,Blue,0,67663,68274,611
2022-06-12,70057,70041,Blue,0,88302,89246,944
2022-11-06,70052,70056,Blue,1,56081,56221,140
2022-10-10,70043,70041,Blue,0,70646,70676,30
2022-10-22,70042,70058,Blue,1,63837,64742,905
2022-10-26,70059,70041,Blue,0,70215,71371,1156
2022-07-16,70042,70058,Blue,1,31962,32885,923
2022-06-28,70044,70046,Blue,1,33296,33426,130
2022-01-05,70049,70041,Blue,0,20437,20838,401
2022-08-26,70045,70039,Blue,0,31449,31742,293
2022-12-31,70044,70046,Blue,1,80038,80143,105
2022-02-14,70049,70838,Blue,0,37575,38233,658
2022-04-19,70051,70041,Blue,0,58409,59009,600
2022-02-11,70057,70043,Blue,0,24935,25804,869
2022-12-09,70042,70048,Blue,1,22346,22634,288
2022-11-07,70044,70052,Blue,1,64858,65370,512
2022-04-09,70044,70056,Blue,1,84909,85616,707
2022-03-30,70052,70060,Blue,1,27967,28360,393
2022-12-20,70043,70041,Blue,0,33231,33266,35
2022-07-16,70044,70050,Blue,1,78162,78509,347
2022-12-16,70038,70046,Blue,1,75238,75572,334
2022-02-10,70042,70058,Blue,1,26229,27082,853
2022-12-06,70046,70056,Blue,1,47536,48387,851
2022-11-05,70053,70045,Blue,0,55946,56360,414
2022-04-24,70050,70052,Blue,1,76634,76742,108
2022-10-09,70057,70041,Blue,0,36275,37123,848
2022-07-20,70058,70060,Blue,1,23497,23565,68
2022-07-04,70052,70054,Blue,1,83924,83992,68
2022-07-05,70046,70050,Blue,1,53858,54046,188
2022-12-13,70042,70058,Blue,1,51634,52533,899
2022-08-28,70046,70054,Blue,1,40029,40420,391
2022-04-08,70046,70052,Blue,1,27031,27391,360
2022-07-21,70042,70058,Blue,1,61508,62409,901
2022-08-25,70052,70056,Blue,1,66653,66802,149
2022-08-22,70045,70041,Blue,0,30951,31183,232
2022-03-15,70055,70053,Blue,0,40767,40813,46
2022-07-30,70051,70049,Blue,0,39312,39414,102
2022-03-09,70051,70049,Blue,0,27968,28074,106
2022-11-23,70040,70044,Blue,1,54030,54160,130
2022-06-21,70042,70054,Blue,1,43486,44269,783
2022-09-19,70057,70041,Blue,0,66827,67761,934
2022-09-17,70040,70046,Blue,1,42316,42568,252
2022-11-24,70053,70041,Blue,0,39736,40340,604
2022-08-20,70046,70060,Blue,1,44169,44969,800
2022-08-18,70048,70058,Blue,1,64709,65256,547
2022-11-25,70059,70041,Blue,0,34880,35909,1029
2022-06-19,70050,70052,Blue,1,68994,69112,118
2022-07-26,70038,70042,Blue,1,19904,20000,96
2022-06-21,70042,70058,Blue,1,53678,54580,902
2022-03-15,70038,70058,Blue,1,57426,58518,1092
2022-03-05,70053,70039,Blue,0,36589,37368,779
2022-02-15,70048,70056,Blue,1,82585,83009,424
2022-01-05,70051,70047,Blue,0,78229,78428,199
2022-03-10,70053,70049,Blue,0,38389,38632,243
2022-07-29,70038,70044,Blue,1,58317,58540,223
2022-11-13,70059,70051,Blue,0,72213,72518,305
2022-11-13,70047,70043,Blue,0,57654,57888,234
2022-10-03,70042,70048,Blue,1,54705,55027,322
2022-11-19,70038,70044,Blue,1,37216,37401,185
2022-07-08,70050,70052,Blue,1,72352,72464,112
2022-12-21,70044,70056,Blue,1,21909,22564,655
2022-01-28,70038,70048,Blue,1,64935,65407,472
2022-02-19,70045,70039,Blue,0,41354,41631,277
2022-01-26,70042,70052,Blue,1,79312,79842,530
2022-03-26,70038,70056,Blue,1,60515,61464,949
2022-09-08,70053,70039,Blue,0,27923,28708,785
2022-09-08,70046,70054,Blue,1,32300,33778,1478
2022-04-18,70040,70044,Blue,1,45851,45956,105
2022-02-16,70050,70058,Blue,1,25922,26320,398
2022-10-04,70047,70045,Blue,0,33360,33454,94
2022-01-05,70040,70046,Blue,1,22744,23034,290
2022-07-01,70040,70048,Blue,1,32030,32558,528
2022-06-20,70048,70056,Blue,1,38392,38833,441
2022-03-08,70041,70039,Blue,0,83322,83357,35
2022-10-22,70042,70056,Blue,1,75165,75937,772
2022-04-13,70057,70047,Blue,0,19243,19795,552
2022-06-23,70043,70838,Blue,0,31127,31338,211
2022-04-15,70059,70053,Blue,0,64104,64332,228
2022-08-15,70057,70053,Blue,0,65623,65772,149
2022-06-08,70038,70046,Blue,1,53152,53539,387
2022-03-06,70050,70058,Blue,1,59669,60049,380
2022-04-22,70046,70060,Blue,1,48613,49378,765
2022-02-18,70046,70048,Blue,1,75597,75689,92
2022-07-25,70040,70056,Blue,1,52342,53187,845
2022-01-29,70059,70041,Blue,0,36008,37295,1287
2022-01-26,70051,70041,Blue,0,51953,52549,596
2022-03-11,70052,70054,Blue,1,71733,71799,66
2022-07-10,70059,70049,Blue,0,30888,31344,456
2022-09-16,70042,70044,Blue,1,39030,39063,33
2022-06-29,70054,70056,Blue,1,33847,33909,62
2022-09-17,70042,70058,Blue,1,54651,55509,858
2022-11-25,70053,70041,Blue,0,44428,45081,653
2022-07-05,70042,70050,Blue,1,24701,25188,487
2022-11-24,70054,70058,Blue,1,80524,80681,157
2022-04-10,70053,70043,Blue,0,38439,39020,581
2022-03-03,70048,70058,Blue,1,35928,36450,522
2022-08-18,70045,70838,Blue,0,74712,75038,326
2022-10-30,70057,70043,Blue,0,86486,87329,843
2022-07-14,70051,70838,Blue,0,59903,60653,750
2022-07-01,70059,70053,Blue,0,60063,60283,220
2022-08-05,70048,70050,Blue,1,28485,28542,57
2022-02-08,70044,70054,Blue,1,57135,57756,621
2022-06-21,70055,70838,Blue,0,52170,53091,921
2022-12-14,70053,70043,Blue,0,54023,54559,536
2022-04-16,70038,70052,Blue,1,79932,80703,771
2022-10-03,70043,70041,Blue,0,28584,28613,29
2022-10-11,70046,70050,Blue,1,24559,24738,179
2022-01-01,70055,70043,Blue,0,52413,53115,702
2022-03-14,70050,70052,Blue,1,59582,59703,121
2022-01-31,70038,70052,Blue,1,32896,33739,843
2022-08-02,70059,70047,Blue,0,76936,77465,529
2022-03-19,70059,70041,Blue,0,40574,41485,911
2022-09-20,70040,70056,Blue,1,80252,81071,819
2022-03-27,70046,70052,Blue,1,71877,72187,310
2022-10-08,70040,70054,Blue,1,77384,78138,754
2022-07-12,70040,70060,Blue,1,87438,88408,970
2022-04-29,70052,70060,Blue,1,74291,74666,375
2022-12-19,70044,70046,Blue,1,43686,43803,117
2022-09-30,70054,70058,Blue,1,53725,53884,159
2022-07-13,70047,70043,Blue,0,32406,32669,263
2022-12-10,70056,70060,Blue,1,42617,42808,191
2022-09-29,70046,70056,Blue,1,55867,56398,531
2022-06-21,70057,70045,Blue,0,43925,44590,665
2022-01-11,70046,70054,Blue,1,64278,64693,415
2022-12-28,70047,70838,Blue,0,65578,66052,474
2022-04-19,70040,70052,Blue,1,81003,81718,715
2022-01-02,70038,70044,Blue,1,71537,71715,178
2022-02-08,70059,70051,Blue,0,88107,88443,336
2022-03-30,70057,70053,Blue,0,77839,77984,145
2022-10-26,70040,70052,Blue,1,60733,61427,694
2022-12-20,70045,70041,Blue,0,85760,85923,163
2022-04-11,70049,70043,Blue,0,65784,66136,352
2022-03-20,70051,70047,Blue,0,43827,44020,193
2022-04-11,70059,70047,Blue,0,44962,45498,536
2022-01-21,70051,70043,Blue,0,45872,46381,509
2022-12-06,70042,70046,Blue,1,32072,32243,171
2022-07-22,70057,70053,Blue,0,61745,61912,167
2022-07-23,70038,70054,Blue,1,79314,80166,852
2022-05-27,70049,70838,Blue,0,54929,55624,695
2022-06-10,70045,70041,Blue,0,33486,33665,179
2022-08-16,70042,70046,Blue,1,59797,59989,192
2022-03-08,70042,70048,Blue,1,69112,69429,317
2022-04-06,70047,70039,Blue,0,23420,23900,480
2022-10-19,70054,70056,Blue,1,29028,29075,47
2022-04-08,70038,70048,Blue,1,77466,77952,486
2022-07-04,70049,70045,Blue,0,30278,30472,194
2022-01-28,70042,70044,Blue,1,75333,75362,29
2022-08-31,70040,70060,Blue,1,69034,70078,1044
2022-03-31,70040,70042,Blue,1,66796,66833,37
2022-06-16,70054,70058,Blue,1,77590,77764,174
2022-11-12,70040,70046,Blue,1,59424,59692,268
2022-07-28,70040,70054,Blue,1,37825,38636,811
2022-11-18,70055,70043,Blue,0,53550,54221,671
2022-08-31,70054,70058,Blue,1,29216,29397,181
2022-03-30,70046,70058,Blue,1,41118,41800,682
2022-03-07,70057,70838,Blue,0,79537,80535,998
2022-02-17,70040,70060,Blue,1,38746,39920,1174
2022-06-21,70050,70056,Blue,1,59090,59401,311
2022-10-11,70042,70046,Blue,1,58298,58487,189
2022-04-22,70047,70041,Blue,0,19806,20154,348
2022-03-26,70057,70039,Blue,0,59694,60658,964
2022-02-28,70042,70054,Blue,1,53551,54251,700
2022-03-01,70057,70043,Blue,0,86990,87900,910
2022-01-28,70044,70054,Blue,1,22082,22691,609
2022-07-21,70046,70058,Blue,1,37028,37709,681
2022-09-17,70055,70045,Blue,0,86719,87251,532
2022-12-14,70047,70043,Blue,0,87143,87377,234
2022-10-08,70048,70056,Blue,1,54483,54870,387
2022-05-12,70056,70058,Blue,1,86058,86141,83
2022-12-09,70048,70058,Blue,1,22680,23407,727
2022-03-12,70050,70060,Blue,1,48086,48569,483
2022-02-04,70051,70043,Blue,0,52901,53437,536
2022-02-25,70053,70047,Blue,0,22076,22418,342
2022-02-03,70042,70046,Blue,1,35293,35475,182
2022-11-02,70044,70048,Blue,1,32223,32463,240
2022-06-06,70047,70041,Blue,0,28203,28662,459
2022-12-17,70057,70049,Blue,0,56869,57250,381
2022-12-11,70043,70041,Blue,0,26320,26348,28
2022-02-04,70057,70051,Blue,0,21761,22039,278
2022-04-13,70055,70039,Blue,0,34346,35328,982
2022-03-16,70038,70052,Blue,1,30255,30975,720
2022-07-14,70059,70045,Blue,0,37123,38017,894
2022-04-04,70050,70054,Blue,1,53082,53280,198
2022-08-11,70043,70039,Blue,0,67149,67255,106
2022-01-01,70051,70043,Blue,0,67870,68420,550
2022-06-30,70057,70041,Blue,0,78503,79395,892
2022-04-07,70044,70046,Blue,1,61868,61969,101
2022-08-30,70045,70039,Blue,0,21161,21462,301
2022-09-05,70048,70052,Blue,1,78122,78342,220
2022-12-22,70040,70058,Blue,1,23519,24458,939
2022-01-28,70049,70039,Blue,0,79956,80492,536
2022-10-13,70040,70050,Blue,1,24776,25282,506
2022-04-07,70044,70048,Blue,1,61550,61823,273
2022-03-24,70040,70048,Blue,1,55166,55596,430
2022-08-09,70046,70054,Blue,1,51058,51554,496
2022-02-09,70046,70050,Blue,1,39093,39303,210
2022-11-16,70059,70039,Blue,0,22482,23669,1187
2022-12-14,70051,70045,Blue,0,31353,31716,363
2022-08-07,70048,70054,Blue,1,84736,85076,340
2022-05-20,70040,70060,Blue,1,36269,37542,1273
2022-09-02,70044,70056,Blue,1,31404,32278,874
2022-01-16,70057,70047,Blue,0,40242,40734,492
2022-04-16,70038,70052,Blue,1,77287,78020,733
2022-08-29,70050,70054,Blue,1,25226,25447,221
2022-08-11,70055,70039,Blue,0,66462,67255,793
2022-09-15,70046,70060,Blue,1,21515,22327,812
2022-11-25,70048,70050,Blue,1,88753,88813,60
2022-04-05,70059,70053,Blue,0,31454,31678,224
2022-06-28,70057,70838,Blue,0,63976,65048,1072
2022-12-18,70040,70046,Blue,1,89177,89439,262
2022-07-06,70055,70041,Blue,0,56587,57363,776
2022-07-21,70050,70056,Blue,1,25744,26039,295
2022-10-28,70042,70058,Blue,1,33383,34256,873
2022-04-14,70044,70058,Blue,1,35640,36551,911
2022-10-28,70046,70054,Blue,1,67348,67790,442
2022-12-02,70041,70838,Blue,0,27216,27356,140
2022-04-21,70044,70060,Blue,1,62504,63445,941
2022-10-27,70042,70044,Blue,1,53121,53151,30
2022-01-20,70059,70055,Blue,0,80060,80229,169
2022-04-19,70047,70039,Blue,0,24375,24837,462
2022-08-30,70054,70056,Blue,1,54727,54774,47
2022-08-17,70052,70054,Blue,1,61512,61567,55
2022-11-10,70049,70041,Blue,0,50091,50544,453
2022-02-20,70042,70060,Blue,1,78810,79912,1102
2022-11-30,70047,70043,Blue,0,63702,63969,267
2022-02-19,70059,70047,Blue,0,71353,71931,578
2022-02-19,70042,70054,Blue,1,58458,59163,705
2022-01-04,70046,70058,Blue,1,74400,75038,638
2022-05-24,70040,70044,Blue,1,56545,56660,115
2022-11-03,70039,70838,Blue,0,27583,27619,36
2022-11-02,70040,70042,Blue,1,56639,56674,35
2022-10-22,70040,70050,Blue,1,71320,71976,656
2022-09-21,70049,70047,Blue,0,81581,81667,86
2022-11-02,70055,70041,Blue,0,30307,31161,854
2022-08-23,70053,70838,Blue,0,21102,21968,866
2022-04-04,70049,70838,Blue,0,43191,43826,635
2022-09-05,70044,70058,Blue,1,73532,74372,840
2022-03-14,70053,70039,Blue,0,27506,28197,691
2022-06-30,70052,70056,Blue,1,81880,82040,160
2022-06-13,70053,70045,Blue,0,65583,66028,445
2022-08-14,70045,70838,Blue,0,40925,41276,351
2022-01-11,70059,70045,Blue,0,77176,77828,652
2022-04-13,70051,70041,Blue,0,47494,48129,635
2022-08-24,70043,70838,Blue,0,24400,24636,236
2022-03-10,70038,70054,Blue,1,68953,69757,804
2022-09-02,70058,70060,Blue,1,52483,52544,61
2022-01-26,70059,70057,Blue,0,57912,57947,35
2022-03-07,70057,70039,Blue,0,78385,79353,968
2022-07-23,70042,70060,Blue,1,27648,28897,1249
2022-11-05,70042,70056,Blue,1,44401,45186,785
2022-01-24,70040,70046,Blue,1,29434,29703,269
2022-12-14,70051,70049,Blue,0,71078,71209,131
2022-08-29,70049,70838,Blue,0,25624,26266,642
2022-10-18,70041,70039,Blue,0,33702,33735,33
2022-12-28,70055,70051,Blue,0,80781,80912,131
2022-01-02,70054,70060,Blue,1,85448,85715,267
2022-01-27,70059,70043,Blue,0,79466,80483,1017
2022-07-26,70046,70052,Blue,1,70675,71014,339
2022-02-26,70045,70039,Blue,0,39242,39505,263
2022-06-07,70048,70052,Blue,1,44532,44820,288
2022-11-30,70038,70042,Blue,1,50772,50864,92
2022-08-04,70055,70051,Blue,0,88391,88534,143
2022-01-01,70051,70039,Blue,0,36591,37295,704
2022-03-24,70040,70044,Blue,1,66154,66262,108
2022-01-15,70044,70048,Blue,1,47311,47540,229
2022-07-02,70044,70050,Blue,1,57467,57824,357
2022-08-01,70050,70052,Blue,1,22349,22460,111
2022-12-16,70055,70039,Blue,0,42787,43661,874
2022-12-11,70054,70060,Blue,1,82582,82858,276
2022-02-16,70049,70041,Blue,0,33786,34236,450
2022-08-25,70049,70045,Blue,0,42300,42504,204
2022-05-08,70055,70047,Blue,0,64992,65400,408
2022-02-12,70055,70045,Blue,0,45607,46143,536
2022-12-02,70046,70052,Blue,1,32301,32630,329
2022-09-22,70054,70060,Blue,1,70398,70668,270
2022-06-16,70047,70043,Blue,0,68731,68989,258
2022-10-23,70053,70838,Blue,0,71928,72792,864
2022-12-29,70053,70045,Blue,0,36495,37000,505
2022-01-28,70047,70838,Blue,0,63217,63690,473
2022-09-24,70055,70043,Blue,0,26723,27437,714
2022-09-13,70044,70046,Blue,1,58527,58630,103
2022-07-18,70059,70039,Blue,0,57367,58349,982
2022-01-17,70051,70045,Blue,0,88613,88962,349
2022-10-17,70048,70050,Blue,1,47588,47647,59
2022-10-22,70055,70041,Blue,0,54789,55520,731
2022-06-15,70059,70039,Blue,0,27570,28677,1107
2022-03-01,70038,70052,Blue,1,60616,61385,769
2022-03-30,70047,70041,Blue,0,24237,24546,309
2022-08-18,70055,70043,Blue,0,32419,33113,694
2022-12-06,70040,70056,Blue,1,74866,75636,770
2022-06-25,70059,70047,Blue,0,81601,82153,552
2022-06-09,70057,70043,Blue,0,59221,60056,835
2022-11-05,70038,70052,Blue,1,51266,52028,762
2022-10-30,70059,70043,Blue,0,23063,23934,871
2022-01-09,70038,70058,Blue,1,78012,79008,996
2022-01-06,70047,70039,Blue,0,51952,52417,465
2022-09-28,70044,70060,Blue,1,43327,44211,884
2022-07-13,70057,70838,Blue,0,34007,35083,1076
2022-01-26,70046,70050,Blue,1,76156,76333,177
2022-02-11,70053,70043,Blue,0,80366,81071,705
2022-04-06,70038,70060,Blue,1,23953,25119,1166
2022-12-15,70042,70046,Blue,1,32539,32767,228
2022-07-05,70038,70046,Blue,1,37639,38025,386
2022-06-30,70050,70056,Blue,1,41695,41991,296
2022-04-15,70046,70052,Blue,1,39152,39558,406
2022-01-15,70039,70838,Blue,0,76373,76409,36
2022-03-21,70046,70050,Blue,1,53261,53434,173
2022-08-09,70054,70056,Blue,1,78620,78667,47
2022-11-10,70042,70054,Blue,1,39018,39727,709
2022-09-03,70046,70052,Blue,1,26004,26340,336
2022-02-21,70052,70058,Blue,1,49924,50164,240
2022-03-08,70048,70058,Blue,1,29820,30285,465
2022-12-16,70055,70049,Blue,0,66195,66481,286
2022-04-13,70053,70051,Blue,0,29042,29095,53
2022-10-03,70051,70049,Blue,0,44103,44218,115
2022-07-31,70045,70041,Blue,0,52553,52751,198
2022-07-07,70053,70838,Blue,0,51011,51936,925
2022-08-20,70047,70043,Blue,0,60228,60472,244
2022-04-05,70048,70058,Blue,1,31996,32543,547
2022-03-10,70053,70039,Blue,0,50065,50889,824
2022-02-25,70059,70043,Blue,0,63791,64646,855
2022-05-18,70044,70056,Blue,1,61041,61876,835
2022-03-21,70059,70041,Blue,0,65896,66940,1044
2022-07-01,70050,70060,Blue,1,67041,67605,564
2022-01-19,70040,70048,Blue,1,70995,71375,380
2022-01-31,70048,70054,Blue,1,33874,34226,352
2022-01-17,70042,70050,Blue,1,71368,71783,415
2022-04-06,70055,70041,Blue,0,66091,66889,798
2022-03-17,70040,70046,Blue,1,62594,62851,257
2022-11-04,70052,70060,Blue,1,22739,23143,404
2022-05-18,70045,70838,Blue,0,56082,56472,390
2022-10-05,70059,70055,Blue,0,47833,47978,145
2022-12-16,70057,70039,Blue,0,76538,77486,948
2022-10-18,70054,70060,Blue,1,50608,50859,251
2022-11-30,70038,70042,Blue,1,33191,33283,92
2022-11-02,70056,70060,Blue,1,33220,33400,180
2022-06-07,70047,70045,Blue,0,54982,55081,99
2022-12-09,70038,70046,Blue,1,23194,23509,315
2022-03-25,70051,70838,Blue,0,28218,28907,689
2022-03-26,70042,70056,Blue,1,60660,61464,804
2022-11-30,70053,70043,Blue,0,29033,29616,583
2022-12-25,70043,70041,Blue,0,85559,85589,30
2022-03-08,70038,70060,Blue,1,23094,24274,1180
2022-10-18,70047,70838,Blue,0,27437,28022,585
2022-01-08,70051,70043,Blue,0,29600,30069,469
2022-08-05,70052,70060,Blue,1,32053,32405,352
2022-11-04,70049,70041,Blue,0,33035,33507,472
2022-12-28,70059,70838,Blue,0,81810,82878,1068
2022-03-07,70047,70838,Blue,0,75529,76020,491
2022-04-22,70055,70043,Blue,0,65480,66179,699
2022-03-12,70046,70052,Blue,1,62439,62771,332
2022-07-30,70043,70039,Blue,0,53932,54044,112
2022-11-14,70047,70043,Blue,0,36859,37092,233
2022-11-03,70040,70056,Blue,1,70577,71392,815
2022-07-12,70057,70045,Blue,0,28980,29668,688
2022-03-06,70043,70041,Blue,0,77970,77999,29
2022-07-09,70055,70045,Blue,0,87555,88064,509
2022-08-10,70040,70058,Blue,1,76351,77219,868
2022-04-16,70038,70050,Blue,1,77956,78498,542
2022-07-13,70051,70049,Blue,0,40298,40406,108
2022-08-19,70040,70054,Blue,1,34606,35382,776
2022-02-25,70059,70041,Blue,0,60190,61092,902
2022-02-03,70040,70044,Blue,1,56755,56943,188
2022-03-19,70051,70043,Blue,0,71168,71656,488
2022-11-03,70039,70838,Blue,0,55114,55192,78
2022-05-25,70040,70044,Blue,1,34990,35089,99
2022-10-19,70055,70051,Blue,0,66773,66914,141
2022-03-23,70038,70046,Blue,1,50774,51133,359
2022-10-08,70047,70045,Blue,0,58984,59077,93
2022-06-06,70049,70047,Blue,0,54989,55062,73
2022-06-27,70043,70838,Blue,0,28333,28570,237
2022-10-18,70051,70043,Blue,0,83174,83654,480
2022-12-13,70046,70058,Blue,1,32713,33322,609
2022-10-28,70051,70041,Blue,0,60894,61500,606
2022-03-13,70056,70058,Blue,1,80067,80137,70
2022-06-19,70059,70053,Blue,0,22277,22552,275
2022-12-31,70043,70838,Blue,0,55971,56172,201
2022-01-11,70047,70041,Blue,0,21996,22372,376
2022-08-18,70051,70838,Blue,0,33902,34769,867
2022-10-25,70057,70045,Blue,0,26851,27541,690
2022-04-05,70046,70056,Blue,1,34788,35288,500
2022-07-23,70059,70057,Blue,0,82663,82711,48
2022-06-24,70055,70039,Blue,0,28780,29741,961
2022-08-30,70040,70044,Blue,1,73636,73733,97
2022-12-11,70040,70056,Blue,1,41057,41859,802
2022-04-20,70046,70060,Blue,1,56324,57158,834
2022-09-28,70042,70048,Blue,1,53545,53866,321
2022-07-27,70042,70054,Blue,1,24491,25147,656
2022-05-24,70041,70838,Blue,0,54001,54125,124
2022-07-31,70047,70838,Blue,0,78213,78706,493
2022-12-26,70048,70060,Blue,1,50912,51490,578
2022-09-22,70055,70041,Blue,0,27402,28202,800
2022-01-22,70042,70060,Blue,1,84757,85665,908
2022-03-28,70052,70060,Blue,1,48351,48705,354
2022-09-02,70038,70042,Blue,1,38571,38592,21
2022-01-04,70055,70039,Blue,0,19002,19979,977
2022-09-07,70057,70055,Blue,0,19615,19684,69
2022-09-19,70057,70049,Blue,0,65857,66213,356
2022-02-17,70052,70056,Blue,1,86092,86226,134
2022-03-20,70048,70060,Blue,1,42175,42840,665
2022-03-09,70057,70043,Blue,0,26447,27371,924
2022-09-19,70055,70045,Blue,0,36072,36642,570
2022-04-20,70050,70060,Blue,1,31826,32346,520
2022-01-02,70048,70058,Blue,1,74721,75235,514
2022-12-12,70057,70838,Blue,0,28144,29323,1179
2022-04-02,70044,70048,Blue,1,22535,22776,241
2022-12-07,70051,70039,Blue,0,40853,41512,659
2022-04-08,70038,70042,Blue,1,55026,55108,82
2022-02-08,70057,70045,Blue,0,72690,73304,614
2022-02-15,70047,70045,Blue,0,81185,81274,89
2022-03-02,70059,70049,Blue,0,81734,82225,491
2022-03-17,70055,70041,Blue,0,21508,22258,750
2022-07-04,70054,70056,Blue,1,62530,62578,48
2022-03-21,70038,70046,Blue,1,34753,35074,321
2022-04-21,70059,70057,Blue,0,34694,34729,35
2022-08-21,70051,70039,Blue,0,35126,35798,672
2022-01-15,70047,70838,Blue,0,49805,50272,467
2022-06-16,70057,70051,Blue,0,26731,26972,241
2022-11-15,70051,70043,Blue,0,41445,41910,465
2022-02-21,70038,70050,Blue,1,39987,40578,591
2022-01-04,70055,70045,Blue,0,32251,32853,602
2022-11-18,70049,70043,Blue,0,25092,25444,352
2022-03-31,70042,70044,Blue,1,58822,58849,27
2022-12-31,70055,70053,Blue,0,23694,23741,47
2022-01-12,70048,70052,Blue,1,51359,51577,218
2022-01-14,70048,70056,Blue,1,58913,59304,391
2022-04-16,70044,70050,Blue,1,56457,56827,370
2022-01-22,70059,70838,Blue,0,38961,40095,1134
2022-01-05,70048,70060,Blue,1,31030,32108,1078
2022-08-10,70057,70045,Blue,0,20916,21540,624
2022-12-29,70038,70044,Blue,1,66023,66213,190
2022-02-10,70048,70056,Blue,1,45732,46141,409
2022-02-05,70042,70044,Blue,1,64356,64387,31
2022-01-26,70040,70056,Blue,1,57202,58113,911
2022-02-03,70057,70053,Blue,0,37051,37240,189
2022-02-12,70038,70040,Blue,1,30728,30745,17
2022-11-19,70048,70060,Blue,1,52386,53011,625
2022-07-05,70041,70838,Blue,0,74258,74363,105
2022-07-30,70045,70039,Blue,0,45107,45402,295
2022-01-19,70059,70049,Blue,0,61396,61854,458
2022-10-03,70059,70051,Blue,0,54119,54450,331
2022-06-07,70047,70039,Blue,0,54982,55452,470
2022-12-30,70048,70056,Blue,1,21994,22406,412
2022-01-24,70059,70039,Blue,0,51554,52585,1031
2022-04-18,70052,70054,Blue,1,42859,42912,53
2022-07-25,70038,70046,Blue,1,23959,24273,314
2022-08-07,70049,70041,Blue,0,85194,85576,382
2022-01-12,70057,70041,Blue,0,36595,37572,977
2022-02-06,70050,70052,Blue,1,52706,52823,117
2022-02-05,70054,70056,Blue,1,25053,25103,50
2022-07-18,70055,70051,Blue,0,56262,56395,133
2022-04-09,70040,70060,Blue,1,82987,84095,1108
2022-03-10,70044,70048,Blue,1,58261,58483,222
2022-07-25,70051,70047,Blue,0,18795,19059,264
2022-10-13,70057,70047,Blue,0,43779,44465,686
2022-02-02,70055,70043,Blue,0,73396,74238,842
2022-02-14,70040,70060,Blue,1,67982,68978,996
2022-07-27,70047,70041,Blue,0,78992,79302,310
2022-01-02,70047,70041,Blue,0,67433,67745,312
2022-02-14,70039,70838,Blue,0,79490,79525,35
2022-01-25,70047,70043,Blue,0,66486,66735,249
2022-01-03,70047,70041,Blue,0,52485,52808,323
2022-08-21,70055,70049,Blue,0,50777,51045,268
2022-06-15,70048,70050,Blue,1,66694,66753,59
2022-09-08,70048,70054,Blue,1,29951,30268,317
2022-10-20,70040,70058,Blue,1,29224,30096,872
2022-01-14,70047,70045,Blue,0,25575,25672,97
2022-06-15,70047,70838,Blue,0,68187,68715,528
2022-09-17,70043,70838,Blue,0,76660,76868,208
2022-10-07,70047,70041,Blue,0,49454,49760,306
2022-11-20,70046,70054,Blue,1,85029,85442,413
2022-04-23,70044,70052,Blue,1,89330,89815,485
2022-05-18,70042,70052,Blue,1,27508,28221,713
2022-01-15,70044,70046,Blue,1,25164,25274,110
2022-03-26,70040,70056,Blue,1,30265,31086,821
2022-02-13,70059,70055,Blue,0,46277,46429,152
2022-12-25,70053,70039,Blue,0,26502,27185,683
2022-06-18,70050,70060,Blue,1,49970,50485,515
2022-11-15,70049,70039,Blue,0,64742,65225,483
2022-02-27,70057,70049,Blue,0,70121,70551,430
2022-09-12,70047,70045,Blue,0,70522,70609,87
2022-04-03,70040,70050,Blue,1,45674,46217,543
2022-02-15,70057,70049,Blue,0,62366,62795,429
2022-07-21,70059,70057,Blue,0,46338,46374,36
2022-06-27,70038,70050,Blue,1,59530,60214,684
2022-05-20,70050,70058,Blue,1,61231,61657,426
2022-07-20,70038,70042,Blue,1,30265,30355,90
2022-01-08,70047,70041,Blue,0,46653,46961,308
2022-05-17,70050,70054,Blue,1,25625,25833,208
2022-07-22,70042,70048,Blue,1,56027,56741,714
2022-03-01,70040,70046,Blue,1,75933,76218,285
2022-10-29,70053,70049,Blue,0,35454,35646,192
2022-02-25,70040,70060,Blue,1,80379,81401,1022
2022-11-28,70040,70060,Blue,1,38659,39831,1172
2022-02-12,70038,70048,Blue,1,28067,28486,419
2022-11-16,70057,70049,Blue,0,36028,36429,401
2022-05-31,70040,70046,Blue,1,43362,43703,341
2022-08-18,70049,70043,Blue,0,35880,36237,357
2022-08-01,70059,70057,Blue,0,52527,52564,37
2022-09-04,70038,70050,Blue,1,76942,77508,566
2022-10-14,70042,70054,Blue,1,71738,72459,721
2022-07-26,70038,70048,Blue,1,20894,21322,428
2022-04-18,70053,70047,Blue,0,28425,28746,321
2022-07-09,70046,70052,Blue,1,57645,57978,333
2022-12-12,70043,70039,Blue,0,77430,77525,95
2022-03-07,70043,70041,Blue,0,50177,50205,28
2022-02-23,70040,70046,Blue,1,59619,59887,268
2022-04-12,70059,70057,Blue,0,32372,32415,43
2022-03-27,70045,70041,Blue,0,75105,75258,153
2022-10-02,70056,70058,Blue,1,60594,60663,69
2022-09-15,70058,70060,Blue,1,73007,73101,94
2022-02-19,70044,70050,Blue,1,46624,46963,339
2022-07-19,70053,70043,Blue,0,85388,85972,584
2022-06-11,70048,70060,Blue,1,54500,55101,601
2022-12-13,70059,70057,Blue,0,37350,37384,34
2022-09-28,70040,70052,Blue,1,51081,51695,614
2022-09-04,70055,70053,Blue,0,85692,85738,46
2022-06-15,70040,70052,Blue,1,25800,26466,666
2022-11-22,70038,70048,Blue,1,79392,79825,433
2022-01-20,70049,70043,Blue,0,51739,52182,443
2022-08-31,70053,70041,Blue,0,57984,58620,636
2022-06-29,70055,70041,Blue,0,51100,51880,780
2022-02-25,70053,70041,Blue,0,36523,37294,771
2022-07-27,70059,70039,Blue,0,60313,61400,1087
2022-02-02,70042,70048,Blue,1,32491,32868,377
2022-08-28,70038,70060,Blue,1,67778,68885,1107
2022-09-20,70059,70049,Blue,0,63438,63902,464
2022-11-03,70055,70049,Blue,0,60742,61027,285
2022-11-06,70047,70039,Blue,0,34591,35001,410
2022-12-27,70046,70058,Blue,1,58145,58812,667
2022-03-26,70059,70041,Blue,0,34096,35030,934
2022-08-31,70044,70058,Blue,1,85983,86804,821
2022-06-10,70052,70054,Blue,1,62843,62902,59
2022-09-11,70042,70052,Blue,1,30146,30685,539
2022-10-14,70051,70838,Blue,0,49506,50187,681
2022-03-30,70042,70058,Blue,1,24428,25369,941
2022-10-10,70047,70838,Blue,0,77563,78015,452
2022-12-26,70047,70041,Blue,0,36836,37160,324
2022-12-27,70055,70045,Blue,0,34574,35143,569
2022-07-14,70041,70039,Blue,0,38317,38351,34
2022-01-13,70056,70058,Blue,1,62168,62245,77
2022-09-11,70057,70049,Blue,0,47965,48355,390
2022-03-01,70046,70054,Blue,1,25830,26269,439
2022-04-08,70054,70058,Blue,1,29332,29485,153
2022-08-07,70057,70055,Blue,0,41553,41621,68
2022-06-15,70044,70056,Blue,1,63083,63873,790
2022-03-08,70042,70046,Blue,1,65677,65847,170
2022-08-15,70040,70042,Blue,1,35410,35441,31
2022-07-18,70047,70045,Blue,0,75484,75574,90
2022-11-04,70059,70057,Blue,0,74356,74391,35
2022-09-08,70059,70041,Blue,0,61906,62971,1065
2022-11-10,70043,70041,Blue,0,25506,25535,29
2022-11-08,70046,70048,Blue,1,58563,58636,73
2022-08-07,70051,70838,Blue,0,59664,60426,762
2022-04-17,70043,70838,Blue,0,37875,38100,225
2022-06-10,70058,70060,Blue,1,64329,64516,187
2022-11-17,70038,70042,Blue,1,26391,26525,134
2022-07-26,70040,70048,Blue,1,69042,69439,397
2022-04-20,70038,70054,Blue,1,72972,73900,928
2022-06-13,70059,70838,Blue,0,62596,63741,1145
2022-09-25,70038,70058,Blue,1,56431,57665,1234
2022-04-06,70051,70049,Blue,0,54724,54826,102
2022-07-31,70042,70052,Blue,1,37835,38418,583
2022-09-19,70043,70039,Blue,0,39415,39518,103
2022-11-29,70044,70060,Blue,1,30059,30937,878
2022-08-26,70054,70056,Blue,1,39761,39808,47
2022-01-16,70052,70056,Blue,1,78258,78400,142
2022-07-30,70040,70046,Blue,1,58511,58798,287
2022-03-23,70043,70838,Blue,0,41460,41725,265
2022-11-04,70049,70043,Blue,0,46816,47203,387
2022-03-05,70049,70045,Blue,0,53484,53665,181
2022-10-05,70049,70041,Blue,0,71753,72161,408
2022-10-24,70040,70052,Blue,1,42269,42909,640
2022-02-08,70050,70056,Blue,1,56559,56854,295
2022-08-16,70042,70046,Blue,1,77454,77649,195
2022-08-23,70048,70056,Blue,1,34563,34966,403
2022-04-01,70041,70039,Blue,0,44768,44801,33
2022-07-22,70038,70052,Blue,1,55063,56669,1606
2022-12-27,70050,70054,Blue,1,74170,74414,244
2022-07-26,70055,70039,Blue,0,62125,62948,823
2022-04-15,70042,70050,Blue,1,47181,47653,472
2022-04-01,70044,70048,Blue,1,62447,62679,232
2022-12-08,70053,70041,Blue,0,27757,28446,689
2022-02-08,70042,70054,Blue,1,59734,60418,684
2022-10-26,70059,70055,Blue,0,24963,25121,158
2022-04-09,70051,70049,Blue,0,76172,76277,105
2022-12-28,70050,70054,Blue,1,23797,24028,231
2022-04-13,70055,70053,Blue,0,27155,27202,47
2022-07-05,70038,70042,Blue,1,40878,40990,112
2022-04-06,70055,70041,Blue,0,81910,82638,728
2022-10-20,70057,70039,Blue,0,23923,24859,936
2022-03-19,70055,70838,Blue,0,68286,69126,840
2022-03-31,70057,70838,Blue,0,64469,65432,963
2022-08-05,70052,70054,Blue,1,42127,42200,73
2022-11-04,70045,70838,Blue,0,45436,45769,333
2022-04-18,70042,70060,Blue,1,79382,80404,1022
2022-03-24,70038,70058,Blue,1,78577,79683,1106
2022-06-30,70051,70041,Blue,0,51989,52577,588
2022-08-26,70045,70039,Blue,0,69161,69419,258
2022-12-22,70057,70047,Blue,0,34366,34912,546
2022-07-22,70052,70056,Blue,1,49139,49293,154
2022-02-01,70047,70043,Blue,0,45016,45344,328
2022-03-31,70051,70043,Blue,0,43555,44045,490
2022-07-22,70057,70055,Blue,0,61745,61814,69
2022-12-12,70044,70048,Blue,1,33493,33752,259
2022-04-24,70047,70045,Blue,0,37463,37560,97
2022-04-15,70048,70060,Blue,1,46865,47462,597
2022-10-18,70052,70060,Blue,1,40503,40853,350
2022-09-29,70059,70043,Blue,0,66309,67309,1000
2022-02-25,70047,70838,Blue,0,31172,31745,573
2022-11-22,70059,70045,Blue,0,51526,52242,716
2022-05-28,70048,70052,Blue,1,33817,34090,273
2022-10-21,70057,70041,Blue,0,36547,37396,849
2022-09-01,70048,70056,Blue,1,51478,51940,462
2022-03-01,70043,70039,Blue,0,53006,53122,116
2022-05-10,70054,70056,Blue,1,84660,84710,50
2022-09-12,70052,70056,Blue,1,63558,63700,142
2022-02-09,70046,70058,Blue,1,27943,28647,704
2022-04-14,70057,70838,Blue,0,43905,45257,1352
2022-09-04,70055,70041,Blue,0,51315,52072,757
2022-06-19,70046,70052,Blue,1,75686,76021,335
2022-02-10,70038,70050,Blue,1,88510,89176,666
2022-04-19,70040,70046,Blue,1,31232,31500,268
2022-08-06,70040,70060,Blue,1,36737,37773,1036
2022-09-06,70055,70043,Blue,0,46165,46933,768
2022-01-18,70040,70054,Blue,1,62908,63722,814
2022-03-25,70043,70039,Blue,0,69361,69467,106
2022-02-03,70059,70039,Blue,0,31455,32627,1172
2022-12-20,70053,70838,Blue,0,72994,73787,793
2022-10-03,70049,70043,Blue,0,31516,31890,374
2022-07-08,70057,70051,Blue,0,79480,79717,237
2022-03-07,70040,70052,Blue,1,57511,58188,677
2022-12-16,70050,70060,Blue,1,80164,80662,498
2022-07-02,70053,70039,Blue,0,52188,53008,820
2022-06-14,70038,70046,Blue,1,50783,51168,385
2022-08-15,70055,70053,Blue,0,23597,23643,46
2022-01-05,70045,70838,Blue,0,60114,60431,317
2022-01-17,70057,70055,Blue,0,74131,74200,69
2022-04-18,70055,70043,Blue,0,26544,27238,694
2022-12-04,70059,70041,Blue,0,24065,25509,1444
2022-01-18,70049,70043,Blue,0,22222,22593,371
2022-07-21,70041,70838,Blue,0,60762,60884,122
2022-10-30,70049,70041,Blue,0,56523,56995,472
2022-12-24,70054,70056,Blue,1,26930,26978,48
2022-06-26,70040,70048,Blue,1,54092,54693,601
2022-12-17,70052,70060,Blue,1,59030,59411,381
2022-11-11,70053,70043,Blue,0,54356,54939,583
2022-09-16,70040,70058,Blue,1,71114,72055,941
2022-06-23,70049,70039,Blue,0,30693,31246,553
2022-03-31,70042,70052,Blue,1,42025,42639,614
2022-03-29,70041,70039,Blue,0,69414,69444,30
2022-03-16,70046,70058,Blue,1,28503,29100,597
2022-12-16,70042,70054,Blue,1,62870,63530,660
2022-07-05,70046,70048,Blue,1,74103,74184,81
2022-02-20,70054,70058,Blue,1,33313,33473,160
2022-02-01,70040,70060,Blue,1,89217,90176,959
2022-07-19,70053,70049,Blue,0,45001,45201,200
2022-07-05,70046,70052,Blue,1,54427,54747,320
2022-01-19,70044,70048,Blue,1,31297,31585,288
2022-11-16,70050,70060,Blue,1,62383,62929,546
2022-11-03,70040,70048,Blue,1,69027,69421,394
2022-01-21,70059,70041,Blue,0,84620,85618,998
2022-11-12,70042,70056,Blue,1,60725,61581,856
2022-06-14,70051,70838,Blue,0,75845,76550,705
2022-09-07,70051,70041,Blue,0,24216,24790,574
2022-07-18,70038,70058,Blue,1,58142,59214,1072
2022-09-06,70057,70838,Blue,0,29827,31000,1173
2022-03-12,70055,70838,Blue,0,81739,82646,907
2022-09-26,70053,70039,Blue,0,48266,49060,794
2022-04-13,70059,70053,Blue,0,23647,23872,225
2022-11-26,70038,70054,Blue,1,24326,25157,831
2022-09-13,70051,70049,Blue,0,86883,86986,103
2022-08-24,70055,70041,Blue,0,54208,54994,786
2022-01-27,70042,70056,Blue,1,58520,59222,702
2022-07-04,70038,70040,Blue,1,57533,57551,18
2022-12-14,70046,70058,Blue,1,31143,31780,637
2022-02-13,70059,70041,Blue,0,31663,32645,982
2022-10-29,70040,70048,Blue,1,41587,41991,404
2022-03-29,70042,70058,Blue,1,58513,59396,883
2022-02-25,70059,70055,Blue,0,22406,22579,173
2022-12-25,70046,70050,Blue,1,74064,74246,182
2022-08-19,70059,70051,Blue,0,54899,55226,327
2022-08-01,70042,70048,Blue,1,71737,72033,296
2022-09-19,70050,70054,Blue,1,32252,32463,211
2022-12-04,70051,70045,Blue,0,69315,69639,324
2022-07-09,70053,70049,Blue,0,64601,64796,195
2022-02-12,70050,70052,Blue,1,32398,32514,116
2022-06-26,70048,70050,Blue,1,78041,78098,57
2022-11-21,70051,70041,Blue,0,66367,66909,542
2022-02-11,70054,70060,Blue,1,55203,55487,284
2022-09-05,70045,70838,Blue,0,58930,59284,354
2022-05-11,70055,70047,Blue,0,59954,60372,418
2022-08-16,70051,70838,Blue,0,80926,81641,715
2022-02-21,70055,70043,Blue,0,35346,36071,725
2022-03-09,70038,70048,Blue,1,39180,39701,521
2022-03-27,70044,70056,Blue,1,76098,76758,660
2022-10-28,70059,70049,Blue,0,61583,62027,444
2022-08-11,70056,70060,Blue,1,49165,49349,184
2022-04-22,70047,70039,Blue,0,34476,34935,459
2022-03-17,70044,70056,Blue,1,44917,45624,707
2022-04-07,70045,70039,Blue,0,46361,46630,269
2022-07-28,70047,70039,Blue,0,28777,29197,420
2022-02-05,70059,70838,Blue,0,19524,20835,1311
2022-10-14,70044,70050,Blue,1,83597,83954,357
2022-12-30,70042,70050,Blue,1,26011,26423,412
2022-12-27,70048,70056,Blue,1,47496,47873,377
2022-02-16,70057,70047,Blue,0,47730,48213,483
2022-01-26,70045,70043,Blue,0,48532,48738,206
2022-03-26,70047,70039,Blue,0,64415,64822,407
2022-04-05,70057,70045,Blue,0,23446,24106,660
2022-07-13,70040,70056,Blue,1,25683,26507,824
2022-01-27,70055,70043,Blue,0,40092,40901,809
2022-01-03,70048,70052,Blue,1,21397,21599,202
2022-09-11,70040,70046,Blue,1,29290,29559,269
2022-12-22,70051,70043,Blue,0,73907,74408,501
2022-04-11,70040,70056,Blue,1,88384,89139,755
2022-07-31,70040,70048,Blue,1,86475,86852,377
2022-10-01,70054,70060,Blue,1,39660,39925,265
2022-03-11,70048,70050,Blue,1,44101,44159,58
2022-10-01,70054,70060,Blue,1,39176,39443,267
2022-03-11,70040,70046,Blue,1,52808,53052,244
2022-01-23,70050,70056,Blue,1,60745,61026,281
2022-08-03,70051,70041,Blue,0,84234,85033,799
2022-01-20,70059,70838,Blue,0,56594,57715,1121
2022-04-18,70055,70049,Blue,0,36378,36684,306
2022-09-23,70049,70838,Blue,0,34084,34761,677
2022-04-22,70045,70838,Blue,0,24716,25067,351
2022-12-31,70059,70045,Blue,0,55883,56598,715
2022-11-03,70059,70041,Blue,0,83595,84460,865
2022-08-22,70049,70045,Blue,0,46261,46453,192
2022-06-20,70050,70052,Blue,1,76875,76986,111
2022-02-11,70046,70052,Blue,1,80659,80989,330
2022-04-06,70040,70056,Blue,1,63800,64709,909
2022-07-19,70059,70039,Blue,0,63975,65010,1035
2022-09-27,70038,70054,Blue,1,67933,68743,810
2022-08-01,70051,70045,Blue,0,75237,75555,318
2022-06-19,70057,70049,Blue,0,46890,47259,369
2022-02-01,70055,70049,Blue,0,59171,59506,335
2022-09-03,70053,70047,Blue,0,63516,63813,297
2022-10-03,70051,70838,Blue,0,72178,72924,746
2022-08-16,70046,70058,Blue,1,53908,54543,635
2022-09-07,70056,70058,Blue,1,61100,61172,72
2022-11-09,70057,70047,Blue,0,56741,57232,491
2022-08-30,70048,70050,Blue,1,30166,30222,56
2022-05-21,70046,70052,Blue,1,67392,67749,357
2022-03-07,70048,70056,Blue,1,58863,59269,406
2022-02-08,70047,70045,Blue,0,36603,36711,108
2022-08-27,70050,70060,Blue,1,49165,49669,504
2022-07-14,70045,70838,Blue,0,52489,52932,443
2022-01-25,70051,70041,Blue,0,79304,79917,613
2022-12-25,70046,70048,Blue,1,78364,78448,84
2022-01-10,70040,70046,Blue,1,85041,85302,261
2022-05-18,70044,70046,Blue,1,57702,57837,135
2022-01-15,70042,70044,Blue,1,63133,63163,30
2022-03-15,70040,70046,Blue,1,74124,74377,253
2022-07-07,70040,70042,Blue,1,61281,61315,34
2022-04-16,70051,70041,Blue,0,33373,33981,608
2022-03-17,70044,70050,Blue,1,23567,23950,383
2022-09-09,70048,70050,Blue,1,72138,72194,56
2022-02-17,70040,70056,Blue,1,34619,35708,1089
2022-02-04,70039,70838,Blue,0,21008,21096,88
2022-04-16,70055,70051,Blue,0,45607,45746,139
2022-07-30,70055,70041,Blue,0,68841,69549,708
2022-04-05,70059,70041,Blue,0,30253,31189,936
2022-01-04,70051,70045,Blue,0,79325,79672,347
2022-12-09,70050,70056,Blue,1,24482,24818,336
2022-11-20,70059,70041,Blue,0,64104,64977,873
2022-01-07,70055,70049,Blue,0,55975,56303,328
2022-09-01,70040,70056,Blue,1,66464,67277,813
2022-07-30,70038,70058,Blue,1,78622,79689,1067
2022-10-20,70048,70052,Blue,1,64565,64786,221
2022-04-01,70048,70050,Blue,1,77560,77623,63
2022-06-24,70040,70048,Blue,1,86423,86911,488
2022-08-09,70044,70048,Blue,1,46557,46798,241
2022-03-10,70045,70043,Blue,0,42849,42937,88
2022-10-26,70052,70054,Blue,1,30389,30440,51
2022-03-22,70038,70058,Blue,1,87162,88175,1013
2022-02-10,70043,70041,Blue,0,55527,55560,33
2022-07-30,70059,70039,Blue,0,55157,56212,1055
2022-11-02,70049,70047,Blue,0,29930,29993,63
2022-09-30,70046,70054,Blue,1,65217,65688,471
2022-11-28,70055,70043,Blue,0,67752,68407,655
2022-10-07,70058,70060,Blue,1,81790,81862,72
2022-08-24,70056,70060,Blue,1,57867,58090,223
2022-11-28,70038,70058,Blue,1,22263,23273,1010
2022-03-30,70053,70049,Blue,0,67053,67247,194
2022-01-05,70047,70838,Blue,0,29393,30054,661
2022-11-11,70038,70052,Blue,1,68252,68960,708
2022-01-21,70052,70054,Blue,1,58784,58835,51
2022-12-18,70054,70060,Blue,1,26855,27084,229
2022-10-03,70042,70044,Blue,1,29633,29662,29
2022-08-29,70038,70048,Blue,1,53892,54371,479
2022-07-07,70041,70039,Blue,0,56666,56696,30
2022-09-25,70048,70054,Blue,1,61496,61826,330
2022-10-25,70055,70053,Blue,0,21040,21091,51
2022-07-23,70059,70057,Blue,0,56774,56814,40
2022-04-12,70053,70049,Blue,0,83746,83920,174
2022-03-22,70059,70045,Blue,0,87495,88176,681
2022-03-14,70050,70058,Blue,1,39754,40182,428
2022-03-04,70045,70041,Blue,0,84366,84554,188
2022-11-25,70040,70052,Blue,1,41314,41940,626
2022-07-31,70057,70041,Blue,0,48557,49435,878
2022-05-21,70053,70043,Blue,0,22447,23357,910
2022-10-17,70059,70838,Blue,0,34037,35419,1382
2022-04-03,70044,70046,Blue,1,37958,38066,108
2022-06-24,70057,70047,Blue,0,37579,38324,745
2022-08-27,70046,70056,Blue,1,65695,66212,517
2022-06-14,70055,70838,Blue,0,32276,33307,1031
2022-02-05,70046,70058,Blue,1,64054,64670,616
2022-12-04,70046,70060,Blue,1,51043,51770,727
2022-04-08,70040,70054,Blue,1,86068,86807,739
2022-07-20,70055,70039,Blue,0,34565,35393,828
2022-01-17,70042,70060,Blue,1,69801,70854,1053
2022-11-07,70038,70042,Blue,1,75278,75397,119
2022-06-30,70059,70043,Blue,0,23594,24509,915
2022-10-12,70041,70039,Blue,0,79990,80025,35
2022-07-10,70044,70046,Blue,1,35691,35823,132
2022-02-16,70057,70055,Blue,0,65714,65800,86
2022-04-06,70042,70052,Blue,1,22904,23526,622
2022-03-24,70038,70052,Blue,1,24903,25660,757
2022-08-01,70046,70060,Blue,1,87821,88529,708
2022-10-01,70056,70058,Blue,1,22587,22661,74
2022-04-21,70057,70051,Blue,0,52175,52430,255
2022-01-20,70055,70049,Blue,0,49959,50297,338
2022-10-05,70047,70041,Blue,0,23669,24030,361
2022-06-13,70054,70058,Blue,1,61000,61157,157
2022-10-27,70038,70048,Blue,1,24040,24500,460
2022-03-07,70044,70046,Blue,1,62187,62291,104
2022-07-02,70048,70050,Blue,1,34479,34540,61
2022-04-08,70050,70052,Blue,1,41526,41659,133
2022-09-13,70038,70052,Blue,1,56481,57227,746
2022-08-18,70059,70838,Blue,0,40563,41729,1166
2022-02-10,70051,70043,Blue,0,44247,44722,475
2022-07-14,70050,70052,Blue,1,56777,56893,116
2022-09-21,70052,70054,Blue,1,71217,71265,48
2022-05-12,70056,70058,Blue,1,49087,49162,75
2022-01-16,70044,70060,Blue,1,32579,33527,948
2022-06-30,70041,70838,Blue,0,49745,49873,128
2022-01-18,70053,70039,Blue,0,56250,56974,724
2022-06-24,70048,70050,Blue,1,41210,41284,74
2022-12-06,70056,70058,Blue,1,49728,49799,71
2022-01-23,70055,70047,Blue,0,71841,72213,372
2022-05-02,70052,70054,Blue,1,47720,47775,55
2022-01-03,70059,70043,Blue,0,53893,54739,846
2022-03-18,70057,70047,Blue,0,68567,69096,529
2022-02-27,70043,70041,Blue,0,80521,80549,28
2022-03-28,70052,70054,Blue,1,42786,42839,53
2022-08-30,70044,70058,Blue,1,29888,30668,780
2022-08-06,70050,70058,Blue,1,34559,34961,402
2022-11-22,70052,70058,Blue,1,84884,85132,248
2022-06-26,70057,70045,Blue,0,29376,29993,617
2022-02-17,70057,70049,Blue,0,80672,81078,406
2022-02-19,70053,70039,Blue,0,44065,44834,769
2022-01-23,70059,70047,Blue,0,53845,54479,634
2022-09-26,70048,70054,Blue,1,46662,46999,337
2022-07-03,70040,70056,Blue,1,81744,82642,898
2022-03-04,70043,70041,Blue,0,73633,73663,30
2022-03-12,70053,70045,Blue,0,77443,77950,507
2022-04-05,70059,70049,Blue,0,81735,82195,460
2022-09-27,70044,70060,Blue,1,78596,79492,896
2022-12-13,70041,70838,Blue,0,65972,66095,123
2022-01-16,70051,70045,Blue,0,46116,46449,333
2022-07-18,70038,70052,Blue,1,29231,29923,692
2022-07-01,70052,70058,Blue,1,34801,35061,260
2022-09-06,70044,70048,Blue,1,26156,26385,229
2022-10-31,70055,70053,Blue,0,42381,42427,46
2022-01-23,70054,70060,Blue,1,34022,34262,240
2022-07-12,70038,70042,Blue,1,71592,71697,105
2022-06-27,70039,70838,Blue,0,28778,28813,35
2022-04-19,70057,70039,Blue,0,50820,51823,1003
2022-04-10,70053,70047,Blue,0,71919,72218,299
2022-11-09,70038,70042,Blue,1,43512,43612,100
2022-06-26,70052,70056,Blue,1,56804,56954,150
2022-03-04,70046,70054,Blue,1,32181,32639,458
2022-02-09,70048,70050,Blue,1,36694,36753,59
2022-10-11,70048,70058,Blue,1,47661,48168,507
2022-11-03,70049,70045,Blue,0,43165,43358,193
2022-05-25,70049,70045,Blue,0,56803,57032,229
2022-09-28,70059,70043,Blue,0,40580,41461,881
2022-03-15,70043,70838,Blue,0,58368,58551,183
2022-10-28,70057,70041,Blue,0,68193,69096,903
2022-07-27,70050,70058,Blue,1,50333,50742,409
2022-06-16,70040,70048,Blue,1,26712,27157,445
2022-04-08,70059,70838,Blue,0,46626,47689,1063
2022-09-20,70053,70051,Blue,0,60036,60090,54
2022-06-24,70044,70056,Blue,1,52219,52935,716
2022-08-02,70051,70047,Blue,0,71115,71302,187
2022-07-12,70046,70050,Blue,1,56582,56796,214
2022-09-05,70046,70050,Blue,1,61685,61866,181
2022-06-16,70050,70058,Blue,1,32134,32700,566
2022-09-11,70038,70042,Blue,1,67207,67302,95
2022-02-21,70040,70052,Blue,1,78688,79363,675
2022-07-28,70048,70060,Blue,1,65273,65925,652
2022-08-25,70043,70041,Blue,0,32041,32071,30
2022-07-05,70052,70058,Blue,1,82109,82406,297
2022-08-04,70059,70041,Blue,0,82160,83052,892
2022-06-13,70050,70052,Blue,1,34765,34891,126
2022-08-13,70059,70043,Blue,0,66495,67349,854
2022-04-01,70053,70039,Blue,0,33228,33967,739
2022-04-05,70057,70053,Blue,0,48276,48424,148
2022-08-16,70048,70060,Blue,1,32701,33356,655
2022-12-06,70055,70045,Blue,0,52157,52684,527
2022-08-26,70055,70053,Blue,0,82935,82981,46
2022-04-22,70047,70043,Blue,0,58368,58605,237
2022-07-14,70038,70048,Blue,1,65968,66453,485
2022-12-24,70051,70045,Blue,0,56595,56933,338
2022-08-13,70054,70058,Blue,1,27179,27332,153
2022-01-06,70038,70052,Blue,1,88338,89091,753
2022-10-12,70050,70058,Blue,1,83331,83755,424
2022-01-06,70053,70043,Blue,0,67462,67996,534
2022-05-19,70038,70040,Blue,1,60886,60902,16
2022-10-21,70051,70045,Blue,0,51479,51818,339
2022-11-23,70040,70060,Blue,1,37344,38463,1119
2022-09-18,70059,70039,Blue,0,51677,52688,1011
2022-03-09,70055,70838,Blue,0,35413,36284,871
2022-01-22,70059,70041,Blue,0,53169,54109,940
2022-08-19,70038,70042,Blue,1,39672,39783,111
2022-12-01,70040,70044,Blue,1,65534,65712,178
2022-01-25,70055,70045,Blue,0,53301,53902,601
2022-03-12,70038,70056,Blue,1,26956,27829,873
2022-09-26,70057,70045,Blue,0,68736,69422,686
2022-04-04,70038,70056,Blue,1,67336,68310,974
2022-11-23,70038,70058,Blue,1,50767,51839,1072
2022-10-21,70055,70051,Blue,0,44904,45059,155
2022-03-25,70049,70045,Blue,0,61902,62093,191
2022-08-29,70048,70050,Blue,1,32108,32168,60
2022-12-23,70038,70046,Blue,1,26680,26996,316
2022-05-20,70038,70046,Blue,1,86248,86626,378
2022-01-26,70042,70056,Blue,1,40304,41127,823
2022-10-24,70055,70041,Blue,0,63852,64608,756
2022-01-03,70038,70046,Blue,1,65544,65861,317
2022-11-02,70044,70060,Blue,1,71335,72243,908
2022-11-11,70051,70838,Blue,0,47646,48356,710
2022-12-28,70059,70053,Blue,0,74554,74775,221
2022-12-31,70054,70056,Blue,1,91078,91126,48
2022-11-11,70044,70050,Blue,1,50481,50817,336
2022-03-16,70048,70056,Blue,1,64330,64747,417
2022-03-29,70038,70060,Blue,1,26669,27834,1165
2022-10-22,70038,70044,Blue,1,26947,27108,161
2022-04-22,70059,70049,Blue,0,80056,80531,475
2022-03-12,70055,70041,Blue,0,62346,63056,710
2022-02-07,70055,70041,Blue,0,31947,32774,827
2022-01-27,70048,70052,Blue,1,21182,21608,426
2022-07-11,70042,70060,Blue,1,24979,26008,1029
2022-03-30,70050,70054,Blue,1,24218,24427,209
2022-09-16,70049,70041,Blue,0,23548,24029,481
2022-02-13,70045,70043,Blue,0,75151,75267,116
2022-03-19,70052,70060,Blue,1,53677,54029,352
2022-02-01,70057,70045,Blue,0,31551,32269,718
2022-06-03,70047,70041,Blue,0,24751,25162,411
2022-10-03,70048,70058,Blue,1,79469,79984,515
2022-03-29,70043,70041,Blue,0,82654,82682,28
2022-10-28,70044,70054,Blue,1,43260,43880,620
2022-09-13,70050,70058,Blue,1,63346,63779,433
2022-01-05,70040,70046,Blue,1,85671,85947,276
2022-10-16,70048,70054,Blue,1,82219,82528,309
2022-01-09,70053,70039,Blue,0,82485,83199,714
2022-08-10,70053,70051,Blue,0,42559,42614,55
2022-05-29,70049,70047,Blue,0,33998,34055,57
2022-11-23,70057,70838,Blue,0,48439,49432,993
2022-07-16,70042,70044,Blue,1,53106,53141,35
2022-06-15,70038,70046,Blue,1,47532,47886,354
2022-08-24,70043,70838,Blue,0,40121,40325,204
2022-03-24,70038,70040,Blue,1,54311,54326,15
2022-11-29,70055,70049,Blue,0,69342,69610,268
2022-12-13,70055,70047,Blue,0,29376,29771,395
2022-10-30,70040,70054,Blue,1,74283,75037,754
2022-11-22,70057,70053,Blue,0,60496,60641,145
2022-05-31,70040,70042,Blue,1,61871,61904,33
2022-02-16,70055,70045,Blue,0,78482,79101,619
2022-03-11,70038,70056,Blue,1,80833,81752,919
2022-10-14,70039,70838,Blue,0,31394,31431,37
2022-11-07,70040,70044,Blue,1,50616,50728,112
2022-03-14,70059,70838,Blue,0,78312,79392,1080
2022-07-26,70059,70053,Blue,0,30566,30810,244
2022-05-20,70058,70060,Blue,1,58253,58332,79
2022-04-01,70038,70060,Blue,1,35386,36527,1141
2022-07-23,70059,70043,Blue,0,86543,87404,861
2022-03-12,70057,70039,Blue,0,59554,60492,938
2022-04-14,70043,70039,Blue,0,55463,55591,128
2022-08-02,70044,70050,Blue,1,34316,34665,349
2022-02-08,70054,70060,Blue,1,61622,61924,302
2022-07-03,70046,70060,Blue,1,60615,61369,754
2022-05-22,70045,70039,Blue,0,69592,69876,284
2022-02-13,70046,70048,Blue,1,73543,73617,74
2022-03-03,70056,70058,Blue,1,89384,89467,83
2022-09-14,70050,70060,Blue,1,43157,43825,668
2022-07-21,70055,70838,Blue,0,46047,47018,971
2022-10-05,70059,70049,Blue,0,40163,40639,476
2022-09-10,70057,70041,Blue,0,61721,62679,958
2022-08-15,70051,70047,Blue,0,67431,67620,189
2022-02-03,70050,70058,Blue,1,32197,32674,477
2022-03-14,70059,70043,Blue,0,57489,58428,939
2022-07-03,70046,70048,Blue,1,24169,24248,79
2022-01-25,70053,70838,Blue,0,21992,22886,894
2022-07-09,70038,70042,Blue,1,80592,80709,117
2022-05-10,70049,70047,Blue,0,29415,29467,52
2022-12-31,70038,70046,Blue,1,59790,60114,324
2022-06-12,70044,70054,Blue,1,34948,35612,664
2022-09-23,70040,70054,Blue,1,72154,72891,737
2022-08-08,70045,70838,Blue,0,55719,56079,360
2022-08-06,70056,70060,Blue,1,34887,35065,178
2022-06-28,70038,70044,Blue,1,60672,60867,195
2022-03-11,70052,70054,Blue,1,60021,60074,53
2022-11-14,70057,70041,Blue,0,44898,45778,880
2022-09-21,70040,70058,Blue,1,27105,28083,978
2022-03-12,70053,70838,Blue,0,36075,36945,870
2022-04-08,70055,70049,Blue,0,37794,38096,302
2022-08-18,70055,70838,Blue,0,41591,42652,1061
2022-03-15,70057,70055,Blue,0,53973,54043,70
2022-12-10,70040,70056,Blue,1,66428,67258,830
2022-08-12,70048,70058,Blue,1,23690,24216,526
2022-05-11,70052,70054,Blue,1,44000,44051,51
2022-03-16,70053,70047,Blue,0,55349,55626,277
2022-10-30,70038,70060,Blue,1,73164,74339,1175
2022-07-31,70048,70058,Blue,1,62863,63402,539
2022-02-07,70055,70047,Blue,0,53853,54369,516
2022-02-08,70055,70043,Blue,0,59481,60294,813
2022-10-18,70044,70048,Blue,1,28575,28820,245
2022-11-24,70040,70042,Blue,1,43076,43112,36
2022-12-20,70038,70052,Blue,1,53052,53748,696
2022-01-04,70047,70838,Blue,0,23456,24012,556
2022-07-03,70044,70058,Blue,1,47065,47858,793
2022-09-29,70056,70058,Blue,1,38606,38676,70
2022-03-25,70044,70046,Blue,1,32284,32393,109
2022-06-12,70053,70049,Blue,0,33498,33702,204
2022-02-09,70055,70838,Blue,0,77944,78792,848
2022-06-01,70047,70838,Blue,0,64631,65213,582
2022-06-15,70038,70046,Blue,1,74679,75045,366
2022-02-20,70044,70046,Blue,1,34893,34994,101
2022-03-02,70050,70056,Blue,1,47565,47904,339
2022-08-18,70040,70050,Blue,1,59867,60381,514
2022-08-26,70045,70838,Blue,0,22918,23297,379
2022-12-20,70041,70039,Blue,0,44598,44631,33
2022-09-12,70050,70052,Blue,1,58399,58511,112
2022-12-04,70050,70060,Blue,1,70572,71131,559
2022-03-06,70044,70052,Blue,1,75511,76001,490
2022-06-10,70050,70052,Blue,1,20444,20569,125
2022-11-15,70055,70838,Blue,0,24856,25787,931
2022-12-31,70044,70054,Blue,1,66181,66798,617
2022-11-17,70057,70053,Blue,0,23098,23270,172
2022-01-10,70047,70838,Blue,0,27345,33140,5795
2022-06-20,70051,70041,Blue,0,40038,40618,580
2022-04-03,70047,70043,Blue,0,32263,32508,245
2022-03-03,70042,70046,Blue,1,68740,68904,164
2022-08-24,70046,70054,Blue,1,59354,59783,429
2022-04-15,70042,70060,Blue,1,50954,51972,1018
2022-01-07,70044,70060,Blue,1,81040,82067,1027
2022-03-24,70038,70046,Blue,1,43082,43398,316
2022-03-02,70040,70046,Blue,1,60799,61098,299
2022-01-31,70048,70058,Blue,1,53898,54600,702
2022-09-03,70040,70056,Blue,1,85598,86488,890
2022-02-12,70046,70050,Blue,1,72676,72857,181
2022-03-10,70041,70838,Blue,0,86101,86216,115
2022-02-18,70056,70058,Blue,1,41014,41084,70
2022-04-22,70042,70046,Blue,1,35268,35461,193
2022-09-27,70053,70838,Blue,0,34422,35340,918
2022-12-02,70055,70838,Blue,0,30764,31682,918
2022-11-21,70059,70053,Blue,0,34395,34644,249
2022-07-01,70048,70054,Blue,1,33004,33322,318
2022-11-26,70042,70054,Blue,1,66079,66716,637
2022-09-24,70048,70052,Blue,1,42553,42752,199
2022-04-17,70055,70041,Blue,0,24836,25592,756
2022-12-29,70052,70054,Blue,1,73029,73094,65
2022-02-10,70042,70046,Blue,1,87279,87445,166
2022-01-02,70038,70056,Blue,1,89790,91784,1994
2022-03-13,70055,70049,Blue,0,32591,32865,274
2022-07-18,70052,70060,Blue,1,28692,29069,377
2022-03-12,70046,70060,Blue,1,76483,77316,833
2022-07-16,70043,70039,Blue,0,53384,53493,109
2022-03-25,70050,70058,Blue,1,69599,70259,660
2022-09-06,70057,70055,Blue,0,27887,27958,71
2022-02-22,70039,70838,Blue,0,55282,55317,35
2022-12-07,70042,70048,Blue,1,73757,74056,299
2022-03-01,70055,70838,Blue,0,83041,83849,808
2022-04-15,70048,70060,Blue,1,35011,35782,771
2022-06-08,70038,70048,Blue,1,33471,33992,521
2022-12-28,70044,70058,Blue,1,63654,64479,825
2022-01-16,70047,70838,Blue,0,83602,84112,510
2022-02-26,70045,70838,Blue,0,26755,27095,340
2022-01-18,70050,70058,Blue,1,68315,68816,501
2022-07-30,70045,70043,Blue,0,58631,58720,89
2022-12-10,70044,70060,Blue,1,57619,58519,900
2022-02-14,70047,70041,Blue,0,87487,87840,353
2022-12-18,70053,70045,Blue,0,46008,46441,433
2022-12-01,70059,70039,Blue,0,33379,34460,1081
2022-01-04,70042,70054,Blue,1,25271,25867,596
2022-06-20,70059,70045,Blue,0,62562,63280,718
2022-11-21,70059,70043,Blue,0,28756,29622,866
2022-01-03,70044,70058,Blue,1,66763,67545,782
2022-03-25,70041,70838,Blue,0,28554,28677,123
2022-09-15,70054,70058,Blue,1,58789,58960,171
2022-09-29,70052,70060,Blue,1,66217,66606,389
2022-04-06,70047,70045,Blue,0,24274,24375,101
2022-01-23,70045,70043,Blue,0,89042,89185,143
2022-04-11,70044,70060,Blue,1,49423,50293,870
2022-02-15,70045,70039,Blue,0,50559,50880,321
2022-09-08,70045,70039,Blue,0,24222,24528,306
2022-12-13,70055,70039,Blue,0,43959,44808,849
2022-04-11,70044,70048,Blue,1,73708,73926,218
2022-03-22,70049,70045,Blue,0,77103,77286,183
2022-10-29,70048,70052,Blue,1,31805,32017,212
2022-08-26,70038,70046,Blue,1,52950,53268,318
2022-09-02,70038,70050,Blue,1,43595,44183,588
2022-03-17,70058,70060,Blue,1,29198,29328,130
2022-07-31,70057,70041,Blue,0,87389,88244,855
2022-12-20,70038,70048,Blue,1,30429,30938,509
2022-11-07,70057,70039,Blue,0,66120,67068,948
2022-02-11,70044,70046,Blue,1,72733,72836,103
2022-07-28,70055,70053,Blue,0,55817,55864,47
2022-11-03,70057,70039,Blue,0,75448,76315,867
2022-04-23,70044,70052,Blue,1,38550,39055,505
2022-07-16,70050,70052,Blue,1,54627,54736,109
2022-08-04,70042,70060,Blue,1,55097,56121,1024
2022-12-26,70055,70045,Blue,0,45910,46419,509
2022-09-26,70042,70046,Blue,1,56640,56815,175
2022-09-27,70044,70058,Blue,1,26790,27598,808
2022-12-23,70048,70056,Blue,1,56069,56544,475
2022-04-05,70056,70060,Blue,1,39729,39944,215
2022-04-08,70049,70045,Blue,0,21083,21265,182
2022-12-18,70040,70060,Blue,1,83770,84930,1160
2022-07-06,70050,70054,Blue,1,74624,74917,293
2022-10-10,70059,70045,Blue,0,21746,22489,743
2022-09-10,70059,70049,Blue,0,75794,76268,474
2022-03-11,70046,70048,Blue,1,70286,70358,72
2022-09-25,70040,70044,Blue,1,53303,53413,110
2022-04-21,70051,70039,Blue,0,59296,59989,693
2022-01-10,70038,70060,Blue,1,72976,74116,1140
2022-08-03,70053,70047,Blue,0,62670,62951,281
2022-04-14,70053,70047,Blue,0,60167,60454,287
2022-07-17,70043,70039,Blue,0,68298,68400,102
2022-11-21,70050,70054,Blue,1,88786,88984,198
2022-12-29,70044,70052,Blue,1,49751,50249,498
2022-07-20,70042,70058,Blue,1,43804,44747,943
2022-01-07,70040,70060,Blue,1,30308,31492,1184
2022-07-26,70059,70039,Blue,0,54621,55796,1175
2022-11-01,70043,70039,Blue,0,32769,32910,141
2022-08-10,70057,70043,Blue,0,62963,63725,762
2022-01-19,70057,70838,Blue,0,26742,27927,1185
2022-03-25,70038,70058,Blue,1,45394,46395,1001
2022-02-22,70046,70048,Blue,1,32121,32198,77
2022-08-22,70059,70047,Blue,0,77383,77981,598
2022-02-28,70059,70053,Blue,0,64697,64959,262
2022-07-03,70052,70054,Blue,1,57280,57347,67
2022-10-08,70045,70838,Blue,0,64565,64917,352
2022-09-07,70046,70048,Blue,1,59351,59431,80
2022-02-07,70046,70052,Blue,1,52600,53201,601
2022-12-13,70051,70047,Blue,0,77977,78182,205
2022-03-31,70051,70041,Blue,0,31257,31871,614
2022-01-22,70052,70058,Blue,1,83060,83325,265
2022-08-09,70053,70051,Blue,0,71503,71567,64
2022-12-03,70040,70048,Blue,1,42536,42908,372
2022-08-27,70053,70039,Blue,0,44627,45366,739
2022-12-15,70054,70058,Blue,1,80822,80981,159
2022-10-14,70050,70060,Blue,1,47343,47865,522
2022-06-30,70038,70048,Blue,1,32425,32956,531
2022-12-23,70038,70056,Blue,1,65998,66988,990
2022-10-03,70053,70047,Blue,0,76180,76500,320
2022-04-21,70041,70039,Blue,0,65378,65415,37
2022-09-08,70059,70041,Blue,0,37935,38963,1028
2022-04-19,70057,70051,Blue,0,84727,84967,240
2022-04-19,70053,70039,Blue,0,26927,27811,884
2022-08-01,70059,70045,Blue,0,79462,80115,653
2022-10-15,70038,70060,Blue,1,84608,85875,1267
2022-10-22,70056,70058,Blue,1,23272,23358,86
2022-07-16,70059,70047,Blue,0,26568,27107,539
2022-03-20,70043,70838,Blue,0,37797,38010,213
2022-05-18,70057,70838,Blue,0,77252,78421,1169
2022-12-22,70057,70047,Blue,0,37903,38698,795
2022-08-24,70053,70047,Blue,0,21791,22125,334
2022-05-07,70051,70047,Blue,0,57638,57891,253
2022-08-13,70057,70047,Blue,0,42817,43306,489
2022-03-21,70050,70052,Blue,1,55359,55501,142
2022-03-15,70044,70048,Blue,1,66053,66281,228
2022-03-07,70045,70039,Blue,0,79660,79884,224
2022-08-03,70046,70056,Blue,1,58451,58986,535
2022-10-04,70051,70043,Blue,0,62768,63249,481
2022-06-09,70046,70052,Blue,1,40027,40408,381
2022-08-13,70053,70051,Blue,0,89299,89354,55
2022-07-12,70044,70048,Blue,1,50027,50344,317
2022-03-19,70059,70838,Blue,0,76455,77540,1085
2022-07-18,70039,70838,Blue,0,30423,30455,32
2022-09-10,70045,70039,Blue,0,22859,23100,241
2022-06-14,70044,70046,Blue,1,46622,46759,137
2022-07-14,70051,70047,Blue,0,56776,56976,200
2022-02-02,70059,70047,Blue,0,28469,29105,636
2022-03-07,70042,70046,Blue,1,87879,88053,174
2022-03-01,70059,70039,Blue,0,19519,20652,1133
2022-12-17,70056,70060,Blue,1,29589,29776,187
2022-12-02,70057,70049,Blue,0,72868,73260,392
2022-04-10,70038,70056,Blue,1,53714,54649,935
2022-06-29,70044,70050,Blue,1,62227,62660,433
2022-02-11,70057,70039,Blue,0,76108,77064,956
2022-06-04,70038,70052,Blue,1,83094,84011,917
2022-12-02,70040,70058,Blue,1,27737,28820,1083
2022-10-29,70044,70046,Blue,1,27682,27787,105
2022-07-18,70045,70039,Blue,0,24531,24776,245
2022-02-03,70056,70060,Blue,1,21874,22078,204
2022-11-28,70055,70039,Blue,0,77134,77984,850
2022-05-21,70044,70050,Blue,1,70300,70742,442
2022-07-01,70038,70056,Blue,1,72852,74027,1175
2022-10-27,70051,70045,Blue,0,73184,73541,357
2022-01-21,70046,70060,Blue,1,48485,49255,770
2022-03-22,70050,70052,Blue,1,46382,46491,109
2022-04-13,70046,70054,Blue,1,21165,21677,512
2022-03-10,70053,70041,Blue,0,20464,21223,759
2022-09-12,70056,70060,Blue,1,43713,43899,186
2022-01-24,70041,70039,Blue,0,79345,79379,34
2022-04-11,70059,70055,Blue,0,74354,74517,163
2022-10-28,70044,70050,Blue,1,35067,35398,331
2022-05-05,70052,70054,Blue,1,55273,55324,51
2022-05-15,70056,70060,Blue,1,55975,56161,186
2022-11-08,70047,70045,Blue,0,78858,78949,91
2022-04-18,70044,70048,Blue,1,24189,24464,275
2022-02-14,70049,70047,Blue,0,18901,18958,57
2022-02-25,70038,70056,Blue,1,76947,77890,943
2022-08-02,70057,70838,Blue,0,73476,74532,1056
2022-12-07,70040,70042,Blue,1,53956,53988,32
2022-04-10,70059,70045,Blue,0,73817,74582,765
2022-01-31,70046,70054,Blue,1,53197,53640,443
2022-06-26,70057,70049,Blue,0,26252,26627,375
2022-04-14,70040,70048,Blue,1,44715,45095,380
2022-08-20,70057,70043,Blue,0,42810,43586,776
2022-11-09,70053,70043,Blue,0,33638,34272,634
2022-01-24,70042,70054,Blue,1,58784,59442,658
2022-02-26,70051,70041,Blue,0,26939,27462,523
2022-07-23,70055,70053,Blue,0,61423,61471,48
2022-07-25,70059,70053,Blue,0,51623,51955,332
2022-09-26,70047,70045,Blue,0,53737,53829,92
2022-07-21,70040,70060,Blue,1,55804,56895,1091
2022-02-03,70046,70060,Blue,1,48547,49349,802
2022-07-25,70040,70050,Blue,1,70027,70568,541
2022-06-15,70039,70838,Blue,0,49307,49343,36
2022-11-26,70055,70047,Blue,0,54789,55148,359
2022-10-14,70057,70055,Blue,0,66093,66163,70
2022-02-23,70038,70046,Blue,1,61069,61394,325
2022-06-20,70050,70058,Blue,1,20493,20895,402
2022-10-05,70042,70044,Blue,1,55637,55672,35
2022-01-24,70042,70044,Blue,1,59122,59155,33
2022-09-21,70048,70054,Blue,1,43838,44161,323
2022-05-26,70048,70050,Blue,1,29158,29220,62
2022-07-15,70056,70060,Blue,1,27467,27646,179
2022-11-03,70053,70039,Blue,0,33365,34194,829
2022-04-11,70042,70046,Blue,1,35245,35421,176
2022-12-11,70046,70058,Blue,1,64880,65503,623
2022-02-20,70057,70049,Blue,0,24840,25277,437
2022-01-13,70055,70039,Blue,0,54388,55186,798
2022-10-04,70048,70058,Blue,1,36470,37019,549
2022-09-16,70053,70043,Blue,0,64915,65507,592
2022-07-13,70055,70053,Blue,0,47360,47406,46
2022-03-16,70051,70043,Blue,0,68211,68671,460
2022-08-09,70038,70058,Blue,1,54142,55216,1074
2022-07-26,70052,70054,Blue,1,53794,53857,63
2022-10-04,70044,70050,Blue,1,21994,22320,326
2022-10-14,70042,70052,Blue,1,57297,57863,566
2022-10-02,70059,70057,Blue,0,68962,68997,35
2022-09-12,70056,70058,Blue,1,56175,56257,82
2022-11-12,70053,70838,Blue,0,72406,73196,790
2022-07-16,70038,70044,Blue,1,41476,41653,177
2022-04-18,70044,70056,Blue,1,34360,35114,754
2022-03-07,70047,70043,Blue,0,60076,60332,256
2022-06-16,70055,70045,Blue,0,74834,75367,533
2022-03-01,70046,70052,Blue,1,72336,72675,339
2022-06-19,70038,70050,Blue,1,37696,38287,591
2022-06-25,70050,70056,Blue,1,56672,57032,360
2022-12-06,70052,70060,Blue,1,31521,31886,365
2022-04-05,70052,70056,Blue,1,28862,28999,137
2022-07-31,70049,70047,Blue,0,32101,32155,54
2022-03-21,70038,70060,Blue,1,34456,35805,1349
2022-04-05,70057,70049,Blue,0,38729,39198,469
2022-07-21,70049,70838,Blue,0,22247,22862,615
2022-02-14,70057,70049,Blue,0,31530,31902,372
2022-03-11,70044,70056,Blue,1,78798,79476,678
2022-01-14,70052,70056,Blue,1,34535,34678,143
2022-04-08,70046,70048,Blue,1,32270,32356,86
2022-06-17,70051,70047,Blue,0,34035,34284,249
2022-07-19,70038,70044,Blue,1,56699,56933,234
2022-07-09,70040,70052,Blue,1,48084,48742,658
2022-01-04,70044,70050,Blue,1,33765,34090,325
2022-03-23,70059,70051,Blue,0,25455,25788,333
2022-11-30,70055,70039,Blue,0,74023,74970,947
2022-03-01,70040,70046,Blue,1,56580,56851,271
2022-10-14,70059,70057,Blue,0,64689,64724,35
2022-07-04,70048,70056,Blue,1,86160,86562,402
2022-04-22,70047,70043,Blue,0,23364,23606,242
2022-09-15,70038,70048,Blue,1,28156,28594,438
2022-10-17,70040,70052,Blue,1,42216,42996,780
2022-12-17,70044,70060,Blue,1,78205,79069,864
2022-11-29,70049,70041,Blue,0,46241,46664,423
2022-11-11,70055,70053,Blue,0,55828,55874,46
2022-12-23,70040,70056,Blue,1,56659,57602,943
2022-11-25,70045,70039,Blue,0,30080,30344,264
2022-08-14,70058,70060,Blue,1,29496,29572,76
2022-03-24,70044,70048,Blue,1,79373,79633,260
2022-02-14,70057,70045,Blue,0,85241,85906,665
2022-08-31,70047,70045,Blue,0,48978,49067,89
2022-03-27,70045,70043,Blue,0,41611,41719,108
2022-07-08,70048,70050,Blue,1,28628,28688,60
2022-04-06,70042,70052,Blue,1,61760,62355,595
2022-07-25,70042,70060,Blue,1,42534,43501,967
2022-10-24,70038,70058,Blue,1,50788,51831,1043
2022-06-23,70051,70838,Blue,0,62423,63184,761
2022-10-19,70044,70056,Blue,1,85132,85837,705
2022-05-19,70049,70041,Blue,0,38628,39207,579
2022-08-24,70051,70045,Blue,0,85528,85869,341
2022-02-26,70046,70052,Blue,1,89518,89889,371
2022-10-28,70055,70041,Blue,0,64633,65347,714
2022-08-12,70044,70054,Blue,1,72973,73583,610
2022-12-15,70047,70045,Blue,0,69319,69412,93
2022-01-08,70052,70056,Blue,1,75238,75378,140
2022-07-29,70042,70058,Blue,1,88519,89503,984
2022-12-07,70047,70039,Blue,0,75517,75898,381
2022-01-11,70057,70055,Blue,0,70062,70130,68
2022-11-17,70039,70838,Blue,0,26355,26389,34
2022-09-26,70044,70048,Blue,1,47020,47284,264
2022-06-01,70047,70045,Blue,0,45841,45950,109
2022-10-09,70051,70039,Blue,0,55802,56434,632
2022-06-20,70056,70060,Blue,1,24529,24753,224
2022-03-29,70058,70060,Blue,1,55909,55977,68
2022-10-19,70055,70051,Blue,0,51193,51367,174
2022-12-17,70053,70838,Blue,0,33312,34270,958
2022-04-13,70047,70039,Blue,0,73854,74228,374
2022-04-13,70055,70049,Blue,0,41735,42092,357
2022-12-18,70038,70050,Blue,1,73689,74281,592
2022-12-04,70052,70056,Blue,1,58248,58391,143
2022-04-04,70038,70058,Blue,1,77526,78603,1077
2022-12-18,70047,70838,Blue,0,82187,82641,454
2022-07-18,70055,70041,Blue,0,65795,66575,780
2022-11-23,70055,70051,Blue,0,84376,84542,166
2022-06-29,70050,70058,Blue,1,72654,73099,445
2022-10-28,70040,70044,Blue,1,58177,58343,166
2022-02-10,70044,70052,Blue,1,31058,31565,507
2022-03-20,70040,70054,Blue,1,54626,55369,743
2022-07-15,70044,70048,Blue,1,62157,62398,241
2022-10-06,70046,70056,Blue,1,60103,60611,508
2022-10-05,70052,70054,Blue,1,33765,33829,64
2022-12-17,70053,70045,Blue,0,45182,45640,458
2022-03-16,70049,70047,Blue,0,60396,60454,58
2022-10-02,70055,70051,Blue,0,45362,45486,124
2022-12-06,70058,70060,Blue,1,32184,32257,73
2022-06-24,70049,70045,Blue,0,86123,86318,195
2022-01-17,70043,70041,Blue,0,70635,70663,28
2022-11-20,70056,70058,Blue,1,87301,87375,74
2022-10-20,70053,70039,Blue,0,78372,79063,691
2022-09-20,70055,70051,Blue,0,60227,60361,134
2022-03-29,70048,70054,Blue,1,72900,73202,302
2022-12-14,70052,70056,Blue,1,49417,49557,140
2022-03-23,70053,70043,Blue,0,53856,54405,549
2022-06-20,70055,70039,Blue,0,38300,39156,856
2022-01-04,70057,70039,Blue,0,49866,50888,1022
2022-11-07,70046,70052,Blue,1,82424,82759,335
2022-09-06,70045,70838,Blue,0,53878,54219,341
2022-12-28,70058,70060,Blue,1,76417,76485,68
2022-06-24,70042,70058,Blue,1,26097,26938,841
2022-09-17,70053,70047,Blue,0,66766,67086,320
2022-06-16,70042,70046,Blue,1,65822,66033,211
2022-12-26,70049,70039,Blue,0,30557,31016,459
2022-10-03,70059,70041,Blue,0,66849,68092,1243
2022-07-10,70055,70053,Blue,0,69698,69746,48
2022-03-11,70049,70043,Blue,0,42052,42398,346
2022-09-19,70056,70058,Blue,1,41788,41857,69
2022-04-15,70052,70054,Blue,1,47107,47164,57
2022-11-18,70057,70047,Blue,0,33890,34402,512
2022-02-20,70038,70042,Blue,1,75307,75401,94
2022-06-11,70046,70058,Blue,1,80569,81262,693
2022-05-24,70040,70052,Blue,1,82308,83129,821
2022-06-10,70050,70058,Blue,1,37414,37870,456
2022-02-16,70053,70049,Blue,0,88381,88574,193
2022-05-18,70057,70055,Blue,0,19244,19314,70
2022-02-11,70038,70040,Blue,1,23048,23065,17
2022-06-12,70059,70057,Blue,0,70033,70070,37
2022-10-26,70040,70046,Blue,1,82902,83176,274
2022-06-07,70042,70046,Blue,1,20145,20354,209
2022-01-27,70057,70047,Blue,0,34773,35321,548
2022-05-10,70050,70054,Blue,1,73181,73392,211
2022-10-18,70050,70060,Blue,1,42284,42816,532
2022-06-29,70057,70045,Blue,0,20910,21517,607
2022-03-13,70049,70041,Blue,0,58109,58545,436
2022-06-14,70059,70049,Blue,0,37530,38079,549
2022-01-15,70056,70060,Blue,1,51631,51809,178
2022-03-09,70059,70051,Blue,0,40937,41287,350
2022-09-25,70044,70048,Blue,1,88410,88630,220
2022-10-05,70051,70047,Blue,0,39431,39629,198
2022-03-22,70057,70041,Blue,0,28253,29176,923
2022-02-15,70041,70838,Blue,0,58813,58950,137
2022-11-21,70038,70040,Blue,1,52334,52352,18
2022-08-12,70040,70042,Blue,1,76358,76387,29
2022-04-06,70049,70047,Blue,0,35765,35821,56
2022-08-15,70044,70052,Blue,1,21288,21820,532
2022-01-16,70047,70043,Blue,0,34643,34954,311
2022-09-28,70057,70047,Blue,0,21830,22407,577
2022-12-30,70055,70043,Blue,0,46376,47082,706
2022-08-06,70042,70056,Blue,1,64368,65112,744
2022-11-09,70050,70054,Blue,1,27986,28183,197
2022-09-22,70047,70041,Blue,0,58682,59002,320
2022-08-08,70038,70048,Blue,1,56661,57134,473
2022-10-14,70040,70046,Blue,1,51849,52108,259
2022-02-04,70048,70056,Blue,1,87631,88023,392
2022-12-05,70057,70055,Blue,0,41798,41870,72
2022-08-23,70038,70050,Blue,1,31119,31694,575
2022-04-22,70038,70056,Blue,1,32063,33030,967
2022-12-06,70057,70045,Blue,0,55174,55783,609
2022-08-05,70059,70055,Blue,0,66541,66683,142
2022-05-27,70038,70050,Blue,1,40937,41635,698
2022-08-11,70040,70058,Blue,1,70097,70988,891
2022-11-28,70038,70060,Blue,1,36479,37677,1198
2022-01-19,70059,70838,Blue,0,32121,33406,1285
2022-08-20,70059,70045,Blue,0,63257,63945,688
2022-07-06,70053,70838,Blue,0,60586,61486,900
2022-07-16,70045,70041,Blue,0,77909,78121,212
2022-03-20,70059,70043,Blue,0,62365,63269,904
2022-08-27,70040,70058,Blue,1,89230,90317,1087
2022-10-29,70047,70039,Blue,0,49951,50393,442
2022-03-30,70053,70043,Blue,0,75742,76279,537
2022-11-04,70044,70060,Blue,1,73349,74390,1041
2022-06-09,70043,70041,Blue,0,81485,81514,29
2022-04-06,70050,70054,Blue,1,57664,57923,259
2022-07-04,70052,70054,Blue,1,33742,33818,76
2022-06-19,70052,70054,Blue,1,45091,45149,58
2022-07-12,70047,70041,Blue,0,27893,28285,392
2022-10-29,70055,70051,Blue,0,82511,82641,130
2022-12-14,70059,70049,Blue,0,35925,36543,618
2022-01-12,70048,70050,Blue,1,65735,65789,54
2022-02-22,70055,70039,Blue,0,36037,36957,920
2022-12-30,70040,70060,Blue,1,74653,75695,1042
2022-11-15,70042,70044,Blue,1,67543,67578,35
2022-11-27,70059,70838,Blue,0,71109,72140,1031
2022-07-09,70050,70052,Blue,1,56228,56331,103
2022-12-05,70049,70039,Blue,0,66778,67285,507
2022-08-13,70057,70039,Blue,0,56309,57266,957
2022-10-03,70042,70054,Blue,1,68084,68747,663
2022-02-22,70053,70041,Blue,0,59284,60018,734
2022-09-06,70049,70039,Blue,0,88738,89397,659
2022-10-26,70059,70049,Blue,0,85759,86229,470
2022-02-14,70038,70054,Blue,1,74766,75612,846
2022-01-04,70050,70056,Blue,1,58718,59016,298
2022-09-17,70051,70041,Blue,0,53913,54612,699
2022-05-07,70059,70057,Blue,0,41419,41461,42
2022-11-11,70038,70048,Blue,1,65134,65584,450
2022-07-05,70052,70056,Blue,1,78658,78810,152
2022-08-13,70038,70044,Blue,1,39908,40112,204
2022-07-19,70040,70042,Blue,1,40066,40097,31
2022-06-23,70046,70052,Blue,1,81878,82609,731
2022-07-21,70055,70047,Blue,0,79611,79994,383
2022-06-28,70059,70838,Blue,0,57366,58566,1200
2022-09-20,70047,70043,Blue,0,65316,65584,268
2022-07-17,70040,70044,Blue,1,37086,37191,105
2022-09-22,70049,70045,Blue,0,57728,57930,202
2022-09-22,70059,70057,Blue,0,22154,22192,38
2022-09-29,70047,70045,Blue,0,87130,87238,108
2022-01-03,70059,70039,Blue,0,30557,31622,1065
2022-09-03,70057,70045,Blue,0,31476,32075,599
2022-01-11,70053,70047,Blue,0,50499,50772,273
2022-11-14,70038,70048,Blue,1,62101,62654,553
2022-09-22,70041,70039,Blue,0,59047,59078,31
2022-10-27,70055,70049,Blue,0,77714,77992,278
2022-06-29,70042,70050,Blue,1,44926,45462,536
2022-04-18,70057,70051,Blue,0,24027,24272,245
2022-10-11,70049,70039,Blue,0,40920,41468,548
2022-02-25,70059,70049,Blue,0,60796,61330,534
2022-06-09,70042,70060,Blue,1,21103,22223,1120
2022-03-16,70049,70041,Blue,0,55573,55990,417
2022-12-20,70059,70045,Blue,0,54469,55139,670
2022-08-23,70038,70054,Blue,1,85126,85904,778
2022-11-19,70059,70049,Blue,0,44356,44803,447
2022-02-08,70059,70055,Blue,0,56591,56739,148
2022-03-01,70047,70043,Blue,0,67387,67621,234
2022-08-23,70050,70056,Blue,1,32698,32999,301
2022-07-17,70059,70045,Blue,0,80240,80928,688
2022-03-22,70048,70050,Blue,1,24838,24896,58
2022-11-01,70055,70051,Blue,0,59479,59606,127
2022-06-28,70055,70043,Blue,0,51727,52397,670
2022-10-07,70046,70052,Blue,1,79966,80302,336
2022-09-20,70059,70041,Blue,0,39561,40516,955
2022-08-24,70055,70053,Blue,0,40801,40850,49
2022-02-02,70044,70048,Blue,1,60743,60994,251
2022-09-07,70058,70060,Blue,1,58419,58488,69
2022-04-01,70059,70045,Blue,0,58698,59356,658
2022-08-11,70055,70049,Blue,0,61517,61806,289
2022-03-07,70046,70060,Blue,1,62962,63796,834
2022-08-05,70038,70046,Blue,1,63416,63763,347
2022-06-16,70053,70043,Blue,0,27840,28485,645
2022-07-31,70055,70051,Blue,0,32599,32738,139
2022-09-22,70049,70041,Blue,0,57728,58166,438
2022-02-24,70047,70045,Blue,0,74369,74478,109
2022-01-22,70046,70056,Blue,1,35431,35970,539
2022-11-23,70047,70043,Blue,0,62737,62980,243
2022-07-12,70038,70042,Blue,1,62291,62413,122
2022-02-01,70048,70050,Blue,1,57919,57973,54
2022-12-08,70058,70060,Blue,1,43134,43192,58
2022-01-08,70054,70060,Blue,1,50517,50790,273
2022-03-21,70048,70058,Blue,1,69080,69655,575
2022-01-13,70038,70056,Blue,1,31152,32133,981
2022-06-19,70040,70044,Blue,1,88268,88362,94
2022-08-02,70041,70838,Blue,0,56519,56636,117
2022-07-29,70038,70044,Blue,1,34537,34701,164
2022-02-27,70049,70043,Blue,0,36723,37095,372
2022-01-12,70050,70052,Blue,1,69515,69711,196
2022-01-11,70038,70052,Blue,1,64067,64720,653
2022-02-18,70059,70045,Blue,0,60500,61272,772
2022-09-06,70043,70041,Blue,0,28132,28161,29
2022-03-08,70050,70058,Blue,1,61889,62281,392
2022-11-30,70042,70054,Blue,1,72869,73585,716
2022-02-04,70044,70056,Blue,1,54796,55560,764
2022-04-13,70038,70052,Blue,1,24664,25382,718
2022-02-01,70050,70054,Blue,1,50934,51170,236
2022-07-01,70038,70040,Blue,1,50473,50491,18
2022-05-03,70056,70060,Blue,1,78040,78209,169
2022-11-26,70057,70049,Blue,0,38483,38862,379
2022-08-28,70052,70056,Blue,1,62126,62263,137
2022-06-30,70040,70052,Blue,1,43721,44479,758
2022-09-15,70042,70048,Blue,1,55053,55371,318
2022-11-14,70046,70060,Blue,1,67802,68551,749
2022-09-08,70055,70838,Blue,0,25716,26680,964
2022-02-08,70057,70045,Blue,0,66863,67459,596
2022-03-03,70038,70052,Blue,1,50782,51503,721
2022-10-23,70038,70058,Blue,1,83719,84816,1097
2022-12-04,70044,70050,Blue,1,76684,77017,333
2022-10-11,70052,70056,Blue,1,25687,25842,155
2022-12-05,70059,70047,Blue,0,84994,85581,587
2022-10-21,70049,70039,Blue,0,43894,44434,540
2022-06-26,70049,70039,Blue,0,25307,25847,540
2022-02-07,70057,70047,Blue,0,35906,36552,646
2022-03-03,70050,70054,Blue,1,28762,28956,194
2022-05-13,70054,70060,Blue,1,34780,35073,293
2022-02-05,70052,70056,Blue,1,40095,40223,128
2022-03-31,70049,70045,Blue,0,50737,50949,212
2022-01-28,70052,70056,Blue,1,61194,61328,134
2022-08-03,70040,70046,Blue,1,49878,50135,257
2022-04-23,70053,70047,Blue,0,73234,73548,314
2022-12-20,70038,70056,Blue,1,31868,32772,904
2022-01-26,70046,70060,Blue,1,46832,47595,763
2022-01-12,70055,70051,Blue,0,76835,77001,166
2022-03-30,70046,70054,Blue,1,67419,67833,414
2022-08-04,70057,70041,Blue,0,65611,66446,835
2022-07-11,70040,70058,Blue,1,72723,73768,1045
2022-09-24,70059,70053,Blue,0,19535,19793,258
2022-10-24,70041,70838,Blue,0,85528,85643,115
2022-01-13,70040,70050,Blue,1,57242,57742,500
2022-03-31,70059,70041,Blue,0,74893,75840,947
2022-01-19,70038,70060,Blue,1,52149,53435,1286
2022-09-26,70038,70046,Blue,1,65481,65819,338
2022-07-18,70045,70838,Blue,0,52756,53101,345
2022-09-15,70051,70039,Blue,0,59772,60443,671
2022-05-01,70059,70057,Blue,0,58337,58373,36
2022-10-23,70057,70043,Blue,0,78338,79100,762
2022-01-21,70057,70053,Blue,0,41068,41255,187
2022-05-23,70047,70041,Blue,0,26349,26782,433
2022-01-31,70057,70838,Blue,0,40265,41445,1180
2022-02-08,70053,70041,Blue,0,56869,57551,682
2022-06-20,70055,70041,Blue,0,24446,25208,762
2022-10-24,70056,70058,Blue,1,34176,34252,76
2022-12-19,70039,70838,Blue,0,68463,68686,223
2022-07-18,70053,70047,Blue,0,20198,20503,305
2022-11-03,70038,70046,Blue,1,88207,88522,315
2022-07-08,70053,70039,Blue,0,27910,28799,889
2022-09-24,70051,70838,Blue,0,75483,76239,756
2022-03-12,70044,70058,Blue,1,44449,45212,763
2022-08-16,70046,70060,Blue,1,52335,53105,770
2022-01-16,70055,70039,Blue,0,38364,39319,955
2022-07-18,70042,70050,Blue,1,88479,88879,400
2022-01-22,70040,70042,Blue,1,24366,24404,38
2022-07-22,70040,70056,Blue,1,24232,25147,915
2022-01-11,70038,70042,Blue,1,32657,32745,88
2022-07-27,70055,70043,Blue,0,20613,21315,702
2022-08-07,70040,70058,Blue,1,52724,53700,976
2022-04-18,70040,70058,Blue,1,36552,37452,900
2022-08-21,70057,70049,Blue,0,53920,54312,392
2022-11-02,70055,70041,Blue,0,71954,72700,746
2022-10-31,70053,70039,Blue,0,32910,33639,729
2022-04-20,70042,70054,Blue,1,64794,65497,703
2022-11-11,70057,70041,Blue,0,66644,67496,852
2022-03-18,70059,70043,Blue,0,40412,41345,933
2022-02-21,70053,70051,Blue,0,72191,72244,53
2022-01-12,70040,70050,Blue,1,58991,59527,536
2022-02-16,70055,70045,Blue,0,31038,31536,498
2022-08-30,70042,70044,Blue,1,77992,78020,28
2022-06-07,70047,70045,Blue,0,79396,79492,96
2022-02-20,70043,70838,Blue,0,64584,64790,206
2022-11-30,70056,70060,Blue,1,66156,66344,188
2022-04-15,70043,70041,Blue,0,42056,42085,29
2022-02-19,70059,70051,Blue,0,20828,21176,348
2022-07-25,70053,70047,Blue,0,82882,83168,286
2022-07-31,70044,70050,Blue,1,36477,36803,326
2022-08-06,70044,70054,Blue,1,20024,20605,581
2022-04-02,70044,70050,Blue,1,62284,62638,354
2022-02-17,70043,70039,Blue,0,20205,20332,127
2022-04-21,70059,70057,Blue,0,70516,70552,36
2022-07-08,70053,70049,Blue,0,26709,26931,222
2022-04-27,70057,70051,Blue,0,53974,54210,236
2022-01-28,70042,70044,Blue,1,33396,33427,31
2022-03-19,70057,70053,Blue,0,22230,22388,158
2022-05-19,70047,70838,Blue,0,45620,46246,626
2022-06-13,70045,70043,Blue,0,63023,63152,129
2022-03-04,70056,70060,Blue,1,73949,74120,171
2022-08-15,70043,70039,Blue,0,33227,33343,116
2022-04-02,70057,70043,Blue,0,57932,58736,804
2022-08-24,70051,70047,Blue,0,19943,20164,221
2022-03-06,70054,70056,Blue,1,76647,76693,46
2022-10-13,70045,70838,Blue,0,77663,77988,325
2022-12-27,70049,70045,Blue,0,23183,23397,214
2022-01-31,70055,70049,Blue,0,79648,79967,319
2022-02-28,70050,70060,Blue,1,70066,70620,554
2022-10-20,70041,70838,Blue,0,56082,56209,127
2022-03-17,70055,70051,Blue,0,47301,47455,154
2022-10-25,70042,70056,Blue,1,26961,27745,784
2022-07-07,70053,70051,Blue,0,67445,67508,63
2022-08-26,70054,70058,Blue,1,46575,46729,154
2022-10-17,70055,70049,Blue,0,21952,22250,298
2022-03-05,70057,70043,Blue,0,28227,28982,755
2022-09-01,70046,70056,Blue,1,21787,22304,517
2022-01-03,70042,70058,Blue,1,53850,54627,777
2022-09-24,70053,70049,Blue,0,43527,43719,192
2022-11-01,70059,70047,Blue,0,51492,52019,527
2022-10-03,70048,70060,Blue,1,30905,31556,651
2022-07-03,70045,70838,Blue,0,47035,47372,337
2022-10-02,70046,70052,Blue,1,54216,54534,318
2022-03-04,70057,70051,Blue,0,33936,34187,251
2022-02-07,70048,70052,Blue,1,60655,60885,230
2022-07-12,70050,70056,Blue,1,75344,75658,314
2022-03-23,70046,70056,Blue,1,62700,63188,488
2022-11-30,70038,70060,Blue,1,33613,34696,1083
2022-03-26,70052,70058,Blue,1,27757,28008,251
2022-02-19,70059,70055,Blue,0,74057,74209,152
2022-08-01,70045,70043,Blue,0,76121,76210,89
2022-05-31,70046,70052,Blue,1,29022,29456,434
2022-11-02,70040,70042,Blue,1,77398,77429,31
2022-01-31,70052,70054,Blue,1,47214,47268,54
2022-12-22,70049,70045,Blue,0,19944,20140,196
2022-03-16,70042,70054,Blue,1,28001,28683,682
2022-02-09,70057,70053,Blue,0,59964,60151,187
2022-03-11,70057,70047,Blue,0,26758,27277,519
2022-06-19,70049,70838,Blue,0,72207,72823,616
2022-02-10,70055,70047,Blue,0,75081,75476,395
2022-06-27,70049,70838,Blue,0,34897,35775,878
2022-04-14,70058,70060,Blue,1,60846,61010,164
2022-04-06,70053,70049,Blue,0,26645,26867,222
2022-09-28,70050,70060,Blue,1,41447,41927,480
2022-07-29,70045,70043,Blue,0,75733,75831,98
2022-10-31,70057,70039,Blue,0,79287,80559,1272
2022-02-22,70053,70039,Blue,0,20614,21532,918
2022-12-05,70055,70041,Blue,0,41908,42676,768
2022-09-09,70054,70056,Blue,1,41689,41736,47
2022-04-05,70044,70050,Blue,1,55554,55914,360
2022-10-02,70042,70058,Blue,1,70063,71000,937
2022-11-20,70057,70053,Blue,0,46238,46390,152
2022-12-25,70057,70051,Blue,0,52292,52542,250
2022-08-23,70054,70058,Blue,1,51069,51268,199
2022-06-16,70046,70050,Blue,1,62774,63006,232
2022-12-26,70056,70060,Blue,1,52498,52676,178
2022-06-15,70051,70043,Blue,0,39717,40266,549
2022-02-15,70059,70051,Blue,0,74352,74696,344
2022-11-02,70048,70060,Blue,1,36229,36893,664
2022-07-07,70059,70043,Blue,0,80605,81543,938
2022-07-15,70038,70052,Blue,1,63080,63861,781
2022-12-31,70045,70838,Blue,0,41400,41731,331
2022-01-20,70049,70047,Blue,0,37733,37795,62
2022-11-03,70047,70045,Blue,0,40292,40407,115
2022-07-06,70038,70060,Blue,1,46175,47309,1134
2022-01-24,70041,70838,Blue,0,81567,81687,120
2022-08-25,70050,70058,Blue,1,59464,59896,432
2022-10-19,70040,70044,Blue,1,32958,33069,111
2022-07-31,70055,70047,Blue,0,85719,86105,386
2022-12-14,70046,70048,Blue,1,70847,70921,74
2022-08-01,70038,70048,Blue,1,73676,74105,429
2022-04-24,70058,70060,Blue,1,30992,31054,62
2022-07-15,70052,70056,Blue,1,33997,34141,144
2022-05-27,70049,70047,Blue,0,64997,65061,64
2022-03-04,70044,70056,Blue,1,84562,85257,695
2022-12-14,70042,70058,Blue,1,42736,43617,881
2022-03-01,70042,70048,Blue,1,80667,80987,320
2022-02-03,70051,70039,Blue,0,24059,24776,717
2022-04-24,70044,70056,Blue,1,63174,63881,707
2022-11-23,70038,70044,Blue,1,28938,29103,165
2022-01-31,70053,70047,Blue,0,64938,65224,286
2022-02-03,70054,70060,Blue,1,63643,64003,360
2022-10-19,70053,70051,Blue,0,80745,80794,49
2022-07-25,70046,70060,Blue,1,41096,41848,752
2022-06-12,70051,70838,Blue,0,85230,86094,864
2022-12-13,70045,70039,Blue,0,41367,41623,256
2022-12-26,70050,70060,Blue,1,50472,50970,498
2022-01-06,70045,70039,Blue,0,27776,28029,253
2022-02-20,70051,70049,Blue,0,83368,83474,106
2022-10-14,70038,70050,Blue,1,70032,70636,604
2022-05-19,70043,70041,Blue,0,53794,53823,29
2022-10-06,70046,70054,Blue,1,54929,55380,451
2022-09-01,70044,70056,Blue,1,77503,78186,683
2022-08-21,70044,70046,Blue,1,56100,56202,102
2022-04-07,70055,70049,Blue,0,77961,78247,286
2022-01-31,70053,70045,Blue,0,65306,65761,455
2022-10-05,70041,70039,Blue,0,72754,72788,34
2022-06-05,70047,70045,Blue,0,67183,67298,115
2022-10-06,70048,70058,Blue,1,49822,50357,535
2022-07-12,70048,70054,Blue,1,68069,68479,410
2022-10-19,70044,70046,Blue,1,84348,84453,105
2022-12-01,70046,70050,Blue,1,22675,22860,185
2022-01-13,70053,70041,Blue,0,60212,60953,741
2022-01-24,70046,70048,Blue,1,47317,47409,92
2022-07-16,70045,70041,Blue,0,66699,66872,173
2022-07-26,70049,70039,Blue,0,66734,67260,526
2022-12-09,70047,70045,Blue,0,38902,39006,104
2022-11-13,70049,70039,Blue,0,43943,44416,473
2022-07-28,70048,70050,Blue,1,25410,25469,59
2022-02-12,70042,70058,Blue,1,84957,85887,930
2022-08-01,70040,70042,Blue,1,61756,61796,40
2022-04-05,70042,70054,Blue,1,66875,67569,694
2022-05-12,70058,70060,Blue,1,81257,81426,169
2022-10-27,70050,70056,Blue,1,51062,51357,295
2022-01-31,70055,70041,Blue,0,56471,57196,725
2022-06-30,70044,70048,Blue,1,66029,66364,335
2022-09-10,70047,70039,Blue,0,66024,66448,424
2022-10-09,70051,70838,Blue,0,35926,36740,814
2022-12-06,70045,70043,Blue,0,73546,73630,84
2022-08-10,70040,70046,Blue,1,34225,34471,246
2022-10-17,70053,70047,Blue,0,59286,59597,311
2022-06-29,70045,70041,Blue,0,88039,88256,217
2022-07-27,70045,70039,Blue,0,55862,56131,269
2022-02-01,70054,70058,Blue,1,88751,88909,158
2022-11-24,70040,70058,Blue,1,47303,48262,959
2022-03-19,70038,70056,Blue,1,42074,42946,872
2022-04-19,70043,70838,Blue,0,49192,49388,196
2022-09-26,70044,70046,Blue,1,24729,24835,106
2022-01-10,70049,70838,Blue,0,60451,61049,598
2022-06-24,70057,70043,Blue,0,62585,63376,791
2022-03-08,70044,70048,Blue,1,60048,60298,250
2022-04-07,70058,70060,Blue,1,66579,66716,137
2022-10-27,70038,70044,Blue,1,39983,40168,185
2022-06-09,70047,70043,Blue,0,33597,33906,309
2022-03-23,70056,70060,Blue,1,45287,45479,192
2022-12-23,70042,70054,Blue,1,47232,47888,656
2022-06-23,70057,70055,Blue,0,61286,61356,70
2022-01-24,70055,70043,Blue,0,38885,39646,761
2022-04-07,70053,70049,Blue,0,80391,80610,219
2022-03-20,70046,70056,Blue,1,78934,79440,506
2022-07-09,70042,70048,Blue,1,22470,22792,322
2022-08-19,70042,70046,Blue,1,38290,38474,184
2022-01-09,70041,70039,Blue,0,32563,32595,32
2022-11-02,70038,70060,Blue,1,83345,84483,1138
2022-01-20,70051,70047,Blue,0,85553,85755,202
2022-03-24,70042,70056,Blue,1,28008,28839,831
2022-01-01,70055,70043,Blue,0,46464,47153,689
2022-07-06,70055,70043,Blue,0,82990,83657,667
2022-09-23,70046,70048,Blue,1,41961,42048,87
2022-12-10,70041,70838,Blue,0,21829,21969,140
2022-01-17,70044,70058,Blue,1,85705,86499,794
2022-12-09,70059,70039,Blue,0,23422,24588,1166
2022-07-03,70040,70052,Blue,1,77608,78292,684
2022-08-26,70044,70054,Blue,1,88514,89138,624
2022-06-27,70040,70054,Blue,1,35524,36527,1003
2022-12-06,70052,70056,Blue,1,58432,58571,139
2022-11-10,70050,70054,Blue,1,75906,76111,205
2022-02-01,70042,70054,Blue,1,26074,26774,700
2022-07-23,70057,70043,Blue,0,77892,78726,834
2022-11-23,70040,70054,Blue,1,39081,39822,741
2022-11-01,70059,70053,Blue,0,22299,22575,276
2022-03-02,70038,70048,Blue,1,26655,27115,460
2022-10-06,70053,70838,Blue,0,80238,81057,819
2022-03-18,70044,70046,Blue,1,25329,25452,123
2022-09-17,70040,70042,Blue,1,58888,58920,32
2022-10-29,70042,70058,Blue,1,62413,63627,1214
2022-07-10,70042,70056,Blue,1,48987,49804,817
2022-07-04,70038,70060,Blue,1,58067,59344,1277
2022-04-21,70042,70050,Blue,1,49882,50277,395
2022-04-29,70054,70056,Blue,1,44216,44262,46
2022-02-12,70051,70045,Blue,0,70670,70993,323
2022-07-20,70044,70060,Blue,1,34379,35323,944
2022-03-03,70050,70058,Blue,1,33254,33668,414
2022-07-01,70055,70041,Blue,0,52400,53558,1158
2022-12-25,70056,70058,Blue,1,66552,66629,77
2022-02-22,70055,70053,Blue,0,62474,62526,52
2022-03-26,70055,70051,Blue,0,67781,67931,150
2022-01-23,70052,70060,Blue,1,75509,75828,319
2022-01-26,70047,70838,Blue,0,24288,24799,511
2022-03-28,70049,70041,Blue,0,67036,67476,440
2022-03-21,70038,70056,Blue,1,19990,20971,981
2022-06-30,70046,70060,Blue,1,31039,31791,752
2022-01-05,70043,70041,Blue,0,33809,33850,41
2022-05-31,70045,70838,Blue,0,19744,20117,373
2022-09-04,70043,70041,Blue,0,59645,59687,42
2022-05-18,70040,70052,Blue,1,46645,47295,650
2022-07-07,70047,70838,Blue,0,39294,39815,521
2022-12-26,70057,70838,Blue,0,22369,23425,1056
2022-04-19,70049,70039,Blue,0,52061,52571,510
2022-10-02,70050,70052,Blue,1,42264,42380,116
2022-12-12,70042,70060,Blue,1,35256,36390,1134
2022-09-23,70054,70058,Blue,1,51016,51169,153
2022-12-01,70038,70054,Blue,1,65834,66620,786
2022-09-01,70040,70056,Blue,1,26207,27024,817
2022-03-02,70053,70043,Blue,0,85446,86042,596
2022-07-19,70046,70050,Blue,1,25252,25441,189
2022-09-12,70047,70039,Blue,0,45374,45774,400
2022-11-12,70054,70058,Blue,1,42396,42550,154
2022-09-10,70048,70050,Blue,1,43683,43739,56
2022-01-15,70038,70052,Blue,1,68597,69350,753
2022-06-09,70059,70039,Blue,0,32059,33226,1167
2022-03-10,70052,70054,Blue,1,45600,45649,49
2022-03-13,70040,70048,Blue,1,85835,86242,407
2022-03-08,70040,70060,Blue,1,30618,31801,1183
2022-11-25,70040,70054,Blue,1,57158,57870,712
2022-04-26,70059,70047,Blue,0,40519,41184,665
2022-11-17,70045,70041,Blue,0,24219,24400,181
2022-02-21,70046,70060,Blue,1,88575,89308,733
2022-10-17,70050,70058,Blue,1,50810,51513,703
2022-06-20,70055,70039,Blue,0,61532,62409,877
2022-06-29,70050,70056,Blue,1,74834,75137,303
2022-01-09,70044,70046,Blue,1,83971,84083,112
2022-07-16,70054,70060,Blue,1,71524,71779,255
2022-12-08,70057,70039,Blue,0,24780,25877,1097
2022-06-15,70054,70058,Blue,1,45641,45797,156
2022-08-04,70050,70052,Blue,1,44834,44951,117
2022-10-28,70049,70838,Blue,0,47346,47934,588
2022-07-10,70057,70041,Blue,0,22351,23208,857
2022-08-13,70038,70050,Blue,1,32581,33114,533
2022-03-01,70047,70039,Blue,0,19004,19450,446
2022-12-25,70053,70039,Blue,0,53047,53802,755
2022-02-07,70038,70040,Blue,1,80289,80304,15
2022-03-31,70042,70054,Blue,1,56390,57026,636
2022-09-20,70040,70046,Blue,1,53802,54089,287
2022-08-23,70040,70058,Blue,1,30816,31763,947
2022-06-20,70053,70049,Blue,0,60715,60910,195
2022-02-11,70053,70043,Blue,0,58955,59629,674
2022-04-02,70044,70052,Blue,1,69831,70318,487
2022-12-19,70049,70039,Blue,0,70466,70965,499
2022-06-30,70049,70043,Blue,0,26892,27265,373
2022-08-10,70038,70058,Blue,1,52435,53483,1048
2022-12-20,70038,70054,Blue,1,33524,34332,808
2022-12-05,70042,70052,Blue,1,31529,32119,590
2022-04-10,70042,70054,Blue,1,43912,44616,704
2022-01-10,70043,70039,Blue,0,80965,81075,110
2022-07-09,70042,70044,Blue,1,36849,36883,34
2022-02-02,70042,70058,Blue,1,60888,62178,1290
2022-11-20,70044,70052,Blue,1,83924,84422,498
2022-11-22,70052,70056,Blue,1,53726,53864,138
2022-01-16,70041,70838,Blue,0,47772,47892,120
2022-03-31,70059,70045,Blue,0,37548,38307,759
2022-07-20,70051,70041,Blue,0,81695,82243,548
2022-06-14,70043,70838,Blue,0,65299,65488,189
2022-07-11,70038,70060,Blue,1,49235,50388,1153
2022-04-05,70041,70838,Blue,0,87334,87447,113
2022-02-10,70057,70049,Blue,0,53965,54389,424
2022-09-28,70052,70058,Blue,1,69232,69473,241
2022-12-28,70053,70049,Blue,0,26927,27127,200
2022-09-26,70038,70048,Blue,1,23796,24230,434
2022-01-12,70052,70058,Blue,1,47131,47368,237
2022-04-14,70055,70041,Blue,0,46814,47954,1140
2022-10-08,70053,70039,Blue,0,54877,55633,756
2022-12-17,70038,70054,Blue,1,62595,63418,823
2022-01-12,70053,70047,Blue,0,57524,57821,297
2022-02-17,70040,70048,Blue,1,87208,87584,376
2022-09-27,70043,70838,Blue,0,49299,49484,185
2022-10-20,70038,70042,Blue,1,26899,26987,88
2022-03-27,70050,70056,Blue,1,40254,40550,296
2022-03-05,70051,70047,Blue,0,21853,22051,198
2022-06-09,70040,70046,Blue,1,37400,37695,295
2022-11-29,70047,70043,Blue,0,74397,74620,223
2022-10-16,70044,70060,Blue,1,23225,24415,1190
2022-04-14,70059,70039,Blue,0,43215,44343,1128
2022-04-28,70052,70058,Blue,1,28744,29009,265
2022-11-30,70043,70039,Blue,0,77936,78043,107
2022-01-13,70055,70043,Blue,0,54680,55364,684
2022-03-25,70046,70048,Blue,1,62917,63016,99
2022-01-13,70040,70050,Blue,1,48171,48720,549
2022-04-14,70057,70838,Blue,0,48749,49958,1209
2022-10-28,70046,70060,Blue,1,26471,27241,770
2022-11-09,70055,70045,Blue,0,43368,43922,554
2022-09-24,70042,70058,Blue,1,37924,38772,848
2022-08-08,70052,70060,Blue,1,88921,89288,367
2022-11-29,70045,70043,Blue,0,68866,68953,87
2022-03-15,70040,70056,Blue,1,88039,88932,893
2022-01-04,70040,70050,Blue,1,64395,64894,499
2022-03-01,70038,70040,Blue,1,25148,25167,19
2022-01-26,70040,70060,Blue,1,27943,29011,1068
2022-09-11,70042,70048,Blue,1,54398,54704,306
2022-07-12,70056,70060,Blue,1,65231,65408,177
2022-04-14,70050,70052,Blue,1,45231,45336,105
2022-02-22,70053,70045,Blue,0,61661,62099,438
2022-01-12,70040,70050,Blue,1,59288,59854,566
2022-10-16,70051,70045,Blue,0,48783,49101,318
2022-01-15,70052,70054,Blue,1,38065,38125,60
2022-10-21,70044,70052,Blue,1,88472,89004,532
2022-03-09,70046,70050,Blue,1,24913,25127,214
2022-02-22,70053,70051,Blue,0,52799,52862,63
2022-01-11,70044,70046,Blue,1,82771,82967,196
2022-01-07,70049,70043,Blue,0,33211,33558,347
2022-09-09,70038,70042,Blue,1,54551,54690,139
2022-05-19,70044,70046,Blue,1,68872,68996,124
2022-02-28,70051,70049,Blue,0,22068,22172,104
2022-01-31,70040,70046,Blue,1,73463,73756,293
2022-08-14,70057,70051,Blue,0,78998,79240,242
2022-11-09,70053,70838,Blue,0,28216,29197,981
2022-03-03,70048,70052,Blue,1,35250,35503,253
2022-03-29,70059,70838,Blue,0,81734,82851,1117
2022-07-22,70055,70838,Blue,0,63882,64920,1038
2022-08-19,70049,70047,Blue,0,54628,54681,53
2022-09-23,70042,70058,Blue,1,72922,73819,897
2022-07-12,70044,70052,Blue,1,30569,31136,567
2022-09-24,70051,70049,Blue,0,57670,57772,102
2022-04-18,70043,70838,Blue,0,72991,73194,203
2022-11-26,70049,70047,Blue,0,73477,73534,57
2022-03-24,70042,70044,Blue,1,26791,26822,31
2022-09-24,70045,70041,Blue,0,28916,29093,177
2022-06-01,70038,70050,Blue,1,74424,75153,729
2022-11-17,70044,70060,Blue,1,41890,42835,945
2022-11-07,70047,70045,Blue,0,38178,38266,88
2022-08-24,70040,70046,Blue,1,29486,29740,254
2022-11-25,70050,70052,Blue,1,38304,38413,109
2022-05-11,70052,70058,Blue,1,55909,56179,270
2022-03-25,70041,70838,Blue,0,60021,60132,111
2022-08-12,70040,70044,Blue,1,44278,44395,117
2022-11-30,70049,70045,Blue,0,82683,82879,196
2022-07-16,70045,70838,Blue,0,73254,73608,354
2022-02-28,70041,70838,Blue,0,27425,27567,142
2022-01-28,70057,70053,Blue,0,22487,22666,179
2022-12-23,70049,70047,Blue,0,26952,27021,69
2022-08-09,70055,70041,Blue,0,70892,71620,728
2022-06-30,70053,70043,Blue,0,69763,70374,611
2022-11-04,70059,70838,Blue,0,54879,56138,1259
2022-08-17,70040,70044,Blue,1,69592,69705,113
2022-05-06,70057,70049,Blue,0,54006,54395,389
2022-06-21,70041,70838,Blue,0,78638,78764,126
2022-09-24,70046,70056,Blue,1,50565,51105,540
2022-03-09,70051,70041,Blue,0,51123,51659,536
2022-10-31,70055,70049,Blue,0,69857,70158,301
2022-02-03,70055,70838,Blue,0,28646,29610,964
2022-06-11,70047,70043,Blue,0,52525,52793,268
2022-01-12,70049,70045,Blue,0,46114,46305,191
2022-07-22,70051,70043,Blue,0,56898,57585,687
2022-08-27,70047,70043,Blue,0,45508,45759,251
2022-06-24,70055,70039,Blue,0,69287,70174,887
2022-10-04,70053,70047,Blue,0,60588,60895,307
2022-02-13,70046,70050,Blue,1,38092,38270,178
2022-11-15,70056,70058,Blue,1,66507,66577,70
2022-09-24,70042,70056,Blue,1,50870,51628,758
2022-05-10,70059,70049,Blue,0,21315,21802,487
2022-07-12,70048,70050,Blue,1,61827,61884,57
2022-05-21,70055,70043,Blue,0,84270,85059,789
2022-12-29,70053,70045,Blue,0,33615,34067,452
2022-07-04,70046,70052,Blue,1,42486,42859,373
2022-02-02,70042,70044,Blue,1,26498,26527,29
2022-01-06,70051,70045,Blue,0,34695,35067,372
2022-08-30,70057,70055,Blue,0,70291,70360,69
2022-01-04,70039,70838,Blue,0,78119,78153,34
2022-10-06,70051,70047,Blue,0,51160,51358,198
2022-12-28,70042,70050,Blue,1,27347,27738,391
2022-11-05,70052,70056,Blue,1,47296,47436,140
2022-08-22,70059,70043,Blue,0,84235,85191,956
2022-08-14,70038,70054,Blue,1,77470,78313,843
2022-07-05,70044,70046,Blue,1,55093,55211,118
2022-07-18,70038,70052,Blue,1,47740,48555,815
2022-09-08,70044,70058,Blue,1,69915,70701,786
2022-06-09,70049,70043,Blue,0,26924,27369,445
2022-11-07,70038,70056,Blue,1,30825,31818,993
2022-12-22,70052,70056,Blue,1,26542,26679,137
2022-12-14,70045,70041,Blue,0,35737,35925,188
2022-02-18,70038,70050,Blue,1,74131,74748,617
2022-01-10,70057,70045,Blue,0,56987,57670,683
2022-05-11,70052,70058,Blue,1,71585,71851,266
2022-12-20,70051,70045,Blue,0,64192,64535,343
2022-08-03,70057,70055,Blue,0,32325,32395,70
2022-01-02,70044,70050,Blue,1,43169,43505,336
2022-11-27,70038,70052,Blue,1,54266,55010,744
2022-10-24,70050,70056,Blue,1,27676,27988,312
2022-03-12,70051,70047,Blue,0,46952,47146,194
2022-11-12,70047,70043,Blue,0,67801,68036,235
2022-04-07,70040,70056,Blue,1,75933,76778,845
2022-03-28,70057,70055,Blue,0,24947,25019,72
2022-12-05,70055,70039,Blue,0,42785,43607,822
2022-02-28,70038,70052,Blue,1,89166,89942,776
2022-08-09,70059,70838,Blue,0,73810,74854,1044
2022-01-20,70056,70058,Blue,1,24119,24206,87
2022-04-22,70054,70056,Blue,1,63144,63191,47
2022-06-27,70044,70060,Blue,1,33891,34907,1016
2022-10-26,70042,70050,Blue,1,21578,21982,404
2022-11-18,70047,70045,Blue,0,32951,33044,93
2022-05-23,70038,70048,Blue,1,82266,82813,547
2022-01-07,70049,70047,Blue,0,44487,44550,63
2022-02-12,70050,70058,Blue,1,35881,36392,511
2022-01-13,70049,70045,Blue,0,44918,45152,234
2022-01-20,70053,70041,Blue,0,32019,32692,673
2022-07-08,70048,70052,Blue,1,84832,85037,205
2022-05-27,70038,70044,Blue,1,68967,69161,194
2022-06-17,70042,70044,Blue,1,84405,84436,31
2022-02-11,70055,70838,Blue,0,69748,70745,997
2022-06-14,70038,70040,Blue,1,59840,59854,14
2022-09-19,70038,70040,Blue,1,84141,84156,15
2022-04-13,70049,70041,Blue,0,83016,83422,406
2022-03-08,70057,70049,Blue,0,59962,60333,371
2022-12-18,70047,70045,Blue,0,85244,85344,100
2022-08-10,70057,70051,Blue,0,22664,22899,235
2022-07-25,70055,70047,Blue,0,60374,60767,393
2022-04-11,70059,70049,Blue,0,47116,47584,468
2022-09-07,70048,70060,Blue,1,28443,29136,693
2022-12-08,70038,70048,Blue,1,46654,47085,431
2022-09-04,70041,70039,Blue,0,46184,46225,41
2022-08-26,70055,70043,Blue,0,27156,27841,685
2022-02-18,70046,70052,Blue,1,91208,91638,430
2022-06-23,70053,70039,Blue,0,61954,62755,801
2022-01-07,70059,70057,Blue,0,23656,23700,44
2022-10-10,70038,70052,Blue,1,51343,52070,727
2022-05-10,70056,70058,Blue,1,74668,74747,79
2022-12-12,70055,70051,Blue,0,60514,60669,155
2022-09-22,70053,70043,Blue,0,86253,86819,566
2022-04-11,70054,70060,Blue,1,35010,35290,280
2022-02-08,70040,70060,Blue,1,42793,43910,1117
2022-12-31,70055,70039,Blue,0,57019,57840,821
2022-11-03,70044,70058,Blue,1,52554,53340,786
2022-01-23,70053,70047,Blue,0,39116,39434,318
2022-12-06,70059,70045,Blue,0,57935,58701,766
2022-09-12,70038,70050,Blue,1,43160,43736,576
2022-02-01,70055,70051,Blue,0,19065,19254,189
2022-03-21,70042,70052,Blue,1,88451,88973,522
2022-04-05,70040,70042,Blue,1,71480,71513,33
2022-03-26,70055,70043,Blue,0,69474,70131,657
2022-02-28,70059,70055,Blue,0,63502,63644,142
2022-04-26,70059,70047,Blue,0,67517,68098,581
2022-03-08,70049,70045,Blue,0,56499,56684,185
2022-05-03,70057,70049,Blue,0,25179,25600,421
2022-02-09,70053,70045,Blue,0,59064,59511,447
2022-02-21,70044,70050,Blue,1,68870,69254,384
2022-08-01,70053,70051,Blue,0,80078,80133,55
2022-01-05,70051,70838,Blue,0,61475,62186,711
2022-02-01,70051,70047,Blue,0,36838,37093,255
2022-07-26,70048,70050,Blue,1,73178,73241,63
2022-07-06,70055,70041,Blue,0,67518,68241,723
2022-01-17,70051,70838,Blue,0,63629,64355,726
2022-12-09,70042,70048,Blue,1,61764,62096,332
2022-12-16,70044,70054,Blue,1,24013,24617,604
2022-11-14,70046,70052,Blue,1,28926,29243,317
2022-08-06,70048,70050,Blue,1,30632,30690,58
2022-12-14,70046,70054,Blue,1,66828,67244,416
2022-02-21,70038,70042,Blue,1,86412,86510,98
2022-09-24,70055,70045,Blue,0,46701,47233,532
2022-08-30,70038,70050,Blue,1,30794,31327,533
2022-07-01,70050,70058,Blue,1,82106,82866,760
2022-05-19,70038,70052,Blue,1,47605,48482,877
2022-07-08,70038,70060,Blue,1,73861,75088,1227
2022-04-19,70042,70050,Blue,1,59439,59871,432
2022-12-29,70055,70045,Blue,0,22477,23023,546
2022-11-11,70042,70058,Blue,1,45756,46588,832
2022-12-15,70044,70052,Blue,1,84815,85348,533
2022-12-14,70057,70043,Blue,0,68190,68956,766
2022-12-14,70053,70045,Blue,0,59093,59542,449
2022-02-27,70057,70049,Blue,0,36273,36688,415
2022-12-30,70052,70060,Blue,1,59214,59591,377
2022-06-16,70046,70052,Blue,1,24371,24741,370
2022-12-07,70044,70056,Blue,1,73833,74461,628
2022-02-26,70057,70047,Blue,0,22238,22764,526
2022-11-15,70049,70041,Blue,0,47371,47822,451
2022-10-07,70044,70058,Blue,1,51765,52552,787
2022-08-16,70050,70052,Blue,1,76343,76466,123
2022-03-18,70059,70041,Blue,0,50241,51187,946
2022-12-16,70051,70041,Blue,0,40444,41013,569
2022-07-24,70047,70838,Blue,0,87905,88403,498
2022-07-14,70038,70052,Blue,1,79127,80017,890
2022-12-01,70044,70050,Blue,1,30875,31218,343
2022-03-18,70053,70051,Blue,0,78033,78090,57
2022-01-03,70046,70048,Blue,1,58149,58221,72
2022-03-07,70045,70838,Blue,0,20733,21113,380
2022-04-13,70040,70048,Blue,1,48735,49134,399
2022-09-08,70059,70055,Blue,0,30140,30286,146
2022-10-14,70044,70050,Blue,1,29405,29737,332
2022-08-26,70057,70051,Blue,0,80921,81169,248
2022-02-10,70050,70056,Blue,1,61987,62291,304
2022-11-30,70038,70058,Blue,1,59190,60202,1012
2022-01-11,70059,70053,Blue,0,66500,66775,275
2022-10-19,70046,70060,Blue,1,66154,66953,799
2022-09-22,70059,70047,Blue,0,56415,57011,596
2022-08-10,70057,70051,Blue,0,23491,23745,254
2022-03-22,70057,70045,Blue,0,50310,50894,584
2022-03-24,70052,70058,Blue,1,34903,35152,249
2022-05-17,70055,70049,Blue,0,44293,44564,271
2022-06-22,70046,70058,Blue,1,72434,73142,708
2022-04-26,70054,70056,Blue,1,75563,75612,49
2022-08-31,70046,70048,Blue,1,48609,48687,78
2022-11-21,70052,70060,Blue,1,62230,62627,397
2022-12-31,70042,70046,Blue,1,62847,63025,178
2022-04-09,70048,70060,Blue,1,59382,59994,612
2022-07-14,70054,70060,Blue,1,62974,63248,274
2022-12-24,70051,70047,Blue,0,50669,50868,199
2022-04-04,70057,70055,Blue,0,88260,88329,69
2022-07-23,70046,70054,Blue,1,25994,26433,439
2022-07-27,70041,70838,Blue,0,70637,70753,116
2022-02-16,70042,70052,Blue,1,21410,21958,548
2022-01-05,70053,70049,Blue,0,35000,35212,212
2022-08-20,70048,70056,Blue,1,43672,44054,382
2022-05-15,70050,70052,Blue,1,58648,58768,120
2022-01-03,70038,70052,Blue,1,29346,29982,636
2022-09-05,70049,70838,Blue,0,59763,60362,599
2022-06-26,70040,70050,Blue,1,43047,43570,523
2022-02-28,70057,70838,Blue,0,59071,60180,1109
2022-01-28,70059,70043,Blue,0,40396,41345,949
2022-12-09,70049,70043,Blue,0,64643,64971,328
2022-10-24,70059,70043,Blue,0,55637,56513,876
2022-12-14,70040,70044,Blue,1,29846,29957,111
2022-08-20,70040,70060,Blue,1,52420,53535,1115
2022-01-15,70055,70047,Blue,0,19696,20067,371
2022-12-05,70055,70838,Blue,0,36549,37420,871
2022-09-13,70042,70050,Blue,1,53519,53923,404
2022-07-15,70044,70052,Blue,1,32725,33267,542
2022-04-04,70057,70041,Blue,0,59682,60511,829
2022-01-27,70050,70054,Blue,1,68801,69182,381
2022-03-24,70058,70060,Blue,1,39569,39637,68
2022-09-22,70053,70045,Blue,0,77199,77613,414
2022-08-02,70056,70060,Blue,1,69606,69982,376
2022-12-17,70044,70048,Blue,1,60145,60395,250
2022-11-10,70038,70044,Blue,1,61154,61351,197
2022-01-20,70045,70043,Blue,0,25991,26131,140
2022-05-18,70038,70042,Blue,1,21487,21592,105
2022-12-10,70040,70046,Blue,1,74000,74244,244
2022-12-30,70056,70058,Blue,1,42741,42810,69
2022-12-02,70052,70054,Blue,1,27210,27269,59
2022-02-10,70054,70058,Blue,1,60411,60570,159
2022-05-20,70052,70060,Blue,1,55610,56084,474
2022-01-22,70042,70060,Blue,1,78076,78985,909
2022-01-07,70053,70039,Blue,0,82615,83362,747
2022-08-30,70038,70054,Blue,1,53716,54501,785
2022-02-09,70041,70039,Blue,0,57653,57688,35
2022-10-20,70059,70043,Blue,0,80525,81393,868
2022-11-23,70038,70056,Blue,1,73637,74476,839
2022-02-06,70056,70058,Blue,1,41452,41527,75
2022-12-09,70038,70046,Blue,1,41319,41623,304
2022-03-31,70058,70060,Blue,1,33953,34064,111
2022-02-15,70055,70049,Blue,0,66078,66402,324
2022-11-20,70048,70056,Blue,1,37599,37982,383
2022-10-31,70043,70041,Blue,0,29824,29852,28
2022-12-27,70050,70058,Blue,1,57968,58423,455
2022-10-20,70048,70060,Blue,1,47629,48218,589
2022-12-23,70045,70039,Blue,0,54284,54539,255
2022-03-10,70049,70045,Blue,0,66097,66297,200
2022-01-18,70057,70055,Blue,0,59969,60037,68
2022-01-08,70044,70056,Blue,1,27688,28356,668
2022-10-17,70042,70052,Blue,1,71955,72509,554
2022-03-18,70049,70045,Blue,0,60092,60307,215
2022-08-18,70043,70039,Blue,0,48444,48558,114
2022-09-04,70047,70043,Blue,0,68476,68713,237
2022-03-24,70059,70057,Blue,0,48194,48229,35
2022-03-19,70059,70039,Blue,0,60555,61544,989
2022-03-05,70059,70039,Blue,0,77802,78799,997
2022-05-19,70059,70041,Blue,0,51552,52638,1086
2022-03-22,70055,70039,Blue,0,55145,55944,799
2022-12-21,70057,70051,Blue,0,55777,56035,258
2022-12-03,70047,70838,Blue,0,79697,80162,465
2022-09-23,70050,70060,Blue,1,51418,51926,508
2022-12-12,70048,70060,Blue,1,70484,71135,651
2022-11-26,70048,70056,Blue,1,69567,69940,373
2022-01-06,70042,70052,Blue,1,36882,37485,603
2022-08-13,70057,70041,Blue,0,49837,50745,908
2022-04-08,70047,70041,Blue,0,69674,69983,309
2022-03-02,70052,70060,Blue,1,25887,26263,376
2022-06-24,70038,70056,Blue,1,84736,85736,1000
2022-03-05,70049,70047,Blue,0,30850,30905,55
2022-09-15,70046,70048,Blue,1,26940,27028,88
2022-08-20,70049,70043,Blue,0,63753,64118,365
2022-12-21,70057,70049,Blue,0,31792,32202,410
2022-06-12,70054,70058,Blue,1,76758,76919,161
2022-03-10,70053,70838,Blue,0,65564,66362,798
2022-12-29,70056,70060,Blue,1,62600,62787,187
2022-08-11,70040,70042,Blue,1,74778,74807,29
2022-02-06,70059,70053,Blue,0,45734,45974,240
2022-04-06,70047,70045,Blue,0,51560,51682,122
2022-11-16,70044,70052,Blue,1,33828,34285,457
2022-01-06,70049,70039,Blue,0,26349,26862,513
2022-06-19,70055,70041,Blue,0,54023,54779,756
2022-12-27,70038,70040,Blue,1,20288,20306,18
2022-08-04,70051,70838,Blue,0,43587,44323,736
2022-11-11,70057,70838,Blue,0,44251,45253,1002
2022-10-27,70057,70041,Blue,0,20913,21762,849
2022-08-29,70040,70048,Blue,1,32524,32911,387
2022-03-03,70038,70042,Blue,1,86533,86641,108
2022-01-10,70046,70054,Blue,1,58890,59310,420
2022-04-05,70046,70052,Blue,1,76719,77072,353
2022-03-28,70042,70054,Blue,1,61814,62460,646
2022-06-19,70051,70039,Blue,0,39228,39922,694
2022-03-31,70045,70043,Blue,0,84775,84870,95
2022-04-05,70059,70053,Blue,0,60497,60742,245
2022-01-06,70048,70054,Blue,1,25953,26261,308
2022-12-24,70053,70049,Blue,0,24778,24984,206
2022-04-04,70047,70043,Blue,0,35877,36134,257
2022-06-14,70059,70838,Blue,0,28761,30011,1250
2022-10-08,70055,70041,Blue,0,71527,72243,716
2022-11-06,70053,70838,Blue,0,39111,39976,865
2022-02-11,70043,70039,Blue,0,64401,64539,138
2022-11-16,70054,70056,Blue,1,63182,63229,47
2022-11-06,70044,70056,Blue,1,80839,81808,969
2022-04-18,70045,70041,Blue,0,27461,27621,160
2022-05-19,70055,70041,Blue,0,39971,40985,1014
2022-09-13,70044,70050,Blue,1,34567,34912,345
2022-01-23,70042,70048,Blue,1,28573,28856,283
2022-08-04,70042,70058,Blue,1,85351,86269,918
2022-10-16,70042,70050,Blue,1,67883,68294,411
2022-02-17,70040,70050,Blue,1,48295,48974,679
2022-07-05,70057,70039,Blue,0,51038,52077,1039
2022-01-31,70038,70040,Blue,1,43518,43536,18
2022-03-30,70050,70056,Blue,1,43539,43821,282
2022-09-09,70059,70053,Blue,0,65237,65951,714
2022-01-14,70053,70039,Blue,0,70297,71097,800
2022-01-22,70038,70046,Blue,1,36671,36982,311
2022-11-17,70057,70055,Blue,0,28194,28264,70
2022-07-23,70053,70045,Blue,0,52195,52623,428
2022-07-12,70044,70048,Blue,1,32625,32878,253
2022-02-04,70044,70046,Blue,1,46016,46134,118
2022-02-10,70052,70060,Blue,1,56357,56873,516
2022-03-08,70051,70047,Blue,0,56955,57155,200
2022-11-30,70038,70040,Blue,1,69565,69581,16
2022-06-16,70051,70043,Blue,0,55443,55985,542
2022-03-06,70046,70054,Blue,1,70818,71277,459
2022-07-22,70059,70043,Blue,0,71395,72278,883
2022-08-01,70053,70838,Blue,0,64968,65810,842
2022-03-07,70051,70045,Blue,0,39074,39423,349
2022-10-31,70050,70052,Blue,1,85964,86071,107
2022-12-07,70059,70053,Blue,0,58032,58275,243
2022-04-16,70048,70056,Blue,1,58308,58695,387
2022-03-17,70040,70060,Blue,1,60505,61681,1176
2022-01-01,70048,70054,Blue,1,77977,78273,296
2022-02-15,70045,70838,Blue,0,63370,63743,373
2022-08-18,70039,70838,Blue,0,64750,64786,36
2022-12-07,70038,70056,Blue,1,31516,32388,872
2022-01-10,70053,70041,Blue,0,38968,39652,684
2022-04-24,70046,70054,Blue,1,57873,58375,502
2022-11-28,70051,70838,Blue,0,65364,66095,731
2022-10-27,70057,70045,Blue,0,61477,62105,628
2022-09-09,70057,70039,Blue,0,71942,72830,888
2022-07-07,70040,70060,Blue,1,25391,26491,1100
2022-03-22,70053,70049,Blue,0,84262,84447,185
2022-03-09,70053,70838,Blue,0,20169,21092,923
2022-06-30,70040,70044,Blue,1,24589,24694,105
2022-08-17,70054,70060,Blue,1,35110,35377,267
2022-01-07,70044,70060,Blue,1,60370,61504,1134
2022-10-24,70056,70058,Blue,1,32860,32934,74
2022-09-28,70040,70042,Blue,1,79714,79744,30
2022-03-29,70047,70838,Blue,0,27012,27631,619
2022-01-28,70046,70056,Blue,1,67678,68198,520
2022-08-22,70056,70058,Blue,1,29964,30075,111
2022-12-21,70044,70056,Blue,1,52198,52950,752
2022-06-22,70055,70045,Blue,0,34823,35384,561
2022-04-07,70057,70838,Blue,0,80686,81677,991
2022-07-02,70048,70050,Blue,1,45350,45409,59
2022-09-12,70059,70043,Blue,0,19514,20466,952
2022-01-26,70056,70060,Blue,1,67412,67680,268
2022-05-20,70055,70039,Blue,0,79110,80052,942
2022-07-17,70053,70838,Blue,0,22532,23336,804
2022-12-28,70052,70054,Blue,1,56503,56552,49
2022-07-21,70059,70043,Blue,0,54073,54921,848
2022-06-30,70047,70838,Blue,0,61578,62127,549
2022-01-01,70052,70058,Blue,1,36239,36489,250
2022-07-09,70059,70039,Blue,0,41667,42745,1078
2022-11-17,70047,70039,Blue,0,26377,26868,491
2022-11-30,70042,70050,Blue,1,63223,63675,452
2022-12-02,70057,70053,Blue,0,80545,80700,155
2022-11-24,70040,70042,Blue,1,91206,91242,36
2022-02-15,70055,70043,Blue,0,20436,21199,763
2022-01-21,70038,70050,Blue,1,64936,65533,597
2022-01-25,70051,70838,Blue,0,60527,61317,790
2022-12-30,70053,70049,Blue,0,43217,43415,198
2022-01-23,70046,70056,Blue,1,69348,69893,545
2022-12-31,70042,70044,Blue,1,82970,82998,28
2022-09-07,70054,70060,Blue,1,49948,50208,260
2022-08-08,70038,70056,Blue,1,61693,62656,963
2022-09-05,70046,70056,Blue,1,78389,78962,573
2022-07-23,70059,70049,Blue,0,82919,83389,470
2022-08-08,70057,70051,Blue,0,45389,45635,246
2022-11-09,70040,70042,Blue,1,24217,24255,38
2022-09-02,70048,70060,Blue,1,57235,57894,659
2022-11-20,70049,70041,Blue,0,78755,79173,418
2022-07-20,70046,70048,Blue,1,33663,33751,88
2022-11-09,70045,70838,Blue,0,39803,40151,348
2022-02-13,70038,70058,Blue,1,46812,47871,1059
2022-08-21,70059,70838,Blue,0,36201,37331,1130
2022-08-14,70055,70041,Blue,0,49162,49924,762
2022-09-20,70040,70056,Blue,1,24689,25538,849
2022-11-20,70056,70058,Blue,1,78066,78141,75
2022-03-10,70038,70056,Blue,1,33550,34471,921
2022-12-19,70059,70053,Blue,0,20425,20647,222
2022-01-08,70055,70045,Blue,0,24975,25497,522
2022-05-18,70055,70045,Blue,0,23353,24063,710
2022-12-29,70052,70054,Blue,1,25697,25753,56
2022-08-19,70044,70046,Blue,1,56297,56405,108
2022-10-28,70049,70045,Blue,0,20936,21156,220
2022-02-12,70051,70049,Blue,0,21234,21341,107
2022-06-12,70042,70046,Blue,1,84774,84953,179
2022-01-22,70040,70042,Blue,1,35125,35158,33
2022-10-21,70057,70041,Blue,0,60088,60920,832
2022-01-04,70042,70060,Blue,1,24093,25173,1080
2022-03-28,70051,70045,Blue,0,54558,54921,363
2022-09-25,70055,70053,Blue,0,40349,40396,47
2022-01-12,70052,70058,Blue,1,61151,61530,379
2022-04-16,70042,70050,Blue,1,19960,20392,432
2022-08-05,70047,70041,Blue,0,63180,63587,407
2022-07-26,70059,70045,Blue,0,76941,77621,680
2022-06-13,70054,70056,Blue,1,22939,22985,46
2022-10-12,70043,70041,Blue,0,80723,80751,28
2022-11-10,70059,70053,Blue,0,32958,33188,230
2022-07-30,70042,70056,Blue,1,73013,73778,765
2022-02-28,70046,70050,Blue,1,20165,20355,190
2022-09-16,70057,70049,Blue,0,23085,23504,419
2022-01-02,70042,70058,Blue,1,39160,39990,830
2022-11-12,70053,70039,Blue,0,35999,36770,771
2022-07-08,70051,70047,Blue,0,26815,27037,222
2022-03-15,70056,70060,Blue,1,59248,59427,179
2022-12-25,70052,70060,Blue,1,57318,57689,371
2022-02-06,70055,70051,Blue,0,49355,49510,155
2022-01-14,70047,70041,Blue,0,21651,21989,338
2022-09-19,70059,70051,Blue,0,54606,54930,324
2022-11-18,70053,70051,Blue,0,79846,79902,56
2022-05-06,70053,70049,Blue,0,43195,43412,217
2022-03-15,70044,70052,Blue,1,34817,35358,541
2022-06-20,70049,70047,Blue,0,73889,73944,55
2022-12-28,70053,70039,Blue,0,27644,28386,742
2022-06-28,70040,70054,Blue,1,26384,27195,811
2022-07-14,70040,70042,Blue,1,82078,82111,33
2022-07-25,70041,70039,Blue,0,38638,38674,36
2022-06-14,70059,70045,Blue,0,42100,42920,820
2022-01-02,70059,70041,Blue,0,81557,82473,916
2022-12-06,70053,70043,Blue,0,69418,69965,547
2022-08-27,70040,70054,Blue,1,26367,27098,731
2022-04-23,70044,70048,Blue,1,38550,38794,244
2022-03-11,70050,70058,Blue,1,22451,22876,425
2022-07-17,70059,70047,Blue,0,62474,63031,557
2022-05-12,70050,70052,Blue,1,52889,53010,121
2022-01-26,70059,70041,Blue,0,50235,51111,876
2022-07-02,70059,70039,Blue,0,27076,28088,1012
2022-11-29,70059,70053,Blue,0,34756,34991,235
2022-10-22,70059,70039,Blue,0,82336,83352,1016
2022-07-10,70048,70052,Blue,1,46154,46379,225
2022-04-12,70053,70045,Blue,0,63160,63612,452
2022-08-29,70051,70838,Blue,0,26739,27605,866
2022-01-26,70047,70039,Blue,0,34193,34668,475
2022-12-01,70047,70045,Blue,0,42843,42936,93
2022-09-02,70059,70047,Blue,0,54073,54629,556
2022-03-30,70050,70058,Blue,1,24607,25026,419
2022-01-05,70045,70043,Blue,0,24394,24479,85
2022-08-16,70038,70044,Blue,1,77302,77487,185
2022-07-15,70047,70041,Blue,0,66799,67141,342
2022-11-19,70044,70046,Blue,1,27148,27247,99
2022-09-17,70051,70045,Blue,0,54531,54939,408
2022-09-12,70057,70041,Blue,0,50018,50900,882
2022-09-13,70057,70041,Blue,0,24632,25528,896
2022-01-06,70049,70043,Blue,0,49877,50370,493
2022-02-26,70059,70051,Blue,0,87382,87759,377
2022-04-22,70048,70056,Blue,1,51247,51623,376
2022-01-10,70046,70056,Blue,1,62437,62949,512
2022-07-31,70053,70051,Blue,0,43058,43116,58
2022-05-07,70053,70049,Blue,0,66285,66487,202
2022-05-31,70049,70838,Blue,0,35929,36641,712
2022-03-25,70040,70060,Blue,1,33307,34438,1131
2022-02-07,70049,70047,Blue,0,23618,23687,69
2022-12-03,70039,70838,Blue,0,25962,25996,34
2022-08-07,70059,70057,Blue,0,51146,51181,35
2022-06-30,70054,70056,Blue,1,23803,23850,47
2022-04-22,70059,70041,Blue,0,65596,66487,891
2022-03-11,70048,70056,Blue,1,56697,57065,368
2022-02-13,70055,70049,Blue,0,45566,45847,281
2022-03-19,70038,70048,Blue,1,53412,53896,484
2022-06-13,70050,70058,Blue,1,20408,20935,527
2022-03-17,70044,70054,Blue,1,78853,79453,600
2022-06-26,70048,70056,Blue,1,28990,29388,398
2022-09-02,70040,70052,Blue,1,24011,24615,604
2022-02-20,70044,70050,Blue,1,49604,49935,331
2022-10-29,70048,70058,Blue,1,83447,83959,512
2022-02-28,70051,70041,Blue,0,86636,87179,543
2022-04-17,70059,70045,Blue,0,59777,60475,698
2022-10-18,70056,70058,Blue,1,53472,53551,79
2022-03-08,70052,70060,Blue,1,40180,40567,387
2022-02-21,70040,70052,Blue,1,59969,60644,675
2022-12-29,70051,70045,Blue,0,66900,67224,324
2022-01-02,70047,70041,Blue,0,72874,73203,329
2022-10-18,70047,70043,Blue,0,27437,27731,294
2022-09-21,70049,70047,Blue,0,25351,25412,61
2022-10-03,70049,70041,Blue,0,65272,65717,445
2022-10-27,70057,70041,Blue,0,31228,32129,901
2022-12-11,70055,70043,Blue,0,63196,63862,666
2022-03-22,70058,70060,Blue,1,72477,72543,66
2022-06-21,70053,70045,Blue,0,68723,69176,453
2022-11-02,70040,70052,Blue,1,31643,32280,637
2022-06-10,70059,70057,Blue,0,63875,63963,88
2022-09-06,70040,70044,Blue,1,26204,26320,116
2022-08-23,70057,70039,Blue,0,61388,62405,1017
2022-11-02,70048,70050,Blue,1,87025,87079,54
2022-11-16,70040,70054,Blue,1,69726,70525,799
2022-12-06,70044,70046,Blue,1,56505,56610,105
2022-11-29,70048,70058,Blue,1,79372,79864,492
2022-06-16,70042,70056,Blue,1,63330,64145,815
2022-06-22,70048,70052,Blue,1,77566,77770,204
2022-10-03,70054,70060,Blue,1,34001,34321,320
2022-01-28,70059,70051,Blue,0,62894,63257,363
2022-05-19,70042,70048,Blue,1,80026,80428,402
2022-10-03,70048,70052,Blue,1,57000,57209,209
2022-03-03,70046,70060,Blue,1,31857,32703,846
2022-07-28,70045,70043,Blue,0,47617,47720,103
2022-09-21,70042,70054,Blue,1,36589,37303,714
2022-10-13,70057,70053,Blue,0,80194,80341,147
2022-06-16,70047,70043,Blue,0,27050,27366,316
2022-01-15,70042,70050,Blue,1,65638,66211,573
2022-08-17,70038,70052,Blue,1,37905,38710,805
2022-10-25,70043,70041,Blue,0,82099,82127,28
2022-02-10,70040,70054,Blue,1,54102,54839,737
2022-05-24,70049,70047,Blue,0,51020,51075,55
2022-03-31,70049,70043,Blue,0,65191,65579,388
2022-12-26,70051,70838,Blue,0,62302,63056,754
2022-08-03,70040,70054,Blue,1,56210,57059,849
2022-07-27,70050,70056,Blue,1,23675,23962,287
2022-03-05,70049,70039,Blue,0,47578,48113,535
2022-11-03,70044,70056,Blue,1,42767,43432,665
2022-09-28,70053,70039,Blue,0,42453,43291,838
2022-04-06,70057,70055,Blue,0,77843,77911,68
2022-01-27,70055,70043,Blue,0,26656,27397,741
2022-05-25,70045,70838,Blue,0,42734,43148,414
2022-06-21,70044,70046,Blue,1,31492,31639,147
2022-05-20,70038,70048,Blue,1,56059,56651,592
2022-01-04,70058,70060,Blue,1,35273,35349,76
2022-12-22,70040,70058,Blue,1,27838,28794,956
2022-01-31,70043,70041,Blue,0,58122,58149,27
2022-02-18,70038,70046,Blue,1,44119,44460,341
2022-02-01,70057,70041,Blue,0,53201,54185,984
2022-03-25,70056,70060,Blue,1,65035,65218,183
2022-03-07,70038,70060,Blue,1,57132,58366,1234
2022-03-15,70051,70043,Blue,0,28636,29194,558
2022-03-14,70057,70053,Blue,0,65374,65525,151
2022-07-15,70044,70060,Blue,1,57857,58868,1011
2022-02-08,70042,70060,Blue,1,56102,57138,1036
2022-01-07,70059,70049,Blue,0,19165,19745,580
2022-12-15,70053,70041,Blue,0,21867,22574,707
2022-02-22,70046,70058,Blue,1,48552,49136,584
2022-12-29,70038,70058,Blue,1,67264,68280,1016
2022-11-10,70057,70047,Blue,0,20935,21501,566
2022-06-15,70049,70043,Blue,0,50936,51352,416
2022-09-20,70051,70043,Blue,0,36263,36853,590
2022-12-20,70055,70053,Blue,0,60561,60607,46
2022-06-25,70042,70060,Blue,1,83341,84586,1245
2022-03-24,70047,70041,Blue,0,19575,20066,491
2022-08-03,70055,70039,Blue,0,69377,70190,813
2022-08-18,70059,70057,Blue,0,73399,73436,37
2022-04-14,70050,70054,Blue,1,59560,59762,202
2022-09-24,70047,70838,Blue,0,24142,24676,534
2022-08-14,70051,70041,Blue,0,68311,68882,571
2022-11-29,70054,70060,Blue,1,46461,46718,257
2022-03-21,70042,70048,Blue,1,44864,45205,341
2022-06-23,70038,70040,Blue,1,67042,67062,20
2022-03-09,70048,70060,Blue,1,26857,27510,653
2022-06-19,70050,70058,Blue,1,67884,68286,402
2022-11-09,70040,70060,Blue,1,77912,78910,998
2022-02-08,70046,70048,Blue,1,50665,50738,73
2022-03-15,70048,70060,Blue,1,54543,55222,679
2022-11-14,70041,70039,Blue,0,43605,43639,34
2022-09-09,70053,70039,Blue,0,71531,72376,845
2022-02-12,70052,70054,Blue,1,27709,27758,49
2022-09-15,70042,70060,Blue,1,58509,59519,1010
2022-03-14,70040,70042,Blue,1,76392,76425,33
2022-08-02,70052,70058,Blue,1,42318,42562,244
2022-04-07,70057,70051,Blue,0,65667,65903,236
2022-10-25,70042,70048,Blue,1,69163,69462,299
2022-10-29,70059,70049,Blue,0,22164,22664,500
2022-03-04,70044,70046,Blue,1,42459,42569,110
2022-10-06,70045,70043,Blue,0,52289,52389,100
2022-09-22,70041,70039,Blue,0,61844,61875,31
2022-08-31,70053,70047,Blue,0,60047,60340,293
2022-07-12,70047,70041,Blue,0,50072,50413,341
2022-11-22,70054,70058,Blue,1,53817,53969,152
2022-06-22,70049,70043,Blue,0,30241,30626,385
2022-03-17,70047,70838,Blue,0,85748,86202,454
2022-08-25,70057,70051,Blue,0,21483,21743,260
2022-06-22,70042,70044,Blue,1,25933,25963,30
2022-03-05,70040,70050,Blue,1,40513,41026,513
2022-07-01,70046,70056,Blue,1,83792,84398,606
2022-02-04,70042,70052,Blue,1,36595,37213,618
2022-03-07,70040,70054,Blue,1,64703,65440,737
2022-12-09,70044,70050,Blue,1,43213,43589,376
2022-05-07,70053,70049,Blue,0,55500,55721,221
2022-12-31,70059,70039,Blue,0,21545,22573,1028
2022-08-22,70043,70039,Blue,0,22759,22913,154
2022-12-24,70048,70058,Blue,1,71191,71722,531
2022-03-21,70044,70054,Blue,1,33825,34456,631
2022-12-08,70047,70838,Blue,0,38328,38801,473
2022-12-15,70040,70060,Blue,1,28213,29276,1063
2022-02-03,70055,70049,Blue,0,55271,55611,340
2022-05-18,70049,70043,Blue,0,56495,56995,500
2022-02-21,70040,70042,Blue,1,88277,88310,33
2022-01-26,70052,70054,Blue,1,45004,45065,61
2022-11-30,70045,70039,Blue,0,62516,62773,257
2022-07-18,70040,70050,Blue,1,64650,65172,522
2022-04-05,70057,70049,Blue,0,65982,66388,406
2022-01-04,70043,70041,Blue,0,61962,61992,30
2022-09-27,70059,70049,Blue,0,64995,65478,483
2022-09-18,70059,70039,Blue,0,85515,86581,1066
2022-02-07,70038,70046,Blue,1,82617,82931,314
2022-06-22,70050,70054,Blue,1,31260,31464,204
2022-05-20,70057,70838,Blue,0,55231,56398,1167
2022-09-27,70050,70060,Blue,1,34629,35195,566
2022-03-16,70044,70058,Blue,1,27499,28315,816
2022-06-16,70047,70041,Blue,0,49312,49673,361
2022-02-20,70055,70041,Blue,0,81050,81956,906
2022-01-26,70049,70041,Blue,0,75979,76377,398
2022-12-15,70056,70060,Blue,1,53804,53988,184
2022-08-18,70053,70045,Blue,0,40374,40825,451
2022-09-07,70055,70043,Blue,0,61664,62294,630
2022-03-24,70042,70058,Blue,1,70921,71794,873
2022-12-20,70053,70043,Blue,0,51708,52293,585
2022-08-24,70055,70047,Blue,0,65434,65798,364
2022-12-19,70042,70056,Blue,1,76083,76823,740
2022-11-03,70059,70057,Blue,0,49935,49970,35
2022-10-25,70046,70060,Blue,1,23626,24554,928
2022-03-09,70040,70052,Blue,1,30607,31266,659
2022-01-12,70045,70039,Blue,0,60982,61232,250
2022-02-18,70046,70052,Blue,1,83626,83982,356
2022-12-28,70050,70056,Blue,1,87628,87930,302
2022-05-14,70059,70057,Blue,0,64214,64249,35
2022-01-05,70042,70046,Blue,1,89334,89510,176
2022-11-14,70042,70050,Blue,1,62039,62484,445
2022-08-28,70043,70041,Blue,0,79812,79843,31
2022-02-10,70045,70039,Blue,0,55321,55643,322
2022-10-08,70048,70050,Blue,1,62623,62680,57
2022-10-14,70043,70039,Blue,0,32381,32498,117
2022-07-04,70046,70050,Blue,1,75108,75303,195
2022-12-26,70048,70052,Blue,1,79606,79822,216
2022-08-12,70040,70050,Blue,1,66000,66505,505
2022-04-03,70042,70060,Blue,1,50643,51661,1018
2022-10-08,70057,70055,Blue,0,43888,43956,68
2022-08-26,70038,70050,Blue,1,74524,75096,572
2022-12-19,70046,70052,Blue,1,41030,41379,349
2022-11-03,70055,70051,Blue,0,76096,76243,147
2022-07-18,70040,70044,Blue,1,25263,25368,105
2022-10-15,70054,70060,Blue,1,49925,50173,248
2022-07-15,70053,70051,Blue,0,65787,65836,49
2022-07-15,70038,70040,Blue,1,41191,41206,15
2022-09-20,70057,70041,Blue,0,30658,31593,935
2022-09-11,70042,70046,Blue,1,70058,70235,177
2022-01-20,70049,70041,Blue,0,85144,85618,474
2022-07-01,70048,70056,Blue,1,75359,75754,395
2022-09-24,70059,70053,Blue,0,79880,80111,231
2022-12-23,70048,70060,Blue,1,66965,67698,733
2022-09-24,70044,70056,Blue,1,43358,44016,658
2022-01-01,70043,70838,Blue,0,70945,71151,206
2022-10-25,70054,70058,Blue,1,47567,47725,158
2022-08-01,70040,70056,Blue,1,71114,72052,938
2022-10-04,70059,70057,Blue,0,66558,66596,38
2022-10-22,70059,70049,Blue,0,44346,44805,459
2022-03-05,70052,70060,Blue,1,75522,75894,372
2022-04-15,70052,70056,Blue,1,70650,70780,130
2022-08-15,70046,70048,Blue,1,74024,74100,76
2022-02-17,70059,70047,Blue,0,25161,25780,619
2022-01-17,70047,70041,Blue,0,20219,20596,377
2022-08-30,70049,70045,Blue,0,48328,48514,186
2022-04-20,70046,70050,Blue,1,53414,53587,173
2022-06-30,70048,70050,Blue,1,63305,63366,61
2022-11-17,70049,70043,Blue,0,73304,73654,350
2022-06-28,70048,70058,Blue,1,84634,85128,494
2022-03-17,70059,70045,Blue,0,63794,64468,674
2022-10-22,70057,70043,Blue,0,63329,64111,782
2022-02-18,70055,70053,Blue,0,31356,31421,65
2022-01-18,70048,70052,Blue,1,40109,40316,207
2022-01-11,70057,70053,Blue,0,22844,23037,193
2022-02-04,70047,70838,Blue,0,86931,87457,526
2022-10-27,70040,70058,Blue,1,75441,76408,967
2022-11-12,70057,70041,Blue,0,73586,74441,855
2022-07-08,70046,70050,Blue,1,52537,52733,196
2022-10-12,70053,70039,Blue,0,23926,25026,1100
2022-01-28,70038,70046,Blue,1,29954,30261,307
2022-06-08,70050,70052,Blue,1,76281,76486,205
2022-02-24,70057,70838,Blue,0,56284,57302,1018
2022-09-01,70053,70045,Blue,0,52259,52698,439
2022-04-16,70038,70050,Blue,1,57775,58364,589
2022-06-17,70055,70838,Blue,0,19187,20150,963
2022-10-01,70053,70051,Blue,0,70004,70054,50
2022-04-10,70043,70838,Blue,0,58536,58747,211
2022-08-28,70050,70058,Blue,1,71629,72084,455
2022-04-05,70057,70043,Blue,0,87566,88435,869
2022-04-08,70053,70838,Blue,0,25780,26677,897
2022-09-11,70048,70060,Blue,1,30478,31062,584
2022-10-25,70045,70838,Blue,0,19287,19676,389
2022-06-25,70051,70045,Blue,0,43659,44031,372
2022-12-12,70038,70052,Blue,1,33277,34024,747
2022-10-12,70054,70056,Blue,1,63271,63319,48
2022-07-03,70046,70048,Blue,1,63869,63948,79
2022-09-11,70042,70050,Blue,1,83140,83562,422
2022-12-12,70046,70058,Blue,1,22727,23396,669
2022-06-16,70044,70058,Blue,1,25668,26480,812
2022-03-06,70055,70053,Blue,0,83168,83225,57
2022-02-08,70055,70051,Blue,0,57671,57806,135
2022-08-07,70059,70045,Blue,0,33221,33886,665
2022-01-13,70044,70046,Blue,1,66956,67123,167
2022-02-07,70047,70043,Blue,0,81819,82112,293
2022-12-28,70039,70838,Blue,0,64182,64216,34
2022-08-21,70059,70838,Blue,0,59772,60841,1069
2022-09-12,70046,70050,Blue,1,25679,25865,186
2022-12-06,70051,70049,Blue,0,42999,43104,105
2022-01-06,70040,70050,Blue,1,62298,62822,524
2022-08-30,70044,70060,Blue,1,83845,84762,917
2022-08-11,70047,70043,Blue,0,27811,28062,251
2022-03-23,70038,70040,Blue,1,32057,32073,16
2022-12-28,70050,70058,Blue,1,61361,61811,450
2022-04-07,70053,70045,Blue,0,87762,88195,433
2022-06-13,70059,70053,Blue,0,33592,33849,257
2022-08-15,70057,70838,Blue,0,73432,74429,997
2022-12-17,70040,70052,Blue,1,69680,70328,648
2022-07-10,70049,70039,Blue,0,47303,47815,512
2022-06-23,70053,70838,Blue,0,73477,74316,839
2022-07-08,70055,70049,Blue,0,41435,41719,284
2022-03-16,70040,70060,Blue,1,44180,45365,1185
2022-03-03,70047,70045,Blue,0,88171,88295,124
2022-06-26,70054,70060,Blue,1,51380,51668,288
2022-01-28,70055,70041,Blue,0,47289,48005,716
2022-11-14,70038,70048,Blue,1,56486,56994,508
2022-02-26,70059,70838,Blue,0,29236,30319,1083
2022-07-11,70057,70041,Blue,0,86607,87464,857
2022-11-28,70059,70039,Blue,0,63074,64110,1036
2022-03-25,70038,70042,Blue,1,24403,24496,93
2022-11-23,70058,70060,Blue,1,26246,26309,63
2022-06-09,70046,70058,Blue,1,60559,61253,694
2022-01-01,70040,70050,Blue,1,39082,39583,501
2022-09-23,70055,70041,Blue,0,51753,52475,722
2022-12-19,70047,70838,Blue,0,42517,43172,655
2022-08-22,70046,70056,Blue,1,42411,42975,564
2022-11-04,70040,70058,Blue,1,87787,88858,1071
2022-04-17,70042,70046,Blue,1,56578,56762,184
2022-09-06,70056,70060,Blue,1,55496,55666,170
2022-11-29,70038,70048,Blue,1,39587,40088,501
2022-01-20,70052,70060,Blue,1,47702,48151,449
2022-06-10,70059,70039,Blue,0,32956,34132,1176
2022-10-19,70054,70056,Blue,1,35795,35842,47
2022-06-14,70046,70060,Blue,1,63238,64066,828
2022-03-19,70055,70051,Blue,0,75313,75442,129
2022-06-10,70042,70044,Blue,1,22896,22926,30
2022-02-07,70059,70051,Blue,0,54788,55165,377
2022-04-18,70038,70054,Blue,1,54593,55531,938
2022-09-02,70038,70056,Blue,1,52911,53807,896
2022-04-04,70044,70058,Blue,1,78223,78992,769
2022-06-10,70059,70039,Blue,0,22794,24019,1225
2022-04-07,70057,70049,Blue,0,30667,31061,394
2022-12-15,70059,70041,Blue,0,32541,33494,953
2022-09-18,70055,70039,Blue,0,41661,42560,899
2022-06-20,70048,70054,Blue,1,58460,58809,349
2022-12-11,70053,70045,Blue,0,54111,54542,431
2022-07-09,70048,70052,Blue,1,67973,68180,207
2022-04-15,70056,70058,Blue,1,37718,37790,72
2022-09-20,70042,70060,Blue,1,35921,36900,979
2022-09-19,70057,70043,Blue,0,58124,58887,763
2022-09-15,70053,70045,Blue,0,71305,71730,425
2022-05-31,70042,70050,Blue,1,55687,56170,483
2022-06-23,70047,70043,Blue,0,30798,31060,262
2022-04-15,70047,70045,Blue,0,49328,49432,104
2022-06-10,70042,70044,Blue,1,36029,36066,37
2022-10-22,70038,70054,Blue,1,82935,83776,841
2022-09-12,70051,70049,Blue,0,72107,72210,103
2022-04-10,70042,70060,Blue,1,63060,64120,1060
2022-02-18,70042,70046,Blue,1,35523,35702,179
2022-12-06,70054,70058,Blue,1,49154,49311,157
2022-01-14,70052,70054,Blue,1,58618,58675,57
2022-11-28,70042,70052,Blue,1,32483,33053,570
2022-02-23,70047,70041,Blue,0,25554,25929,375
2022-03-09,70053,70039,Blue,0,36149,36966,817
2022-12-31,70059,70041,Blue,0,63195,64101,906
2022-03-05,70043,70838,Blue,0,69014,69214,200
2022-07-29,70038,70042,Blue,1,34231,34346,115
2022-12-14,70048,70058,Blue,1,38722,39275,553
2022-12-25,70038,70046,Blue,1,49392,49697,305
2022-04-04,70045,70043,Blue,0,56772,56873,101
2022-05-30,70047,70043,Blue,0,44890,45186,296
2022-10-01,70041,70838,Blue,0,66438,66562,124
2022-09-18,70044,70060,Blue,1,39227,40095,868
2022-02-04,70046,70056,Blue,1,22897,23499,602
2022-09-11,70040,70060,Blue,1,52727,53732,1005
2022-01-03,70046,70060,Blue,1,27631,28416,785
2022-06-12,70057,70838,Blue,0,55010,56187,1177
2022-07-12,70048,70060,Blue,1,41153,41801,648
2022-06-02,70042,70048,Blue,1,48217,48572,355
2022-12-08,70051,70047,Blue,0,31211,31440,229
2022-03-30,70051,70047,Blue,0,35067,35272,205
2022-03-19,70042,70052,Blue,1,50870,51451,581
2022-01-24,70057,70838,Blue,0,47722,48760,1038
2022-08-10,70038,70052,Blue,1,57335,58193,858
2022-06-28,70057,70043,Blue,0,50016,50796,780
2022-12-25,70057,70043,Blue,0,72811,73577,766
2022-02-12,70038,70048,Blue,1,68536,68976,440
2022-12-24,70046,70052,Blue,1,41866,42749,883
2022-02-18,70048,70060,Blue,1,54197,54890,693
2022-07-16,70038,70040,Blue,1,24306,24323,17
2022-04-14,70040,70060,Blue,1,52467,53686,1219
2022-02-12,70044,70060,Blue,1,44997,45913,916
2022-03-08,70059,70039,Blue,0,86303,87290,987
2022-12-05,70042,70060,Blue,1,73315,74276,961
2022-09-27,70057,70043,Blue,0,26681,27635,954
2022-10-12,70047,70039,Blue,0,26692,27385,693
2022-08-05,70038,70058,Blue,1,21796,22795,999
2022-01-21,70042,70052,Blue,1,24476,25081,605
2022-04-10,70057,70053,Blue,0,38927,39085,158
2022-06-17,70048,70050,Blue,1,43636,43697,61
2022-10-25,70057,70039,Blue,0,75445,76344,899
2022-01-22,70055,70045,Blue,0,88413,89016,603
2022-10-26,70055,70039,Blue,0,64155,64968,813
2022-08-22,70051,70039,Blue,0,47645,48286,641
2022-09-25,70052,70054,Blue,1,74935,74989,54
2022-08-17,70056,70060,Blue,1,45677,45861,184
2022-09-26,70049,70039,Blue,0,29453,30108,655
2022-02-16,70038,70046,Blue,1,67327,67651,324
2022-02-15,70050,70056,Blue,1,31497,31817,320
2022-12-29,70057,70053,Blue,0,22372,22524,152
2022-12-28,70050,70056,Blue,1,40257,40574,317
2022-12-30,70043,70039,Blue,0,58167,58274,107
2022-12-24,70041,70838,Blue,0,54539,54654,115
2022-01-03,70051,70049,Blue,0,74407,74510,103
2022-01-18,70059,70039,Blue,0,43349,44400,1051
2022-12-16,70048,70058,Blue,1,34096,34602,506
2022-02-27,70042,70050,Blue,1,68970,69366,396
2022-03-13,70054,70056,Blue,1,54039,54085,46
2022-01-25,70043,70039,Blue,0,34830,34946,116
2022-10-25,70044,70052,Blue,1,63009,63512,503
2022-09-24,70038,70060,Blue,1,60430,61572,1142
2022-07-25,70053,70051,Blue,0,27069,27132,63
2022-10-26,70047,70045,Blue,0,78878,78972,94
2022-08-16,70058,70060,Blue,1,53035,53105,70
2022-08-11,70054,70060,Blue,1,35452,35721,269
2022-11-16,70054,70058,Blue,1,88646,88810,164
2022-08-12,70050,70060,Blue,1,29699,30260,561
2022-10-08,70057,70055,Blue,0,84086,84155,69
2022-02-02,70041,70838,Blue,0,64304,64481,177
2022-06-11,70041,70838,Blue,0,86647,86759,112
2022-12-31,70039,70838,Blue,0,90787,90817,30
2022-12-02,70051,70047,Blue,0,30230,30449,219
2022-08-07,70057,70838,Blue,0,23919,24880,961
2022-11-18,70043,70041,Blue,0,54419,54448,29
2022-08-25,70041,70039,Blue,0,48589,48624,35
2022-10-29,70055,70049,Blue,0,86707,87002,295
2022-11-22,70057,70051,Blue,0,22606,22932,326
2022-11-11,70038,70040,Blue,1,53358,53371,13
2022-12-04,70040,70050,Blue,1,74295,74827,532
2022-01-07,70055,70838,Blue,0,25380,26353,973
2022-05-19,70049,70041,Blue,0,52863,53565,702
2022-02-04,70059,70045,Blue,0,73311,74079,768
2022-06-17,70059,70043,Blue,0,28460,29475,1015
2022-03-17,70046,70048,Blue,1,74431,74524,93
2022-12-12,70038,70050,Blue,1,52866,53399,533
2022-12-31,70059,70043,Blue,0,85418,86228,810
2022-03-20,70046,70054,Blue,1,29586,30014,428
2022-04-01,70055,70045,Blue,0,22226,22817,591
2022-01-13,70057,70051,Blue,0,30630,30922,292
2022-07-11,70059,70045,Blue,0,27195,27927,732
2022-01-26,70053,70838,Blue,0,86631,87563,932
2022-10-30,70051,70039,Blue,0,84996,85610,614
2022-06-13,70049,70039,Blue,0,21491,22041,550
2022-11-07,70042,70050,Blue,1,89265,89685,420
2022-01-13,70056,70058,Blue,1,60886,60963,77
2022-07-18,70046,70060,Blue,1,55330,56435,1105
2022-08-27,70038,70040,Blue,1,51793,51808,15
2022-11-22,70054,70056,Blue,1,72920,72966,46
2022-02-09,70043,70838,Blue,0,33605,33837,232
2022-10-11,70057,70055,Blue,0,78908,78976,68
2022-09-08,70042,70060,Blue,1,35138,36206,1068
2022-12-29,70052,70054,Blue,1,71216,71266,50
2022-01-10,70057,70039,Blue,0,77251,78176,925
2022-09-15,70059,70041,Blue,0,28466,29481,1015
2022-01-12,70053,70043,Blue,0,63467,64034,567
2022-01-17,70052,70060,Blue,1,65031,65393,362
2022-01-17,70040,70048,Blue,1,53493,53950,457
2022-07-26,70059,70057,Blue,0,38853,38888,35
2022-08-24,70053,70049,Blue,0,30392,30598,206
2022-12-08,70042,70048,Blue,1,30000,30318,318
2022-06-19,70059,70053,Blue,0,38182,38419,237
2022-10-31,70059,70057,Blue,0,45258,45294,36
2022-07-26,70053,70049,Blue,0,28806,29024,218
2022-07-18,70042,70052,Blue,1,58867,59464,597
2022-08-22,70038,70040,Blue,1,30796,30813,17
2022-12-17,70045,70838,Blue,0,77200,77537,337
2022-07-13,70046,70048,Blue,1,24658,24746,88
2022-01-13,70057,70047,Blue,0,18871,19392,521
2022-03-24,70042,70044,Blue,1,25596,25630,34
2022-09-15,70038,70060,Blue,1,75359,76631,1272
2022-08-07,70047,70838,Blue,0,77678,78219,541
2022-06-29,70039,70838,Blue,0,62651,62687,36
2022-12-29,70038,70040,Blue,1,60529,60544,15
2022-07-10,70047,70045,Blue,0,39460,39557,97
2022-07-08,70059,70039,Blue,0,40222,41296,1074
2022-01-17,70038,70046,Blue,1,42074,42391,317
2022-09-28,70048,70058,Blue,1,31312,31781,469
2022-04-29,70049,70047,Blue,0,32773,32816,43
2022-10-16,70043,70041,Blue,0,54258,54286,28
2022-11-27,70051,70041,Blue,0,54208,54818,610
2022-07-26,70049,70041,Blue,0,88769,89192,423
2022-02-23,70048,70058,Blue,1,43100,43635,535
2022-02-10,70043,70039,Blue,0,63443,63548,105
2022-07-28,70050,70052,Blue,1,65044,65154,110
2022-05-20,70040,70044,Blue,1,34517,34622,105
2022-03-28,70057,70043,Blue,0,77250,78058,808
2022-01-28,70048,70058,Blue,1,30454,31001,547
2022-04-10,70050,70060,Blue,1,72727,73261,534
2022-06-13,70059,70055,Blue,0,64993,65144,151
2022-11-07,70044,70050,Blue,1,77520,77871,351
2022-11-24,70042,70060,Blue,1,55512,56422,910
2022-05-30,70044,70052,Blue,1,70749,71350,601
2022-09-06,70059,70049,Blue,0,40234,40766,532
2022-04-10,70059,70045,Blue,0,63620,64280,660
2022-06-28,70048,70050,Blue,1,56273,56332,59
2022-12-20,70055,70047,Blue,0,85793,86152,359
2022-10-10,70056,70058,Blue,1,59212,59292,80
2022-07-18,70050,70058,Blue,1,34595,35009,414
2022-07-29,70044,70056,Blue,1,27931,28583,652
2022-03-30,70042,70050,Blue,1,68090,68522,432
2022-04-06,70057,70047,Blue,0,77843,78313,470
2022-06-19,70057,70039,Blue,0,55019,56003,984
2022-01-12,70042,70052,Blue,1,65660,66218,558
2022-09-23,70057,70045,Blue,0,24838,25511,673
2022-03-20,70051,70047,Blue,0,43077,43272,195
2022-05-16,70054,70058,Blue,1,85501,85678,177
2022-03-19,70040,70046,Blue,1,78756,79016,260
2022-04-13,70038,70050,Blue,1,27567,28192,625
2022-01-04,70059,70838,Blue,0,40610,41753,1143
2022-04-12,70053,70041,Blue,0,23918,24543,625
2022-03-08,70041,70838,Blue,0,54595,54700,105
2022-12-20,70044,70056,Blue,1,20032,20841,809
2022-12-29,70049,70043,Blue,0,54875,55211,336
2022-10-11,70057,70039,Blue,0,84273,85236,963
2022-01-31,70046,70058,Blue,1,21243,24380,3137
2022-02-23,70045,70838,Blue,0,53311,53718,407
2022-09-05,70038,70042,Blue,1,56410,56535,125
2022-04-17,70059,70049,Blue,0,82224,82726,502
2022-06-06,70049,70041,Blue,0,44557,45033,476
2022-10-26,70056,70060,Blue,1,72713,72890,177
2022-02-02,70054,70058,Blue,1,77713,77870,157
2022-10-21,70038,70052,Blue,1,56990,57768,778
2022-03-03,70042,70058,Blue,1,25291,26150,859
2022-08-25,70057,70047,Blue,0,26011,26502,491
2022-02-23,70059,70043,Blue,0,73213,74222,1009
2022-06-24,70046,70054,Blue,1,70613,71090,477
2022-06-16,70059,70051,Blue,0,81734,82065,331
2022-10-20,70059,70041,Blue,0,81192,82129,937
2022-12-22,70048,70056,Blue,1,83703,84092,389
2022-01-01,70059,70045,Blue,0,36853,37591,738
2022-10-17,70058,70060,Blue,1,33509,33585,76
2022-03-20,70040,70048,Blue,1,29295,29674,379
2022-01-03,70051,70047,Blue,0,55798,56004,206
2022-04-18,70054,70060,Blue,1,30851,31151,300
2022-12-08,70059,70055,Blue,0,34360,34536,176
2022-08-14,70046,70050,Blue,1,51523,51695,172
2022-03-01,70054,70056,Blue,1,56590,56639,49
2022-07-16,70038,70054,Blue,1,59424,60380,956
2022-09-06,70046,70056,Blue,1,48073,48584,511
2022-09-02,70048,70052,Blue,1,63707,63938,231
2022-08-29,70059,70049,Blue,0,60314,60779,465
2022-11-13,70050,70058,Blue,1,79645,80037,392
2022-07-22,70040,70046,Blue,1,26967,27218,251
2022-02-14,70053,70047,Blue,0,20146,20429,283
2022-03-10,70042,70058,Blue,1,24576,25463,887
2022-09-21,70048,70058,Blue,1,34575,35159,584
2022-12-31,70048,70052,Blue,1,37714,37916,202
2022-08-12,70047,70039,Blue,0,34562,35066,504
2022-04-15,70042,70052,Blue,1,59074,59636,562
2022-03-14,70050,70056,Blue,1,67360,67649,289
2022-10-12,70059,70049,Blue,0,75930,76406,476
2022-08-23,70050,70052,Blue,1,79405,79516,111
2022-12-03,70053,70049,Blue,0,52189,52389,200
2022-02-23,70051,70043,Blue,0,31870,32426,556
2022-11-10,70042,70052,Blue,1,70637,71187,550
2022-01-13,70046,70056,Blue,1,38833,39352,519
2022-12-20,70050,70060,Blue,1,59199,59882,683
2022-12-25,70042,70044,Blue,1,37853,37881,28
2022-04-15,70042,70056,Blue,1,75994,76931,937
2022-01-02,70051,70039,Blue,0,47840,48644,804
2022-10-02,70057,70838,Blue,0,30925,31987,1062
2022-04-22,70038,70056,Blue,1,80426,81305,879
2022-11-09,70038,70044,Blue,1,72073,72254,181
2022-01-11,70040,70054,Blue,1,37921,38807,886
2022-10-16,70057,70039,Blue,0,77896,78809,913
2022-02-07,70048,70056,Blue,1,42728,43327,599
2022-09-11,70049,70041,Blue,0,43980,44430,450
2022-07-17,70040,70044,Blue,1,35539,35660,121
2022-04-16,70059,70045,Blue,0,83176,83896,720
2022-09-24,70050,70052,Blue,1,35642,35753,111
2022-12-26,70055,70041,Blue,0,31040,31758,718
2022-12-03,70057,70838,Blue,0,37947,38899,952
2022-03-07,70044,70048,Blue,1,28079,28355,276
2022-06-17,70053,70049,Blue,0,30253,30516,263
2022-03-11,70055,70049,Blue,0,54968,55225,257
2022-09-12,70042,70056,Blue,1,29976,30745,769
2022-03-02,70048,70054,Blue,1,28981,29280,299
2022-02-14,70038,70054,Blue,1,34162,35008,846
2022-08-04,70050,70056,Blue,1,59753,60044,291
2022-08-18,70043,70838,Blue,0,55996,56287,291
2022-12-29,70051,70049,Blue,0,68352,68460,108
2022-07-02,70046,70052,Blue,1,58661,59013,352
2022-12-21,70042,70056,Blue,1,34924,35620,696
2022-10-30,70049,70039,Blue,0,39993,40501,508
2022-07-21,70046,70060,Blue,1,70382,71267,885
2022-10-01,70059,70838,Blue,0,47594,48701,1107
2022-07-14,70038,70050,Blue,1,46683,47249,566
2022-03-03,70042,70046,Blue,1,65086,65263,177
2022-12-20,70038,70058,Blue,1,46931,47942,1011
2022-02-20,70047,70039,Blue,0,86999,87440,441
2022-04-07,70041,70838,Blue,0,51292,51438,146
2022-07-16,70042,70058,Blue,1,61155,62033,878
2022-11-21,70050,70060,Blue,1,52972,53494,522
2022-05-18,70055,70041,Blue,0,71125,72132,1007
2022-08-31,70059,70053,Blue,0,65536,65754,218
2022-01-13,70059,70043,Blue,0,28755,29699,944
2022-10-08,70046,70050,Blue,1,55973,56141,168
2022-10-11,70059,70838,Blue,0,80469,81570,1101
2022-12-17,70057,70051,Blue,0,38536,38773,237
2022-10-08,70054,70056,Blue,1,36937,36983,46
2022-04-09,70040,70060,Blue,1,86472,87528,1056
2022-09-29,70056,70060,Blue,1,77369,77563,194
2022-01-27,70046,70052,Blue,1,78473,78939,466
2022-04-13,70055,70047,Blue,0,70154,70553,399
2022-04-11,70054,70060,Blue,1,22897,23263,366
2022-10-07,70059,70043,Blue,0,34398,35258,860
2022-01-06,70055,70047,Blue,0,25033,25448,415
2022-04-11,70043,70041,Blue,0,32082,32134,52
2022-11-30,70059,70055,Blue,0,31296,31449,153
2022-08-19,70053,70049,Blue,0,48768,48969,201
2022-10-06,70042,70050,Blue,1,61305,61709,404
2022-02-02,70048,70056,Blue,1,54533,55006,473
2022-03-25,70051,70049,Blue,0,33051,33207,156
2022-03-10,70038,70046,Blue,1,32660,32985,325
2022-07-30,70046,70052,Blue,1,66204,66557,353
2022-09-27,70055,70041,Blue,0,66734,67486,752
2022-09-23,70044,70048,Blue,1,36503,36740,237
2022-07-20,70046,70048,Blue,1,63116,63199,83
2022-09-24,70049,70047,Blue,0,69158,69238,80
2022-01-05,70059,70838,Blue,0,88100,89369,1269
2022-11-11,70042,70046,Blue,1,62501,62693,192
2022-02-28,70057,70047,Blue,0,84089,84603,514
2022-12-19,70054,70060,Blue,1,79954,80229,275
2022-01-12,70043,70039,Blue,0,45129,45241,112
2022-09-07,70057,70045,Blue,0,56918,57551,633
2022-01-21,70039,70838,Blue,0,58540,58579,39
2022-10-12,70038,70058,Blue,1,25642,26563,921
2022-01-04,70038,70050,Blue,1,56936,57550,614
2022-02-26,70040,70042,Blue,1,54026,54059,33
2022-11-25,70038,70058,Blue,1,21033,22056,1023
2022-02-09,70038,70042,Blue,1,58934,59031,97
2022-02-24,70051,70047,Blue,0,50823,51044,221
2022-11-07,70038,70040,Blue,1,84419,84432,13
2022-12-22,70042,70054,Blue,1,30698,31531,833
2022-02-02,70038,70040,Blue,1,53351,53368,17
2022-02-06,70055,70045,Blue,0,39044,39621,577
2022-03-24,70038,70040,Blue,1,47527,47543,16
2022-10-01,70048,70050,Blue,1,38255,38312,57
2022-04-06,70053,70049,Blue,0,75171,75371,200
2022-05-19,70042,70060,Blue,1,54472,55824,1352
2022-03-13,70051,70041,Blue,0,70943,71559,616
2022-08-30,70049,70047,Blue,0,28725,28783,58
2022-11-21,70048,70058,Blue,1,72592,73340,748
2022-10-01,70042,70052,Blue,1,32491,33057,566
2022-03-02,70045,70041,Blue,0,63048,63204,156
2022-10-25,70057,70049,Blue,0,53157,53547,390
2022-12-19,70056,70060,Blue,1,69922,70393,471
2022-04-01,70057,70049,Blue,0,30328,30758,430
2022-04-04,70047,70838,Blue,0,23451,24056,605
2022-07-18,70042,70054,Blue,1,67888,68624,736
2022-12-09,70044,70050,Blue,1,56411,56844,433
2022-07-11,70045,70039,Blue,0,39715,39977,262
2022-02-27,70046,70048,Blue,1,54755,54840,85
2022-08-31,70041,70838,Blue,0,26967,27096,129
2022-05-06,70059,70055,Blue,0,20132,20282,150
2022-08-11,70038,70058,Blue,1,55449,56522,1073
2022-11-24,70057,70045,Blue,0,78989,79577,588
2022-03-09,70055,70045,Blue,0,45693,46358,665
2022-04-22,70047,70039,Blue,0,53703,54118,415
2022-11-15,70051,70043,Blue,0,54243,55360,1117
2022-04-17,70057,70838,Blue,0,39586,41482,1896
2022-10-04,70057,70838,Blue,0,21837,22974,1137
2022-06-15,70050,70056,Blue,1,52697,53048,351
2022-01-21,70059,70051,Blue,0,57497,57814,317
2022-04-10,70057,70045,Blue,0,38927,39599,672
2022-04-14,70050,70052,Blue,1,65270,65376,106
2022-01-05,70039,70838,Blue,0,84656,84690,34
2022-06-24,70047,70838,Blue,0,68457,68996,539
2022-02-27,70055,70043,Blue,0,34267,34962,695
2022-11-29,70059,70057,Blue,0,51520,51555,35
2022-04-11,70046,70050,Blue,1,65615,65783,168
2022-03-28,70052,70060,Blue,1,63635,64436,801
2022-11-26,70057,70041,Blue,0,72506,73307,801
2022-12-22,70053,70838,Blue,0,78302,79136,834
2022-03-08,70038,70060,Blue,1,76886,77945,1059
2022-08-25,70038,70046,Blue,1,34615,34979,364
2022-02-09,70038,70040,Blue,1,57733,57755,22
2022-02-26,70038,70044,Blue,1,74481,74666,185
2022-08-19,70038,70046,Blue,1,21918,22271,353
2022-05-10,70057,70047,Blue,0,66167,66693,526
2022-08-23,70043,70039,Blue,0,23100,23222,122
2022-12-27,70042,70050,Blue,1,74743,75144,401
2022-09-05,70040,70058,Blue,1,61874,62802,928
2022-01-28,70051,70043,Blue,0,65713,66235,522
2022-03-02,70055,70045,Blue,0,54674,55243,569
2022-02-26,70059,70043,Blue,0,28159,29082,923
2022-09-21,70055,70047,Blue,0,30329,30771,442
2022-10-05,70040,70060,Blue,1,65428,66486,1058
2022-12-07,70059,70051,Blue,0,52028,52348,320
2022-06-28,70055,70043,Blue,0,26960,27692,732
2022-02-24,70051,70049,Blue,0,56561,56662,101
2022-04-19,70040,70052,Blue,1,32413,33080,667
2022-08-28,70059,70047,Blue,0,38839,39429,590
2022-01-12,70044,70050,Blue,1,63401,63787,386
2022-02-07,70055,70045,Blue,0,65176,65712,536
2022-04-10,70042,70058,Blue,1,39170,40079,909
2022-04-09,70055,70053,Blue,0,70461,70506,45
2022-10-12,70053,70043,Blue,0,76720,77277,557
2022-01-10,70038,70050,Blue,1,74055,74667,612
2022-11-03,70058,70060,Blue,1,67028,67185,157
2022-11-29,70059,70047,Blue,0,72805,73361,556
2022-05-21,70044,70060,Blue,1,27695,28793,1098
2022-10-18,70053,70051,Blue,0,27075,27140,65
2022-03-25,70054,70058,Blue,1,22441,22640,199
2022-05-12,70059,70049,Blue,0,51018,51517,499
2022-10-29,70046,70060,Blue,1,68359,69287,928
2022-03-21,70048,70052,Blue,1,23274,23534,260
2022-06-12,70044,70060,Blue,1,61522,62465,943
2022-12-08,70059,70838,Blue,0,26258,27499,1241
2022-12-24,70048,70052,Blue,1,57702,57897,195
2022-03-15,70059,70057,Blue,0,62603,62638,35
2022-01-14,70038,70046,Blue,1,33846,34145,299
2022-08-11,70057,70055,Blue,0,31483,31554,71
2022-03-16,70051,70043,Blue,0,52468,52952,484
2022-06-20,70049,70045,Blue,0,42769,42979,210
2022-04-18,70050,70058,Blue,1,60456,60895,439
2022-07-27,70042,70056,Blue,1,61185,62085,900
2022-03-10,70040,70058,Blue,1,79820,80880,1060
2022-02-22,70042,70048,Blue,1,73648,73938,290
2022-02-07,70038,70054,Blue,1,42373,43481,1108
2022-02-17,70059,70045,Blue,0,57502,58235,733
2022-03-04,70045,70043,Blue,0,67892,67980,88
2022-11-26,70038,70050,Blue,1,28035,28537,502
2022-02-20,70059,70057,Blue,0,44656,44691,35
2022-09-14,70049,70043,Blue,0,55623,55981,358
2022-07-07,70042,70056,Blue,1,64739,65613,874
2022-11-04,70052,70058,Blue,1,30695,30960,265
2022-09-16,70040,70042,Blue,1,49288,49323,35
2022-09-06,70039,70838,Blue,0,39169,39200,31
2022-06-14,70055,70049,Blue,0,60078,60347,269
2022-06-19,70059,70049,Blue,0,42795,43271,476
2022-09-07,70038,70042,Blue,1,45053,45150,97
2022-09-04,70059,70049,Blue,0,80245,80692,447
2022-07-23,70040,70042,Blue,1,53474,53506,32
2022-03-01,70040,70058,Blue,1,27931,28890,959
2022-04-20,70059,70039,Blue,0,27267,28233,966
2022-11-04,70051,70838,Blue,0,22469,23474,1005
2022-03-06,70045,70838,Blue,0,34737,35075,338
2022-01-12,70041,70039,Blue,0,66958,66988,30
2022-07-01,70057,70041,Blue,0,52295,53558,1263
2022-01-28,70055,70047,Blue,0,45685,46079,394
2022-03-23,70057,70051,Blue,0,21406,21660,254
2022-02-01,70054,70056,Blue,1,53928,53975,47
2022-09-26,70038,70042,Blue,1,72632,72726,94
2022-12-01,70051,70041,Blue,0,24236,24830,594
2022-09-13,70052,70054,Blue,1,43328,43390,62
2022-03-05,70059,70838,Blue,0,70274,71401,1127
2022-12-02,70040,70052,Blue,1,23757,24424,667
2022-09-22,70050,70060,Blue,1,25110,25647,537
2022-09-28,70054,70060,Blue,1,62610,62871,261
2022-03-20,70042,70054,Blue,1,74605,75267,662
2022-12-11,70055,70045,Blue,0,55133,55618,485
2022-10-27,70047,70045,Blue,0,59858,59952,94
2022-11-16,70042,70056,Blue,1,38965,39723,758
2022-04-05,70057,70043,Blue,0,65982,66813,831
2022-06-13,70049,70838,Blue,0,67694,68295,601
2022-12-05,70040,70050,Blue,1,39031,39524,493
2022-10-23,70049,70045,Blue,0,31327,31535,208
2022-08-03,70049,70047,Blue,0,76431,76486,55
2022-06-12,70048,70054,Blue,1,58032,58329,297
2022-11-20,70053,70043,Blue,0,60584,61163,579
2022-07-25,70050,70056,Blue,1,46677,46992,315
2022-10-22,70051,70047,Blue,0,58219,58403,184
2022-12-09,70059,70039,Blue,0,39264,40312,1048
2022-07-12,70053,70039,Blue,0,73087,73876,789
2022-07-01,70059,70049,Blue,0,30141,30607,466
2022-01-05,70038,70042,Blue,1,22862,22961,99
2022-06-26,70051,70041,Blue,0,85966,86554,588
2022-10-11,70040,70056,Blue,1,40047,40911,864
2022-01-11,70055,70047,Blue,0,38834,39651,817
2022-06-20,70052,70054,Blue,1,55377,55450,73
2022-12-07,70052,70056,Blue,1,41174,41332,158
2022-10-12,70050,70052,Blue,1,53938,54057,119
2022-10-01,70051,70838,Blue,0,38813,39652,839
2022-07-11,70045,70041,Blue,0,68072,68242,170
2022-09-21,70055,70838,Blue,0,77132,78059,927
2022-03-15,70046,70054,Blue,1,52859,53258,399
2022-03-06,70051,70041,Blue,0,74198,74756,558
2022-09-06,70049,70041,Blue,0,75455,75853,398
2022-08-29,70059,70053,Blue,0,35370,35614,244
2022-07-13,70048,70050,Blue,1,28787,28847,60
2022-06-25,70042,70048,Blue,1,76676,77014,338
2022-07-01,70059,70049,Blue,0,32657,33131,474
2022-12-24,70058,70060,Blue,1,83186,83250,64
2022-04-20,70059,70057,Blue,0,66793,66828,35
2022-12-05,70045,70039,Blue,0,42928,43173,245
2022-07-18,70040,70044,Blue,1,33323,33437,114
2022-04-15,70038,70050,Blue,1,65559,66171,612
2022-10-13,70049,70041,Blue,0,78705,79111,406
2022-11-20,70040,70046,Blue,1,87366,87641,275
2022-04-21,70047,70838,Blue,0,82927,83421,494
2022-06-09,70042,70056,Blue,1,31083,31902,819
2022-03-30,70049,70047,Blue,0,83931,83985,54
2022-05-03,70050,70052,Blue,1,79217,79327,110
2022-06-10,70050,70054,Blue,1,55452,55669,217
2022-09-12,70059,70047,Blue,0,81996,82514,518
2022-11-20,70054,70058,Blue,1,86389,86547,158
2022-07-11,70040,70048,Blue,1,85866,86271,405
2022-02-18,70042,70060,Blue,1,63895,65025,1130
2022-08-11,70056,70058,Blue,1,70918,70988,70
2022-02-04,70042,70046,Blue,1,68228,68452,224
2022-04-18,70049,70045,Blue,0,67991,68177,186
2022-08-24,70055,70041,Blue,0,53859,54736,877
2022-11-24,70049,70039,Blue,0,30608,31117,509
2022-07-31,70042,70050,Blue,1,68517,68939,422
2022-11-09,70055,70045,Blue,0,54855,55403,548
2022-02-22,70045,70043,Blue,0,38485,38649,164
2022-03-31,70049,70039,Blue,0,80545,81021,476
2022-03-27,70059,70039,Blue,0,55995,57032,1037
2022-05-21,70038,70040,Blue,1,66110,66124,14
2022-12-01,70040,70058,Blue,1,25691,26594,903
2022-12-01,70055,70041,Blue,0,55583,56369,786
2022-03-23,70047,70043,Blue,0,76676,76958,282
2022-08-26,70038,70052,Blue,1,30270,30935,665
2022-04-16,70038,70054,Blue,1,81367,82161,794
2022-08-06,70042,70044,Blue,1,51404,51433,29
2022-02-05,70040,70058,Blue,1,55671,56674,1003
2022-09-09,70056,70060,Blue,1,22676,22947,271
2022-08-31,70055,70043,Blue,0,54559,55224,665
2022-10-30,70052,70054,Blue,1,41769,41827,58
2022-12-23,70051,70039,Blue,0,23979,24686,707
2022-12-08,70044,70046,Blue,1,21567,21677,110
2022-01-10,70048,70054,Blue,1,51934,52273,339
2022-05-19,70059,70057,Blue,0,49216,49252,36
2022-03-12,70057,70053,Blue,0,53078,53241,163
2022-10-18,70056,70058,Blue,1,41966,42035,69
2022-01-10,70055,70838,Blue,0,21867,22862,995
2022-10-06,70059,70045,Blue,0,74894,75611,717
2022-10-26,70042,70052,Blue,1,53842,54391,549
2022-12-10,70053,70838,Blue,0,27347,28149,802
2022-10-07,70052,70058,Blue,1,35143,35395,252
2022-01-26,70044,70050,Blue,1,21754,22077,323
2022-02-08,70059,70047,Blue,0,54496,55081,585
2022-08-16,70050,70058,Blue,1,22942,23390,448
2022-03-04,70053,70047,Blue,0,35510,35791,281
2022-05-19,70043,70039,Blue,0,61244,61341,97
2022-07-13,70042,70054,Blue,1,52228,52908,680
2022-05-26,70049,70047,Blue,0,58811,58867,56
2022-10-02,70059,70039,Blue,0,56005,57047,1042
2022-05-22,70045,70838,Blue,0,38564,38992,428
2022-11-04,70059,70053,Blue,0,58862,59087,225
2022-12-11,70056,70060,Blue,1,77285,77459,174
2022-07-01,70040,70050,Blue,1,21924,22501,577
2022-04-21,70038,70046,Blue,1,19844,20148,304
2022-10-29,70052,70056,Blue,1,82207,82348,141
2022-01-24,70046,70056,Blue,1,31532,32092,560
2022-09-22,70040,70056,Blue,1,39566,40391,825
2022-01-31,70042,70044,Blue,1,20619,20673,54
2022-09-10,70043,70838,Blue,0,76768,76972,204
2022-09-19,70055,70049,Blue,0,61520,61805,285
2022-12-19,70053,70047,Blue,0,62663,62982,319
2022-12-22,70050,70060,Blue,1,42340,43306,966
2022-05-18,70055,70049,Blue,0,72620,72892,272
2022-03-26,70040,70056,Blue,1,71842,72971,1129
2022-01-09,70051,70043,Blue,0,43846,44302,456
2022-06-29,70054,70056,Blue,1,22810,22857,47
2022-01-18,70041,70039,Blue,0,34269,34304,35
2022-06-20,70051,70838,Blue,0,44096,44882,786
2022-11-24,70053,70039,Blue,0,79854,80591,737
2022-01-03,70045,70039,Blue,0,55250,55804,554
2022-04-11,70044,70052,Blue,1,32880,33384,504
2022-12-16,70041,70039,Blue,0,73746,73779,33
2022-08-16,70059,70043,Blue,0,79537,80432,895
2022-09-22,70049,70045,Blue,0,23177,23422,245
2022-01-16,70054,70058,Blue,1,78353,78514,161
2022-03-19,70049,70047,Blue,0,76286,76339,53
2022-01-14,70057,70049,Blue,0,63274,63678,404
2022-07-10,70044,70056,Blue,1,82590,83354,764
2022-04-03,70038,70048,Blue,1,40335,40771,436
2022-09-23,70053,70047,Blue,0,23744,24074,330
2022-09-22,70053,70039,Blue,0,73839,74640,801
2022-02-10,70059,70041,Blue,0,55093,56095,1002
2022-07-19,70054,70058,Blue,1,25379,25545,166
2022-09-07,70055,70045,Blue,0,22341,22869,528
2022-08-15,70043,70041,Blue,0,68999,69030,31
2022-10-03,70055,70045,Blue,0,74580,75135,555
2022-04-14,70055,70053,Blue,0,64276,64326,50
2022-03-18,70050,70058,Blue,1,31415,31813,398
2022-10-19,70049,70043,Blue,0,20903,21233,330
2022-03-30,70059,70053,Blue,0,61989,62228,239
2022-08-17,70051,70045,Blue,0,62509,62852,343
2022-02-13,70055,70838,Blue,0,25093,26100,1007
2022-06-17,70038,70050,Blue,1,36219,36887,668
2022-01-12,70038,70040,Blue,1,42696,42712,16
2022-11-06,70048,70054,Blue,1,35173,35467,294
2022-10-03,70053,70039,Blue,0,54395,55148,753
2022-03-03,70059,70838,Blue,0,87518,88728,1210
2022-04-16,70048,70054,Blue,1,60027,60351,324
2022-12-01,70048,70052,Blue,1,48867,49076,209
2022-08-25,70041,70838,Blue,0,58301,58439,138
2022-12-22,70055,70053,Blue,0,61873,61918,45
2022-08-13,70059,70838,Blue,0,72975,74104,1129
2022-02-12,70051,70041,Blue,0,55006,55602,596
2022-06-10,70044,70054,Blue,1,55030,55669,639
2022-09-30,70051,70047,Blue,0,67047,67277,230
2022-01-01,70057,70039,Blue,0,52305,53291,986
2022-08-25,70040,70054,Blue,1,72175,72934,759
2022-12-20,70044,70058,Blue,1,79801,80599,798
2022-08-07,70040,70048,Blue,1,36311,36705,394
2022-11-28,70055,70051,Blue,0,49411,49546,135
2022-11-30,70059,70051,Blue,0,46868,47194,326
2022-11-22,70043,70039,Blue,0,48205,48318,113
2022-04-16,70057,70045,Blue,0,74187,74851,664
2022-08-28,70053,70043,Blue,0,55168,55733,565
2022-03-29,70050,70052,Blue,1,68557,68672,115
2022-08-04,70059,70039,Blue,0,30973,32122,1149
2022-08-30,70057,70041,Blue,0,69777,70661,884
2022-08-12,70040,70060,Blue,1,37887,38986,1099
2022-02-19,70048,70060,Blue,1,59349,59944,595
2022-09-14,70043,70041,Blue,0,56033,56061,28
2022-03-25,70046,70048,Blue,1,75565,75644,79
2022-10-28,70038,70058,Blue,1,56090,57199,1109
2022-10-22,70055,70053,Blue,0,42380,42427,47
2022-05-20,70038,70056,Blue,1,54802,55770,968
2022-10-07,70053,70047,Blue,0,68387,68668,281
2022-03-17,70059,70053,Blue,0,66234,66451,217
2022-09-12,70043,70039,Blue,0,70013,70111,98
2022-02-18,70053,70039,Blue,0,69790,70515,725
2022-04-12,70044,70052,Blue,1,41028,41650,622
2022-01-17,70042,70056,Blue,1,28822,29625,803
2022-06-11,70051,70049,Blue,0,59332,59433,101
2022-01-14,70057,70043,Blue,0,22830,23645,815
2022-04-22,70049,70838,Blue,0,81695,82285,590
2022-09-05,70053,70041,Blue,0,42397,43069,672
2022-10-20,70044,70056,Blue,1,67294,68001,707
2022-10-05,70040,70058,Blue,1,53462,54400,938
2022-04-08,70053,70041,Blue,0,70440,71090,650
2022-07-28,70046,70050,Blue,1,64469,64652,183
2022-09-25,70041,70838,Blue,0,31049,31161,112
2022-05-27,70042,70046,Blue,1,56186,56402,216
2022-12-21,70059,70051,Blue,0,29241,29584,343
2022-04-19,70057,70051,Blue,0,55479,55734,255
2022-05-17,70053,70049,Blue,0,22423,22616,193
2022-07-05,70038,70056,Blue,1,25307,26204,897
2022-10-03,70048,70056,Blue,1,73752,74149,397
2022-08-18,70038,70048,Blue,1,71760,72235,475
2022-04-05,70059,70838,Blue,0,60189,61269,1080
2022-12-05,70042,70044,Blue,1,39540,39573,33
2022-01-10,70038,70060,Blue,1,50776,51993,1217
2022-02-14,70051,70045,Blue,0,87257,87621,364
2022-02-16,70049,70047,Blue,0,51758,51813,55
2022-04-18,70057,70039,Blue,0,25577,26657,1080
2022-04-17,70059,70041,Blue,0,63556,64508,952
2022-08-19,70045,70039,Blue,0,46160,46448,288
2022-06-12,70045,70039,Blue,0,76850,77113,263
2022-07-31,70042,70052,Blue,1,71697,72273,576
2022-07-19,70040,70044,Blue,1,61331,61460,129
2022-05-20,70057,70051,Blue,0,19246,19526,280
2022-12-12,70059,70043,Blue,0,56655,57510,855
2022-05-25,70041,70039,Blue,0,44559,44591,32
2022-02-09,70046,70054,Blue,1,74483,74959,476
2022-05-03,70052,70054,Blue,1,57080,57129,49
2022-08-31,70059,70041,Blue,0,75107,76071,964
2022-02-21,70042,70044,Blue,1,32499,32537,38
2022-01-11,70038,70050,Blue,1,62528,63103,575
2022-03-11,70052,70060,Blue,1,28404,28878,474
2022-07-07,70047,70045,Blue,0,30771,30876,105
2022-02-16,70049,70047,Blue,0,66420,66480,60
2022-10-22,70053,70047,Blue,0,63522,63809,287
2022-10-12,70059,70055,Blue,0,67125,67277,152
2022-02-13,70051,70838,Blue,0,81261,82047,786
2022-07-25,70049,70041,Blue,0,44385,44826,441
2022-02-17,70038,70044,Blue,1,29667,29829,162
2022-03-02,70046,70058,Blue,1,20214,20897,683
2022-03-30,70047,70045,Blue,0,87446,87532,86
2022-06-08,70042,70044,Blue,1,67222,67260,38
2022-03-15,70042,70060,Blue,1,68379,69452,1073
2022-07-31,70046,70050,Blue,1,25692,25878,186
2022-12-06,70040,70046,Blue,1,71109,71392,283
2022-10-25,70052,70054,Blue,1,83471,83532,61
2022-10-28,70059,70051,Blue,0,64457,64769,312
2022-09-18,70040,70048,Blue,1,55941,56314,373
2022-02-05,70046,70060,Blue,1,37615,38393,778
2022-08-29,70059,70047,Blue,0,70290,70835,545
2022-08-25,70044,70046,Blue,1,78526,78628,102
2022-03-31,70058,70060,Blue,1,47408,47468,60
2022-07-26,70044,70056,Blue,1,28984,29668,684
2022-03-16,70044,70060,Blue,1,53933,54835,902
2022-12-17,70054,70060,Blue,1,61899,62147,248
2022-11-05,70049,70047,Blue,0,82817,82874,57
2022-12-25,70055,70051,Blue,0,81075,81205,130
2022-02-22,70059,70047,Blue,0,62600,63154,554
2022-01-17,70052,70056,Blue,1,83667,83801,134
2022-02-28,70048,70050,Blue,1,57019,57071,52
2022-04-12,70040,70042,Blue,1,54709,54743,34
2022-10-24,70057,70041,Blue,0,63504,64313,809
2022-11-14,70044,70048,Blue,1,31756,31990,234
2022-03-08,70047,70045,Blue,0,34775,34898,123
2022-10-31,70042,70056,Blue,1,87560,88320,760
2022-09-15,70051,70049,Blue,0,83779,83886,107
2022-10-08,70055,70043,Blue,0,75982,76636,654
2022-11-03,70038,70052,Blue,1,52033,52910,877
2022-09-30,70049,70045,Blue,0,87044,87258,214
2022-06-05,70042,70046,Blue,1,76669,76872,203
2022-06-01,70049,70043,Blue,0,32726,33133,407
2022-06-24,70059,70057,Blue,0,70057,70093,36
2022-02-07,70051,70045,Blue,0,20247,20585,338
2022-12-29,70059,70039,Blue,0,86305,87321,1016
2022-11-17,70059,70039,Blue,0,29747,30859,1112
2022-11-04,70044,70046,Blue,1,22145,22255,110
2022-04-05,70051,70041,Blue,0,44286,44861,575
2022-01-02,70045,70043,Blue,0,67109,67203,94
2022-09-20,70046,70056,Blue,1,69877,70391,514
2022-01-19,70038,70052,Blue,1,80286,81028,742
2022-04-20,70042,70056,Blue,1,35793,36742,949
2022-10-25,70048,70050,Blue,1,36427,36482,55
2022-08-01,70046,70054,Blue,1,61609,62039,430
2022-06-23,70057,70049,Blue,0,35132,35643,511
2022-10-07,70057,70039,Blue,0,55771,56739,968
2022-12-28,70040,70052,Blue,1,80176,80839,663
2022-04-08,70044,70054,Blue,1,60701,61357,656
2022-08-02,70059,70053,Blue,0,79036,79268,232
2022-07-06,70050,70058,Blue,1,60450,60888,438
2022-04-25,70058,70060,Blue,1,74557,74630,73
2022-06-21,70051,70047,Blue,0,61329,61513,184
2022-11-06,70044,70046,Blue,1,67446,67553,107
2022-10-17,70046,70048,Blue,1,42626,42713,87
2022-05-26,70049,70039,Blue,0,19408,19952,544
2022-09-18,70053,70043,Blue,0,40470,41120,650
2022-11-13,70040,70046,Blue,1,64606,64867,261
2022-11-09,70043,70838,Blue,0,61796,61979,183
2022-07-15,70040,70050,Blue,1,45436,45942,506
2022-12-01,70057,70047,Blue,0,43259,43812,553
2022-10-26,70040,70046,Blue,1,37840,38097,257
2022-01-27,70055,70838,Blue,0,63971,64844,873
2022-09-28,70038,70042,Blue,1,67307,67408,101
2022-12-11,70053,70041,Blue,0,24935,25615,680
2022-07-18,70055,70043,Blue,0,22350,23051,701
2022-07-13,70047,70045,Blue,0,19096,19220,124
2022-06-15,70053,70047,Blue,0,26061,26348,287
2022-07-17,70042,70046,Blue,1,69188,69387,199
2022-07-25,70044,70046,Blue,1,26383,26495,112
2022-10-20,70057,70053,Blue,0,80601,80755,154
2022-08-29,70051,70041,Blue,0,41952,42526,574
2022-08-17,70038,70040,Blue,1,32976,32995,19
2022-01-25,70059,70047,Blue,0,88102,88698,596
2022-01-09,70048,70054,Blue,1,78521,78817,296
2022-03-14,70057,70039,Blue,0,27698,28714,1016
2022-02-11,70048,70050,Blue,1,28697,28753,56
2022-01-22,70055,70045,Blue,0,66126,66645,519
2022-12-19,70046,70048,Blue,1,23252,23349,97
2022-05-27,70042,70048,Blue,1,37090,37506,416
2022-01-11,70042,70044,Blue,1,30091,30126,35
2022-12-02,70048,70056,Blue,1,47685,48086,401
2022-04-21,70049,70045,Blue,0,81079,81280,201
2022-02-19,70050,70060,Blue,1,70374,70892,518
2022-12-12,70042,70052,Blue,1,34168,34708,540
2022-03-16,70038,70040,Blue,1,65526,65544,18
2022-08-09,70050,70056,Blue,1,72162,72510,348
2022-11-03,70047,70039,Blue,0,51370,51758,388
2022-05-30,70039,70838,Blue,0,63531,63566,35
2022-08-11,70049,70047,Blue,0,22660,22723,63
2022-01-06,70049,70047,Blue,0,31952,32006,54
2022-09-19,70054,70060,Blue,1,52890,53241,351
2022-02-15,70043,70039,Blue,0,77579,77681,102
2022-06-26,70053,70039,Blue,0,81215,82011,796
2022-03-16,70055,70045,Blue,0,62489,63064,575
2022-07-09,70055,70047,Blue,0,38133,38494,361
2022-09-19,70052,70056,Blue,1,51923,52064,141
2022-08-21,70038,70050,Blue,1,48848,49441,593
2022-04-24,70056,70058,Blue,1,32561,32633,72
2022-12-20,70042,70044,Blue,1,57183,57221,38
2022-12-13,70038,70056,Blue,1,80262,81196,934
2022-11-19,70051,70041,Blue,0,63250,63800,550
2022-04-08,70040,70058,Blue,1,33922,35070,1148
2022-12-01,70045,70041,Blue,0,73558,73748,190
2022-07-08,70059,70055,Blue,0,62137,62283,146
2022-02-15,70042,70044,Blue,1,49883,49911,28
2022-08-03,70044,70060,Blue,1,48948,49828,880
2022-11-10,70044,70056,Blue,1,49966,50635,669
2022-12-13,70048,70058,Blue,1,43482,44007,525
2022-03-22,70053,70049,Blue,0,29628,29812,184
2022-03-17,70047,70039,Blue,0,41595,42033,438
2022-02-06,70050,70052,Blue,1,64630,64750,120
2022-01-04,70044,70048,Blue,1,28705,28942,237
2022-12-06,70038,70044,Blue,1,56133,56408,275
2022-11-01,70049,70047,Blue,0,57189,57250,61
2022-01-22,70055,70051,Blue,0,43473,43604,131
2022-07-12,70051,70047,Blue,0,65135,65327,192
2022-12-01,70044,70046,Blue,1,58818,58946,128
2022-07-10,70050,70060,Blue,1,61485,62009,524
2022-08-09,70050,70058,Blue,1,40612,41062,450
2022-12-24,70059,70053,Blue,0,61631,61868,237
2022-11-21,70042,70060,Blue,1,58401,59465,1064
2022-01-11,70040,70042,Blue,1,59897,59931,34
2022-03-14,70044,70048,Blue,1,62475,62720,245
2022-07-05,70038,70042,Blue,1,63317,63441,124
2022-11-02,70059,70055,Blue,0,60308,60447,139
2022-10-07,70055,70049,Blue,0,59628,59909,281
2022-12-19,70051,70049,Blue,0,77911,78016,105
2022-02-01,70046,70048,Blue,1,88673,88742,69
2022-02-05,70051,70039,Blue,0,62564,63217,653
2022-03-18,70041,70838,Blue,0,50749,50867,118
2022-07-02,70038,70058,Blue,1,48016,49087,1071
2022-09-25,70051,70047,Blue,0,52637,52832,195
2022-02-08,70048,70056,Blue,1,56697,57069,372
2022-02-24,70042,70050,Blue,1,54441,54864,423
2022-07-30,70055,70039,Blue,0,62965,63809,844
2022-02-13,70040,70048,Blue,1,74886,75299,413
2022-10-14,70046,70048,Blue,1,75154,75252,98
2022-01-21,70057,70043,Blue,0,61782,62884,1102
2022-03-23,70044,70054,Blue,1,49430,50029,599
2022-07-04,70055,70838,Blue,0,56499,57430,931
2022-02-22,70046,70050,Blue,1,67394,67609,215
2022-02-04,70050,70056,Blue,1,22825,23120,295
2022-11-25,70056,70060,Blue,1,46531,46711,180
2022-10-03,70040,70052,Blue,1,64364,65109,745
2022-09-21,70042,70050,Blue,1,53059,53461,402
2022-06-13,70047,70039,Blue,0,57519,57918,399
2022-10-05,70040,70044,Blue,1,75264,75373,109
2022-01-18,70057,70838,Blue,0,83574,84732,1158
2022-04-24,70057,70838,Blue,0,70642,71673,1031
2022-12-11,70040,70044,Blue,1,61905,62020,115
2022-04-07,70058,70060,Blue,1,43578,43645,67
2022-04-29,70053,70047,Blue,0,21165,21583,418
2022-09-14,70049,70047,Blue,0,54532,54583,51
2022-04-17,70038,70042,Blue,1,29235,29333,98
2022-08-30,70042,70050,Blue,1,32068,32536,468
2022-04-07,70055,70041,Blue,0,38324,39093,769
2022-01-27,70053,70047,Blue,0,33868,34172,304
2022-09-03,70040,70046,Blue,1,25692,25961,269
2022-12-28,70038,70058,Blue,1,44418,45482,1064
2022-01-28,70048,70052,Blue,1,56112,56313,201
2022-09-30,70042,70058,Blue,1,27909,28771,862
2022-01-25,70045,70043,Blue,0,69201,69319,118
2022-06-13,70042,70058,Blue,1,57884,58701,817
2022-02-01,70038,70052,Blue,1,67029,67730,701
2022-08-20,70059,70049,Blue,0,34635,35082,447
2022-11-03,70052,70058,Blue,1,73006,73256,250
2022-05-23,70049,70041,Blue,0,54394,54955,561
2022-07-12,70052,70060,Blue,1,68860,69238,378
2022-06-14,70046,70054,Blue,1,63590,64057,467
2022-01-20,70053,70043,Blue,0,45244,45809,565
2022-06-30,70040,70058,Blue,1,26604,27618,1014
2022-06-27,70042,70058,Blue,1,35632,36802,1170
2022-09-04,70051,70039,Blue,0,63943,64593,650
2022-04-01,70047,70043,Blue,0,39909,40181,272
2022-07-09,70050,70056,Blue,1,76675,76962,287
2022-01-22,70046,70050,Blue,1,89590,89784,194
2022-07-24,70040,70056,Blue,1,74909,75910,1001
2022-03-27,70056,70058,Blue,1,85566,85640,74
2022-05-17,70050,70056,Blue,1,78369,78705,336
2022-10-24,70059,70055,Blue,0,78976,79120,144
2022-12-22,70045,70041,Blue,0,56594,56762,168
2022-01-10,70057,70041,Blue,0,68034,68872,838
2022-08-07,70059,70053,Blue,0,67878,68113,235
2022-07-12,70046,70060,Blue,1,43116,43905,789
2022-07-26,70038,70044,Blue,1,31612,31789,177
2022-01-07,70057,70045,Blue,0,56441,57111,670
2022-10-28,70052,70058,Blue,1,58483,58727,244
2022-05-19,70056,70058,Blue,1,66656,66728,72
2022-01-20,70048,70056,Blue,1,67848,68245,397
2022-10-20,70056,70058,Blue,1,51423,51498,75
2022-06-15,70040,70050,Blue,1,59607,60147,540
2022-10-18,70055,70045,Blue,0,72430,72903,473
2022-02-07,70051,70838,Blue,0,45320,46020,700
2022-03-10,70040,70044,Blue,1,26839,27013,174
2022-07-08,70051,70043,Blue,0,81873,82383,510
2022-03-06,70040,70058,Blue,1,33189,34093,904
2022-03-31,70038,70042,Blue,1,45791,45915,124
2022-01-25,70038,70044,Blue,1,30293,30478,185
2022-10-21,70054,70058,Blue,1,69336,69497,161
2022-09-03,70040,70052,Blue,1,67004,67684,680
2022-04-05,70045,70043,Blue,0,48920,49012,92
2022-07-20,70055,70039,Blue,0,48646,49488,842
2022-04-19,70042,70054,Blue,1,69600,70330,730
2022-07-03,70055,70053,Blue,0,36388,36433,45
2022-06-23,70044,70058,Blue,1,55868,56760,892
2022-04-28,70055,70051,Blue,0,32846,32990,144
2022-04-20,70040,70058,Blue,1,61123,62221,1098
2022-08-03,70052,70060,Blue,1,71244,71620,376
2022-10-06,70038,70054,Blue,1,35316,36107,791
2022-09-13,70053,70045,Blue,0,21807,22351,544
2022-02-15,70057,70838,Blue,0,78385,79480,1095
2022-03-07,70056,70060,Blue,1,71504,71685,181
2022-11-26,70048,70054,Blue,1,69038,69336,298
2022-01-28,70059,70055,Blue,0,64987,65127,140
2022-01-06,70047,70039,Blue,0,51693,52222,529
2022-04-14,70044,70060,Blue,1,88532,89541,1009
2022-04-25,70049,70047,Blue,0,64789,64928,139
2022-12-14,70042,70060,Blue,1,31343,32335,992
2022-02-04,70048,70052,Blue,1,56303,56498,195
2022-12-05,70042,70056,Blue,1,89291,90029,738
2022-12-27,70044,70058,Blue,1,56354,57130,776
2022-12-22,70057,70055,Blue,0,24521,24592,71
2022-02-23,70059,70039,Blue,0,53891,54881,990
2022-01-31,70053,70041,Blue,0,81715,82476,761
2022-03-01,70048,70052,Blue,1,59014,59205,191
2022-03-20,70038,70042,Blue,1,44198,44290,92
2022-12-27,70046,70058,Blue,1,37040,37647,607
2022-05-07,70057,70053,Blue,0,63090,63240,150
2022-04-13,70045,70043,Blue,0,87117,87212,95
2022-06-09,70042,70060,Blue,1,30926,32005,1079
2022-01-21,70057,70051,Blue,0,27659,27913,254
2022-08-17,70042,70046,Blue,1,80242,80458,216
2022-02-09,70042,70052,Blue,1,68162,68729,567
2022-11-09,70057,70043,Blue,0,24675,25484,809
2022-09-19,70055,70838,Blue,0,62821,63843,1022
2022-07-17,70043,70838,Blue,0,39715,39919,204
2022-06-15,70052,70054,Blue,1,45538,45599,61
2022-11-01,70048,70058,Blue,1,42253,42769,516
2022-11-17,70044,70058,Blue,1,68749,69577,828
2022-12-05,70050,70052,Blue,1,71195,71318,123
2022-07-26,70044,70058,Blue,1,48880,49950,1070
2022-08-28,70040,70042,Blue,1,48951,48981,30
2022-11-05,70046,70058,Blue,1,65786,66463,677
2022-12-09,70055,70045,Blue,0,52159,52681,522
2022-11-29,70040,70054,Blue,1,21509,22267,758
2022-01-06,70038,70046,Blue,1,58028,58336,308
2022-06-16,70056,70060,Blue,1,21745,22012,267
2022-04-02,70049,70838,Blue,0,81161,81745,584
2022-11-19,70050,70054,Blue,1,73951,74158,207
2022-08-11,70055,70053,Blue,0,58935,58981,46
2022-01-09,70048,70054,Blue,1,48789,49127,338
2022-02-13,70051,70043,Blue,0,57965,58443,478
2022-02-10,70038,70050,Blue,1,84299,84877,578
2022-05-18,70055,70838,Blue,0,25412,26544,1132
2022-07-08,70055,70049,Blue,0,22039,22340,301
2022-03-23,70059,70053,Blue,0,73782,74018,236
2022-02-11,70043,70041,Blue,0,27713,27744,31
2022-06-28,70055,70051,Blue,0,55001,55132,131
2022-06-28,70053,70051,Blue,0,25550,25610,60
2022-02-19,70048,70054,Blue,1,49687,49993,306
2022-10-06,70050,70054,Blue,1,47710,47922,212
2022-03-04,70055,70043,Blue,0,57381,58033,652
2022-03-05,70051,70043,Blue,0,29585,30058,473
2022-01-05,70045,70043,Blue,0,66354,66443,89
2022-11-27,70055,70838,Blue,0,50773,51728,955
2022-05-18,70053,70047,Blue,0,48955,49277,322
2022-02-18,70054,70060,Blue,1,71894,72265,371
2022-01-12,70057,70039,Blue,0,27949,28834,885
2022-03-04,70057,70039,Blue,0,72710,73757,1047
2022-08-13,70057,70053,Blue,0,79670,79827,157
2022-02-02,70051,70041,Blue,0,25017,25685,668
2022-03-21,70040,70046,Blue,1,52273,52533,260
2022-02-28,70057,70053,Blue,0,34425,34630,205
2022-09-11,70050,70060,Blue,1,49996,50494,498
2022-10-12,70044,70060,Blue,1,27322,28326,1004
2022-02-20,70040,70046,Blue,1,69981,70240,259
2022-02-08,70057,70045,Blue,0,61458,62083,625
2022-04-24,70039,70838,Blue,0,48475,48516,41
2022-07-24,70057,70051,Blue,0,56616,56869,253
2022-01-25,70052,70054,Blue,1,57762,57822,60
2022-10-30,70040,70050,Blue,1,58119,58639,520
2022-11-13,70045,70041,Blue,0,80337,80499,162
2022-11-28,70040,70048,Blue,1,75343,75735,392
2022-04-08,70050,70052,Blue,1,29076,29192,116
2022-06-15,70059,70838,Blue,0,60794,61881,1087
2022-10-17,70052,70058,Blue,1,50963,51513,550
2022-09-05,70051,70043,Blue,0,62822,63274,452
2022-09-03,70055,70043,Blue,0,83414,84052,638
2022-07-09,70040,70044,Blue,1,78014,78117,103
2022-11-03,70053,70049,Blue,0,39351,39590,239
2022-07-16,70052,70060,Blue,1,35594,36006,412
2022-06-01,70046,70050,Blue,1,79093,79385,292
2022-07-25,70046,70058,Blue,1,66426,67104,678
2022-12-24,70055,70041,Blue,0,56419,57156,737
2022-04-29,70054,70056,Blue,1,59304,59351,47
2022-03-23,70042,70048,Blue,1,20714,21052,338
2022-01-04,70055,70039,Blue,0,85939,86730,791
2022-11-25,70051,70041,Blue,0,74786,75358,572
2022-09-24,70042,70060,Blue,1,69243,70145,902
2022-02-03,70055,70045,Blue,0,22323,22976,653
2022-11-26,70046,70054,Blue,1,32179,32616,437
2022-04-01,70040,70046,Blue,1,55694,55991,297
2022-06-22,70059,70045,Blue,0,48874,49587,713
2022-03-05,70048,70052,Blue,1,55574,55781,207
2022-09-03,70046,70052,Blue,1,52278,52618,340
2022-01-12,70043,70041,Blue,0,48336,48363,27
2022-01-15,70049,70047,Blue,0,88932,89001,69
2022-03-07,70048,70056,Blue,1,36172,36684,512
2022-01-22,70052,70054,Blue,1,51468,51525,57
2022-04-19,70040,70042,Blue,1,32413,32447,34
2022-09-27,70055,70051,Blue,0,65186,65326,140
2022-04-24,70046,70058,Blue,1,27252,27872,620
2022-11-07,70053,70051,Blue,0,34181,34280,99
2022-08-02,70046,70058,Blue,1,32756,33404,648
2022-01-10,70048,70052,Blue,1,65744,65951,207
2022-08-01,70051,70047,Blue,0,61699,61891,192
2022-09-06,70041,70838,Blue,0,27450,27596,146
2022-02-13,70049,70047,Blue,0,86989,87043,54
2022-07-31,70052,70056,Blue,1,63725,63877,152
2022-11-19,70053,70043,Blue,0,41442,41997,555
2022-02-09,70041,70039,Blue,0,54240,54273,33
2022-03-03,70048,70054,Blue,1,86047,86367,320
2022-09-09,70055,70047,Blue,0,45448,45851,403
2022-07-29,70053,70051,Blue,0,31275,31323,48
2022-01-26,70044,70060,Blue,1,44853,45700,847
2022-03-02,70054,70056,Blue,1,50640,50686,46
2022-08-20,70054,70056,Blue,1,55870,55917,47
2022-03-13,70055,70047,Blue,0,27988,28390,402
2022-11-02,70047,70045,Blue,0,40245,40345,100
2022-08-06,70047,70041,Blue,0,44950,45304,354
2022-01-02,70040,70048,Blue,1,54312,54695,383
2022-04-13,70038,70044,Blue,1,56526,56720,194
2022-09-30,70040,70054,Blue,1,35880,36614,734
2022-01-07,70039,70838,Blue,0,79470,79508,38
2022-06-20,70051,70049,Blue,0,46795,46902,107
2022-09-30,70055,70049,Blue,0,83141,83410,269
2022-01-11,70044,70050,Blue,1,23306,23716,410
2022-04-21,70048,70058,Blue,1,71028,71525,497
2022-02-20,70042,70060,Blue,1,29460,30442,982
2022-08-26,70044,70058,Blue,1,50540,51416,876
2022-01-13,70038,70050,Blue,1,74069,74620,551
2022-03-17,70059,70043,Blue,0,28159,29053,894
2022-09-24,70050,70052,Blue,1,42144,42255,111
2022-12-03,70043,70041,Blue,0,64190,64219,29
2022-08-05,70050,70052,Blue,1,79695,79810,115
2022-09-18,70057,70047,Blue,0,25486,25980,494
2022-06-15,70049,70838,Blue,0,50266,50901,635
2022-01-22,70038,70048,Blue,1,35615,36056,441
2022-06-29,70051,70047,Blue,0,85404,85610,206
2022-07-30,70038,70054,Blue,1,25633,26499,866
2022-10-30,70057,70039,Blue,0,51763,52742,979
2022-03-06,70047,70039,Blue,0,76578,76962,384
2022-03-25,70052,70058,Blue,1,69092,69357,265
2022-01-15,70048,70050,Blue,1,73754,73815,61
2022-06-21,70050,70060,Blue,1,76974,77507,533
2022-02-02,70041,70838,Blue,0,54788,54910,122
2022-02-26,70057,70055,Blue,0,42255,42324,69
2022-07-26,70048,70050,Blue,1,72093,72149,56
2022-01-05,70057,70051,Blue,0,62366,62621,255
2022-12-02,70049,70047,Blue,0,67591,67648,57
2022-02-22,70042,70054,Blue,1,38743,39503,760
2022-01-09,70048,70054,Blue,1,60694,60997,303
2022-09-19,70059,70047,Blue,0,25522,26088,566
2022-01-12,70053,70039,Blue,0,54163,54913,750
2022-11-14,70046,70052,Blue,1,36160,36497,337
2022-08-17,70047,70043,Blue,0,57547,57807,260
2022-05-10,70050,70054,Blue,1,24848,25049,201
2022-02-19,70055,70043,Blue,0,67232,67953,721
2022-10-12,70040,70058,Blue,1,60755,61720,965
2022-12-11,70057,70039,Blue,0,45266,46203,937
2022-10-05,70046,70052,Blue,1,24020,24406,386
2022-09-03,70055,70039,Blue,0,45624,46477,853
2022-07-27,70059,70053,Blue,0,77473,77696,223
2022-11-23,70048,70050,Blue,1,37210,37267,57
2022-11-15,70046,70054,Blue,1,34823,35233,410
2022-11-15,70046,70058,Blue,1,59141,59848,707
2022-03-03,70038,70040,Blue,1,30569,30591,22
2022-07-07,70046,70048,Blue,1,28588,28679,91
2022-09-02,70053,70838,Blue,0,24113,24932,819
2022-01-30,70049,70047,Blue,0,85289,85389,100
2022-01-04,70058,70060,Blue,1,55735,55811,76
2022-08-18,70048,70058,Blue,1,44123,44612,489
2022-08-27,70042,70056,Blue,1,79429,80207,778
2022-01-19,70044,70060,Blue,1,75399,76296,897
2022-07-27,70046,70052,Blue,1,55251,55647,396
2022-12-07,70051,70043,Blue,0,65376,65845,469
2022-02-02,70046,70058,Blue,1,62314,63337,1023
2022-05-17,70055,70049,Blue,0,60376,60759,383
2022-08-26,70048,70052,Blue,1,41940,42168,228
2022-10-03,70038,70052,Blue,1,27485,28162,677
2022-02-10,70042,70044,Blue,1,29488,29518,30
2022-10-12,70050,70060,Blue,1,81102,81624,522
2022-11-09,70047,70045,Blue,0,44186,44278,92
2022-08-31,70040,70052,Blue,1,38107,38713,606
2022-05-13,70050,70060,Blue,1,55316,55836,520
2022-07-27,70038,70058,Blue,1,28170,29231,1061
2022-01-26,70055,70047,Blue,0,63076,63482,406
2022-09-12,70051,70049,Blue,0,51327,51431,104
2022-03-31,70040,70058,Blue,1,66489,67433,944
2022-04-21,70055,70041,Blue,0,85356,86171,815
2022-11-13,70050,70054,Blue,1,82318,82525,207
2022-12-04,70046,70056,Blue,1,51043,51555,512
2022-11-06,70040,70048,Blue,1,67284,67679,395
2022-03-30,70051,70049,Blue,0,53189,53295,106
2022-10-12,70059,70055,Blue,0,88102,88240,138
2022-04-12,70038,70060,Blue,1,21859,23058,1199
2022-10-21,70040,70048,Blue,1,24560,24952,392
2022-04-24,70048,70052,Blue,1,88667,88865,198
2022-07-01,70053,70041,Blue,0,30005,30702,697
2022-09-15,70045,70041,Blue,0,63646,63838,192
2022-03-31,70047,70045,Blue,0,59647,59727,80
2022-02-18,70055,70051,Blue,0,52703,52852,149
2022-11-16,70047,70041,Blue,0,40626,40962,336
2022-01-19,70051,70043,Blue,0,65673,66173,500
2022-11-07,70057,70838,Blue,0,61092,62121,1029
2022-03-08,70059,70047,Blue,0,65896,66470,574
2022-01-09,70059,70049,Blue,0,39497,39997,500
2022-10-21,70042,70044,Blue,1,75420,75454,34
2022-03-24,70038,70060,Blue,1,84848,85952,1104
2022-12-07,70045,70043,Blue,0,65755,65845,90
2022-02-16,70049,70043,Blue,0,65486,65829,343
2022-07-14,70049,70043,Blue,0,40396,40772,376
2022-04-02,70049,70041,Blue,0,37823,38246,423
2022-04-19,70057,70041,Blue,0,67946,68830,884
2022-02-15,70046,70048,Blue,1,57478,57561,83
2022-02-13,70045,70838,Blue,0,83867,84254,387
2022-01-15,70040,70050,Blue,1,45383,45896,513
2022-11-16,70059,70055,Blue,0,66316,66466,150
2022-06-28,70044,70052,Blue,1,58124,58646,522
2022-04-11,70057,70053,Blue,0,68574,68725,151
2022-07-29,70059,70053,Blue,0,76739,76974,235
2022-02-18,70059,70041,Blue,0,23057,24222,1165
2022-04-07,70051,70047,Blue,0,22087,22293,206
2022-08-26,70053,70039,Blue,0,30885,31742,857
2022-10-10,70049,70041,Blue,0,22280,22725,445
2022-06-03,70049,70045,Blue,0,19390,19608,218
2022-04-05,70042,70048,Blue,1,25628,25948,320
2022-01-12,70049,70043,Blue,0,21004,21414,410
2022-02-23,70045,70041,Blue,0,20422,20643,221
2022-01-26,70048,70060,Blue,1,76836,77447,611
2022-04-05,70042,70056,Blue,1,80655,81451,796
2022-10-15,70046,70050,Blue,1,47957,48136,179
2022-09-27,70038,70050,Blue,1,56815,57376,561
2022-11-26,70044,70056,Blue,1,50939,51616,677
2022-11-03,70039,70838,Blue,0,46012,46049,37
2022-07-13,70055,70043,Blue,0,31989,32669,680
2022-02-20,70040,70048,Blue,1,49456,49829,373
2022-03-27,70053,70045,Blue,0,43708,44124,416
2022-05-30,70042,70046,Blue,1,77863,78074,211
2022-12-19,70046,70048,Blue,1,78059,78142,83
2022-10-17,70045,70039,Blue,0,53332,53602,270
2022-07-12,70045,70039,Blue,0,54259,54602,343
2022-10-22,70051,70838,Blue,0,73328,74058,730
2022-04-07,70042,70044,Blue,1,28000,28032,32
2022-11-10,70053,70047,Blue,0,31976,32290,314
2022-11-19,70059,70838,Blue,0,44909,46005,1096
2022-08-17,70055,70043,Blue,0,37486,38299,813
2022-11-10,70042,70048,Blue,1,24279,24601,322
2022-11-28,70057,70055,Blue,0,69209,69277,68
2022-01-07,70038,70054,Blue,1,54675,55553,878
2022-02-22,70040,70052,Blue,1,51375,52149,774
2022-03-31,70057,70053,Blue,0,64162,64313,151
2022-11-04,70045,70838,Blue,0,75234,75562,328
2022-08-02,70047,70039,Blue,0,49468,49883,415
2022-12-27,70046,70056,Blue,1,37040,37541,501
2022-09-26,70047,70041,Blue,0,53160,53498,338
2022-02-19,70051,70041,Blue,0,54474,55118,644
2022-12-25,70051,70039,Blue,0,66055,66659,604
2022-01-07,70059,70043,Blue,0,38115,39113,998
2022-03-30,70038,70060,Blue,1,22751,23933,1182
2022-01-17,70053,70041,Blue,0,28479,29179,700
2022-04-20,70059,70045,Blue,0,82334,83044,710
2022-04-20,70040,70052,Blue,1,33916,34612,696
2022-11-03,70039,70838,Blue,0,52013,52051,38
2022-07-30,70044,70058,Blue,1,63426,64267,841
2022-12-05,70047,70045,Blue,0,42779,42872,93
2022-03-23,70053,70039,Blue,0,26356,27230,874
2022-01-27,70055,70053,Blue,0,68644,68695,51
2022-07-08,70055,70051,Blue,0,53260,53395,135
2022-07-31,70042,70044,Blue,1,27795,27823,28
2022-08-22,70056,70060,Blue,1,38320,38528,208
2022-03-16,70059,70051,Blue,0,35828,36161,333
2022-06-28,70042,70058,Blue,1,27454,28429,975
2022-01-24,70038,70052,Blue,1,45381,46126,745
2022-05-03,70058,70060,Blue,1,72776,72847,71
2022-08-14,70050,70054,Blue,1,61881,62110,229
2022-07-08,70041,70039,Blue,0,43048,43085,37
2022-03-12,70057,70041,Blue,0,52532,53389,857
2022-12-30,70040,70052,Blue,1,82829,83679,850
2022-02-17,70043,70039,Blue,0,39139,39240,101
2022-03-10,70056,70060,Blue,1,36852,37158,306
2022-01-08,70055,70039,Blue,0,81769,82563,794
2022-03-20,70049,70045,Blue,0,62887,63117,230
2022-01-21,70051,70049,Blue,0,66234,66336,102
2022-07-09,70055,70045,Blue,0,32224,32821,597
2022-07-28,70057,70043,Blue,0,21480,22307,827
2022-07-14,70049,70838,Blue,0,66261,66867,606
2022-07-24,70052,70056,Blue,1,89833,89991,158
2022-02-21,70040,70048,Blue,1,88277,88674,397
2022-12-28,70045,70838,Blue,0,54619,54954,335
2022-11-09,70059,70055,Blue,0,42628,42774,146
2022-08-22,70053,70043,Blue,0,77082,77697,615
2022-02-08,70038,70040,Blue,1,80833,80850,17
2022-04-15,70048,70052,Blue,1,32991,33206,215
2022-02-16,70057,70055,Blue,0,21401,21473,72
2022-08-29,70059,70053,Blue,0,63441,63671,230
2022-09-14,70057,70049,Blue,0,48453,48846,393
2022-10-13,70038,70052,Blue,1,29731,30420,689
2022-02-05,70047,70039,Blue,0,61176,61601,425
2022-04-01,70040,70060,Blue,1,72007,73083,1076
2022-03-07,70059,70838,Blue,0,29662,30862,1200
2022-03-20,70051,70039,Blue,0,62748,63445,697
2022-08-08,70049,70838,Blue,0,65018,65612,594
2022-07-12,70055,70045,Blue,0,29945,30599,654
2022-06-11,70057,70838,Blue,0,80634,81803,1169
2022-10-24,70048,70054,Blue,1,43279,43677,398
2022-10-17,70053,70049,Blue,0,65481,65744,263
2022-08-01,70053,70049,Blue,0,55919,56148,229
2022-11-29,70042,70044,Blue,1,29624,29656,32
2022-09-24,70057,70049,Blue,0,51997,52396,399
2022-01-14,70049,70047,Blue,0,68968,69024,56
2022-08-26,70057,70049,Blue,0,70648,71046,398
2022-06-29,70045,70039,Blue,0,44924,45205,281
2022-04-27,70058,70060,Blue,1,49162,49227,65
2022-04-09,70054,70060,Blue,1,45099,45359,260
2022-07-30,70039,70838,Blue,0,35154,35188,34
2022-03-28,70059,70039,Blue,0,82336,83313,977
2022-08-24,70055,70051,Blue,0,44347,44486,139
2022-02-24,70051,70039,Blue,0,62404,63113,709
2022-05-26,70041,70039,Blue,0,76767,76799,32
2022-07-20,70055,70053,Blue,0,83093,83140,47
2022-05-16,70057,70055,Blue,0,59013,59081,68
2022-05-10,70056,70058,Blue,1,26777,26851,74
2022-05-22,70041,70039,Blue,0,37689,37723,34
2022-12-16,70046,70050,Blue,1,41801,41981,180
2022-07-12,70054,70058,Blue,1,67833,67990,157
2022-04-09,70041,70039,Blue,0,28077,28111,34
2022-02-28,70047,70838,Blue,0,30651,31345,694
2022-12-28,70052,70054,Blue,1,69636,69696,60
2022-08-15,70057,70045,Blue,0,74615,75252,637
2022-07-07,70047,70039,Blue,0,66791,67244,453
2022-03-25,70050,70054,Blue,1,53709,53951,242
2022-11-04,70038,70058,Blue,1,46409,47516,1107
2022-01-21,70050,70058,Blue,1,29392,29924,532
2022-06-16,70059,70051,Blue,0,58463,58768,305
2022-05-09,70055,70051,Blue,0,86617,86770,153
2022-06-20,70057,70049,Blue,0,82479,82949,470
2022-10-18,70053,70041,Blue,0,33759,34487,728
2022-12-06,70040,70046,Blue,1,84462,84745,283
2022-11-02,70059,70045,Blue,0,75915,76602,687
2022-04-07,70057,70049,Blue,0,62077,62443,366
2022-10-03,70059,70051,Blue,0,63218,63525,307
2022-06-02,70038,70044,Blue,1,86407,86574,167
2022-02-10,70051,70043,Blue,0,57832,58319,487
2022-04-21,70054,70060,Blue,1,37084,37342,258
2022-08-25,70040,70056,Blue,1,54706,55578,872
2022-12-18,70047,70043,Blue,0,62518,62752,234
2022-03-02,70055,70049,Blue,0,46267,46611,344
2022-06-22,70045,70043,Blue,0,21316,21463,147
2022-08-02,70046,70060,Blue,1,61881,62740,859
2022-09-23,70044,70060,Blue,1,26708,27673,965
2022-01-21,70040,70052,Blue,1,75869,76528,659
2022-11-11,70053,70838,Blue,0,36926,37755,829
2022-12-15,70044,70054,Blue,1,78073,78702,629
2022-06-25,70040,70052,Blue,1,33486,34201,715
2022-11-30,70057,70055,Blue,0,35371,35452,81
2022-06-29,70045,70838,Blue,0,72939,73517,578
2022-11-19,70042,70054,Blue,1,89262,89931,669
2022-01-26,70055,70838,Blue,0,45677,46657,980
2022-02-27,70048,70060,Blue,1,36743,37337,594
2022-12-05,70046,70054,Blue,1,80650,81071,421
2022-12-31,70047,70045,Blue,0,22867,22986,119
2022-08-30,70044,70050,Blue,1,34351,34677,326
2022-08-10,70042,70058,Blue,1,80823,81636,813
2022-12-01,70053,70051,Blue,0,58739,58795,56
2022-07-27,70052,70056,Blue,1,30259,30415,156
2022-02-07,70038,70042,Blue,1,42373,42460,87
2022-04-29,70052,70060,Blue,1,37167,37520,353
2022-03-12,70043,70041,Blue,0,74968,74997,29
2022-03-22,70059,70838,Blue,0,20260,21355,1095
2022-06-26,70042,70060,Blue,1,40498,41473,975
2022-01-04,70040,70060,Blue,1,86603,87650,1047
2022-09-08,70054,70056,Blue,1,71618,71666,48
2022-01-19,70046,70052,Blue,1,57535,57913,378
2022-04-27,70059,70053,Blue,0,19515,19782,267
2022-04-01,70057,70055,Blue,0,48258,48326,68
2022-02-09,70051,70049,Blue,0,65672,65774,102
2022-03-05,70040,70056,Blue,1,74692,75670,978
2022-09-30,70057,70041,Blue,0,56263,57179,916
2022-03-30,70042,70056,Blue,1,39814,40528,714
2022-11-25,70045,70039,Blue,0,79442,79721,279
2022-09-01,70043,70039,Blue,0,54424,54530,106
2022-08-09,70044,70052,Blue,1,62685,63163,478
2022-10-29,70054,70060,Blue,1,28276,28533,257
2022-12-14,70040,70044,Blue,1,65955,66088,133
2022-11-14,70056,70060,Blue,1,41695,41860,165
2022-12-03,70044,70060,Blue,1,62706,63596,890
2022-01-15,70040,70054,Blue,1,69109,70075,966
2022-10-24,70053,70051,Blue,0,54650,54707,57
2022-08-29,70059,70053,Blue,0,79355,79580,225
2022-01-03,70055,70047,Blue,0,45687,46077,390
2022-02-03,70040,70054,Blue,1,23409,24158,749
2022-12-22,70059,70051,Blue,0,58815,59117,302
2022-07-25,70038,70050,Blue,1,29906,30508,602
2022-12-22,70057,70049,Blue,0,33345,33779,434
2022-01-09,70055,70047,Blue,0,50255,50625,370
2022-07-14,70043,70039,Blue,0,30370,30508,138
2022-12-13,70053,70041,Blue,0,82437,83065,628
2022-09-10,70052,70060,Blue,1,74231,74610,379
2022-06-15,70042,70044,Blue,1,41465,41493,28
2022-01-07,70047,70838,Blue,0,61499,62018,519
2022-01-05,70057,70039,Blue,0,66901,67879,978
2022-10-21,70054,70058,Blue,1,57904,58063,159
2022-09-19,70053,70039,Blue,0,41896,42686,790
2022-06-14,70040,70048,Blue,1,23133,23551,418
2022-02-20,70055,70049,Blue,0,42997,43294,297
2022-10-01,70038,70044,Blue,1,79936,80145,209
2022-05-27,70041,70838,Blue,0,31408,31538,130
2022-09-23,70047,70045,Blue,0,27039,27157,118
2022-06-12,70040,70056,Blue,1,43052,43937,885
2022-04-11,70045,70039,Blue,0,25351,25743,392
2022-10-02,70042,70054,Blue,1,64728,65413,685
2022-12-26,70047,70045,Blue,0,32251,32339,88
2022-09-21,70059,70049,Blue,0,74354,74862,508
2022-04-02,70042,70046,Blue,1,69755,69931,176
2022-12-25,70039,70838,Blue,0,45246,45276,30
2022-11-30,70047,70045,Blue,0,65054,65150,96
2022-03-11,70044,70050,Blue,1,20648,21018,370
2022-05-20,70053,70838,Blue,0,60144,61049,905
2022-01-13,70055,70051,Blue,0,63072,63245,173
2022-07-29,70049,70047,Blue,0,68583,68645,62
2022-09-02,70042,70046,Blue,1,52325,52501,176
2022-09-19,70041,70039,Blue,0,44723,44752,29
2022-03-15,70059,70053,Blue,0,58086,58303,217
2022-09-29,70038,70042,Blue,1,68956,69059,103
2022-01-25,70051,70039,Blue,0,58508,59197,689
2022-01-06,70059,70838,Blue,0,48782,50048,1266
2022-05-19,70042,70046,Blue,1,83022,83252,230
2022-07-19,70048,70052,Blue,1,62918,63126,208
2022-07-18,70042,70048,Blue,1,67654,67989,335
2022-09-03,70047,70043,Blue,0,40642,40919,277
2022-08-27,70045,70043,Blue,0,70490,70613,123
2022-01-22,70048,70054,Blue,1,77774,78074,300
2022-10-11,70046,70050,Blue,1,63410,63603,193
2022-12-12,70042,70046,Blue,1,65517,65689,172
2022-03-03,70055,70051,Blue,0,20906,21064,158
2022-09-06,70049,70043,Blue,0,77209,77541,332
2022-11-30,70052,70060,Blue,1,28664,29074,410
2022-02-10,70054,70060,Blue,1,87404,87831,427
2022-03-01,70059,70051,Blue,0,37519,37892,373
2022-11-01,70042,70056,Blue,1,71731,72446,715
2022-12-17,70050,70056,Blue,1,63759,64055,296
2022-10-10,70044,70060,Blue,1,39223,40159,936
2022-04-04,70042,70060,Blue,1,87873,88898,1025
2022-10-27,70056,70060,Blue,1,27429,27682,253
2022-10-18,70055,70041,Blue,0,29504,30325,821
2022-10-14,70042,70044,Blue,1,82799,82836,37
2022-12-15,70042,70048,Blue,1,37421,37735,314
2022-09-27,70053,70051,Blue,0,28355,28413,58
2022-09-02,70051,70039,Blue,0,86180,86805,625
2022-03-17,70051,70049,Blue,0,36048,36149,101
2022-09-06,70051,70039,Blue,0,27565,28253,688
2022-01-21,70049,70047,Blue,0,21501,21555,54
2022-02-10,70053,70045,Blue,0,54825,55261,436
2022-03-16,70053,70838,Blue,0,63450,64279,829
2022-12-12,70049,70041,Blue,0,31144,31618,474
2022-06-11,70038,70044,Blue,1,22432,22606,174
2022-08-26,70044,70056,Blue,1,59806,60560,754
2022-06-20,70040,70048,Blue,1,25712,26141,429
2022-05-19,70057,70047,Blue,0,80701,81184,483
2022-03-04,70055,70049,Blue,0,47287,47560,273
2022-02-17,70054,70060,Blue,1,30564,30821,257
2022-08-24,70038,70042,Blue,1,76449,76545,96
2022-02-22,70041,70039,Blue,0,41543,41576,33
2022-08-07,70042,70046,Blue,1,62513,62685,172
2022-10-01,70057,70049,Blue,0,22233,22620,387
2022-04-14,70049,70041,Blue,0,65805,66214,409
2022-03-31,70057,70049,Blue,0,43284,43662,378
2022-07-13,70044,70048,Blue,1,78634,78884,250
2022-09-19,70058,70060,Blue,1,54497,54560,63
2022-11-12,70053,70041,Blue,0,39904,40620,716
2022-11-28,70058,70060,Blue,1,27874,27941,67
2022-10-27,70044,70050,Blue,1,57955,58310,355
2022-12-21,70046,70058,Blue,1,68729,69522,793
2022-02-28,70040,70048,Blue,1,25236,25593,357
2022-02-08,70042,70060,Blue,1,29646,31044,1398
2022-10-28,70059,70047,Blue,0,58218,58763,545
2022-11-15,70056,70058,Blue,1,80874,80944,70
2022-06-15,70054,70058,Blue,1,30183,30338,155
2022-06-12,70046,70054,Blue,1,30369,30772,403
2022-06-15,70042,70056,Blue,1,56701,57500,799
2022-06-15,70055,70838,Blue,0,79643,80567,924
2022-08-01,70057,70055,Blue,0,25600,25668,68
2022-10-08,70048,70054,Blue,1,23797,24123,326
2022-06-23,70059,70051,Blue,0,31308,31626,318
2022-08-13,70051,70045,Blue,0,44186,44535,349
2022-06-11,70048,70060,Blue,1,73373,73994,621
2022-06-29,70048,70052,Blue,1,77875,78089,214
2022-12-16,70041,70838,Blue,0,87576,87684,108
2022-08-17,70048,70052,Blue,1,62363,62578,215
2022-08-27,70042,70060,Blue,1,45455,46367,912
2022-05-31,70046,70052,Blue,1,64608,65054,446
2022-04-19,70049,70838,Blue,0,82855,83430,575
2022-04-15,70038,70060,Blue,1,69489,70678,1189
2022-07-19,70045,70039,Blue,0,32628,32908,280
2022-01-01,70055,70039,Blue,0,31812,32582,770
2022-09-19,70040,70048,Blue,1,69689,70081,392
2022-08-29,70040,70060,Blue,1,67651,68807,1156
2022-12-09,70045,70039,Blue,0,78238,78475,237
2022-12-04,70048,70056,Blue,1,81518,81899,381
2022-11-03,70053,70047,Blue,0,49120,49431,311
2022-08-24,70042,70044,Blue,1,59619,59648,29
2022-12-17,70059,70051,Blue,0,57854,58164,310
2022-05-17,70050,70054,Blue,1,22397,22607,210
2022-01-31,70048,70060,Blue,1,72196,72983,787
2022-11-11,70053,70041,Blue,0,34657,35294,637
2022-03-06,70040,70058,Blue,1,48907,49876,969
2022-11-13,70046,70060,Blue,1,42023,42717,694
2022-04-14,70038,70052,Blue,1,81426,82162,736
2022-01-04,70040,70050,Blue,1,51368,51862,494
2022-10-10,70046,70054,Blue,1,67347,67813,466
2022-05-30,70040,70044,Blue,1,45969,46072,103
2022-03-31,70057,70055,Blue,0,57274,57343,69
2022-05-04,70049,70047,Blue,0,80898,80968,70
2022-12-31,70038,70048,Blue,1,61045,61515,470
2022-09-16,70047,70838,Blue,0,84990,85516,526
2022-08-09,70054,70058,Blue,1,82783,82944,161
2022-11-04,70038,70052,Blue,1,61655,62574,919
2022-05-07,70050,70060,Blue,1,89928,90481,553
2022-12-26,70055,70053,Blue,0,71294,71340,46
2022-04-14,70046,70054,Blue,1,76234,76705,471
2022-07-12,70038,70040,Blue,1,35676,35694,18
2022-06-24,70040,70052,Blue,1,36341,37386,1045
2022-09-01,70038,70042,Blue,1,29472,29576,104
2022-09-01,70038,70052,Blue,1,31119,31937,818
2022-04-21,70040,70042,Blue,1,64709,64745,36
2022-02-04,70040,70058,Blue,1,51969,52999,1030
2022-03-29,70057,70039,Blue,0,24048,25025,977
2022-07-04,70045,70043,Blue,0,28919,29025,106
2022-12-18,70038,70044,Blue,1,83710,83870,160
2022-03-19,70047,70043,Blue,0,42782,43050,268
2022-11-24,70040,70050,Blue,1,78674,79170,496
2022-01-27,70042,70056,Blue,1,68080,68857,777
2022-06-20,70050,70058,Blue,1,83792,84345,553
2022-11-26,70042,70050,Blue,1,53569,53969,400
2022-11-12,70038,70040,Blue,1,33998,34014,16
2022-12-02,70040,70042,Blue,1,25690,25721,31
2022-01-12,70049,70047,Blue,0,44752,44806,54
2022-06-11,70048,70058,Blue,1,70175,70674,499
2022-10-05,70055,70043,Blue,0,30332,31066,734
2022-12-18,70043,70838,Blue,0,22404,22611,207
2022-01-09,70047,70039,Blue,0,82823,83199,376
2022-11-21,70042,70052,Blue,1,46833,47434,601
2022-12-21,70055,70043,Blue,0,21816,22476,660
2022-09-03,70050,70058,Blue,1,28095,28492,397
2022-04-15,70043,70838,Blue,0,35209,35421,212
2022-04-07,70044,70054,Blue,1,28070,28681,611
2022-08-19,70044,70052,Blue,1,67610,68175,565
2022-08-06,70049,70041,Blue,0,25936,26376,440
2022-05-19,70038,70058,Blue,1,54560,56008,1448
2022-10-15,70044,70052,Blue,1,50934,51415,481
2022-07-15,70044,70052,Blue,1,74179,74654,475
2022-10-27,70051,70043,Blue,0,24823,25348,525
2022-01-16,70047,70838,Blue,0,30065,30666,601
2022-03-05,70040,70056,Blue,1,32951,33776,825
2022-02-27,70053,70045,Blue,0,75725,76155,430
2022-03-01,70038,70048,Blue,1,34157,34651,494
2022-08-17,70042,70058,Blue,1,39598,40493,895
2022-01-17,70045,70043,Blue,0,72684,72775,91
2022-09-28,70050,70060,Blue,1,68831,69358,527
2022-03-12,70051,70049,Blue,0,61574,61679,105
2022-12-24,70046,70058,Blue,1,51660,52286,626
2022-08-18,70052,70054,Blue,1,22414,22462,48
2022-08-23,70045,70041,Blue,0,30897,31131,234
2022-08-25,70049,70043,Blue,0,38012,38389,377
2022-11-29,70040,70044,Blue,1,84201,84311,110
2022-07-23,70042,70046,Blue,1,64900,65078,178
2022-03-23,70038,70050,Blue,1,29654,30215,561
2022-03-28,70059,70049,Blue,0,73754,74221,467
2022-10-12,70053,70049,Blue,0,43762,43997,235
2022-01-21,70042,70060,Blue,1,62471,63598,1127
2022-01-16,70044,70058,Blue,1,38597,39421,824
2022-11-28,70059,70045,Blue,0,55096,55806,710
2022-03-07,70042,70048,Blue,1,74802,75147,345
2022-08-20,70055,70053,Blue,0,52103,52150,47
2022-11-08,70053,70049,Blue,0,70522,70704,182
2022-08-02,70053,70041,Blue,0,52608,53327,719
2022-02-18,70057,70039,Blue,0,55778,56728,950
2022-08-03,70057,70047,Blue,0,53606,54079,473
2022-02-07,70043,70838,Blue,0,20785,21001,216
2022-08-09,70053,70051,Blue,0,33359,33426,67
2022-11-17,70051,70838,Blue,0,59119,59876,757
2022-04-12,70040,70052,Blue,1,61085,61847,762
2022-01-11,70059,70055,Blue,0,28155,28295,140
2022-06-29,70057,70051,Blue,0,85104,85366,262
2022-04-17,70056,70060,Blue,1,55209,55379,170
2022-12-05,70038,70050,Blue,1,72075,72613,538
2022-05-04,70050,70052,Blue,1,45058,45185,127
2022-10-09,70059,70057,Blue,0,64627,64661,34
2022-04-01,70055,70047,Blue,0,52283,52641,358
2022-09-07,70038,70046,Blue,1,78368,78687,319
2022-06-17,70038,70058,Blue,1,55335,56387,1052
2022-11-18,70040,70044,Blue,1,22941,23053,112
2022-02-03,70048,70050,Blue,1,65446,65503,57
2022-01-23,70051,70043,Blue,0,37196,37799,603
2022-07-23,70048,70056,Blue,1,83159,83571,412
2022-12-06,70054,70060,Blue,1,45423,45681,258
2022-09-13,70040,70042,Blue,1,37814,37844,30
2022-02-22,70044,70052,Blue,1,21531,22079,548
2022-08-15,70051,70041,Blue,0,36280,36880,600
2022-10-15,70051,70047,Blue,0,27975,28175,200
2022-02-10,70040,70056,Blue,1,35446,36281,835
2022-03-31,70059,70049,Blue,0,82879,83371,492
2022-02-20,70053,70045,Blue,0,27215,27606,391
2022-07-16,70057,70049,Blue,0,67153,67541,388
2022-03-18,70055,70049,Blue,0,47899,48173,274
2022-08-02,70045,70039,Blue,0,57984,58261,277
2022-10-25,70051,70039,Blue,0,67627,68232,605
2022-04-14,70047,70043,Blue,0,63521,63775,254
2022-12-09,70038,70060,Blue,1,62173,63329,1156
2022-12-21,70057,70043,Blue,0,73899,74629,730
2022-06-28,70048,70056,Blue,1,67063,67559,496
2022-02-22,70057,70043,Blue,0,21043,21965,922
2022-06-10,70042,70058,Blue,1,28028,29958,1930
2022-12-01,70055,70045,Blue,0,60755,61373,618
2022-07-04,70038,70060,Blue,1,66736,67907,1171
2022-08-10,70053,70051,Blue,0,83054,83106,52
2022-12-23,70048,70054,Blue,1,50285,50629,344
2022-09-02,70052,70060,Blue,1,25476,25822,346
2022-01-25,70054,70056,Blue,1,79344,79390,46
2022-10-14,70050,70060,Blue,1,32503,32983,480
2022-02-08,70057,70838,Blue,0,72143,73177,1034
2022-06-17,70042,70060,Blue,1,34310,35472,1162
2022-03-07,70057,70055,Blue,0,28842,28912,70
2022-10-22,70051,70043,Blue,0,44161,44701,540
2022-12-10,70050,70060,Blue,1,58369,58856,487
2022-08-06,70052,70058,Blue,1,40086,40328,242
2022-08-08,70059,70047,Blue,0,59404,59998,594
2022-08-03,70048,70052,Blue,1,36316,36528,212
2022-08-05,70059,70045,Blue,0,32653,33378,725
2022-01-12,70038,70060,Blue,1,61034,62264,1230
2022-07-26,70045,70039,Blue,0,51326,51596,270
2022-06-14,70049,70047,Blue,0,34488,34545,57
2022-03-12,70047,70041,Blue,0,31480,31812,332
2022-01-28,70050,70056,Blue,1,31504,31897,393
2022-06-24,70052,70058,Blue,1,55318,55586,268
2022-08-16,70047,70045,Blue,0,75974,76071,97
2022-08-14,70042,70044,Blue,1,73300,73330,30
2022-01-26,70059,70051,Blue,0,39786,40183,397
2022-07-26,70048,70060,Blue,1,32120,32785,665
2022-01-05,70046,70054,Blue,1,39942,40460,518
2022-08-09,70046,70060,Blue,1,31215,31959,744
2022-07-15,70057,70043,Blue,0,59633,60467,834
2022-02-11,70055,70838,Blue,0,33438,34432,994
2022-02-14,70050,70058,Blue,1,32671,33073,402
2022-11-13,70041,70039,Blue,0,58549,58581,32
2022-11-09,70038,70054,Blue,1,57614,58500,886
2022-08-21,70041,70838,Blue,0,79240,79368,128
2022-08-22,70052,70056,Blue,1,42805,42975,170
2022-01-20,70041,70039,Blue,0,29036,29071,35
2022-12-04,70049,70838,Blue,0,82082,82634,552
2022-01-28,70053,70051,Blue,0,35578,35627,49
2022-06-09,70055,70053,Blue,0,55296,55342,46
2022-03-26,70046,70060,Blue,1,32203,32904,701
2022-12-22,70046,70050,Blue,1,36146,36324,178
2022-08-09,70055,70041,Blue,0,33274,34064,790
2022-07-26,70051,70041,Blue,0,71060,71626,566
2022-11-10,70044,70060,Blue,1,25792,26719,927
2022-09-18,70044,70052,Blue,1,37910,38389,479
2022-11-12,70053,70051,Blue,0,40313,40368,55
2022-10-20,70051,70047,Blue,0,72137,72337,200
2022-12-01,70040,70056,Blue,1,61803,62715,912
2022-10-06,70048,70060,Blue,1,31883,32552,669
2022-12-24,70054,70060,Blue,1,81440,81727,287
2022-04-23,70040,70050,Blue,1,49305,49883,578
2022-03-01,70051,70838,Blue,0,67879,68658,779
2022-02-14,70049,70039,Blue,0,64933,65484,551
2022-08-16,70040,70052,Blue,1,19983,20633,650
2022-04-08,70040,70060,Blue,1,23700,24810,1110
2022-12-09,70053,70051,Blue,0,67358,67405,47
2022-08-31,70042,70050,Blue,1,27453,27855,402
2022-12-04,70057,70039,Blue,0,56299,57309,1010
2022-06-11,70048,70060,Blue,1,62626,63256,630
2022-08-07,70059,70041,Blue,0,26175,27107,932
2022-08-13,70040,70056,Blue,1,26359,27226,867
2022-01-03,70059,70057,Blue,0,28756,28792,36
2022-02-05,70043,70838,Blue,0,36175,36382,207
2022-08-19,70046,70060,Blue,1,21488,22280,792
2022-11-04,70053,70838,Blue,0,61920,62830,910
2022-01-24,70040,70042,Blue,1,44246,44276,30
2022-05-06,70059,70057,Blue,0,39924,39960,36
2022-10-18,70048,70060,Blue,1,52681,53333,652
2022-07-02,70059,70045,Blue,0,53538,54232,694
2022-11-03,70059,70041,Blue,0,36997,38141,1144
2022-01-01,70047,70043,Blue,0,62021,62261,240
2022-09-25,70042,70056,Blue,1,83999,84888,889
2022-10-06,70058,70060,Blue,1,64580,64728,148
2022-09-20,70038,70044,Blue,1,52388,52608,220
2022-09-01,70059,70055,Blue,0,86528,86681,153
2022-01-19,70051,70045,Blue,0,63898,64237,339
2022-05-01,70059,70047,Blue,0,40815,41609,794
2022-08-03,70053,70051,Blue,0,24109,24164,55
2022-06-21,70040,70050,Blue,1,27370,27902,532
2022-09-22,70059,70043,Blue,0,41172,42083,911
2022-06-14,70048,70058,Blue,1,56397,57218,821
2022-12-08,70040,70044,Blue,1,80462,80590,128
2022-06-26,70052,70054,Blue,1,56804,56868,64
2022-06-09,70051,70049,Blue,0,68999,69101,102
2022-09-02,70048,70052,Blue,1,62089,62297,208
2022-12-22,70055,70838,Blue,0,70144,71036,892
2022-01-16,70038,70040,Blue,1,59113,59130,17
2022-07-29,70054,70058,Blue,1,43183,43336,153
2022-02-26,70038,70050,Blue,1,35605,36193,588
2022-06-09,70050,70052,Blue,1,86692,86936,244
2022-12-18,70047,70838,Blue,0,65298,65782,484
2022-11-09,70044,70060,Blue,1,48465,49352,887
2022-02-06,70053,70045,Blue,0,77874,78294,420
2022-09-01,70046,70060,Blue,1,50671,51384,713
2022-03-23,70049,70047,Blue,0,61567,61622,55
2022-01-24,70053,70045,Blue,0,64352,64803,451
2022-08-31,70042,70052,Blue,1,28712,29241,529
2022-05-20,70040,70044,Blue,1,39646,39773,127
2022-07-15,70040,70052,Blue,1,48420,49091,671
2022-01-20,70053,70039,Blue,0,66790,67602,812
2022-08-17,70057,70049,Blue,0,35522,35921,399
2022-11-10,70055,70043,Blue,0,81362,82050,688
2022-04-01,70057,70838,Blue,0,55157,56114,957
2022-04-03,70045,70043,Blue,0,54578,54667,89
2022-03-03,70053,70047,Blue,0,70782,71078,296
2022-02-18,70038,70044,Blue,1,78006,78184,178
2022-03-03,70051,70043,Blue,0,34534,35062,528
2022-09-06,70057,70055,Blue,0,87419,87488,69
2022-06-19,70042,70044,Blue,1,59300,59328,28
2022-11-09,70040,70054,Blue,1,28214,28943,729
2022-05-04,70054,70058,Blue,1,67846,68000,154
2022-02-06,70038,70060,Blue,1,55337,56479,1142
2022-08-16,70059,70057,Blue,0,77477,77513,36
2022-06-13,70044,70050,Blue,1,63701,64174,473
2022-05-19,70048,70056,Blue,1,25222,25717,495
2022-07-13,70048,70060,Blue,1,66246,67070,824
2022-01-21,70040,70058,Blue,1,73039,74067,1028
2022-09-02,70047,70043,Blue,0,51617,51856,239
2022-07-16,70051,70047,Blue,0,37781,37984,203
2022-01-12,70059,70041,Blue,0,28455,29402,947
2022-01-05,70050,70052,Blue,1,27531,27647,116
2022-03-05,70043,70039,Blue,0,31272,31381,109
2022-07-19,70056,70060,Blue,1,23826,24010,184
2022-04-18,70050,70060,Blue,1,53693,54210,517
2022-08-13,70038,70044,Blue,1,66378,66563,185
2022-10-06,70044,70058,Blue,1,30038,30855,817
2022-03-03,70057,70047,Blue,0,30045,30608,563
2022-06-10,70044,70050,Blue,1,33605,33993,388
2022-07-06,70038,70046,Blue,1,80073,80422,349
2022-03-29,70042,70048,Blue,1,43690,44018,328
2022-01-12,70049,70838,Blue,0,51691,52352,661
2022-09-20,70038,70040,Blue,1,23293,23309,16
2022-06-19,70038,70040,Blue,1,56408,56427,19
2022-06-20,70055,70043,Blue,0,63289,64008,719
2022-08-20,70059,70051,Blue,0,54075,54404,329
2022-02-15,70057,70045,Blue,0,54897,55614,717
2022-07-25,70039,70838,Blue,0,62937,62972,35
2022-03-04,70051,70041,Blue,0,33650,34210,560
2022-06-25,70048,70052,Blue,1,81956,82166,210
2022-03-24,70043,70838,Blue,0,28537,28746,209
2022-04-08,70042,70056,Blue,1,87889,88666,777
2022-06-09,70049,70041,Blue,0,31971,32444,473
2022-01-16,70044,70060,Blue,1,78847,79749,902
2022-01-17,70045,70043,Blue,0,33212,33308,96
2022-06-12,70042,70058,Blue,1,72793,73705,912
2022-03-28,70049,70041,Blue,0,33504,33933,429
2022-11-05,70055,70039,Blue,0,85891,86700,809
2022-08-11,70040,70046,Blue,1,53050,53348,298
2022-08-28,70038,70042,Blue,1,47788,47884,96
2022-03-08,70059,70051,Blue,0,22760,23133,373
2022-01-12,70051,70047,Blue,0,37380,37571,191
2022-12-08,70050,70058,Blue,1,35461,35903,442
2022-05-22,70038,70044,Blue,1,66941,67140,199
2022-04-20,70046,70050,Blue,1,61245,61463,218
2022-12-07,70054,70060,Blue,1,62887,63158,271
2022-01-20,70046,70058,Blue,1,57330,57999,669
2022-06-29,70057,70047,Blue,0,72747,73216,469
2022-01-25,70054,70060,Blue,1,41010,41274,264
2022-06-11,70056,70060,Blue,1,59288,59478,190
2022-07-20,70052,70056,Blue,1,79062,79204,142
2022-09-04,70057,70045,Blue,0,35690,36437,747
2022-10-19,70053,70041,Blue,0,76705,77336,631
2022-08-21,70059,70043,Blue,0,66263,67254,991
2022-07-05,70043,70838,Blue,0,31126,31343,217
2022-02-26,70053,70051,Blue,0,81907,81959,52
2022-06-26,70059,70053,Blue,0,77046,77273,227
2022-12-08,70048,70058,Blue,1,71015,71550,535
2022-08-12,70057,70051,Blue,0,31515,31775,260
2022-06-09,70051,70045,Blue,0,65255,65626,371
2022-11-08,70038,70058,Blue,1,83428,84492,1064
2022-04-09,70059,70039,Blue,0,77127,78107,980
2022-04-08,70049,70045,Blue,0,81099,81291,192
2022-08-05,70044,70056,Blue,1,57639,58318,679
2022-06-23,70054,70056,Blue,1,43879,43926,47
2022-01-28,70052,70054,Blue,1,56676,56730,54
2022-10-15,70049,70043,Blue,0,36809,37169,360
2022-08-04,70038,70050,Blue,1,64348,64967,619
2022-11-12,70051,70047,Blue,0,27471,27671,200
2022-08-19,70059,70838,Blue,0,23000,24241,1241
2022-08-24,70055,70051,Blue,0,65996,66432,436
2022-12-13,70057,70045,Blue,0,55713,56370,657
2022-11-04,70054,70060,Blue,1,87436,87686,250
2022-12-27,70053,70047,Blue,0,65574,65859,285
2022-07-04,70040,70056,Blue,1,63198,64114,916
2022-12-03,70055,70041,Blue,0,40256,41543,1287
2022-03-14,70049,70041,Blue,0,44909,45318,409
2022-01-27,70057,70045,Blue,0,58468,59215,747
2022-02-18,70050,70054,Blue,1,34703,34912,209
2022-06-16,70044,70050,Blue,1,84073,84445,372
2022-03-07,70059,70053,Blue,0,81202,81439,237
2022-11-15,70040,70046,Blue,1,51934,52222,288
2022-03-27,70050,70060,Blue,1,68353,68870,517
2022-05-15,70059,70057,Blue,0,80927,80974,47
2022-03-26,70054,70060,Blue,1,77580,77856,276
2022-09-24,70046,70052,Blue,1,28392,28722,330
2022-03-27,70038,70046,Blue,1,76934,77262,328
2022-07-18,70040,70042,Blue,1,32751,32784,33
2022-02-27,70059,70051,Blue,0,30926,31251,325
2022-04-04,70046,70056,Blue,1,25823,26325,502
2022-10-17,70053,70838,Blue,0,34699,35602,903
2022-09-01,70040,70054,Blue,1,69125,69879,754
2022-03-07,70055,70838,Blue,0,31351,32320,969
2022-10-22,70055,70051,Blue,0,73699,73838,139
2022-03-26,70058,70060,Blue,1,73880,73941,61
2022-12-17,70057,70045,Blue,0,28232,28863,631
2022-08-23,70042,70054,Blue,1,53103,53832,729
2022-12-14,70039,70838,Blue,0,59912,59943,31
2022-12-09,70045,70043,Blue,0,50161,50249,88
2022-08-04,70055,70051,Blue,0,25713,25850,137
2022-06-20,70038,70040,Blue,1,34045,34062,17
2022-03-11,70059,70055,Blue,0,26673,26834,161
2022-09-22,70044,70046,Blue,1,47426,47796,370
2022-07-20,70044,70048,Blue,1,62499,62752,253
2022-05-25,70044,70052,Blue,1,50053,50631,578
2022-01-04,70038,70050,Blue,1,61929,62468,539
2022-03-14,70046,70058,Blue,1,32419,33073,654
2022-02-27,70055,70045,Blue,0,59962,60489,527
2022-06-30,70038,70050,Blue,1,87362,87905,543
2022-11-05,70057,70047,Blue,0,45520,46001,481
2022-10-01,70052,70056,Blue,1,36341,36473,132
2022-12-02,70045,70838,Blue,0,58487,58818,331
2022-10-01,70039,70838,Blue,0,70834,70872,38
2022-02-23,70044,70048,Blue,1,54233,54456,223
2022-10-14,70043,70041,Blue,0,29820,29848,28
2022-11-07,70045,70838,Blue,0,52300,52652,352
2022-07-22,70055,70043,Blue,0,69406,70105,699
2022-08-01,70053,70049,Blue,0,63463,63695,232
2022-11-22,70056,70058,Blue,1,33659,33732,73
2022-06-15,70040,70044,Blue,1,51280,51412,132
2022-03-22,70038,70044,Blue,1,68603,68905,302
2022-05-22,70038,70052,Blue,1,30913,31808,895
2022-10-04,70059,70838,Blue,0,34394,35644,1250
2022-05-23,70038,70042,Blue,1,35958,36054,96
2022-01-11,70039,70838,Blue,0,60051,60085,34
2022-10-02,70052,70054,Blue,1,59829,59883,54
2022-02-17,70048,70056,Blue,1,88818,89201,383
2022-01-27,70045,70039,Blue,0,32485,32745,260
2022-01-19,70049,70047,Blue,0,75405,75464,59
2022-09-29,70040,70054,Blue,1,79106,79812,706
2022-04-18,70058,70060,Blue,1,23839,23900,61
2022-06-20,70057,70041,Blue,0,39097,40038,941
2022-11-05,70049,70043,Blue,0,76279,76633,354
2022-07-03,70053,70047,Blue,0,81174,81467,293
2022-12-02,70059,70043,Blue,0,32119,33026,907
2022-12-22,70054,70058,Blue,1,89232,89388,156
2022-02-06,70051,70041,Blue,0,22654,23266,612
2022-10-22,70051,70039,Blue,0,27472,28153,681
2022-04-14,70052,70056,Blue,1,26463,26603,140
2022-04-18,70045,70041,Blue,0,24204,24397,193
2022-02-26,70049,70045,Blue,0,43812,44020,208
2022-11-18,70057,70039,Blue,0,19606,20620,1014
2022-01-21,70044,70060,Blue,1,80504,81380,876
2022-03-04,70055,70051,Blue,0,37188,37407,219
2022-12-28,70053,70041,Blue,0,60112,60770,658
2022-02-06,70042,70048,Blue,1,59940,60262,322
2022-04-06,70044,70046,Blue,1,39337,39445,108
2022-02-20,70042,70044,Blue,1,76541,76572,31
2022-11-14,70049,70047,Blue,0,57953,58009,56
2022-06-22,70052,70056,Blue,1,51461,51637,176
2022-02-03,70059,70043,Blue,0,86893,87873,980
2022-09-29,70038,70046,Blue,1,59841,60203,362
2022-02-07,70059,70045,Blue,0,42680,43503,823
2022-12-10,70058,70060,Blue,1,42723,42808,85
2022-11-30,70049,70047,Blue,0,68063,68117,54
2022-01-24,70042,70052,Blue,1,70533,71120,587
2022-09-23,70044,70060,Blue,1,33694,34579,885
2022-04-20,70055,70045,Blue,0,37702,38304,602
2022-04-20,70040,70058,Blue,1,31260,32233,973
2022-03-28,70057,70049,Blue,0,23485,23907,422
2022-08-03,70047,70041,Blue,0,88838,89136,298
2022-04-28,70051,70047,Blue,0,79968,80202,234
2022-03-08,70057,70055,Blue,0,24929,24997,68
2022-09-19,70038,70056,Blue,1,29542,30401,859
2022-04-13,70057,70045,Blue,0,59088,59770,682
2022-08-14,70045,70043,Blue,0,77823,77949,126
2022-03-11,70040,70044,Blue,1,56041,56174,133
2022-07-13,70042,70046,Blue,1,20097,20293,196
2022-12-03,70051,70039,Blue,0,74964,75637,673
2022-06-30,70040,70048,Blue,1,19976,20359,383
2022-12-19,70038,70050,Blue,1,59530,60177,647
2022-06-27,70059,70041,Blue,0,45444,46442,998
2022-12-19,70050,70060,Blue,1,56794,57400,606
2022-11-15,70057,70051,Blue,0,30948,31211,263
2022-04-13,70040,70046,Blue,1,76409,76704,295
2022-03-07,70052,70056,Blue,1,32286,32433,147
2022-06-20,70046,70052,Blue,1,53373,53717,344
2022-07-16,70049,70045,Blue,0,31922,32201,279
2022-04-14,70045,70039,Blue,0,32260,32512,252
2022-09-11,70045,70838,Blue,0,33986,34378,392
2022-04-06,70050,70052,Blue,1,38512,38628,116
2022-10-01,70059,70055,Blue,0,62536,62674,138
2022-03-30,70053,70045,Blue,0,40697,41180,483
2022-04-05,70047,70039,Blue,0,65563,65926,363
2022-01-19,70038,70042,Blue,1,56900,57011,111
2022-04-20,70047,70838,Blue,0,88085,88569,484
2022-03-09,70048,70056,Blue,1,74655,75095,440
2022-07-10,70042,70052,Blue,1,34045,34631,586
2022-02-10,70044,70046,Blue,1,58019,58130,111
2022-02-11,70055,70053,Blue,0,28960,29006,46
2022-02-08,70059,70055,Blue,0,80611,80762,151
2022-04-06,70055,70043,Blue,0,87666,88293,627
2022-10-04,70042,70058,Blue,1,64723,65681,958
2022-02-23,70043,70041,Blue,0,80418,80448,30
2022-01-03,70047,70043,Blue,0,86340,86561,221
2022-04-05,70051,70838,Blue,0,31800,32613,813
2022-08-22,70048,70056,Blue,1,85445,85851,406
2022-01-17,70052,70060,Blue,1,22615,22984,369
2022-07-16,70042,70060,Blue,1,46494,47513,1019
2022-01-14,70044,70058,Blue,1,40371,41186,815
2022-09-19,70046,70054,Blue,1,56942,57358,416
2022-03-19,70055,70045,Blue,0,65047,65534,487
2022-02-10,70042,70052,Blue,1,71194,71770,576
2022-02-08,70038,70046,Blue,1,52342,52698,356
2022-01-23,70044,70058,Blue,1,34889,35586,697
2022-07-27,70049,70043,Blue,0,22723,23118,395
2022-01-07,70055,70053,Blue,0,29652,29795,143
2022-05-18,70040,70044,Blue,1,58179,58303,124
2022-10-30,70055,70049,Blue,0,62668,62970,302
2022-02-05,70053,70051,Blue,0,46863,46923,60
2022-03-17,70053,70041,Blue,0,50540,51297,757
2022-02-23,70059,70051,Blue,0,66221,66560,339
2022-10-10,70042,70054,Blue,1,59759,60429,670
2022-09-06,70057,70049,Blue,0,79097,79464,367
2022-04-04,70039,70838,Blue,0,22862,22909,47
2022-08-09,70038,70056,Blue,1,63335,64331,996
2022-11-12,70051,70041,Blue,0,56081,56663,582
2022-07-24,70048,70056,Blue,1,76165,76621,456
2022-10-05,70042,70048,Blue,1,66747,67043,296
2022-05-17,70057,70051,Blue,0,80313,80586,273
2022-01-28,70038,70046,Blue,1,42968,43283,315
2022-11-19,70057,70043,Blue,0,43355,44127,772
2022-03-16,70055,70039,Blue,0,73404,74215,811
2022-02-17,70059,70049,Blue,0,67873,68362,489
2022-03-26,70051,70039,Blue,0,44748,45489,741
2022-01-18,70038,70056,Blue,1,67327,68282,955
2022-02-15,70038,70052,Blue,1,26953,27719,766
2022-03-01,70042,70056,Blue,1,40908,41654,746
2022-02-19,70046,70052,Blue,1,53264,53612,348
2022-09-27,70055,70047,Blue,0,44985,45495,510
2022-09-02,70049,70045,Blue,0,71437,71639,202
2022-11-11,70048,70058,Blue,1,62263,62789,526
2022-02-25,70048,70058,Blue,1,22391,23014,623
2022-04-23,70059,70039,Blue,0,79097,80042,945
2022-11-22,70059,70838,Blue,0,47846,48994,1148
2022-11-20,70057,70055,Blue,0,52862,52931,69
2022-02-14,70047,70041,Blue,0,31814,32186,372
2022-02-10,70038,70040,Blue,1,84978,84995,17
2022-02-14,70052,70058,Blue,1,80694,80963,269
2022-09-01,70045,70039,Blue,0,30517,30806,289
2022-11-07,70048,70058,Blue,1,37187,37700,513
2022-01-18,70044,70056,Blue,1,29987,30670,683
2022-10-05,70053,70051,Blue,0,35631,35690,59
2022-06-20,70046,70054,Blue,1,86104,86554,450
2022-04-07,70043,70838,Blue,0,24594,24872,278
2022-09-23,70042,70060,Blue,1,74323,75273,950
2022-08-15,70054,70056,Blue,1,86943,86990,47
2022-11-23,70044,70050,Blue,1,78085,78427,342
2022-05-28,70040,70050,Blue,1,43526,44176,650
2022-04-08,70040,70052,Blue,1,40217,40937,720
2022-07-07,70059,70049,Blue,0,62215,62690,475
2022-12-29,70058,70060,Blue,1,62259,62409,150
2022-12-07,70040,70050,Blue,1,23590,24073,483
2022-07-01,70045,70043,Blue,0,54234,54414,180
2022-12-06,70040,70046,Blue,1,49283,49555,272
2022-09-06,70053,70838,Blue,0,45034,45862,828
2022-01-31,70057,70043,Blue,0,67242,68029,787
2022-08-06,70050,70052,Blue,1,29698,29816,118
2022-10-31,70042,70052,Blue,1,61206,61804,598
2022-10-06,70044,70048,Blue,1,55699,55947,248
2022-05-02,70057,70049,Blue,0,29368,29767,399
2022-03-29,70038,70042,Blue,1,76867,76956,89
2022-04-04,70053,70039,Blue,0,61051,61766,715
2022-01-14,70049,70047,Blue,0,23974,24032,58
2022-05-24,70042,70050,Blue,1,49206,49651,445
2022-02-04,70044,70050,Blue,1,27436,27763,327
2022-05-28,70049,70838,Blue,0,51915,52579,664
2022-03-03,70043,70039,Blue,0,39621,39723,102
2022-10-17,70049,70047,Blue,0,56789,56848,59
2022-04-20,70044,70054,Blue,1,67881,68515,634
2022-02-15,70059,70051,Blue,0,69973,70343,370
2022-06-17,70043,70838,Blue,0,27052,27277,225
2022-12-30,70055,70053,Blue,0,76459,76505,46
2022-08-30,70058,70060,Blue,1,53885,53946,61
2022-04-13,70048,70060,Blue,1,48048,48652,604
2022-08-22,70056,70060,Blue,1,38896,39139,243
2022-04-19,70040,70042,Blue,1,45489,45522,33
2022-01-02,70051,70047,Blue,0,21972,22197,225
2022-08-04,70049,70043,Blue,0,50505,50877,372
2022-09-12,70038,70042,Blue,1,42263,42352,89
2022-09-12,70044,70060,Blue,1,32614,33510,896
2022-10-19,70044,70056,Blue,1,79652,80261,609
2022-09-14,70053,70047,Blue,0,22849,23138,289
2022-10-22,70040,70042,Blue,1,40000,40036,36
2022-03-01,70047,70045,Blue,0,32984,33081,97
2022-01-16,70057,70043,Blue,0,23139,24106,967
2022-04-12,70051,70045,Blue,0,52951,53599,648
2022-12-06,70049,70039,Blue,0,57796,58305,509
2022-07-23,70045,70039,Blue,0,69755,70031,276
2022-10-24,70059,70057,Blue,0,80473,80509,36
2022-07-23,70040,70060,Blue,1,62855,64002,1147
2022-06-24,70042,70050,Blue,1,76078,76573,495
2022-12-24,70059,70057,Blue,0,84856,84891,35
2022-01-10,70052,70058,Blue,1,28951,29215,264
2022-03-22,70053,70047,Blue,0,55594,55893,299
2022-03-17,70059,70041,Blue,0,86895,87751,856
2022-08-27,70053,70838,Blue,0,44627,45454,827
2022-12-02,70045,70039,Blue,0,72003,72246,243
2022-06-20,70041,70838,Blue,0,31960,32083,123
2022-07-01,70046,70056,Blue,1,34015,34605,590
2022-01-31,70042,70050,Blue,1,83888,84302,414
2022-04-29,70059,70055,Blue,0,52219,52371,152
2022-11-25,70057,70055,Blue,0,26020,26091,71
2022-04-12,70050,70054,Blue,1,45213,45407,194
2022-08-10,70055,70045,Blue,0,59982,60967,985
2022-01-27,70044,70050,Blue,1,85669,85984,315
2022-07-27,70049,70047,Blue,0,37580,37636,56
2022-08-03,70055,70041,Blue,0,62588,63340,752
2022-10-28,70048,70056,Blue,1,29689,30081,392
2022-11-30,70041,70838,Blue,0,46543,46654,111
2022-08-08,70038,70046,Blue,1,88217,88518,301
2022-11-22,70047,70039,Blue,0,70261,70642,381
2022-12-16,70049,70041,Blue,0,30330,30846,516
2022-07-26,70042,70056,Blue,1,73330,74093,763
2022-04-16,70059,70049,Blue,0,51384,51900,516
2022-11-16,70051,70047,Blue,0,54290,54484,194
2022-11-11,70044,70060,Blue,1,34273,35361,1088
2022-07-05,70045,70041,Blue,0,69898,70072,174
2022-06-26,70038,70042,Blue,1,49944,50059,115
2022-09-28,70047,70045,Blue,0,60386,60487,101
2022-07-08,70049,70047,Blue,0,64081,64138,57
2022-12-09,70054,70060,Blue,1,80287,80533,246
2022-02-15,70055,70047,Blue,0,63369,63746,377
2022-12-21,70049,70838,Blue,0,68997,69541,544
2022-03-28,70044,70050,Blue,1,61539,61872,333
2022-07-02,70040,70050,Blue,1,25690,26180,490
2022-06-20,70053,70047,Blue,0,50675,50960,285
2022-03-09,70046,70056,Blue,1,32768,33317,549
2022-11-25,70059,70053,Blue,0,68114,68341,227
2022-08-25,70038,70058,Blue,1,26474,27508,1034
2022-07-24,70038,70050,Blue,1,87317,87886,569
2022-04-28,70054,70058,Blue,1,23852,24007,155
2022-08-19,70040,70060,Blue,1,30020,31050,1030
2022-05-21,70059,70049,Blue,0,56301,56757,456
2022-03-03,70045,70838,Blue,0,46945,47291,346
2022-02-14,70044,70052,Blue,1,65442,65916,474
2022-07-28,70048,70056,Blue,1,24710,25140,430
2022-02-06,70045,70041,Blue,0,23915,24133,218
2022-06-10,70053,70041,Blue,0,19202,19964,762
2022-04-15,70046,70056,Blue,1,20747,21303,556
2022-06-14,70040,70044,Blue,1,29395,29493,98
2022-07-15,70038,70046,Blue,1,68820,69145,325
2022-08-14,70053,70049,Blue,0,75735,75942,207
2022-02-13,70059,70041,Blue,0,25395,26382,987
2022-11-26,70044,70048,Blue,1,60654,60896,242
2022-10-16,70046,70056,Blue,1,31934,32432,498
2022-07-10,70040,70042,Blue,1,72670,72700,30
2022-08-10,70038,70056,Blue,1,28992,29855,863
2022-03-01,70052,70060,Blue,1,48348,48694,346
2022-06-23,70051,70043,Blue,0,53094,53738,644
2022-12-09,70038,70056,Blue,1,72647,73532,885
2022-02-15,70044,70048,Blue,1,66646,66866,220
2022-05-19,70049,70045,Blue,0,79440,79719,279
2022-10-11,70043,70039,Blue,0,63274,63374,100
2022-02-03,70038,70040,Blue,1,89166,89179,13
2022-05-14,70053,70051,Blue,0,85319,85380,61
2022-10-11,70053,70049,Blue,0,84494,84700,206
2022-06-13,70039,70838,Blue,0,24016,24056,40
2022-04-14,70038,70052,Blue,1,24390,25126,736
2022-09-21,70059,70057,Blue,0,24815,24850,35
2022-08-07,70053,70039,Blue,0,49799,50543,744
2022-12-26,70043,70838,Blue,0,37719,37901,182
2022-09-12,70051,70047,Blue,0,75243,75444,201
2022-06-09,70057,70053,Blue,0,36520,36668,148
2022-10-07,70054,70058,Blue,1,58788,58947,159
2022-03-04,70044,70054,Blue,1,27176,27792,616
2022-04-22,70050,70054,Blue,1,55432,55655,223
2022-11-10,70040,70056,Blue,1,68410,69224,814
2022-04-01,70038,70060,Blue,1,60455,61688,1233
2022-12-13,70049,70045,Blue,0,70166,70360,194
2022-11-05,70045,70041,Blue,0,69551,69786,235
2022-10-04,70040,70050,Blue,1,46700,47167,467
2022-02-13,70049,70039,Blue,0,78783,79363,580
2022-03-23,70038,70052,Blue,1,25157,25868,711
2022-08-03,70040,70042,Blue,1,60867,60900,33
2022-10-20,70038,70040,Blue,1,57558,57572,14
2022-06-09,70044,70046,Blue,1,43801,43945,144
2022-12-21,70057,70051,Blue,0,49962,50206,244
2022-04-17,70050,70058,Blue,1,33686,34110,424
2022-08-03,70049,70041,Blue,0,46596,47095,499
2022-04-22,70057,70041,Blue,0,88237,89122,885
2022-12-10,70057,70041,Blue,0,27161,27983,822
2022-03-27,70055,70041,Blue,0,75614,76354,740
2022-05-19,70040,70042,Blue,1,66908,66949,41
2022-10-21,70041,70838,Blue,0,49315,49432,117
2022-03-15,70043,70838,Blue,0,65223,65406,183
2022-07-20,70046,70052,Blue,1,24906,25310,404
2022-08-21,70044,70054,Blue,1,44520,45137,617
2022-08-16,70059,70047,Blue,0,38009,38620,611
2022-11-27,70045,70043,Blue,0,59543,59640,97
2022-02-27,70040,70048,Blue,1,71623,72069,446
2022-03-15,70053,70041,Blue,0,81435,82033,598
2022-05-21,70055,70049,Blue,0,68830,69101,271
2022-10-09,70044,70048,Blue,1,61135,61385,250
2022-02-11,70040,70044,Blue,1,58720,58827,107
2022-09-17,70047,70041,Blue,0,41394,41761,367
2022-02-11,70043,70838,Blue,0,56996,57195,199
2022-03-14,70042,70052,Blue,1,55821,56433,612
2022-02-08,70038,70060,Blue,1,22163,23517,1354
2022-12-07,70040,70050,Blue,1,89175,89693,518
2022-03-24,70040,70042,Blue,1,71350,71387,37
2022-01-26,70046,70060,Blue,1,59049,59947,898
2022-06-27,70051,70838,Blue,0,36831,37581,750
2022-08-30,70057,70043,Blue,0,72868,73629,761
2022-06-10,70055,70053,Blue,0,59200,59251,51
2022-01-09,70042,70052,Blue,1,56584,57162,578
2022-08-31,70057,70053,Blue,0,31778,31932,154
2022-08-02,70042,70058,Blue,1,35542,36414,872
2022-12-15,70042,70054,Blue,1,61445,62204,759
2022-11-26,70057,70051,Blue,0,55241,55482,241
2022-03-22,70052,70058,Blue,1,24519,24780,261
2022-06-14,70045,70041,Blue,0,27225,27455,230
2022-06-22,70044,70052,Blue,1,58533,59195,662
2022-10-21,70043,70039,Blue,0,27709,27824,115
2022-03-28,70038,70040,Blue,1,71948,71962,14
2022-01-05,70040,70058,Blue,1,72004,72868,864
2022-07-03,70045,70039,Blue,0,55162,55454,292
2022-07-26,70046,70056,Blue,1,76767,77286,519
2022-11-17,70046,70054,Blue,1,62745,63180,435
2022-01-05,70057,70047,Blue,0,27042,27549,507
2022-09-16,70038,70050,Blue,1,70513,71074,561
2022-08-22,70046,70048,Blue,1,23871,23958,87
2022-09-02,70055,70043,Blue,0,65219,65848,629
2022-02-08,70055,70053,Blue,0,19018,19076,58
2022-09-08,70055,70049,Blue,0,77102,77366,264
2022-02-18,70055,70049,Blue,0,22219,22604,385
2022-09-19,70044,70048,Blue,1,28612,28858,246
2022-11-12,70057,70045,Blue,0,52537,53205,668
2022-08-31,70050,70054,Blue,1,55489,55728,239
2022-06-21,70046,70052,Blue,1,79434,79764,330
2022-07-09,70051,70039,Blue,0,63091,63779,688
2022-07-05,70053,70049,Blue,0,23727,23959,232
2022-12-26,70059,70039,Blue,0,38178,39141,963
2022-01-01,70055,70838,Blue,0,33505,34427,922
2022-11-02,70057,70051,Blue,0,40238,40523,285
2022-09-09,70057,70041,Blue,0,60921,61776,855
2022-12-23,70051,70049,Blue,0,61175,61312,137
2022-04-15,70051,70047,Blue,0,59945,60150,205
2022-06-18,70054,70058,Blue,1,33291,33451,160
2022-07-04,70059,70838,Blue,0,50835,52026,1191
2022-11-09,70044,70054,Blue,1,85150,85719,569
2022-03-16,70040,70052,Blue,1,55998,56701,703
2022-09-22,70040,70056,Blue,1,60224,61123,899
2022-04-28,70051,70047,Blue,0,78741,78972,231
2022-06-21,70059,70047,Blue,0,45017,45603,586
2022-12-27,70055,70039,Blue,0,30127,30994,867
2022-07-03,70046,70056,Blue,1,24922,25487,565
2022-07-06,70038,70048,Blue,1,79831,80283,452
2022-04-23,70048,70050,Blue,1,26120,26176,56
2022-12-31,70046,70056,Blue,1,57093,57597,504
2022-04-14,70038,70060,Blue,1,21858,23097,1239
2022-12-25,70040,70060,Blue,1,49450,50493,1043
2022-06-22,70046,70052,Blue,1,26515,26835,320
2022-07-12,70040,70056,Blue,1,85764,86625,861
2022-10-31,70057,70049,Blue,0,47904,48268,364
2022-09-20,70045,70838,Blue,0,49630,49968,338
2022-06-30,70055,70049,Blue,0,71873,72169,296
2022-01-20,70050,70058,Blue,1,70076,70543,467
2022-01-06,70059,70057,Blue,0,61405,61442,37
2022-08-10,70057,70045,Blue,0,43386,44078,692
2022-06-28,70048,70052,Blue,1,54512,54726,214
2022-07-07,70040,70050,Blue,1,23725,24241,516
2022-11-16,70059,70051,Blue,0,19531,19908,377
2022-01-12,70045,70041,Blue,0,38533,38680,147
2022-04-05,70055,70053,Blue,0,21506,21557,51
2022-03-25,70059,70057,Blue,0,45493,45528,35
2022-07-26,70051,70049,Blue,0,68532,68637,105
2022-01-01,70059,70053,Blue,0,78617,78891,274
2022-01-05,70057,70039,Blue,0,84694,85586,892
2022-02-16,70038,70048,Blue,1,20326,20799,473
2022-12-28,70055,70039,Blue,0,56780,57727,947
2022-02-01,70038,70060,Blue,1,54797,56381,1584
2022-01-06,70057,70055,Blue,0,28537,28604,67
2022-05-27,70038,70044,Blue,1,69441,69611,170
2022-12-06,70042,70044,Blue,1,68629,68660,31
2022-12-21,70051,70041,Blue,0,60114,60678,564
2022-07-24,70051,70838,Blue,0,76352,77135,783
2022-02-08,70046,70050,Blue,1,33377,33572,195
2022-04-10,70042,70050,Blue,1,65762,66209,447
2022-07-01,70038,70060,Blue,1,63195,64538,1343
2022-09-13,70053,70047,Blue,0,43462,43780,318
2022-06-29,70046,70048,Blue,1,79257,79347,90
2022-09-03,70042,70044,Blue,1,49236,49262,26
2022-06-19,70040,70050,Blue,1,81799,82389,590
2022-04-25,70053,70051,Blue,0,41390,41457,67
2022-03-31,70048,70050,Blue,1,22602,22656,54
2022-05-12,70055,70049,Blue,0,21525,21839,314
2022-10-15,70044,70052,Blue,1,27717,28196,479
2022-12-11,70057,70053,Blue,0,55022,55178,156
2022-06-25,70047,70041,Blue,0,20760,21114,354
2022-12-02,70057,70039,Blue,0,32206,33208,1002
2022-09-10,70055,70047,Blue,0,56989,57375,386
2022-09-20,70043,70039,Blue,0,19448,19575,127
2022-01-31,70054,70060,Blue,1,42610,42873,263
2022-08-09,70057,70047,Blue,0,88411,88893,482
2022-03-16,70057,70838,Blue,0,52183,53308,1125
2022-06-24,70050,70060,Blue,1,75928,76450,522
2022-03-02,70042,70056,Blue,1,48814,49552,738
2022-01-04,70040,70050,Blue,1,60207,60684,477
2022-01-16,70042,70052,Blue,1,89273,89840,567
2022-12-02,70038,70058,Blue,1,76858,77829,971
2022-10-23,70038,70046,Blue,1,34723,35024,301
2022-08-01,70053,70041,Blue,0,33325,34061,736
2022-08-01,70059,70047,Blue,0,82640,83165,525
2022-07-30,70053,70047,Blue,0,71623,71904,281
2022-07-31,70059,70045,Blue,0,71665,72356,691
2022-06-05,70042,70050,Blue,1,60073,60611,538
2022-03-09,70051,70043,Blue,0,59963,60471,508
2022-03-17,70046,70058,Blue,1,52327,53000,673
2022-04-12,70043,70838,Blue,0,72475,72664,189
2022-02-13,70042,70060,Blue,1,61438,62383,945
2022-02-08,70053,70043,Blue,0,32954,33559,605
2022-07-11,70040,70048,Blue,1,25921,26356,435
2022-10-02,70059,70047,Blue,0,53835,54434,599
2022-12-27,70055,70051,Blue,0,45690,45833,143
2022-09-20,70057,70039,Blue,0,71310,72219,909
2022-09-27,70042,70054,Blue,1,67820,68493,673
2022-11-12,70059,70045,Blue,0,36796,37489,693
2022-09-26,70046,70056,Blue,1,56533,57074,541
2022-05-05,70056,70058,Blue,1,50790,50866,76
2022-03-02,70053,70049,Blue,0,26953,27166,213
2022-11-24,70046,70048,Blue,1,65385,65464,79
2022-11-06,70053,70049,Blue,0,69735,69919,184
2022-02-10,70044,70052,Blue,1,20945,21433,488
2022-02-24,70054,70058,Blue,1,22731,22935,204
2022-09-05,70059,70047,Blue,0,77065,77649,584
2022-09-10,70053,70838,Blue,0,60854,61758,904
2022-11-06,70045,70039,Blue,0,28528,28779,251
2022-03-11,70059,70051,Blue,0,30031,30430,399
2022-06-19,70038,70050,Blue,1,72095,72672,577
2022-03-12,70059,70041,Blue,0,48134,49163,1029
2022-12-30,70044,70054,Blue,1,73746,74382,636
2022-08-11,70059,70043,Blue,0,32653,33547,894
2022-04-03,70055,70053,Blue,0,77248,77296,48
2022-11-18,70051,70838,Blue,0,55606,56335,729
2022-06-22,70059,70051,Blue,0,60512,60841,329
2022-03-10,70059,70047,Blue,0,59894,60458,564
2022-03-08,70046,70058,Blue,1,71283,71888,605
2022-02-03,70057,70041,Blue,0,28536,29431,895
2022-04-23,70048,70058,Blue,1,79833,80340,507
2022-11-15,70049,70045,Blue,0,28885,29100,215
2022-09-24,70051,70039,Blue,0,51722,52391,669
2022-05-27,70046,70050,Blue,1,21405,21631,226
2022-12-12,70047,70838,Blue,0,46912,47405,493
2022-12-20,70049,70041,Blue,0,74753,75122,369
2022-08-21,70049,70047,Blue,0,33698,33750,52
2022-06-29,70059,70053,Blue,0,78306,78529,223
2022-01-14,70044,70054,Blue,1,76532,77158,626
2022-08-30,70056,70060,Blue,1,32886,33056,170
2022-11-17,70059,70039,Blue,0,25158,26287,1129
2022-06-03,70042,70048,Blue,1,62885,63214,329
2022-05-26,70038,70050,Blue,1,85817,86396,579
2022-01-25,70038,70058,Blue,1,28207,29261,1054
2022-01-02,70042,70048,Blue,1,61418,61774,356
2022-06-28,70044,70048,Blue,1,26540,26837,297
2022-04-04,70043,70041,Blue,0,69309,69336,27
2022-01-20,70055,70045,Blue,0,53304,53890,586
2022-11-04,70044,70054,Blue,1,46142,46962,820
2022-12-30,70057,70039,Blue,0,59512,60475,963
2022-08-11,70051,70043,Blue,0,26301,26824,523
2022-07-04,70045,70039,Blue,0,53587,53914,327
2022-12-07,70059,70045,Blue,0,21759,22528,769
2022-07-28,70045,70041,Blue,0,59530,59726,196
2022-01-05,70038,70050,Blue,1,56233,56766,533
2022-10-06,70059,70053,Blue,0,28093,28334,241
2022-08-02,70051,70049,Blue,0,47186,47289,103
2022-09-25,70040,70044,Blue,1,46232,46333,101
2022-08-09,70040,70042,Blue,1,58583,58619,36
2022-07-14,70046,70050,Blue,1,67281,67532,251
2022-07-14,70051,70045,Blue,0,21866,22226,360
2022-06-13,70039,70838,Blue,0,86222,86254,32
2022-06-18,70059,70838,Blue,0,50354,51494,1140
2022-01-14,70053,70838,Blue,0,35017,35900,883
2022-08-12,70057,70041,Blue,0,34960,35986,1026
2022-04-22,70045,70039,Blue,0,27144,27382,238
2022-09-03,70059,70041,Blue,0,44892,45822,930
2022-11-29,70059,70055,Blue,0,46287,46432,145
2022-02-26,70059,70039,Blue,0,75133,76163,1030
2022-09-29,70040,70044,Blue,1,80971,81078,107
2022-08-20,70046,70056,Blue,1,46280,46784,504
2022-10-04,70044,70054,Blue,1,73430,74062,632
2022-12-06,70055,70051,Blue,0,29452,29600,148
2022-06-28,70044,70060,Blue,1,31793,32765,972
2022-05-19,70049,70045,Blue,0,38628,38940,312
2022-09-20,70047,70041,Blue,0,64062,64385,323
2022-04-20,70040,70050,Blue,1,32994,33450,456
2022-06-13,70057,70045,Blue,0,37099,37819,720
2022-07-06,70050,70052,Blue,1,34257,34376,119
2022-03-10,70038,70054,Blue,1,31456,32399,943
2022-04-08,70046,70060,Blue,1,33320,34051,731
2022-06-18,70056,70060,Blue,1,42908,43102,194
2022-12-07,70057,70055,Blue,0,51088,51156,68
2022-01-24,70040,70050,Blue,1,74110,74611,501
2022-05-11,70053,70051,Blue,0,63825,63886,61
2022-02-17,70047,70039,Blue,0,30310,30747,437
2022-06-12,70043,70039,Blue,0,27101,27216,115
2022-01-31,70038,70054,Blue,1,35144,36198,1054
2022-02-14,70056,70058,Blue,1,78306,78388,82
2022-04-17,70057,70039,Blue,0,58769,59730,961
2022-04-06,70042,70050,Blue,1,62037,62476,439
2022-08-03,70038,70056,Blue,1,29842,30774,932
2022-10-16,70053,70043,Blue,0,46741,47311,570
2022-07-12,70042,70050,Blue,1,56845,57287,442
2022-04-18,70054,70056,Blue,1,55718,55766,48
2022-04-03,70045,70043,Blue,0,80510,80597,87
2022-02-05,70042,70056,Blue,1,73540,74471,931
2022-03-30,70055,70039,Blue,0,22961,23864,903
2022-12-05,70051,70045,Blue,0,83860,84202,342
2022-04-02,70038,70060,Blue,1,74492,75711,1219
2022-10-27,70053,70041,Blue,0,31998,32715,717
2022-11-01,70057,70047,Blue,0,33574,34078,504
2022-10-04,70043,70041,Blue,0,53433,53461,28
2022-04-22,70052,70058,Blue,1,44419,44666,247
2022-12-31,70038,70046,Blue,1,68599,68925,326
2022-01-08,70051,70043,Blue,0,19866,20347,481
2022-03-01,70044,70054,Blue,1,67528,68081,553
2022-02-02,70053,70043,Blue,0,67037,67773,736
2022-11-30,70048,70056,Blue,1,62027,62440,413
2022-12-10,70049,70043,Blue,0,64305,64642,337
2022-07-01,70044,70046,Blue,1,66541,66722,181
2022-10-11,70053,70043,Blue,0,53812,54407,595
2022-01-11,70051,70045,Blue,0,46501,46882,381
2022-09-25,70040,70046,Blue,1,72696,72963,267
2022-04-20,70042,70050,Blue,1,33995,34403,408
2022-04-05,70044,70050,Blue,1,63707,64045,338
2022-06-20,70055,70838,Blue,0,29858,30790,932
2022-03-27,70056,70058,Blue,1,39185,39254,69
2022-03-17,70050,70054,Blue,1,36318,36548,230
2022-04-10,70056,70058,Blue,1,47101,47169,68
2022-03-22,70038,70048,Blue,1,29652,30100,448
2022-03-16,70042,70054,Blue,1,70672,71348,676
2022-09-23,70047,70838,Blue,0,25253,25791,538
2022-09-30,70057,70045,Blue,0,70769,71379,610
2022-10-08,70038,70042,Blue,1,75561,75663,102
2022-10-14,70051,70838,Blue,0,49752,50472,720
2022-04-13,70054,70058,Blue,1,29524,29671,147
2022-02-01,70040,70046,Blue,1,32427,32698,271
2022-03-17,70053,70047,Blue,0,55959,56239,280
2022-09-30,70047,70039,Blue,0,36971,37383,412
2022-08-24,70053,70045,Blue,0,30023,30493,470
2022-06-29,70042,70052,Blue,1,84466,85061,595
2022-11-26,70040,70044,Blue,1,46515,46637,122
2022-06-09,70047,70041,Blue,0,19503,19852,349
2022-02-09,70054,70060,Blue,1,57995,58305,310
2022-02-11,70057,70043,Blue,0,48266,49036,770
2022-02-12,70048,70052,Blue,1,72799,73003,204
2022-06-25,70042,70052,Blue,1,40196,40788,592
2022-04-30,70056,70060,Blue,1,67849,68021,172
2022-02-13,70044,70050,Blue,1,32918,33283,365
2022-03-25,70053,70041,Blue,0,79720,80331,611
2022-12-12,70042,70046,Blue,1,65988,66167,179
2022-11-11,70053,70047,Blue,0,32936,33224,288
2022-03-04,70038,70050,Blue,1,25746,26391,645
2022-11-23,70042,70044,Blue,1,23172,23204,32
2022-08-03,70052,70060,Blue,1,53165,53536,371
2022-08-12,70049,70041,Blue,0,22254,22717,463
2022-10-06,70047,70043,Blue,0,83533,83771,238
2022-10-25,70040,70058,Blue,1,75251,76221,970
2022-11-14,70057,70049,Blue,0,63546,63944,398
2022-09-30,70045,70838,Blue,0,76126,76502,376
2022-02-20,70038,70060,Blue,1,35536,36618,1082
2022-12-14,70044,70058,Blue,1,70701,71428,727
2022-01-07,70051,70043,Blue,0,58819,59325,506
2022-01-19,70054,70060,Blue,1,54729,55007,278
2022-07-08,70050,70056,Blue,1,50864,51161,297
2022-04-06,70046,70060,Blue,1,55753,56720,967
2022-07-20,70055,70051,Blue,0,77107,77239,132
2022-04-25,70056,70060,Blue,1,65580,65763,183
2022-03-05,70053,70049,Blue,0,81789,81985,196
2022-09-12,70038,70058,Blue,1,64834,66050,1216
2022-10-25,70049,70039,Blue,0,33663,34193,530
2022-07-18,70051,70039,Blue,0,47658,48301,643
2022-01-04,70038,70052,Blue,1,26710,27531,821
2022-06-10,70055,70045,Blue,0,38900,39465,565
2022-10-15,70051,70045,Blue,0,71699,72016,317
2022-04-12,70041,70838,Blue,0,75868,75992,124
2022-01-22,70040,70054,Blue,1,71835,72576,741
2022-08-29,70050,70058,Blue,1,50303,50709,406
2022-03-16,70038,70054,Blue,1,61036,61929,893
2022-10-21,70055,70041,Blue,0,57085,57822,737
2022-02-22,70055,70051,Blue,0,53301,53490,189
2022-11-02,70044,70054,Blue,1,85981,86602,621
2022-03-15,70057,70051,Blue,0,74969,75213,244
2022-09-01,70053,70838,Blue,0,20214,21133,919
2022-09-20,70041,70039,Blue,0,39536,39568,32
2022-02-23,70056,70058,Blue,1,52557,52627,70
2022-03-30,70059,70053,Blue,0,42687,42963,276
2022-09-24,70057,70051,Blue,0,74662,74900,238
2022-05-18,70038,70040,Blue,1,74735,74757,22
2022-11-10,70038,70056,Blue,1,89113,90014,901
2022-12-27,70057,70047,Blue,0,49953,50413,460
2022-02-25,70048,70050,Blue,1,75680,75735,55
2022-03-10,70053,70045,Blue,0,48970,49421,451
2022-07-19,70057,70039,Blue,0,32756,33870,1114
2022-07-18,70052,70060,Blue,1,33254,33635,381
2022-08-15,70057,70039,Blue,0,67663,68547,884
2022-03-23,70055,70045,Blue,0,83656,84135,479
2022-09-01,70043,70838,Blue,0,36341,36529,188
2022-09-25,70054,70056,Blue,1,81236,81285,49
2022-03-12,70042,70044,Blue,1,68127,68160,33
2022-03-24,70050,70056,Blue,1,69549,69871,322
2022-08-18,70046,70050,Blue,1,36943,37153,210
2022-10-27,70040,70054,Blue,1,31456,32198,742
2022-12-06,70049,70043,Blue,0,44323,44668,345
2022-07-26,70040,70042,Blue,1,83703,83736,33
2022-02-07,70044,70054,Blue,1,76325,76934,609
2022-07-28,70047,70838,Blue,0,47465,47976,511
2022-10-22,70039,70838,Blue,0,62112,62142,30
2022-08-01,70057,70049,Blue,0,68728,69104,376
2022-02-03,70044,70058,Blue,1,52141,52900,759
2022-02-22,70038,70058,Blue,1,57435,58515,1080
2022-08-29,70057,70049,Blue,0,42688,43097,409
2022-11-21,70045,70043,Blue,0,32474,32569,95
2022-04-01,70057,70055,Blue,0,35367,35436,69
2022-04-01,70056,70060,Blue,1,31230,31418,188
2022-08-29,70042,70054,Blue,1,50377,51095,718
2022-01-20,70044,70060,Blue,1,63678,64624,946
2022-11-24,70043,70838,Blue,0,31008,31199,191
2022-04-07,70042,70050,Blue,1,31283,31691,408
2022-06-18,70042,70056,Blue,1,80831,81595,764
2022-10-26,70040,70046,Blue,1,29916,30308,392
2022-04-11,70052,70054,Blue,1,65371,65422,51
2022-08-26,70043,70041,Blue,0,34919,34950,31
2022-09-22,70057,70051,Blue,0,58160,58388,228
2022-12-05,70055,70047,Blue,0,83688,84061,373
2022-04-17,70048,70050,Blue,1,82895,82953,58
2022-08-15,70045,70043,Blue,0,50815,50923,108
2022-09-29,70038,70054,Blue,1,57014,57818,804
2022-08-26,70053,70051,Blue,0,86345,86393,48
2022-11-11,70057,70049,Blue,0,20492,20905,413
2022-09-24,70042,70054,Blue,1,55193,55857,664
2022-10-14,70049,70041,Blue,0,40641,41096,455
2022-11-11,70038,70056,Blue,1,25661,26515,854
2022-09-16,70057,70838,Blue,0,23085,24219,1134
2022-03-26,70049,70043,Blue,0,67013,67379,366
2022-04-30,70052,70056,Blue,1,22173,22310,137
2022-03-29,70038,70050,Blue,1,42967,43483,516
2022-11-26,70059,70051,Blue,0,67576,67893,317
2022-12-16,70055,70043,Blue,0,54258,54953,695
2022-12-27,70042,70058,Blue,1,53668,54583,915
2022-12-06,70040,70058,Blue,1,29478,30422,944
2022-07-26,70059,70057,Blue,0,50524,50558,34
2022-12-05,70053,70045,Blue,0,27806,28269,463
2022-04-06,70038,70054,Blue,1,28151,28937,786
2022-02-17,70040,70050,Blue,1,22217,22672,455
2022-02-03,70044,70050,Blue,1,23242,23562,320
2022-12-26,70042,70046,Blue,1,53873,54045,172
2022-07-15,70040,70052,Blue,1,56611,57466,855
2022-08-08,70046,70054,Blue,1,79230,79684,454
2022-12-19,70046,70056,Blue,1,21308,21802,494
2022-07-22,70050,70052,Blue,1,29676,29788,112
2022-01-04,70040,70042,Blue,1,29113,29149,36
2022-11-01,70046,70048,Blue,1,51246,51331,85
2022-02-15,70039,70838,Blue,0,85712,85745,33
2022-12-16,70052,70058,Blue,1,33632,33900,268
2022-09-07,70047,70039,Blue,0,40880,41295,415
2022-06-16,70057,70043,Blue,0,59896,60663,767
2022-01-27,70059,70045,Blue,0,74898,75609,711
2022-10-16,70038,70060,Blue,1,69367,70484,1117
2022-04-01,70059,70047,Blue,0,22756,23653,897
2022-03-12,70057,70039,Blue,0,56330,57285,955
2022-10-27,70042,70044,Blue,1,75534,75567,33
2022-02-22,70047,70045,Blue,0,55705,55797,92
2022-07-13,70050,70052,Blue,1,57820,57951,131
2022-11-29,70038,70058,Blue,1,42714,43781,1067
2022-02-18,70053,70838,Blue,0,27859,28719,860
2022-07-29,70046,70048,Blue,1,34078,34169,91
2022-07-21,70046,70060,Blue,1,77144,78025,881
2022-03-03,70052,70056,Blue,1,69087,69229,142
2022-02-23,70051,70041,Blue,0,39706,40338,632
2022-10-15,70048,70052,Blue,1,72318,72535,217
2022-08-19,70040,70052,Blue,1,36818,37460,642
2022-11-15,70059,70051,Blue,0,32118,32430,312
2022-11-06,70057,70045,Blue,0,74554,75190,636
2022-03-17,70059,70043,Blue,0,38121,38980,859
2022-11-21,70049,70047,Blue,0,27586,27643,57
2022-04-22,70040,70058,Blue,1,38699,39681,982
2022-04-21,70051,70049,Blue,0,84350,84452,102
2022-12-20,70039,70838,Blue,0,73751,73787,36
2022-09-04,70055,70039,Blue,0,54923,55832,909
2022-09-14,70049,70039,Blue,0,20081,20718,637
2022-03-10,70038,70058,Blue,1,46387,47338,951
2022-07-08,70057,70838,Blue,0,30643,31804,1161
2022-03-09,70053,70051,Blue,0,86561,86623,62
2022-07-17,70057,70043,Blue,0,76050,76820,770
2022-12-31,70059,70043,Blue,0,35175,36131,956
2022-02-02,70059,70043,Blue,0,23105,24065,960
2022-04-14,70048,70056,Blue,1,67518,67877,359
2022-04-12,70042,70056,Blue,1,53414,54130,716
2022-05-20,70059,70039,Blue,0,40165,41406,1241
2022-03-08,70057,70838,Blue,0,68623,69686,1063
2022-07-15,70044,70054,Blue,1,75864,76484,620
2022-06-14,70055,70045,Blue,0,68672,69176,504
2022-02-20,70048,70060,Blue,1,24323,24905,582
2022-07-26,70046,70052,Blue,1,81709,82039,330
2022-02-08,70055,70043,Blue,0,49403,50147,744
2022-02-06,70055,70039,Blue,0,55349,56189,840
2022-07-02,70046,70058,Blue,1,87746,88429,683
2022-03-08,70051,70039,Blue,0,28577,29221,644
2022-07-23,70041,70838,Blue,0,65877,66001,124
2022-03-17,70040,70052,Blue,1,26118,26764,646
2022-01-23,70052,70058,Blue,1,39775,40013,238
2022-12-15,70058,70060,Blue,1,84612,84669,57
2022-02-18,70050,70054,Blue,1,51393,51638,245
2022-01-02,70042,70058,Blue,1,31693,32472,779
2022-04-15,70050,70056,Blue,1,49887,50199,312
2022-08-23,70053,70051,Blue,0,73278,73336,58
2022-08-24,70049,70039,Blue,0,57537,58069,532
2022-01-07,70053,70041,Blue,0,53870,54564,694
2022-12-16,70055,70051,Blue,0,39330,39487,157
2022-11-20,70051,70047,Blue,0,70907,71094,187
2022-02-03,70050,70052,Blue,1,34423,34701,278
2022-06-22,70047,70039,Blue,0,80814,81247,433
2022-05-27,70047,70045,Blue,0,52574,52681,107
2022-10-27,70059,70041,Blue,0,34405,35331,926
2022-10-04,70040,70058,Blue,1,22459,23420,961
2022-03-23,70057,70055,Blue,0,25534,25604,70
2022-01-07,70040,70054,Blue,1,83786,84515,729
2022-06-09,70052,70060,Blue,1,22976,23572,596
2022-10-15,70052,70054,Blue,1,27103,27158,55
2022-10-29,70053,70047,Blue,0,30580,30852,272
2022-12-13,70053,70041,Blue,0,24969,25698,729
2022-12-31,70049,70039,Blue,0,90629,91176,547
2022-02-02,70049,70047,Blue,0,83328,83381,53
2022-02-28,70038,70058,Blue,1,73521,74560,1039
2022-12-10,70059,70053,Blue,0,45974,46204,230
2022-02-02,70054,70060,Blue,1,28507,28789,282
2022-03-28,70057,70047,Blue,0,78976,79471,495
2022-03-29,70048,70052,Blue,1,60941,61161,220
2022-10-02,70054,70060,Blue,1,58912,59167,255
2022-04-10,70053,70039,Blue,0,63292,64023,731
2022-11-08,70046,70054,Blue,1,63892,64326,434
2022-09-06,70051,70043,Blue,0,20784,21264,480
2022-06-23,70042,70054,Blue,1,30405,31181,776
2022-01-05,70048,70050,Blue,1,30113,30169,56
2022-11-16,70057,70053,Blue,0,19620,19792,172
2022-04-01,70053,70049,Blue,0,61673,61873,200
2022-09-20,70051,70049,Blue,0,32157,32259,102
2022-08-27,70049,70039,Blue,0,72416,72956,540
2022-12-11,70057,70053,Blue,0,63089,63256,167
2022-10-11,70052,70058,Blue,1,54673,54932,259
2022-09-24,70055,70053,Blue,0,54247,54292,45
2022-08-22,70046,70048,Blue,1,27925,28011,86
2022-04-11,70057,70049,Blue,0,58470,58888,418
2022-11-25,70042,70046,Blue,1,21976,22146,170
2022-12-27,70040,70054,Blue,1,25507,26274,767
2022-04-04,70041,70039,Blue,0,22751,22793,42
2022-06-21,70057,70838,Blue,0,52700,53803,1103
2022-02-12,70048,70054,Blue,1,33367,33717,350
2022-06-09,70047,70838,Blue,0,56618,57196,578
2022-09-16,70053,70838,Blue,0,58929,59944,1015
2022-04-19,70047,70043,Blue,0,47804,48059,255
2022-10-15,70045,70043,Blue,0,43516,43610,94
2022-08-09,70044,70060,Blue,1,42690,43629,939
2022-11-17,70050,70052,Blue,1,36353,36607,254
2022-06-22,70046,70048,Blue,1,68887,68982,95
2022-08-18,70058,70060,Blue,1,55369,55436,67
2022-06-13,70045,70039,Blue,0,61017,61290,273
2022-10-05,70057,70055,Blue,0,58294,58363,69
2022-07-06,70042,70046,Blue,1,77431,77664,233
2022-06-13,70044,70048,Blue,1,37084,37343,259
2022-02-28,70038,70052,Blue,1,50775,51452,677
2022-04-05,70055,70039,Blue,0,34030,34864,834
2022-11-19,70040,70054,Blue,1,23057,23865,808
2022-04-23,70045,70838,Blue,0,61860,62217,357
2022-02-26,70040,70048,Blue,1,75615,76021,406
2022-04-14,70040,70056,Blue,1,65633,66492,859
2022-09-12,70038,70060,Blue,1,82631,83791,1160
2022-01-01,70039,70838,Blue,0,76078,76112,34
2022-03-11,70041,70039,Blue,0,49726,49760,34
2022-05-20,70055,70043,Blue,0,56171,56953,782
2022-12-07,70040,70046,Blue,1,74228,74474,246
2022-03-12,70051,70039,Blue,0,63651,64332,681
2022-12-21,70040,70050,Blue,1,27694,28168,474
2022-01-20,70044,70050,Blue,1,85595,85911,316
2022-04-11,70056,70058,Blue,1,45651,45722,71
2022-01-31,70050,70056,Blue,1,57123,57489,366
2022-06-10,70052,70056,Blue,1,85815,85961,146
2022-12-14,70044,70048,Blue,1,83814,84066,252
2022-08-19,70045,70838,Blue,0,74584,74930,346
2022-10-19,70048,70052,Blue,1,66304,66534,230
2022-02-11,70038,70052,Blue,1,73506,74189,683
2022-03-12,70050,70056,Blue,1,20487,20786,299
2022-10-28,70052,70054,Blue,1,43830,43880,50
2022-01-19,70044,70048,Blue,1,24080,24399,319
2022-10-14,70051,70049,Blue,0,65349,65450,101
2022-08-06,70042,70052,Blue,1,66711,67304,593
2022-08-07,70042,70052,Blue,1,59810,60586,776
2022-09-11,70057,70051,Blue,0,21574,21837,263
2022-04-24,70042,70060,Blue,1,63097,64119,1022
2022-02-03,70042,70052,Blue,1,42518,43146,628
2022-06-21,70049,70039,Blue,0,44129,44711,582
2022-12-25,70045,70039,Blue,0,55163,55403,240
2022-09-29,70052,70054,Blue,1,20758,20813,55
2022-06-27,70051,70043,Blue,0,87338,87843,505
2022-12-07,70052,70056,Blue,1,80181,80313,132
2022-01-01,70048,70050,Blue,1,91645,91713,68
2022-07-18,70055,70043,Blue,0,22763,23464,701
2022-02-14,70057,70039,Blue,0,59368,60342,974
2022-02-07,70042,70048,Blue,1,76257,76571,314
2022-06-15,70055,70051,Blue,0,49420,49569,149
2022-11-21,70043,70039,Blue,0,46185,46293,108
2022-03-14,70044,70054,Blue,1,34976,35549,573
2022-01-29,70052,70058,Blue,1,45964,46348,384
2022-08-04,70057,70053,Blue,0,57033,57187,154
2022-03-18,70055,70049,Blue,0,61583,61868,285
2022-02-02,70055,70043,Blue,0,57999,58659,660
2022-09-13,70050,70052,Blue,1,68863,68974,111
2022-06-22,70053,70045,Blue,0,43677,44202,525
2022-04-15,70051,70045,Blue,0,63539,63879,340
2022-12-21,70038,70044,Blue,1,50717,50934,217
2022-11-11,70044,70052,Blue,1,24740,25231,491
2022-03-09,70049,70041,Blue,0,87436,87954,518
2022-10-14,70057,70039,Blue,0,54727,55665,938
2022-11-13,70047,70838,Blue,0,59391,59931,540
2022-10-07,70050,70056,Blue,1,45771,46090,319
2022-02-18,70053,70041,Blue,0,55363,56024,661
2022-09-13,70043,70039,Blue,0,30842,30975,133
2022-06-05,70040,70042,Blue,1,84305,84341,36
2022-07-26,70051,70047,Blue,0,58144,58332,188
2022-10-02,70045,70043,Blue,0,58363,58456,93
2022-07-12,70053,70039,Blue,0,51242,52024,782
2022-01-27,70040,70050,Blue,1,52211,52729,518
2022-09-21,70051,70045,Blue,0,36757,37134,377
2022-10-16,70055,70838,Blue,0,68594,69489,895
2022-12-22,70048,70060,Blue,1,35132,35732,600
2022-10-20,70049,70047,Blue,0,81030,81085,55
2022-12-02,70047,70045,Blue,0,80440,80533,93
2022-03-05,70044,70058,Blue,1,43364,44116,752
2022-02-24,70055,70047,Blue,0,34060,34618,558
2022-06-29,70040,70044,Blue,1,33459,33601,142
2022-01-13,70049,70043,Blue,0,67663,68009,346
2022-02-22,70038,70042,Blue,1,24375,24483,108
2022-12-07,70054,70060,Blue,1,55405,55682,277
2022-11-09,70051,70041,Blue,0,74723,75244,521
2022-06-17,70055,70053,Blue,0,62477,62523,46
2022-09-08,70055,70051,Blue,0,25315,25472,157
2022-01-17,70045,70039,Blue,0,22951,23233,282
2022-11-24,70043,70039,Blue,0,27856,27960,104
2022-05-18,70040,70052,Blue,1,31869,32718,849
2022-11-20,70051,70049,Blue,0,22630,22745,115
2022-01-13,70040,70050,Blue,1,87783,88353,570
2022-11-30,70040,70054,Blue,1,25200,25948,748
2022-03-02,70059,70045,Blue,0,58695,59362,667
2022-07-04,70039,70838,Blue,0,32499,32537,38
2022-03-31,70053,70049,Blue,0,54765,54962,197
2022-07-14,70050,70052,Blue,1,64719,64836,117
2022-01-09,70059,70838,Blue,0,27808,28938,1130
2022-12-01,70049,70041,Blue,0,79257,79688,431
2022-12-16,70053,70041,Blue,0,62696,63410,714
2022-11-07,70049,70039,Blue,0,55115,55743,628
2022-09-27,70048,70056,Blue,1,55513,55958,445
2022-11-26,70038,70046,Blue,1,36666,36952,286
2022-10-21,70051,70041,Blue,0,85309,85892,583
2022-04-07,70042,70048,Blue,1,32522,32850,328
2022-12-30,70046,70060,Blue,1,54435,55205,770
2022-07-19,70042,70056,Blue,1,72766,73543,777
2022-07-01,70040,70042,Blue,1,67457,67488,31
2022-01-05,70056,70060,Blue,1,35577,35940,363
2022-02-01,70050,70056,Blue,1,26523,26858,335
2022-12-09,70057,70838,Blue,0,33253,34297,1044
2022-04-18,70051,70041,Blue,0,56623,57192,569
2022-01-18,70043,70041,Blue,0,49068,49096,28
2022-05-28,70047,70838,Blue,0,53251,53802,551
2022-05-20,70053,70049,Blue,0,19790,19988,198
2022-04-20,70057,70838,Blue,0,59673,60757,1084
2022-12-15,70048,70060,Blue,1,24152,24909,757
2022-04-22,70047,70043,Blue,0,29991,30261,270
2022-11-21,70050,70060,Blue,1,46182,46701,519
2022-03-06,70059,70838,Blue,0,54918,56095,1177
2022-07-05,70044,70058,Blue,1,53676,54518,842
2022-04-07,70057,70838,Blue,0,84087,85114,1027
2022-10-20,70056,70060,Blue,1,23082,23259,177
2022-05-17,70051,70047,Blue,0,46250,46469,219
2022-03-14,70057,70045,Blue,0,57577,58241,664
2022-11-12,70042,70048,Blue,1,47708,48056,348
2022-12-30,70038,70052,Blue,1,24409,25066,657
2022-03-21,70046,70056,Blue,1,20348,20971,623
2022-09-16,70042,70054,Blue,1,48810,49571,761
2022-06-10,70042,70046,Blue,1,29696,30030,334
2022-02-28,70040,70056,Blue,1,61415,62285,870
2022-03-22,70053,70047,Blue,0,23988,24299,311
2022-02-02,70057,70045,Blue,0,25542,26199,657
2022-03-21,70042,70048,Blue,1,68088,68419,331
2022-11-29,70052,70054,Blue,1,46363,46424,61
2022-06-07,70040,70050,Blue,1,35022,35602,580
2022-04-15,70050,70056,Blue,1,65819,66106,287
2022-12-20,70040,70058,Blue,1,21558,22467,909
2022-12-05,70059,70053,Blue,0,47833,48065,232
2022-06-03,70049,70047,Blue,0,67917,67973,56
2022-10-06,70057,70041,Blue,0,58833,59695,862
2022-04-02,70059,70045,Blue,0,27622,28376,754
2022-06-03,70044,70046,Blue,1,46577,46712,135
2022-01-12,70057,70043,Blue,0,67959,68787,828
2022-07-09,70038,70058,Blue,1,48016,49040,1024
2022-06-30,70053,70043,Blue,0,65497,66080,583
2022-07-03,70057,70049,Blue,0,72379,72762,383
2022-01-26,70046,70052,Blue,1,63001,63383,382
2022-10-11,70059,70043,Blue,0,19521,20593,1072
2022-07-02,70059,70047,Blue,0,24141,24708,567
2022-01-16,70051,70041,Blue,0,41221,41782,561
2022-07-15,70042,70054,Blue,1,55136,55839,703
2022-07-30,70055,70047,Blue,0,59115,59519,404
2022-08-22,70038,70060,Blue,1,25370,26527,1157
2022-01-18,70042,70056,Blue,1,26692,27734,1042
2022-08-18,70047,70041,Blue,0,19066,19435,369
2022-10-07,70051,70045,Blue,0,38673,39034,361
2022-08-24,70044,70046,Blue,1,22295,22409,114
2022-04-07,70042,70048,Blue,1,49368,49678,310
2022-10-25,70055,70838,Blue,0,60482,61515,1033
2022-10-11,70048,70052,Blue,1,29674,29871,197
2022-09-14,70044,70054,Blue,1,66600,67204,604
2022-11-26,70055,70049,Blue,0,65054,65321,267
2022-01-01,70053,70049,Blue,0,76284,76481,197
2022-08-29,70059,70043,Blue,0,69674,70542,868
2022-10-19,70038,70044,Blue,1,77284,77459,175
2022-09-19,70059,70057,Blue,0,64289,64324,35
2022-10-31,70040,70044,Blue,1,29971,30081,110
2022-02-12,70055,70049,Blue,0,87562,87850,288
2022-11-24,70038,70058,Blue,1,45638,46644,1006
2022-02-01,70042,70048,Blue,1,33253,33602,349
2022-10-06,70057,70053,Blue,0,20014,20172,158
2022-10-25,70044,70048,Blue,1,68728,68974,246
2022-11-18,70042,70044,Blue,1,29132,29162,30
2022-10-10,70050,70058,Blue,1,78002,78428,426
2022-06-10,70038,70040,Blue,1,39404,39427,23
2022-07-26,70044,70048,Blue,1,46928,47182,254
2022-07-13,70055,70049,Blue,0,64925,65212,287
2022-02-01,70043,70039,Blue,0,56024,56133,109
2022-02-04,70048,70052,Blue,1,32077,32339,262
2022-03-15,70057,70838,Blue,0,57565,58551,986
2022-08-26,70053,70039,Blue,0,59247,59987,740
2022-07-22,70059,70041,Blue,0,80862,81787,925
2022-03-25,70045,70043,Blue,0,80849,80930,81
2022-06-18,70053,70838,Blue,0,63106,63911,805
2022-04-28,70059,70053,Blue,0,38140,38390,250
2022-11-09,70059,70047,Blue,0,21740,22334,594
2022-03-07,70043,70041,Blue,0,27130,27161,31
2022-07-13,70044,70060,Blue,1,52291,53305,1014
2022-06-09,70043,70838,Blue,0,35042,35239,197
2022-11-10,70042,70054,Blue,1,64467,65185,718
2022-08-14,70042,70046,Blue,1,52833,53011,178
2022-03-23,70045,70039,Blue,0,33165,33428,263
2022-12-30,70057,70047,Blue,0,28365,28854,489
2022-09-14,70038,70054,Blue,1,53659,54556,897
2022-09-08,70044,70056,Blue,1,48541,49232,691
2022-03-11,70038,70054,Blue,1,50314,51159,845
2022-07-19,70057,70045,Blue,0,42688,43313,625
2022-08-20,70038,70050,Blue,1,54519,55159,640
2022-03-10,70053,70043,Blue,0,55060,55678,618
2022-11-22,70040,70052,Blue,1,39928,40606,678
2022-05-30,70041,70039,Blue,0,42929,42961,32
2022-03-06,70050,70054,Blue,1,66216,66431,215
2022-08-04,70049,70043,Blue,0,52492,52860,368
2022-11-12,70046,70048,Blue,1,75372,75452,80
2022-11-26,70038,70048,Blue,1,28566,29007,441
2022-06-24,70059,70047,Blue,0,47864,48429,565
2022-11-22,70046,70058,Blue,1,74570,75202,632
2022-12-28,70040,70056,Blue,1,69178,70003,825
2022-06-09,70042,70056,Blue,1,67821,68647,826
2022-11-13,70046,70048,Blue,1,52450,52523,73
2022-11-18,70038,70042,Blue,1,68538,68638,100
2022-10-07,70038,70054,Blue,1,75238,76053,815
2022-02-07,70057,70838,Blue,0,54865,56017,1152
2022-08-18,70040,70046,Blue,1,70947,71217,270
2022-07-23,70047,70045,Blue,0,36345,36444,99
2022-09-30,70050,70060,Blue,1,37012,37555,543
2022-10-05,70055,70041,Blue,0,76642,77372,730
2022-01-23,70044,70056,Blue,1,30213,30882,669
2022-08-04,70055,70838,Blue,0,43888,44882,994
2022-11-01,70046,70058,Blue,1,46511,47158,647
2022-03-06,70045,70041,Blue,0,29271,29430,159
2022-06-08,70049,70047,Blue,0,87237,87294,57
2022-08-19,70046,70056,Blue,1,74036,74566,530
2022-01-27,70053,70043,Blue,0,74027,74647,620
2022-10-16,70049,70047,Blue,0,21995,22067,72
2022-02-03,70049,70041,Blue,0,42114,42601,487
2022-07-15,70042,70048,Blue,1,41326,41626,300
2022-01-07,70056,70058,Blue,1,69492,69636,144
2022-06-02,70045,70838,Blue,0,40126,40542,416
2022-07-29,70050,70052,Blue,1,54811,54956,145
2022-03-23,70042,70044,Blue,1,44778,44805,27
2022-01-10,70040,70050,Blue,1,36013,36580,567
2022-10-15,70042,70052,Blue,1,83105,83681,576
2022-01-15,70046,70052,Blue,1,45318,45671,353
2022-11-15,70044,70050,Blue,1,70901,71231,330
2022-03-25,70053,70838,Blue,0,29341,30261,920
2022-06-13,70040,70050,Blue,1,22813,23376,563
2022-05-21,70041,70039,Blue,0,66072,66107,35
2022-03-07,70055,70047,Blue,0,71716,72127,411
2022-09-23,70057,70055,Blue,0,36473,36541,68
2022-02-27,70040,70050,Blue,1,76463,76983,520
2022-03-22,70059,70047,Blue,0,42076,42623,547
2022-05-09,70054,70060,Blue,1,83556,83831,275
2022-10-28,70048,70056,Blue,1,49956,50344,388
2022-01-26,70038,70058,Blue,1,65932,66991,1059
2022-10-26,70038,70060,Blue,1,62286,63468,1182
2022-07-13,70040,70054,Blue,1,45620,46572,952
2022-06-16,70050,70058,Blue,1,59851,60944,1093
2022-02-22,70053,70051,Blue,0,65603,65662,59
2022-05-16,70049,70047,Blue,0,31030,31122,92
2022-08-20,70042,70048,Blue,1,69815,70135,320
2022-08-26,70042,70048,Blue,1,63719,64025,306
2022-10-19,70051,70039,Blue,0,31334,32017,683
2022-04-20,70052,70054,Blue,1,22817,22865,48
2022-04-30,70055,70051,Blue,0,80125,80277,152
2022-03-30,70052,70054,Blue,1,60180,60229,49
2022-10-03,70049,70047,Blue,0,31957,32017,60
2022-01-11,70045,70838,Blue,0,75677,76013,336
2022-05-21,70054,70058,Blue,1,37607,37768,161
2022-06-27,70059,70041,Blue,0,33076,34128,1052
2022-01-04,70044,70048,Blue,1,47832,48068,236
2022-06-03,70050,70052,Blue,1,37193,37402,209
2022-06-11,70040,70048,Blue,1,57893,58349,456
2022-01-23,70059,70057,Blue,0,60387,60422,35
2022-06-13,70053,70041,Blue,0,41808,42511,703
2022-12-15,70043,70838,Blue,0,70585,70758,173
2022-06-27,70042,70052,Blue,1,55624,56351,727
2022-06-25,70052,70060,Blue,1,58885,59304,419
2022-06-28,70059,70047,Blue,0,45477,46097,620
2022-10-31,70051,70045,Blue,0,46637,46960,323
2022-03-29,70040,70056,Blue,1,35772,36638,866
2022-04-11,70042,70056,Blue,1,27124,27900,776
2022-07-13,70042,70056,Blue,1,20097,20858,761
2022-12-29,70053,70045,Blue,0,20692,21126,434
2022-07-05,70059,70045,Blue,0,29723,30467,744
2022-11-26,70042,70056,Blue,1,77437,78188,751
2022-12-26,70059,70053,Blue,0,75436,75671,235
2022-02-28,70055,70053,Blue,0,56179,56246,67
2022-09-01,70048,70052,Blue,1,69049,69259,210
2022-09-05,70042,70046,Blue,1,73866,74030,164
2022-02-13,70038,70040,Blue,1,67753,67767,14
2022-05-20,70055,70049,Blue,0,68057,68365,308
2022-07-23,70040,70042,Blue,1,76860,76894,34
2022-02-01,70048,70052,Blue,1,48300,48604,304
2022-09-07,70051,70041,Blue,0,39745,40354,609
2022-10-30,70044,70054,Blue,1,48577,49160,583
2022-10-18,70042,70054,Blue,1,69646,70330,684
2022-01-21,70045,70838,Blue,0,57656,58025,369
2022-06-16,70054,70056,Blue,1,74251,74299,48
2022-08-26,70050,70056,Blue,1,78385,78671,286
2022-03-29,70052,70054,Blue,1,29259,29315,56
2022-10-05,70055,70049,Blue,0,63359,63627,268
2022-10-20,70046,70050,Blue,1,45165,45363,198
2022-10-18,70057,70041,Blue,0,41371,42486,1115
2022-06-30,70057,70051,Blue,0,43886,44146,260
2022-07-02,70045,70043,Blue,0,35944,36048,104
2022-12-13,70040,70042,Blue,1,86587,86617,30
2022-02-06,70042,70050,Blue,1,30147,30542,395
2022-08-30,70055,70838,Blue,0,51236,52169,933
2022-10-01,70042,70046,Blue,1,43092,43257,165
2022-10-18,70042,70052,Blue,1,67800,68449,649
2022-01-04,70052,70054,Blue,1,34959,35007,48
2022-02-02,70053,70041,Blue,0,29694,30442,748
2022-08-01,70048,70050,Blue,1,27404,27466,62
2022-01-11,70049,70047,Blue,0,68994,69055,61
2022-07-31,70038,70046,Blue,1,38349,38653,304
2022-03-19,70045,70041,Blue,0,27443,27628,185
2022-02-15,70045,70039,Blue,0,32441,32704,263
2022-08-19,70041,70039,Blue,0,52745,52779,34
2022-06-01,70044,70050,Blue,1,76796,77145,349
2022-01-09,70044,70052,Blue,1,57185,57677,492
2022-10-22,70057,70049,Blue,0,52533,52920,387
2022-02-27,70044,70050,Blue,1,77726,78080,354
2022-08-04,70038,70060,Blue,1,78966,80134,1168
2022-07-01,70045,70838,Blue,0,41836,42270,434
2022-10-16,70046,70052,Blue,1,63827,64182,355
2022-10-03,70047,70043,Blue,0,78799,79040,241
2022-02-01,70052,70054,Blue,1,22310,22381,71
2022-12-02,70042,70048,Blue,1,48898,49201,303
2022-06-28,70052,70058,Blue,1,69784,70038,254
2022-02-01,70047,70041,Blue,0,83558,83921,363
2022-12-26,70049,70838,Blue,0,23532,24069,537
2022-06-29,70044,70048,Blue,1,49949,50222,273
2022-06-26,70038,70046,Blue,1,52173,52603,430
2022-06-29,70045,70838,Blue,0,37426,37789,363
2022-04-08,70041,70039,Blue,0,55485,55520,35
2022-07-02,70053,70041,Blue,0,76080,76804,724
2022-01-04,70051,70047,Blue,0,27594,27782,188
2022-06-15,70046,70052,Blue,1,26120,26466,346
2022-01-07,70053,70039,Blue,0,70803,71499,696
2022-08-10,70038,70050,Blue,1,76274,76794,520
2022-12-31,70057,70045,Blue,0,77125,77730,605
2022-03-21,70045,70039,Blue,0,26904,27172,268
2022-02-25,70040,70056,Blue,1,72017,72857,840
2022-07-28,70046,70048,Blue,1,54658,54748,90
2022-12-31,70055,70053,Blue,0,59845,59895,50
2022-01-24,70041,70039,Blue,0,35223,35259,36
2022-01-17,70046,70050,Blue,1,67899,68079,180
2022-04-18,70048,70050,Blue,1,58000,58059,59
2022-01-27,70047,70039,Blue,0,65085,65539,454
2022-12-07,70045,70039,Blue,0,80543,80784,241
2022-09-08,70059,70049,Blue,0,59300,59772,472
2022-12-19,70057,70055,Blue,0,65562,65633,71
2022-08-14,70053,70047,Blue,0,24101,24396,295
2022-06-10,70057,70055,Blue,0,81271,81339,68
2022-09-29,70044,70056,Blue,1,32613,33272,659
2022-03-25,70051,70043,Blue,0,61743,62236,493
2022-04-11,70042,70058,Blue,1,30991,31883,892
2022-11-01,70049,70043,Blue,0,78938,79258,320
2022-10-19,70059,70041,Blue,0,30569,31542,973
2022-11-23,70040,70048,Blue,1,50838,51251,413
2022-07-09,70053,70049,Blue,0,74345,74538,193
2022-03-30,70053,70051,Blue,0,33559,33614,55
2022-11-30,70043,70039,Blue,0,49038,49153,115
2022-07-26,70059,70047,Blue,0,34395,34952,557
2022-03-17,70039,70838,Blue,0,67040,67075,35
2022-05-18,70038,70042,Blue,1,79809,79913,104
2022-08-04,70038,70058,Blue,1,51434,52537,1103
2022-08-15,70057,70053,Blue,0,42740,42897,157
2022-02-15,70038,70056,Blue,1,74106,75044,938
2022-04-21,70051,70045,Blue,0,46507,46867,360
2022-06-23,70040,70042,Blue,1,27878,27909,31
2022-10-09,70040,70056,Blue,1,63199,64076,877
2022-08-13,70059,70045,Blue,0,24793,25524,731
2022-12-06,70042,70050,Blue,1,58480,58863,383
2022-09-01,70057,70051,Blue,0,28130,28384,254
2022-06-26,70048,70052,Blue,1,52135,52335,200
2022-09-29,70055,70045,Blue,0,62054,62591,537
2022-06-01,70048,70050,Blue,1,23516,23577,61
2022-06-26,70038,70056,Blue,1,30789,31755,966
2022-01-16,70038,70042,Blue,1,60187,60280,93
2022-02-08,70039,70838,Blue,0,52441,52539,98
2022-10-22,70038,70058,Blue,1,49637,50683,1046
2022-02-17,70042,70058,Blue,1,51491,52426,935
2022-04-11,70051,70039,Blue,0,55447,56139,692
2022-12-27,70059,70049,Blue,0,34938,35393,455
2022-11-16,70057,70049,Blue,0,32200,32612,412
2022-03-30,70055,70049,Blue,0,28647,28949,302
2022-04-17,70038,70040,Blue,1,85513,85528,15
2022-03-12,70057,70055,Blue,0,26079,26148,69
2022-01-25,70054,70058,Blue,1,38343,38510,167
2022-03-27,70050,70056,Blue,1,47859,48162,303
2022-03-02,70043,70039,Blue,0,30414,30529,115
2022-01-28,70057,70039,Blue,0,65687,66653,966
2022-07-25,70050,70060,Blue,1,86260,86777,517
2022-04-25,70059,70055,Blue,0,67996,68136,140
2022-10-22,70044,70048,Blue,1,22538,22793,255
2022-08-12,70055,70043,Blue,0,45437,46108,671
2022-12-19,70041,70838,Blue,0,22991,23107,116
2022-03-30,70052,70060,Blue,1,49459,49842,383
2022-08-15,70042,70048,Blue,1,21214,21547,333
2022-06-30,70051,70041,Blue,0,42814,43475,661
2022-07-28,70052,70060,Blue,1,49597,49947,350
2022-02-17,70042,70056,Blue,1,29472,30182,710
2022-10-14,70047,70039,Blue,0,38038,38418,380
2022-03-02,70053,70043,Blue,0,82019,82599,580
2022-06-18,70053,70045,Blue,0,77482,77954,472
2022-01-05,70050,70054,Blue,1,58065,58301,236
2022-08-19,70047,70039,Blue,0,38793,39265,472
2022-04-22,70059,70838,Blue,0,34159,35348,1189
2022-04-09,70048,70050,Blue,1,76472,76535,63
2022-07-23,70049,70043,Blue,0,54635,55000,365
2022-01-09,70047,70045,Blue,0,28449,28551,102
2022-12-12,70048,70060,Blue,1,30476,31104,628
2022-10-27,70044,70050,Blue,1,56739,57072,333
2022-11-11,70046,70054,Blue,1,40534,41002,468
2022-11-09,70040,70058,Blue,1,76388,77349,961
2022-09-25,70040,70058,Blue,1,31622,32488,866
2022-02-01,70049,70045,Blue,0,49409,49611,202
2022-04-16,70042,70052,Blue,1,56376,56999,623
2022-12-24,70040,70046,Blue,1,31452,31696,244
2022-11-03,70053,70045,Blue,0,28022,28527,505
2022-09-14,70054,70058,Blue,1,27555,27709,154
2022-07-11,70044,70058,Blue,1,70895,71842,947
2022-01-29,70044,70058,Blue,1,54763,55934,1171
2022-04-03,70057,70051,Blue,0,55527,55763,236
2022-10-18,70038,70042,Blue,1,64289,64383,94
2022-05-16,70054,70058,Blue,1,65359,65514,155
2022-12-21,70047,70041,Blue,0,44190,44529,339
2022-01-11,70054,70056,Blue,1,28382,28444,62
2022-03-23,70053,70051,Blue,0,69354,69416,62
2022-10-02,70057,70039,Blue,0,86499,87402,903
2022-11-10,70057,70051,Blue,0,81263,81486,223
2022-08-22,70049,70041,Blue,0,52645,53088,443
2022-03-16,70053,70043,Blue,0,64346,64949,603
2022-07-28,70038,70058,Blue,1,42974,44007,1033
2022-12-21,70055,70838,Blue,0,82393,83632,1239
2022-03-26,70038,70046,Blue,1,45343,45653,310
2022-03-12,70040,70052,Blue,1,44929,45597,668
2022-03-07,70057,70045,Blue,0,53186,53876,690
2022-12-24,70049,70838,Blue,0,86206,86807,601
2022-12-27,70051,70049,Blue,0,57999,58100,101
2022-03-17,70049,70039,Blue,0,64589,65137,548
2022-02-20,70042,70058,Blue,1,73847,74696,849
2022-06-12,70053,70045,Blue,0,67641,68031,390
2022-09-03,70048,70056,Blue,1,77130,77555,425
2022-06-16,70038,70054,Blue,1,30427,31270,843
2022-04-08,70045,70043,Blue,0,52508,52605,97
2022-07-12,70059,70053,Blue,0,26955,27181,226
2022-02-20,70038,70040,Blue,1,49393,49410,17
2022-07-12,70053,70047,Blue,0,58545,58842,297
2022-04-17,70046,70056,Blue,1,49771,50338,567
2022-10-13,70050,70054,Blue,1,22564,22768,204
2022-11-20,70053,70045,Blue,0,37677,38131,454
2022-08-09,70040,70048,Blue,1,78366,78739,373
2022-02-02,70057,70053,Blue,0,66538,66689,151
2022-03-28,70053,70039,Blue,0,69352,70067,715
2022-02-07,70038,70058,Blue,1,71412,72962,1550
2022-06-07,70043,70041,Blue,0,57288,57316,28
2022-09-08,70043,70039,Blue,0,33729,33842,113
2022-12-14,70057,70053,Blue,0,56792,56945,153
2022-06-21,70053,70049,Blue,0,32200,32417,217
2022-09-05,70057,70043,Blue,0,51750,52644,894
2022-02-15,70050,70054,Blue,1,25323,25524,201
2022-07-08,70057,70043,Blue,0,22664,23473,809
2022-02-17,70057,70041,Blue,0,20670,21630,960
2022-12-12,70056,70060,Blue,1,86670,86852,182
2022-05-18,70043,70039,Blue,0,67375,67488,113
2022-02-11,70038,70046,Blue,1,59534,59852,318
2022-07-14,70049,70041,Blue,0,70437,70932,495
2022-06-12,70057,70051,Blue,0,79809,80040,231
2022-12-07,70044,70052,Blue,1,60560,61071,511
2022-01-26,70044,70052,Blue,1,63965,64455,490
2022-09-14,70042,70054,Blue,1,87504,88146,642
2022-01-03,70044,70058,Blue,1,67025,67841,816
2022-04-12,70044,70058,Blue,1,32264,33115,851
2022-09-07,70049,70045,Blue,0,32324,32532,208
2022-08-03,70044,70050,Blue,1,41069,42187,1118
2022-11-10,70058,70060,Blue,1,53099,53167,68
2022-08-27,70054,70056,Blue,1,43995,44042,47
2022-01-14,70042,70056,Blue,1,24102,24914,812
2022-03-12,70050,70052,Blue,1,75053,75165,112
2022-06-25,70048,70060,Blue,1,72750,73369,619
2022-01-19,70040,70058,Blue,1,56610,57613,1003
2022-07-21,70040,70042,Blue,1,55804,55839,35
2022-01-02,70042,70052,Blue,1,75990,76511,521
2022-02-02,70059,70043,Blue,0,35831,36811,980
2022-04-13,70038,70054,Blue,1,19859,20698,839
2022-10-29,70056,70060,Blue,1,24694,24966,272
2022-05-09,70052,70054,Blue,1,21937,21994,57
2022-06-26,70055,70049,Blue,0,61644,61942,298
2022-11-04,70044,70048,Blue,1,54360,54604,244
2022-09-06,70044,70056,Blue,1,84591,85251,660
2022-04-01,70040,70044,Blue,1,45418,45529,111
2022-07-26,70050,70056,Blue,1,66533,66853,320
2022-01-26,70042,70054,Blue,1,59700,60409,709
2022-01-28,70049,70047,Blue,0,36514,36569,55
2022-10-08,70038,70050,Blue,1,58818,59381,563
2022-02-27,70051,70043,Blue,0,44500,45003,503
2022-09-20,70059,70039,Blue,0,43170,44274,1104
2022-01-04,70055,70043,Blue,0,37785,38487,702
2022-05-24,70047,70039,Blue,0,49909,50353,444
2022-11-14,70059,70047,Blue,0,71776,72327,551
2022-04-23,70052,70058,Blue,1,29378,29630,252
2022-02-26,70041,70838,Blue,0,63749,63858,109
2022-04-14,70048,70060,Blue,1,61273,61959,686
2022-08-03,70051,70039,Blue,0,37569,38221,652
2022-11-22,70050,70056,Blue,1,24967,25283,316
2022-02-24,70043,70039,Blue,0,59224,59347,123
2022-10-07,70048,70058,Blue,1,88789,89358,569
2022-11-21,70056,70058,Blue,1,43979,44063,84
2022-11-07,70051,70045,Blue,0,24873,25221,348
2022-07-07,70057,70039,Blue,0,35140,36220,1080
2022-07-20,70042,70058,Blue,1,89234,90107,873
2022-11-19,70051,70041,Blue,0,36102,36682,580
2022-09-08,70055,70051,Blue,0,28643,28798,155
2022-02-15,70057,70049,Blue,0,24639,25053,414
2022-02-27,70038,70042,Blue,1,50476,50571,95
2022-01-20,70045,70838,Blue,0,70234,70568,334
2022-06-13,70038,70058,Blue,1,38671,39833,1162
2022-06-27,70040,70056,Blue,1,62783,63711,928
2022-06-02,70044,70046,Blue,1,86614,86752,138
2022-07-07,70038,70052,Blue,1,52548,53289,741
2022-10-25,70053,70041,Blue,0,28166,28863,697
2022-08-20,70047,70039,Blue,0,42882,43360,478
2022-11-25,70038,70058,Blue,1,25632,26602,970
2022-06-29,70046,70050,Blue,1,59382,59577,195
2022-01-14,70042,70046,Blue,1,52588,52771,183
2022-10-13,70047,70041,Blue,0,74084,74451,367
2022-11-17,70039,70838,Blue,0,24947,24980,33
2022-01-19,70054,70058,Blue,1,30462,30627,165
2022-12-26,70046,70050,Blue,1,84990,85171,181
2022-11-04,70047,70045,Blue,0,59463,59557,94
2022-06-17,70059,70838,Blue,0,44409,45520,1111
2022-02-25,70059,70049,Blue,0,18845,19417,572
2022-04-12,70055,70053,Blue,0,45682,45732,50
2022-02-03,70055,70043,Blue,0,61087,62051,964
2022-05-24,70047,70039,Blue,0,35988,36597,609
2022-08-26,70042,70060,Blue,1,84402,85530,1128
2022-02-22,70053,70045,Blue,0,44124,44625,501
2022-04-18,70059,70053,Blue,0,48192,48413,221
2022-06-09,70043,70039,Blue,0,83790,83902,112
2022-04-01,70039,70838,Blue,0,84431,84465,34
2022-10-12,70059,70047,Blue,0,21711,22329,618
2022-10-06,70041,70838,Blue,0,81430,81575,145
2022-07-06,70044,70058,Blue,1,85377,86267,890
2022-06-21,70054,70060,Blue,1,81634,81923,289
2022-04-04,70043,70041,Blue,0,77510,77541,31
2022-08-27,70059,70838,Blue,0,46530,47738,1208
2022-05-19,70050,70060,Blue,1,62710,63283,573
2022-11-04,70040,70042,Blue,1,42536,42571,35
2022-07-06,70048,70054,Blue,1,22574,22895,321
2022-07-07,70048,70056,Blue,1,37135,37593,458
2022-01-05,70042,70048,Blue,1,30698,30985,287
2022-11-13,70042,70046,Blue,1,69516,69715,199
2022-12-31,70051,70049,Blue,0,49075,49177,102
2022-12-14,70038,70050,Blue,1,57065,57603,538
2022-08-03,70055,70045,Blue,0,21638,22158,520
2022-03-29,70057,70043,Blue,0,78378,79162,784
2022-07-18,70049,70045,Blue,0,48343,48543,200
2022-09-01,70038,70048,Blue,1,84334,84810,476
2022-12-28,70055,70053,Blue,0,84581,84628,47
2022-07-31,70041,70039,Blue,0,45108,45139,31
2022-09-28,70040,70042,Blue,1,75277,75309,32
2022-03-13,70050,70060,Blue,1,40279,40798,519
2022-04-04,70056,70058,Blue,1,47920,47994,74
2022-10-11,70038,70046,Blue,1,78848,79185,337
2022-08-02,70038,70044,Blue,1,39312,39464,152
2022-11-07,70046,70054,Blue,1,53132,53849,717
2022-03-24,70047,70043,Blue,0,35835,36096,261
2022-06-09,70052,70060,Blue,1,77682,78036,354
2022-09-06,70059,70039,Blue,0,87348,88334,986
2022-05-24,70047,70043,Blue,0,86217,86554,337
2022-11-29,70040,70046,Blue,1,21509,21770,261
2022-02-02,70059,70041,Blue,0,56888,57785,897
2022-02-21,70049,70041,Blue,0,65387,65833,446
2022-01-19,70049,70047,Blue,0,29982,30036,54
2022-01-26,70051,70041,Blue,0,84983,85534,551
2022-05-20,70056,70060,Blue,1,63302,63473,171
2022-01-27,70038,70042,Blue,1,56530,56633,103
2022-11-03,70040,70052,Blue,1,40601,41351,750
2022-10-21,70055,70053,Blue,0,41521,41568,47
2022-06-26,70051,70047,Blue,0,77436,77632,196
2022-05-20,70057,70053,Blue,0,51745,51892,147
2022-05-04,70057,70051,Blue,0,71489,71729,240
2022-06-20,70049,70039,Blue,0,60276,60826,550
2022-10-16,70044,70052,Blue,1,41874,42332,458
2022-06-04,70047,70838,Blue,0,63049,63604,555
2022-02-09,70040,70056,Blue,1,89226,90192,966
2022-07-27,70040,70052,Blue,1,69063,69722,659
2022-11-13,70041,70039,Blue,0,47356,47389,33
2022-03-29,70052,70054,Blue,1,34001,34057,56
2022-01-06,70041,70838,Blue,0,52855,53180,325
2022-06-22,70053,70047,Blue,0,40808,41148,340
2022-07-30,70038,70044,Blue,1,50714,50899,185
2022-10-08,70045,70838,Blue,0,73158,73493,335
2022-11-03,70059,70051,Blue,0,70712,71023,311
2022-06-25,70057,70041,Blue,0,21575,22416,841
2022-11-25,70047,70041,Blue,0,39059,39369,310
2022-12-27,70051,70043,Blue,0,68880,69357,477
2022-12-12,70038,70048,Blue,1,68474,68936,462
2022-03-09,70046,70056,Blue,1,31851,32482,631
2022-09-11,70038,70054,Blue,1,63435,64284,849
2022-10-06,70059,70043,Blue,0,59772,60609,837
2022-11-17,70057,70049,Blue,0,21696,22142,446
2022-12-20,70051,70049,Blue,0,59058,59166,108
2022-10-31,70048,70058,Blue,1,45621,46119,498
2022-09-16,70052,70058,Blue,1,71807,72055,248
2022-02-26,70053,70045,Blue,0,73811,74236,425
2022-01-21,70042,70048,Blue,1,50430,50742,312
2022-01-07,70054,70058,Blue,1,35363,35552,189
2022-06-26,70051,70043,Blue,0,49891,50390,499
2022-05-17,70050,70058,Blue,1,40573,41039,466
2022-06-09,70040,70046,Blue,1,62580,63220,640
2022-10-01,70053,70838,Blue,0,60273,61174,901
2022-09-07,70042,70044,Blue,1,40015,40088,73
2022-01-03,70040,70042,Blue,1,39146,39181,35
2022-04-12,70049,70047,Blue,0,21852,21918,66
2022-10-06,70043,70039,Blue,0,81359,81465,106
2022-05-01,70050,70054,Blue,1,74129,74332,203
2022-12-13,70053,70039,Blue,0,44039,44808,769
2022-12-07,70049,70838,Blue,0,31833,32493,660
2022-10-15,70044,70048,Blue,1,26550,26801,251
2022-06-23,70040,70054,Blue,1,62990,63760,770
2022-01-10,70052,70054,Blue,1,68225,68279,54
2022-04-19,70038,70046,Blue,1,58647,59009,362
2022-01-10,70043,70838,Blue,0,54222,54432,210
2022-12-26,70038,70040,Blue,1,48853,48867,14
2022-12-09,70048,70058,Blue,1,32796,33259,463
2022-05-20,70048,70060,Blue,1,34197,34806,609
2022-10-07,70053,70039,Blue,0,34181,34921,740
2022-09-14,70053,70051,Blue,0,40886,40942,56
2022-03-14,70052,70058,Blue,1,26421,26670,249
2022-02-19,70057,70039,Blue,0,46590,47658,1068
2022-12-26,70042,70048,Blue,1,61497,61822,325
2022-03-10,70038,70060,Blue,1,89169,90184,1015
2022-03-03,70057,70043,Blue,0,31546,32402,856
2022-12-01,70038,70058,Blue,1,54915,56619,1704
2022-01-02,70038,70058,Blue,1,42966,43900,934
2022-04-15,70059,70057,Blue,0,67151,67186,35
2022-03-15,70042,70058,Blue,1,51753,52566,813
2022-04-19,70052,70056,Blue,1,77169,77311,142
2022-03-27,70059,70043,Blue,0,26232,27103,871
2022-09-07,70059,70838,Blue,0,68677,69778,1101
2022-03-14,70038,70050,Blue,1,54887,55510,623
2022-07-12,70059,70039,Blue,0,20432,21617,1185
2022-12-15,70051,70047,Blue,0,29583,29798,215
2022-09-21,70059,70047,Blue,0,56191,56789,598
2022-01-20,70053,70043,Blue,0,61109,61763,654
2022-04-24,70051,70045,Blue,0,25057,25421,364
2022-02-09,70038,70054,Blue,1,72967,73720,753
2022-11-13,70059,70838,Blue,0,45205,46289,1084
2022-09-15,70052,70060,Blue,1,36071,36412,341
2022-08-26,70059,70045,Blue,0,65399,66069,670
2022-01-07,70057,70047,Blue,0,59390,59887,497
2022-06-30,70055,70047,Blue,0,71313,71689,376
2022-12-20,70046,70054,Blue,1,71344,71824,480
2022-10-05,70038,70052,Blue,1,28993,29655,662
2022-07-01,70042,70052,Blue,1,54336,55125,789
2022-01-15,70040,70050,Blue,1,48087,48615,528
2022-10-05,70057,70053,Blue,0,35971,36138,167
2022-01-09,70052,70056,Blue,1,43011,43146,135
2022-09-01,70038,70048,Blue,1,47122,47564,442
2022-03-09,70038,70056,Blue,1,30552,31454,902
2022-09-16,70054,70058,Blue,1,30846,31011,165
2022-12-01,70055,70049,Blue,0,51145,51424,279
2022-12-20,70052,70054,Blue,1,70382,70435,53
2022-03-11,70052,70058,Blue,1,28023,28281,258
2022-09-06,70038,70040,Blue,1,60376,60390,14
2022-08-26,70053,70039,Blue,0,44490,45345,855
2022-02-16,70044,70058,Blue,1,22617,23509,892
2022-06-30,70046,70060,Blue,1,46432,47293,861
2022-04-07,70050,70054,Blue,1,67329,67540,211
2022-11-20,70047,70838,Blue,0,63098,63566,468
2022-08-06,70055,70047,Blue,0,78628,78988,360
2022-01-25,70059,70051,Blue,0,26294,26677,383
2022-07-18,70044,70050,Blue,1,25398,25707,309
2022-12-02,70057,70041,Blue,0,76528,77374,846
2022-07-06,70057,70039,Blue,0,33170,34232,1062
2022-09-08,70049,70047,Blue,0,28974,29029,55
2022-01-21,70052,70060,Blue,1,53448,53802,354
2022-01-25,70040,70054,Blue,1,52031,52779,748
2022-01-22,70045,70838,Blue,0,45656,46032,376
2022-11-11,70053,70047,Blue,0,79662,79973,311
2022-12-28,70059,70838,Blue,0,62763,63893,1130
2022-08-02,70045,70039,Blue,0,37361,37597,236
2022-03-16,70040,70056,Blue,1,48129,48902,773
2022-02-11,70039,70838,Blue,0,56132,56167,35
2022-04-15,70045,70043,Blue,0,21312,21401,89
2022-09-22,70050,70054,Blue,1,29145,29339,194
2022-03-25,70044,70048,Blue,1,62504,62734,230
2022-10-17,70038,70044,Blue,1,72661,72844,183
2022-05-28,70045,70838,Blue,0,71995,72328,333
2022-12-06,70053,70051,Blue,0,76706,76760,54
2022-10-22,70040,70060,Blue,1,77356,78426,1070
2022-02-08,70045,70039,Blue,0,87042,87309,267
2022-07-08,70051,70043,Blue,0,33480,34031,551
2022-03-25,70051,70043,Blue,0,70860,71333,473
2022-04-26,70051,70047,Blue,0,40331,40635,304
2022-08-31,70059,70055,Blue,0,44296,44435,139
2022-08-10,70048,70050,Blue,1,29453,29514,61
2022-04-10,70059,70045,Blue,0,47353,48057,704
2022-04-06,70048,70054,Blue,1,52425,52734,309
2022-08-09,70043,70838,Blue,0,21384,21587,203
2022-06-09,70059,70051,Blue,0,38658,39017,359
2022-02-24,70057,70047,Blue,0,54709,55192,483
2022-06-10,70044,70056,Blue,1,73239,73990,751
2022-01-19,70049,70041,Blue,0,25969,26386,417
2022-12-19,70059,70057,Blue,0,24743,24778,35
2022-10-08,70055,70041,Blue,0,27788,28538,750
2022-05-20,70059,70039,Blue,0,47656,48960,1304
2022-11-27,70040,70056,Blue,1,49442,50205,763
2022-11-19,70045,70041,Blue,0,47322,47494,172
2022-12-03,70050,70058,Blue,1,72353,72768,415
2022-03-31,70059,70039,Blue,0,69503,70465,962
2022-04-03,70051,70045,Blue,0,53651,53984,333
2022-04-07,70042,70046,Blue,1,64780,64974,194
2022-04-21,70055,70045,Blue,0,29237,29828,591
2022-03-05,70059,70838,Blue,0,66511,67683,1172
2022-11-12,70056,70060,Blue,1,72698,72876,178
2022-09-23,70059,70053,Blue,0,30156,30403,247
2022-02-08,70059,70838,Blue,0,33017,34288,1271
2022-07-06,70038,70048,Blue,1,49278,49758,480
2022-11-30,70038,70052,Blue,1,37917,38598,681
2022-12-22,70044,70058,Blue,1,20132,21117,985
2022-12-08,70043,70838,Blue,0,54104,54317,213
2022-11-24,70040,70058,Blue,1,69430,70346,916
2022-08-01,70059,70049,Blue,0,81274,81735,461
2022-11-08,70041,70838,Blue,0,77885,78005,120
2022-07-04,70042,70044,Blue,1,30326,30359,33
2022-07-21,70049,70039,Blue,0,36939,37464,525
2022-02-23,70059,70047,Blue,0,42679,43300,621
2022-10-27,70046,70048,Blue,1,71469,71552,83
2022-09-19,70049,70047,Blue,0,54624,54710,86
2022-07-18,70059,70039,Blue,0,66640,67643,1003
2022-02-17,70050,70056,Blue,1,62539,62874,335
2022-08-10,70051,70049,Blue,0,56102,56204,102
2022-12-12,70049,70047,Blue,0,73904,73956,52
2022-02-14,70038,70058,Blue,1,28590,29693,1103
2022-09-30,70040,70042,Blue,1,34518,34553,35
2022-10-09,70042,70054,Blue,1,73847,74524,677
2022-12-30,70055,70041,Blue,0,57474,58194,720
2022-02-05,70041,70838,Blue,0,58359,58482,123
2022-12-24,70057,70047,Blue,0,34323,34798,475
2022-04-11,70053,70045,Blue,0,69776,70213,437
2022-08-12,70038,70040,Blue,1,44208,44223,15
2022-07-31,70046,70056,Blue,1,58469,59004,535
2022-12-09,70038,70056,Blue,1,87401,88362,961
2022-12-10,70057,70051,Blue,0,24877,25130,253
2022-01-31,70056,70060,Blue,1,72534,72729,195
2022-05-21,70048,70054,Blue,1,37729,38051,322
2022-10-27,70056,70058,Blue,1,61720,61791,71
2022-07-02,70057,70045,Blue,0,63877,64515,638
2022-01-18,70051,70045,Blue,0,45332,45639,307
2022-12-31,70041,70838,Blue,0,61275,61389,114
2022-03-27,70054,70056,Blue,1,72314,72365,51
2022-01-01,70051,70039,Blue,0,42507,43119,612
2022-03-15,70042,70048,Blue,1,40297,40640,343
2022-10-15,70059,70057,Blue,0,64332,64367,35
2022-12-22,70051,70039,Blue,0,47514,48157,643
2022-11-04,70040,70048,Blue,1,36726,37187,461
2022-04-04,70047,70039,Blue,0,77765,78155,390
2022-06-23,70038,70044,Blue,1,58189,58437,248
2022-03-01,70051,70047,Blue,0,80943,81139,196
2022-04-10,70044,70056,Blue,1,53445,54152,707
2022-09-02,70047,70039,Blue,0,19083,19570,487
2022-09-08,70038,70046,Blue,1,80176,80553,377
2022-01-08,70044,70050,Blue,1,45148,45483,335
2022-07-23,70049,70047,Blue,0,44796,44848,52
2022-12-12,70051,70049,Blue,0,46096,46196,100
2022-02-21,70045,70041,Blue,0,36447,36645,198
2022-10-08,70047,70045,Blue,0,84643,84738,95
2022-10-21,70052,70058,Blue,1,87373,87631,258
2022-02-05,70055,70053,Blue,0,20362,20409,47
2022-07-14,70040,70056,Blue,1,84327,85145,818
2022-03-07,70059,70039,Blue,0,29062,30122,1060
2022-07-29,70042,70052,Blue,1,70305,70885,580
2022-08-12,70046,70050,Blue,1,57524,57715,191
2022-03-13,70053,70838,Blue,0,54672,55545,873
2022-12-16,70048,70056,Blue,1,76795,77189,394
2022-07-16,70056,70058,Blue,1,30012,30086,74
2022-06-23,70046,70050,Blue,1,43308,43517,209
2022-04-29,70051,70049,Blue,0,50916,51020,104
2022-10-30,70051,70045,Blue,0,74746,75074,328
2022-12-21,70041,70838,Blue,0,23680,23897,217
2022-06-24,70040,70050,Blue,1,56349,56954,605
2022-02-10,70051,70045,Blue,0,67172,67517,345
2022-10-19,70055,70047,Blue,0,43894,44287,393
2022-08-31,70038,70060,Blue,1,71107,72310,1203
2022-10-08,70048,70058,Blue,1,43765,44305,540
2022-01-31,70042,70054,Blue,1,38891,39835,944
2022-02-04,70038,70042,Blue,1,30165,30253,88
2022-12-04,70046,70048,Blue,1,40711,40785,74
2022-04-21,70048,70052,Blue,1,79657,79860,203
2022-04-20,70059,70838,Blue,0,71537,72689,1152
2022-02-10,70059,70051,Blue,0,35826,36164,338
2022-04-06,70050,70056,Blue,1,51495,51806,311
2022-01-04,70053,70838,Blue,0,70353,71168,815
2022-11-15,70052,70060,Blue,1,51026,51380,354
2022-09-02,70053,70051,Blue,0,86077,86140,63
2022-02-09,70059,70055,Blue,0,32054,32206,152
2022-03-04,70055,70049,Blue,0,67342,67619,277
2022-11-16,70043,70041,Blue,0,49218,49246,28
2022-02-13,70049,70039,Blue,0,51116,51661,545
2022-02-01,70048,70056,Blue,1,34963,35418,455
2022-10-14,70056,70060,Blue,1,69899,70075,176
2022-02-04,70038,70054,Blue,1,51908,52786,878
2022-05-24,70044,70048,Blue,1,60114,60369,255
2022-01-04,70050,70052,Blue,1,21247,21362,115
2022-03-22,70057,70047,Blue,0,42826,43333,507
2022-05-23,70048,70052,Blue,1,27769,28095,326
2022-09-13,70050,70052,Blue,1,29813,29924,111
2022-08-23,70059,70049,Blue,0,58961,59431,470
2022-02-13,70052,70060,Blue,1,36963,37299,336
2022-08-28,70057,70047,Blue,0,61474,61922,448
2022-07-25,70043,70039,Blue,0,30745,30871,126
2022-12-07,70044,70048,Blue,1,56809,57119,310
2022-02-03,70052,70056,Blue,1,35595,35746,151
2022-09-26,70043,70041,Blue,0,62499,62531,32
2022-11-03,70057,70043,Blue,0,44964,45776,812
2022-05-10,70059,70051,Blue,0,80051,80380,329
2022-03-09,70049,70039,Blue,0,79447,79923,476
2022-05-20,70057,70051,Blue,0,62664,62912,248
2022-02-05,70054,70058,Blue,1,25525,25675,150
2022-09-01,70052,70056,Blue,1,61025,61163,138
2022-03-22,70057,70053,Blue,0,63748,63926,178
2022-11-18,70042,70054,Blue,1,54100,54802,702
2022-07-17,70052,70054,Blue,1,77721,77790,69
2022-01-27,70057,70041,Blue,0,21060,22018,958
2022-06-11,70048,70052,Blue,1,67457,67657,200
2022-04-03,70049,70041,Blue,0,66760,67214,454
2022-01-27,70049,70045,Blue,0,30243,30435,192
2022-04-14,70049,70045,Blue,0,75399,75606,207
2022-10-11,70055,70039,Blue,0,30344,31280,936
2022-08-28,70051,70049,Blue,0,39229,39332,103
2022-09-15,70042,70050,Blue,1,75571,76001,430
2022-07-24,70042,70048,Blue,1,65736,66035,299
2022-01-13,70040,70058,Blue,1,40207,41139,932
2022-11-24,70053,70041,Blue,0,23402,24139,737
2022-04-11,70046,70056,Blue,1,76175,76681,506
2022-10-16,70053,70051,Blue,0,81157,81209,52
2022-01-04,70050,70056,Blue,1,54943,55250,307
2022-08-27,70043,70039,Blue,0,80888,81002,114
2022-07-12,70046,70060,Blue,1,77149,77914,765
2022-02-16,70057,70043,Blue,0,53179,54070,891
2022-06-26,70042,70060,Blue,1,61165,62186,1021
2022-07-04,70055,70041,Blue,0,48318,49129,811
2022-12-26,70055,70043,Blue,0,78442,79134,692
2022-03-08,70041,70838,Blue,0,42072,42203,131
2022-02-18,70044,70056,Blue,1,26884,27596,712
2022-07-22,70040,70044,Blue,1,83311,83416,105
2022-07-05,70059,70053,Blue,0,28734,29034,300
2022-12-07,70046,70048,Blue,1,75583,75663,80
2022-02-16,70042,70058,Blue,1,42079,43209,1130
2022-09-15,70052,70060,Blue,1,51188,51538,350
2022-06-13,70055,70043,Blue,0,31661,32342,681
2022-01-29,70059,70055,Blue,0,19513,19663,150
2022-10-05,70050,70060,Blue,1,59290,59824,534
2022-01-24,70051,70045,Blue,0,22080,22426,346
2022-07-10,70050,70060,Blue,1,82374,82905,531
2022-07-17,70045,70039,Blue,0,78332,78604,272
2022-12-10,70059,70055,Blue,0,50309,50469,160
2022-01-05,70049,70043,Blue,0,27493,27840,347
2022-03-22,70047,70039,Blue,0,85187,85555,368
2022-12-13,70046,70050,Blue,1,74599,74801,202
2022-01-24,70045,70041,Blue,0,40739,40910,171
2022-08-22,70042,70044,Blue,1,25218,25249,31
2022-06-30,70046,70054,Blue,1,86023,86520,497
2022-09-25,70042,70056,Blue,1,56066,56810,744
2022-10-30,70038,70056,Blue,1,62895,63727,832
2022-03-12,70048,70058,Blue,1,50182,50698,516
2022-07-02,70051,70049,Blue,0,52991,53092,101
2022-06-23,70055,70043,Blue,0,41125,41897,772
2022-01-31,70048,70052,Blue,1,35790,36092,302
2022-04-05,70059,70057,Blue,0,55092,55127,35
2022-03-15,70056,70060,Blue,1,32397,32567,170
2022-12-17,70050,70060,Blue,1,78578,79069,491
2022-01-04,70051,70049,Blue,0,61191,61302,111
2022-07-27,70038,70042,Blue,1,67419,67508,89
2022-10-11,70040,70050,Blue,1,41905,42444,539
2022-07-10,70040,70046,Blue,1,78081,78361,280
2022-09-10,70053,70045,Blue,0,52179,52610,431
2022-04-13,70055,70053,Blue,0,34053,34102,49
2022-02-16,70038,70044,Blue,1,70506,70687,181
2022-07-19,70049,70043,Blue,0,62080,62456,376
2022-07-26,70057,70043,Blue,0,48957,49844,887
2022-02-04,70038,70048,Blue,1,58887,59370,483
2022-11-08,70042,70056,Blue,1,77964,78682,718
2022-03-23,70047,70043,Blue,0,25496,25789,293
2022-06-12,70059,70043,Blue,0,63014,63889,875
2022-03-12,70038,70058,Blue,1,53463,54450,987
2022-03-21,70043,70838,Blue,0,59042,59246,204
2022-12-25,70057,70043,Blue,0,79652,80412,760
2022-12-10,70040,70054,Blue,1,71838,72614,776
2022-11-18,70045,70838,Blue,0,69096,69427,331
2022-09-01,70048,70056,Blue,1,36226,36635,409
2022-07-19,70049,70838,Blue,0,28571,29203,632
2022-09-16,70052,70056,Blue,1,85786,85924,138
2022-10-20,70055,70838,Blue,0,31609,32638,1029
2022-10-23,70055,70045,Blue,0,54549,55096,547
2022-01-07,70059,70051,Blue,0,65295,65652,357
2022-12-20,70050,70060,Blue,1,86276,86804,528
2022-04-11,70047,70039,Blue,0,56061,56493,432
2022-01-14,70052,70054,Blue,1,62147,62198,51
2022-04-10,70045,70043,Blue,0,61632,61733,101
2022-08-26,70049,70047,Blue,0,35449,35515,66
2022-05-19,70057,70041,Blue,0,58467,59581,1114
2022-03-23,70057,70049,Blue,0,33995,34374,379
2022-04-02,70038,70054,Blue,1,58813,59684,871
2022-10-11,70059,70053,Blue,0,71235,71466,231
2022-10-06,70038,70054,Blue,1,31974,32746,772
2022-02-05,70042,70052,Blue,1,78118,78709,591
2022-10-24,70051,70039,Blue,0,64321,64937,616
2022-07-09,70051,70041,Blue,0,72247,72835,588
2022-10-26,70044,70050,Blue,1,85193,85544,351
2022-07-20,70040,70048,Blue,1,44101,44537,436
2022-08-18,70048,70056,Blue,1,84849,85338,489
2022-02-16,70048,70058,Blue,1,83250,83763,513
2022-12-08,70039,70838,Blue,0,59315,59348,33
2022-10-29,70057,70047,Blue,0,64462,64972,510
2022-02-11,70054,70060,Blue,1,68316,68670,354
2022-06-29,70042,70054,Blue,1,41179,41983,804
2022-10-31,70044,70054,Blue,1,78298,79209,911
2022-01-07,70040,70042,Blue,1,26263,26301,38
2022-03-07,70055,70039,Blue,0,68644,69458,814
2022-11-26,70051,70039,Blue,0,35526,36129,603
2022-06-17,70051,70047,Blue,0,41912,42115,203
2022-03-08,70057,70838,Blue,0,38196,39287,1091
2022-01-25,70057,70053,Blue,0,65059,65222,163
2022-02-12,70044,70050,Blue,1,33649,33985,336
2022-12-05,70043,70039,Blue,0,34669,34776,107
2022-06-12,70040,70060,Blue,1,73771,74874,1103
2022-01-06,70038,70046,Blue,1,36202,36498,296
2022-01-14,70057,70047,Blue,0,65370,65860,490
2022-02-15,70051,70838,Blue,0,22056,22916,860
2022-07-29,70053,70838,Blue,0,69779,70603,824
2022-01-27,70038,70052,Blue,1,76336,77069,733
2022-02-07,70040,70048,Blue,1,79268,79637,369
2022-01-30,70042,70060,Blue,1,87537,88670,1133
2022-10-10,70052,70060,Blue,1,81065,81449,384
2022-06-29,70046,70060,Blue,1,63902,64934,1032
2022-03-08,70040,70048,Blue,1,32454,32879,425
2022-08-11,70049,70043,Blue,0,56684,57063,379
2022-10-31,70038,70054,Blue,1,45560,46371,811
2022-07-03,70045,70041,Blue,0,86307,86494,187
2022-12-07,70042,70054,Blue,1,30385,31043,658
2022-02-07,70051,70045,Blue,0,29138,29496,358
2022-11-21,70048,70052,Blue,1,83153,83376,223
2022-03-11,70049,70047,Blue,0,60429,60488,59
2022-03-15,70053,70049,Blue,0,22295,22497,202
2022-09-17,70038,70058,Blue,1,70156,71270,1114
2022-09-20,70059,70055,Blue,0,71236,71377,141
2022-06-13,70042,70058,Blue,1,28892,29780,888
2022-02-02,70040,70056,Blue,1,61442,62307,865
2022-07-18,70040,70052,Blue,1,73691,74327,636
2022-01-25,70050,70052,Blue,1,51363,51474,111
2022-05-19,70055,70838,Blue,0,61979,63006,1027
2022-11-04,70044,70052,Blue,1,28801,29313,512
2022-09-08,70045,70039,Blue,0,50179,50455,276
2022-03-09,70057,70838,Blue,0,86972,88131,1159
2022-07-13,70053,70043,Blue,0,34655,35226,571
2022-09-30,70057,70055,Blue,0,56263,56333,70
2022-09-25,70059,70039,Blue,0,85580,86558,978
2022-07-12,70045,70838,Blue,0,29291,29660,369
2022-02-22,70059,70051,Blue,0,23958,24300,342
2022-05-11,70057,70047,Blue,0,45386,45867,481
2022-08-18,70048,70056,Blue,1,24917,25376,459
2022-12-30,70050,70054,Blue,1,35210,35406,196
2022-07-12,70052,70058,Blue,1,57351,57615,264
2022-12-24,70041,70039,Blue,0,36668,36734,66
2022-10-21,70048,70056,Blue,1,22274,22642,368
2022-01-04,70038,70052,Blue,1,82607,83300,693
2022-04-19,70047,70041,Blue,0,59060,59372,312
2022-12-19,70046,70060,Blue,1,60677,61576,899
2022-06-03,70038,70042,Blue,1,74415,74509,94
2022-04-03,70054,70056,Blue,1,60012,60059,47
2022-09-14,70038,70042,Blue,1,23730,23834,104
2022-07-11,70044,70058,Blue,1,68832,69651,819
2022-06-03,70038,70050,Blue,1,57916,58559,643
2022-04-11,70045,70838,Blue,0,38939,39269,330
2022-08-20,70059,70047,Blue,0,61123,61699,576
2022-10-15,70048,70050,Blue,1,66899,66958,59
2022-02-16,70046,70052,Blue,1,30001,30321,320
2022-10-21,70056,70060,Blue,1,67410,67599,189
2022-03-23,70059,70057,Blue,0,30558,30594,36
2022-04-17,70057,70041,Blue,0,61467,62334,867
2022-04-22,70051,70041,Blue,0,68221,68798,577
2022-12-18,70049,70047,Blue,0,82093,82147,54
2022-01-10,70047,70039,Blue,0,48220,48621,401
2022-04-18,70049,70043,Blue,0,71480,71887,407
2022-12-08,70047,70039,Blue,0,49558,49979,421
2022-10-12,70047,70045,Blue,0,26692,26803,111
2022-10-15,70046,70050,Blue,1,22030,22218,188
2022-09-17,70044,70058,Blue,1,39437,40539,1102
2022-02-26,70038,70040,Blue,1,62592,62608,16
2022-07-19,70053,70051,Blue,0,87484,87534,50
2022-02-15,70055,70053,Blue,0,23243,23341,98
2022-12-27,70057,70047,Blue,0,26314,26786,472
2022-01-03,70055,70047,Blue,0,63862,64279,417
2022-03-09,70042,70044,Blue,1,69598,69625,27
2022-09-27,70046,70058,Blue,1,53252,53847,595
2022-12-28,70057,70041,Blue,0,60641,61506,865
2022-12-12,70045,70041,Blue,0,62093,62254,161
2022-12-14,70059,70051,Blue,0,21787,22423,636
2022-09-25,70059,70049,Blue,0,81553,82025,472
2022-12-26,70048,70058,Blue,1,53615,54116,501
2022-10-30,70038,70044,Blue,1,43627,43810,183
2022-09-12,70040,70058,Blue,1,62354,63320,966
2022-08-28,70047,70838,Blue,0,77135,77607,472
2022-10-01,70057,70047,Blue,0,50380,50940,560
2022-10-07,70050,70060,Blue,1,74878,75387,509
2022-07-23,70053,70041,Blue,0,35425,36136,711
2022-11-10,70045,70043,Blue,0,30180,30264,84
2022-04-06,70046,70058,Blue,1,65648,66266,618
2022-05-12,70057,70053,Blue,0,76290,76441,151
2022-02-11,70040,70054,Blue,1,49281,50081,800
2022-12-03,70056,70060,Blue,1,40693,40977,284
2022-11-13,70049,70043,Blue,0,74284,74604,320
2022-03-29,70040,70044,Blue,1,81089,81219,130
2022-04-11,70044,70052,Blue,1,57480,57980,500
2022-07-19,70055,70039,Blue,0,86026,86862,836
2022-02-28,70046,70048,Blue,1,45029,45099,70
2022-09-18,70049,70039,Blue,0,69433,70021,588
2022-06-23,70042,70050,Blue,1,27455,27904,449
2022-06-28,70044,70052,Blue,1,62313,62900,587
2022-11-01,70059,70043,Blue,0,26356,27389,1033
2022-08-28,70046,70052,Blue,1,55695,56049,354
2022-03-11,70055,70039,Blue,0,53817,54681,864
2022-02-17,70055,70045,Blue,0,80243,80862,619
2022-05-20,70053,70049,Blue,0,61104,61291,187
2022-02-19,70049,70045,Blue,0,26477,26722,245
2022-05-19,70055,70047,Blue,0,30764,31162,398
2022-08-05,70042,70054,Blue,1,48438,49130,692
2022-11-18,70055,70047,Blue,0,66528,67065,537
2022-04-07,70057,70039,Blue,0,77853,78786,933
2022-07-16,70046,70050,Blue,1,60841,61031,190
2022-06-10,70040,70044,Blue,1,50360,50472,112
2022-07-11,70059,70838,Blue,0,39680,40911,1231
2022-07-04,70055,70039,Blue,0,65181,66021,840
2022-03-16,70047,70043,Blue,0,34253,34534,281
2022-01-06,70059,70049,Blue,0,32359,32867,508
2022-12-06,70056,70058,Blue,1,74133,74206,73
2022-08-21,70042,70050,Blue,1,89241,89645,404
2022-12-24,70048,70056,Blue,1,31858,32234,376
2022-10-22,70049,70043,Blue,0,65376,65719,343
2022-12-01,70048,70060,Blue,1,75766,76392,626
2022-02-18,70038,70056,Blue,1,61638,62526,888
2022-11-12,70059,70043,Blue,0,43814,44646,832
2022-01-17,70057,70045,Blue,0,57397,58034,637
2022-03-09,70048,70056,Blue,1,50825,51371,546
2022-06-17,70046,70050,Blue,1,87641,87835,194
2022-06-29,70040,70048,Blue,1,81341,81816,475
2022-09-07,70059,70057,Blue,0,55100,55134,34
2022-04-17,70053,70041,Blue,0,35053,35769,716
2022-03-20,70042,70052,Blue,1,57664,58244,580
2022-07-17,70053,70039,Blue,0,82497,83259,762
2022-01-16,70059,70051,Blue,0,31649,31967,318
2022-07-19,70044,70046,Blue,1,21574,21681,107
2022-04-18,70042,70046,Blue,1,31293,31469,176
2022-11-04,70038,70048,Blue,1,52798,53224,426
2022-10-21,70039,70838,Blue,0,41663,41695,32
2022-10-10,70040,70056,Blue,1,29244,30037,793
2022-09-12,70051,70049,Blue,0,44132,44236,104
2022-12-22,70042,70050,Blue,1,22002,22435,433
2022-02-08,70057,70045,Blue,0,24340,25061,721
2022-05-04,70057,70055,Blue,0,52305,52375,70
2022-06-26,70042,70056,Blue,1,56065,56954,889
2022-09-15,70057,70045,Blue,0,32742,33377,635
2022-08-07,70044,70056,Blue,1,40686,41398,712
2022-08-05,70049,70838,Blue,0,25181,25775,594
2022-12-08,70051,70838,Blue,0,27036,27834,798
2022-04-01,70040,70052,Blue,1,56010,56742,732
2022-07-26,70042,70058,Blue,1,26559,27426,867
2022-06-22,70046,70060,Blue,1,82129,82963,834
2022-05-24,70043,70041,Blue,0,38579,38606,27
2022-09-08,70057,70838,Blue,0,25188,26279,1091
2022-06-23,70042,70052,Blue,1,80292,80917,625
2022-09-08,70053,70051,Blue,0,31291,31352,61
2022-08-05,70042,70044,Blue,1,32921,32950,29
2022-10-15,70045,70043,Blue,0,67302,67414,112
2022-01-01,70058,70060,Blue,1,56835,56895,60
2022-10-07,70053,70043,Blue,0,28143,28728,585
2022-08-26,70056,70058,Blue,1,61207,61280,73
2022-05-09,70050,70058,Blue,1,61419,61837,418
2022-12-17,70059,70051,Blue,0,60558,60873,315
2022-04-09,70056,70060,Blue,1,61379,61559,180
2022-03-13,70059,70055,Blue,0,24844,25002,158
2022-09-02,70038,70052,Blue,1,36576,37375,799
2022-08-06,70043,70838,Blue,0,49588,49770,182
2022-01-13,70055,70041,Blue,0,65800,66607,807
2022-05-16,70055,70049,Blue,0,63787,64077,290
2022-09-18,70044,70056,Blue,1,53408,54051,643
2022-09-28,70056,70058,Blue,1,36716,36790,74
2022-06-17,70040,70054,Blue,1,49924,50708,784
2022-04-25,70054,70058,Blue,1,45025,45174,149
2022-03-11,70055,70053,Blue,0,71716,71761,45
2022-04-13,70057,70045,Blue,0,54271,54927,656
2022-08-26,70051,70047,Blue,0,39890,40080,190
2022-07-27,70053,70047,Blue,0,24945,25243,298
2022-02-08,70051,70047,Blue,0,30935,31144,209
2022-05-20,70052,70058,Blue,1,74027,74310,283
2022-09-14,70044,70056,Blue,1,81169,81902,733
2022-07-11,70042,70054,Blue,1,37023,38021,998
2022-04-20,70046,70060,Blue,1,81927,82716,789
2022-12-13,70044,70058,Blue,1,35512,36370,858
2022-03-04,70059,70039,Blue,0,58102,59129,1027
2022-08-23,70055,70041,Blue,0,63109,63883,774
2022-03-19,70051,70039,Blue,0,63075,63694,619
2022-10-19,70053,70041,Blue,0,47128,47806,678
2022-01-28,70059,70057,Blue,0,27263,27300,37
2022-07-16,70050,70054,Blue,1,31320,31555,235
2022-02-22,70051,70049,Blue,0,67133,67235,102
2022-11-06,70048,70056,Blue,1,68796,69195,399
2022-01-15,70044,70052,Blue,1,39048,39540,492
2022-08-16,70042,70056,Blue,1,33116,33918,802
2022-07-15,70042,70050,Blue,1,44833,45378,545
2022-09-19,70048,70054,Blue,1,57210,57518,308
2022-10-20,70047,70045,Blue,0,21003,21101,98
2022-10-31,70059,70053,Blue,0,33083,33325,242
2022-01-11,70057,70053,Blue,0,49291,49459,168
2022-07-16,70038,70040,Blue,1,61516,61532,16
2022-06-16,70040,70046,Blue,1,21640,21944,304
2022-01-27,70044,70046,Blue,1,22812,22915,103
2022-10-27,70059,70053,Blue,0,71774,72001,227
2022-04-20,70043,70039,Blue,0,31545,31664,119
2022-08-14,70042,70058,Blue,1,81251,82166,915
2022-01-28,70050,70060,Blue,1,78053,78562,509
2022-01-24,70044,70050,Blue,1,78774,79123,349
2022-11-03,70048,70054,Blue,1,54171,54488,317
2022-08-15,70048,70054,Blue,1,25024,25353,329
2022-04-08,70055,70043,Blue,0,69709,70531,822
2022-11-08,70039,70838,Blue,0,49399,49433,34
2022-04-16,70057,70041,Blue,0,28238,29149,911
2022-12-16,70059,70039,Blue,0,81193,82215,1022
2022-12-13,70042,70054,Blue,1,82070,82779,709
2022-02-13,70053,70039,Blue,0,76846,77650,804
2022-09-17,70046,70048,Blue,1,66221,66303,82
2022-05-03,70054,70056,Blue,1,61019,61066,47
2022-06-04,70048,70050,Blue,1,51280,51362,82
2022-07-25,70038,70042,Blue,1,55830,55928,98
2022-04-24,70052,70056,Blue,1,86212,86346,134
2022-04-11,70051,70043,Blue,0,67919,68417,498
2022-10-31,70050,70052,Blue,1,69551,69666,115
2022-08-03,70054,70056,Blue,1,87407,87454,47
2022-04-04,70050,70056,Blue,1,87117,87413,296
2022-06-13,70057,70053,Blue,0,49846,49997,151
2022-11-25,70059,70055,Blue,0,62897,63047,150
2022-08-09,70047,70838,Blue,0,71866,72347,481
2022-04-15,70038,70048,Blue,1,72425,72890,465
2022-10-02,70042,70048,Blue,1,85663,85990,327
2022-12-23,70057,70051,Blue,0,84082,84430,348
2022-08-02,70038,70060,Blue,1,22980,24133,1153
2022-10-19,70051,70047,Blue,0,58070,58277,207
2022-09-05,70059,70041,Blue,0,73876,74899,1023
2022-05-19,70040,70048,Blue,1,59765,60296,531
2022-06-15,70056,70060,Blue,1,60522,60720,198
2022-11-10,70050,70052,Blue,1,23755,23878,123
2022-11-14,70038,70052,Blue,1,54920,55691,771
2022-12-28,70055,70838,Blue,0,35237,36400,1163
2022-08-17,70052,70058,Blue,1,36293,36576,283
2022-12-28,70040,70048,Blue,1,22777,23152,375
2022-08-08,70047,70041,Blue,0,28717,29047,330
2022-04-03,70040,70060,Blue,1,73254,74325,1071
2022-04-13,70057,70051,Blue,0,47722,47973,251
2022-12-06,70055,70043,Blue,0,88293,88944,651
2022-07-07,70059,70838,Blue,0,69669,70801,1132
2022-10-24,70040,70048,Blue,1,69030,69495,465
2022-04-21,70038,70044,Blue,1,59073,59278,205
2022-03-13,70047,70045,Blue,0,36130,36268,138
2022-09-23,70057,70049,Blue,0,32143,32576,433
2022-11-26,70045,70041,Blue,0,69382,69547,165
2022-07-05,70044,70058,Blue,1,84364,85207,843
2022-07-28,70044,70056,Blue,1,57367,58046,679
2022-10-21,70056,70060,Blue,1,30329,30517,188
2022-03-02,70045,70838,Blue,0,64586,64964,378
2022-04-08,70048,70050,Blue,1,29339,29405,66
2022-01-04,70042,70056,Blue,1,51761,52459,698
2022-12-19,70044,70048,Blue,1,35419,35654,235
2022-07-27,70040,70056,Blue,1,33845,34777,932
2022-08-24,70038,70048,Blue,1,67644,68165,521
2022-09-14,70059,70043,Blue,0,48853,49669,816
2022-09-21,70057,70049,Blue,0,58289,58673,384
2022-07-29,70040,70058,Blue,1,87676,88770,1094
2022-09-14,70055,70043,Blue,0,22340,23143,803
2022-10-06,70055,70047,Blue,0,86768,87173,405
2022-02-07,70053,70039,Blue,0,84270,84963,693
2022-08-07,70038,70050,Blue,1,54255,54925,670
2022-10-21,70040,70060,Blue,1,49526,50635,1109
2022-08-05,70051,70047,Blue,0,79838,80030,192
2022-02-08,70047,70043,Blue,0,27140,27469,329
2022-10-20,70038,70058,Blue,1,63931,65105,1174
2022-10-25,70053,70039,Blue,0,79066,79773,707
2022-06-12,70053,70041,Blue,0,67641,68264,623
2022-03-05,70038,70056,Blue,1,46930,47911,981
2022-10-07,70045,70039,Blue,0,35158,35419,261
2022-03-14,70059,70043,Blue,0,80057,80898,841
2022-06-14,70044,70058,Blue,1,58592,59419,827
2022-10-29,70038,70060,Blue,1,62237,63740,1503
2022-01-25,70040,70056,Blue,1,58749,59661,912
2022-12-17,70059,70043,Blue,0,70270,71119,849
2022-08-31,70048,70056,Blue,1,76981,77373,392
2022-09-17,70043,70041,Blue,0,45268,45295,27
2022-01-06,70049,70838,Blue,0,26884,27597,713
2022-07-18,70051,70039,Blue,0,52020,52653,633
2022-03-08,70055,70041,Blue,0,77959,78713,754
2022-06-14,70056,70058,Blue,1,69299,69383,84
2022-02-17,70048,70058,Blue,1,68567,69069,502
2022-06-24,70038,70040,Blue,1,21173,21191,18
2022-06-11,70044,70056,Blue,1,23882,24602,720
2022-02-15,70057,70049,Blue,0,73838,74267,429
2022-01-24,70042,70044,Blue,1,43808,43836,28
2022-04-14,70052,70054,Blue,1,79411,79466,55
2022-01-09,70047,70043,Blue,0,65776,65997,221
2022-03-13,70055,70047,Blue,0,81064,81421,357
2022-04-06,70038,70046,Blue,1,29955,30282,327
2022-06-01,70040,70048,Blue,1,67634,68101,467
2022-01-04,70042,70054,Blue,1,64176,64782,606
2022-09-14,70043,70838,Blue,0,23207,23426,219
2022-07-01,70047,70043,Blue,0,48076,48339,263
2022-10-11,70051,70039,Blue,0,23401,24130,729
2022-08-08,70043,70041,Blue,0,85214,85242,28
2022-07-16,70042,70060,Blue,1,78094,79059,965
2022-03-27,70042,70056,Blue,1,63571,64313,742
2022-11-26,70043,70039,Blue,0,39816,39924,108
2022-03-30,70056,70058,Blue,1,30207,30277,70
2022-11-21,70045,70043,Blue,0,22280,22377,97
2022-12-20,70058,70060,Blue,1,35431,35494,63
2022-01-20,70057,70043,Blue,0,70159,70990,831
2022-08-02,70038,70048,Blue,1,66396,66942,546
2022-02-27,70042,70046,Blue,1,68970,69139,169
2022-08-20,70052,70060,Blue,1,46111,46492,381
2022-10-28,70056,70058,Blue,1,53627,53698,71
2022-02-23,70051,70039,Blue,0,62695,63415,720
2022-04-09,70042,70048,Blue,1,38490,38829,339
2022-05-07,70055,70051,Blue,0,70398,70549,151
2022-08-31,70042,70046,Blue,1,34580,34758,178
2022-03-07,70040,70044,Blue,1,54074,54184,110
2022-12-18,70048,70060,Blue,1,63414,64048,634
2022-10-29,70053,70047,Blue,0,82593,82874,281
2022-10-16,70059,70041,Blue,0,52756,53695,939
2022-07-01,70041,70039,Blue,0,26259,26296,37
2022-10-28,70057,70838,Blue,0,20496,21565,1069
2022-08-31,70050,70060,Blue,1,62924,63444,520
2022-06-18,70049,70041,Blue,0,20750,21230,480
2022-07-12,70055,70039,Blue,0,60592,61631,1039
2022-02-11,70040,70058,Blue,1,36271,37333,1062
2022-03-12,70042,70044,Blue,1,42748,42780,32
2022-05-18,70057,70053,Blue,0,22236,22382,146
2022-03-25,70052,70054,Blue,1,68467,68520,53
2022-10-26,70052,70060,Blue,1,42778,43132,354
2022-02-20,70057,70055,Blue,0,61484,61556,72
2022-08-03,70046,70050,Blue,1,50188,50369,181
2022-03-24,70038,70060,Blue,1,32698,33870,1172
2022-07-30,70044,70056,Blue,1,75252,75965,713
2022-02-11,70038,70060,Blue,1,58369,59724,1355
2022-09-20,70057,70051,Blue,0,26027,26296,269
2022-01-07,70045,70043,Blue,0,81370,81454,84
2022-06-28,70040,70042,Blue,1,58211,58244,33
2022-08-02,70053,70039,Blue,0,26302,27161,859
2022-02-07,70047,70043,Blue,0,55076,55330,254
2022-10-20,70048,70060,Blue,1,61393,62059,666
2022-01-04,70059,70043,Blue,0,51203,52082,879
2022-01-14,70045,70039,Blue,0,40745,41035,290
2022-11-01,70042,70056,Blue,1,55631,56431,800
2022-04-01,70038,70058,Blue,1,40739,41797,1058
2022-02-02,70053,70041,Blue,0,61225,62132,907
2022-08-15,70038,70054,Blue,1,68472,69261,789
2022-07-11,70040,70054,Blue,1,88266,89040,774
2022-07-22,70051,70043,Blue,0,58563,59095,532
2022-12-13,70046,70050,Blue,1,35682,35862,180
2022-11-25,70055,70039,Blue,0,44346,45164,818
2022-05-12,70053,70047,Blue,0,48358,48740,382
2022-03-15,70038,70052,Blue,1,57134,57823,689
2022-06-14,70038,70054,Blue,1,53365,54262,897
2022-12-30,70057,70039,Blue,0,26755,27645,890
2022-11-03,70054,70060,Blue,1,88271,88541,270
2022-06-17,70051,70039,Blue,0,51585,52328,743
2022-01-26,70052,70056,Blue,1,83907,84045,138
2022-07-07,70038,70040,Blue,1,21319,21337,18
2022-09-11,70042,70046,Blue,1,34835,35018,183
2022-07-13,70040,70050,Blue,1,23300,23843,543
2022-03-10,70048,70056,Blue,1,39244,39680,436
2022-08-12,70044,70054,Blue,1,65853,66498,645
2022-09-12,70038,70042,Blue,1,80174,80321,147
2022-02-03,70059,70057,Blue,0,76678,76717,39
2022-12-01,70040,70048,Blue,1,56076,56694,618
2022-01-13,70053,70045,Blue,0,19479,19913,434
2022-03-05,70055,70041,Blue,0,59648,60425,777
2022-10-12,70054,70060,Blue,1,27411,27682,271
2022-12-29,70049,70838,Blue,0,79917,80510,593
2022-09-15,70038,70056,Blue,1,65886,67040,1154
2022-01-11,70051,70045,Blue,0,82177,82534,357
2022-10-01,70040,70046,Blue,1,22396,22679,283
2022-11-05,70044,70056,Blue,1,80831,81536,705
2022-12-17,70049,70838,Blue,0,81996,82569,573
2022-09-22,70050,70058,Blue,1,29701,30113,412
2022-06-26,70055,70041,Blue,0,84787,85584,797
2022-01-25,70038,70060,Blue,1,44990,46125,1135
2022-12-10,70055,70039,Blue,0,51037,51893,856
2022-12-30,70059,70049,Blue,0,30117,30591,474
2022-01-10,70053,70047,Blue,0,58401,58706,305
2022-01-12,70053,70047,Blue,0,69343,69636,293
2022-05-20,70046,70054,Blue,1,61197,61665,468
2022-09-10,70052,70054,Blue,1,27623,27680,57
2022-09-22,70051,70047,Blue,0,40429,40630,201
2022-01-09,70040,70054,Blue,1,53797,54550,753
2022-06-14,70038,70060,Blue,1,54383,55784,1401
2022-06-27,70038,70056,Blue,1,58960,59863,903
2022-04-21,70040,70042,Blue,1,21660,21699,39
2022-07-08,70046,70052,Blue,1,66715,67050,335
2022-06-26,70045,70043,Blue,0,31777,31865,88
2022-01-25,70046,70058,Blue,1,58733,59425,692
2022-01-04,70053,70045,Blue,0,60813,61270,457
2022-09-01,70057,70041,Blue,0,46252,47193,941
2022-03-15,70051,70047,Blue,0,51571,51772,201
2022-01-12,70057,70045,Blue,0,57870,58528,658
2022-07-07,70053,70047,Blue,0,29206,29527,321
2022-10-09,70049,70838,Blue,0,73301,73868,567
2022-08-10,70038,70048,Blue,1,35391,35881,490
2022-03-31,70042,70050,Blue,1,66013,66438,425
2022-05-06,70055,70049,Blue,0,32016,32314,298
2022-06-24,70052,70054,Blue,1,52213,52278,65
2022-10-18,70040,70052,Blue,1,30872,31533,661
2022-06-24,70049,70041,Blue,0,75028,75514,486
2022-04-26,70053,70049,Blue,0,46167,46356,189
2022-12-21,70055,70045,Blue,0,61649,62182,533
2022-08-31,70051,70045,Blue,0,54954,55290,336
2022-03-12,70042,70058,Blue,1,43292,44224,932
2022-11-09,70040,70050,Blue,1,61838,62402,564
2022-07-16,70040,70058,Blue,1,70354,71323,969
2022-10-11,70057,70039,Blue,0,46449,47419,970
2022-03-24,70042,70054,Blue,1,74837,75449,612
2022-08-09,70038,70060,Blue,1,76286,77395,1109
2022-02-10,70057,70041,Blue,0,25587,26492,905
2022-02-14,70059,70045,Blue,0,79456,80252,796
2022-11-24,70044,70048,Blue,1,57698,57927,229
2022-02-17,70043,70041,Blue,0,48711,48741,30
2022-01-07,70048,70060,Blue,1,34378,35095,717
2022-10-21,70053,70045,Blue,0,40472,40940,468
2022-11-26,70055,70049,Blue,0,82519,82797,278
2022-07-11,70049,70045,Blue,0,87022,87211,189
2022-02-10,70040,70042,Blue,1,34893,34928,35
2022-10-11,70049,70838,Blue,0,35476,36124,648
2022-03-03,70059,70043,Blue,0,40426,41488,1062
2022-06-30,70040,70048,Blue,1,40777,41316,539
2022-07-07,70038,70040,Blue,1,50567,50583,16
2022-06-02,70047,70041,Blue,0,31967,32340,373
2022-02-24,70045,70043,Blue,0,25684,25785,101
2022-03-29,70045,70838,Blue,0,47340,47693,353
2022-08-16,70050,70056,Blue,1,74788,75122,334
2022-02-18,70056,70058,Blue,1,75532,75601,69
2022-07-27,70045,70039,Blue,0,72970,73242,272
2022-08-14,70059,70041,Blue,0,47358,48359,1001
2022-07-30,70043,70041,Blue,0,26390,26417,27
2022-01-25,70044,70050,Blue,1,63320,63661,341
2022-07-10,70045,70043,Blue,0,46034,46126,92
2022-01-03,70057,70053,Blue,0,65372,65539,167
2022-10-15,70048,70054,Blue,1,52864,53145,281
2022-01-10,70059,70039,Blue,0,40394,41480,1086
2022-10-12,70042,70044,Blue,1,91059,91085,26
2022-09-24,70048,70054,Blue,1,69578,69855,277
2022-04-12,70040,70060,Blue,1,54289,55534,1245
2022-02-27,70044,70048,Blue,1,57723,57959,236
2022-04-05,70059,70838,Blue,0,60497,61661,1164
2022-12-27,70052,70056,Blue,1,60603,60742,139
2022-07-12,70042,70050,Blue,1,31747,32217,470
2022-04-09,70051,70039,Blue,0,27429,28111,682
2022-02-06,70057,70043,Blue,0,74972,75765,793
2022-01-24,70042,70044,Blue,1,54460,54490,30
2022-08-06,70051,70838,Blue,0,59328,60102,774
2022-07-03,70042,70052,Blue,1,91038,91698,660
2022-10-25,70046,70056,Blue,1,52392,52893,501
2022-09-12,70057,70045,Blue,0,24342,24960,618
2022-07-28,70059,70057,Blue,0,74365,74400,35
2022-04-05,70048,70056,Blue,1,49729,50128,399
2022-06-09,70040,70048,Blue,1,30843,31293,450
2022-03-18,70042,70060,Blue,1,56676,57868,1192
2022-09-24,70057,70838,Blue,0,51442,52472,1030
2022-01-31,70050,70056,Blue,1,65376,65892,516
2022-05-19,70057,70045,Blue,0,61170,61873,703
2022-11-04,70048,70052,Blue,1,40512,40727,215
2022-12-20,70042,70060,Blue,1,27217,28155,938
2022-07-25,70038,70056,Blue,1,59934,60806,872
2022-07-08,70052,70054,Blue,1,41245,41324,79
2022-03-01,70042,70048,Blue,1,63763,64098,335
2022-05-14,70059,70047,Blue,0,45007,45616,609
2022-08-04,70045,70838,Blue,0,32594,32954,360
2022-06-20,70048,70056,Blue,1,48355,48767,412
2022-09-19,70057,70041,Blue,0,55264,56126,862
2022-08-31,70047,70045,Blue,0,47890,47988,98
2022-06-20,70053,70051,Blue,0,20752,20825,73
2022-03-01,70042,70058,Blue,1,29208,30077,869
2022-04-16,70045,70043,Blue,0,74313,74406,93
2022-03-03,70040,70060,Blue,1,56007,57106,1099
2022-11-14,70057,70049,Blue,0,73889,74298,409
2022-05-18,70040,70060,Blue,1,51893,53264,1371
2022-08-08,70055,70838,Blue,0,47064,48067,1003
2022-10-10,70051,70045,Blue,0,48713,49024,311
2022-10-26,70053,70043,Blue,0,28489,29105,616
2022-05-19,70053,70043,Blue,0,22694,23511,817
2022-07-05,70046,70052,Blue,1,78901,79265,364
2022-05-19,70038,70046,Blue,1,71491,71872,381
2022-11-18,70042,70056,Blue,1,65501,66247,746
2022-06-03,70047,70041,Blue,0,25721,26128,407
2022-09-20,70055,70045,Blue,0,65782,66359,577
2022-09-04,70038,70058,Blue,1,62382,63388,1006
2022-04-21,70056,70058,Blue,1,68753,68824,71
2022-01-07,70038,70040,Blue,1,87734,87750,16
2022-08-20,70041,70039,Blue,0,23880,23915,35
2022-06-30,70040,70052,Blue,1,24007,24653,646
2022-02-06,70053,70838,Blue,0,52894,53761,867
2022-12-05,70059,70041,Blue,0,44712,45648,936
2022-03-06,70057,70047,Blue,0,55531,56006,475
2022-10-08,70042,70044,Blue,1,51935,51962,27
2022-04-15,70047,70045,Blue,0,59281,59384,103
2022-04-08,70045,70043,Blue,0,83706,83827,121
2022-08-02,70051,70838,Blue,0,60486,61365,879
2022-04-23,70059,70057,Blue,0,42198,42234,36
2022-02-02,70040,70044,Blue,1,61442,61560,118
2022-07-07,70038,70052,Blue,1,52768,53503,735
2022-06-26,70040,70060,Blue,1,72747,73917,1170
2022-11-11,70041,70838,Blue,0,68220,68338,118
2022-03-16,70046,70048,Blue,1,52281,52384,103
2022-06-19,70048,70052,Blue,1,30543,30755,212
2022-03-22,70048,70056,Blue,1,29721,30114,393
2022-02-02,70052,70060,Blue,1,76755,77139,384
2022-12-14,70053,70039,Blue,0,60110,60895,785
2022-07-17,70055,70051,Blue,0,54038,54172,134
2022-01-18,70049,70039,Blue,0,33765,34304,539
2022-10-12,70044,70050,Blue,1,22427,22761,334
2022-11-03,70059,70051,Blue,0,43698,44030,332
2022-02-20,70046,70054,Blue,1,48187,48586,399
2022-03-14,70038,70046,Blue,1,52754,53075,321
2022-04-15,70046,70060,Blue,1,61486,62391,905
2022-07-04,70040,70046,Blue,1,32974,33261,287
2022-09-23,70057,70049,Blue,0,71363,71800,437
2022-11-29,70057,70055,Blue,0,19649,19724,75
2022-03-06,70047,70039,Blue,0,56056,56448,392
2022-03-23,70038,70042,Blue,1,65227,65343,116
2022-06-06,70046,70052,Blue,1,53532,54027,495
2022-01-20,70051,70041,Blue,0,52904,53501,597
2022-07-04,70054,70056,Blue,1,20678,20727,49
2022-11-03,70050,70052,Blue,1,43119,43226,107
2022-07-18,70054,70058,Blue,1,60790,60945,155
2022-08-24,70040,70054,Blue,1,34958,35810,852
2022-06-18,70058,70060,Blue,1,43021,43102,81
2022-06-11,70044,70056,Blue,1,84997,85706,709
2022-09-05,70056,70060,Blue,1,64867,65035,168
2022-03-17,70059,70057,Blue,0,72092,72127,35
2022-10-22,70050,70060,Blue,1,46987,47511,524
2022-11-08,70043,70039,Blue,0,50841,50950,109
2022-02-14,70045,70043,Blue,0,56453,56567,114
2022-05-31,70042,70048,Blue,1,35545,35882,337
2022-01-13,70039,70838,Blue,0,26940,26984,44
2022-07-29,70053,70045,Blue,0,20726,21150,424
2022-09-08,70048,70050,Blue,1,87840,87895,55
2022-07-05,70056,70060,Blue,1,80875,81048,173
2022-02-12,70046,70054,Blue,1,65353,65767,414
2022-04-01,70052,70058,Blue,1,49486,49741,255
2022-09-04,70051,70049,Blue,0,54022,54125,103
2022-12-29,70045,70041,Blue,0,39287,39466,179
2022-06-27,70052,70060,Blue,1,34677,35121,444
2022-11-22,70057,70049,Blue,0,62616,63010,394
2022-10-05,70054,70060,Blue,1,31956,32220,264
2022-07-25,70055,70049,Blue,0,86710,87188,478
2022-07-11,70049,70045,Blue,0,53046,53242,196
2022-10-26,70038,70046,Blue,1,75284,75659,375
2022-10-17,70059,70039,Blue,0,67579,68540,961
2022-03-12,70047,70043,Blue,0,30353,30578,225
2022-09-05,70055,70039,Blue,0,54562,55525,963
2022-09-07,70048,70050,Blue,1,29051,29109,58
2022-12-06,70057,70047,Blue,0,22516,23115,599
2022-10-27,70054,70058,Blue,1,60703,60860,157
2022-10-17,70049,70047,Blue,0,31839,31895,56
2022-10-24,70047,70041,Blue,0,60356,60686,330
2022-08-02,70057,70051,Blue,0,21817,22106,289
2022-08-10,70052,70058,Blue,1,43883,44140,257
2022-10-04,70038,70052,Blue,1,62757,63513,756
2022-10-04,70059,70041,Blue,0,28896,29920,1024
2022-01-19,70053,70039,Blue,0,36096,36816,720
2022-04-07,70057,70055,Blue,0,61770,61838,68
2022-03-29,70055,70049,Blue,0,81930,82220,290
2022-07-17,70044,70050,Blue,1,83959,84312,353
2022-03-31,70042,70050,Blue,1,30698,31129,431
2022-08-12,70051,70043,Blue,0,51331,51815,484
2022-03-26,70044,70058,Blue,1,60144,61076,932
2022-08-31,70059,70055,Blue,0,32117,32258,141
2022-10-05,70044,70052,Blue,1,57111,57624,513
2022-06-30,70053,70043,Blue,0,77948,78587,639
2022-04-15,70052,70054,Blue,1,89898,89946,48
2022-03-16,70038,70044,Blue,1,37868,38040,172
2022-11-26,70042,70052,Blue,1,54095,54667,572
2022-04-21,70055,70053,Blue,0,75670,75716,46
2022-05-06,70050,70058,Blue,1,68860,69371,511
2022-12-15,70048,70054,Blue,1,54998,55309,311
2022-02-25,70056,70060,Blue,1,73615,73797,182
2022-08-30,70048,70058,Blue,1,65394,65917,523
2022-03-22,70040,70054,Blue,1,82027,82850,823
2022-06-11,70044,70056,Blue,1,72537,73230,693
2022-06-25,70049,70838,Blue,0,68695,69340,645
2022-04-04,70038,70054,Blue,1,40746,41596,850
2022-09-27,70051,70838,Blue,0,55705,56510,805
2022-03-17,70046,70060,Blue,1,33598,34412,814
2022-08-18,70046,70056,Blue,1,47623,48156,533
2022-03-23,70038,70048,Blue,1,42433,42931,498
2022-02-20,70042,70046,Blue,1,46880,47125,245
2022-08-15,70048,70054,Blue,1,66926,67251,325
2022-11-08,70057,70055,Blue,0,67433,67508,75
2022-08-22,70047,70039,Blue,0,59123,59530,407
2022-10-15,70055,70049,Blue,0,77948,78231,283
2022-08-18,70042,70058,Blue,1,32384,33291,907
2022-01-22,70054,70058,Blue,1,24613,24775,162
2022-06-13,70059,70053,Blue,0,27896,28138,242
2022-02-22,70051,70838,Blue,0,34588,35494,906
2022-03-23,70055,70045,Blue,0,29552,30093,541
2022-07-27,70046,70052,Blue,1,67783,68147,364
2022-05-18,70053,70043,Blue,0,29341,30106,765
2022-07-11,70056,70060,Blue,1,55097,55273,176
2022-01-19,70048,70058,Blue,1,54327,54893,566
2022-03-08,70051,70838,Blue,0,25215,25952,737
2022-11-13,70059,70041,Blue,0,47894,48803,909
2022-11-15,70044,70054,Blue,1,38717,39420,703
2022-09-08,70042,70052,Blue,1,79852,80429,577
2022-11-21,70057,70041,Blue,0,22553,23397,844
2022-10-24,70038,70058,Blue,1,86606,87617,1011
2022-06-25,70051,70045,Blue,0,18814,19157,343
2022-04-12,70038,70060,Blue,1,52191,53400,1209
2022-10-17,70048,70060,Blue,1,28316,28951,635
2022-08-15,70051,70045,Blue,0,59196,59533,337
2022-06-09,70043,70039,Blue,0,80987,81103,116
2022-05-11,70059,70053,Blue,0,78453,78674,221
2022-01-21,70047,70041,Blue,0,50838,51197,359
2022-10-26,70042,70050,Blue,1,35502,35943,441
2022-01-13,70051,70047,Blue,0,55786,55978,192
2022-11-22,70042,70054,Blue,1,28302,28963,661
2022-09-19,70038,70056,Blue,1,49720,50670,950
2022-08-15,70052,70054,Blue,1,25281,25353,72
2022-10-05,70038,70040,Blue,1,65355,65369,14
2022-05-13,70052,70058,Blue,1,26272,26509,237
2022-11-05,70049,70045,Blue,0,44330,44545,215
2022-01-23,70059,70049,Blue,0,61394,61869,475
2022-07-05,70052,70056,Blue,1,48932,49070,138
2022-02-15,70041,70039,Blue,0,24273,24308,35
2022-08-01,70057,70043,Blue,0,55428,56233,805
2022-11-17,70044,70048,Blue,1,63316,63562,246
2022-09-21,70054,70060,Blue,1,33790,34059,269
2022-03-06,70057,70041,Blue,0,45313,46235,922
2022-01-06,70038,70042,Blue,1,54220,54315,95
2022-10-12,70057,70051,Blue,0,57844,58084,240
2022-07-24,70045,70043,Blue,0,51336,51436,100
2022-12-29,70040,70058,Blue,1,31741,32706,965
2022-11-22,70057,70041,Blue,0,30518,31388,870
2022-03-08,70057,70049,Blue,0,52597,53049,452
2022-07-06,70043,70041,Blue,0,38522,38564,42
2022-09-06,70055,70039,Blue,0,51708,52506,798
2022-10-29,70044,70050,Blue,1,79516,79859,343
2022-01-10,70051,70049,Blue,0,69467,69572,105
2022-05-01,70055,70049,Blue,0,87969,88263,294
2022-11-22,70049,70041,Blue,0,33511,33917,406
2022-08-31,70047,70041,Blue,0,69737,70042,305
2022-03-01,70044,70058,Blue,1,21741,22613,872
2022-09-13,70056,70060,Blue,1,68905,69086,181
2022-02-14,70047,70043,Blue,0,86352,86623,271
2022-06-25,70038,70048,Blue,1,68877,69380,503
2022-01-26,70059,70041,Blue,0,35835,36989,1154
2022-04-07,70046,70058,Blue,1,39954,40561,607
2022-02-10,70051,70041,Blue,0,33359,33999,640
2022-09-25,70040,70060,Blue,1,36381,37352,971
2022-07-15,70059,70053,Blue,0,25099,25351,252
2022-04-12,70050,70060,Blue,1,46188,46740,552
2022-03-22,70040,70056,Blue,1,58685,59533,848
2022-11-13,70051,70838,Blue,0,53124,53853,729
2022-09-01,70050,70058,Blue,1,58287,58710,423
2022-08-20,70055,70838,Blue,0,48886,49908,1022
2022-04-17,70044,70060,Blue,1,67990,68917,927
2022-07-30,70057,70043,Blue,0,80743,81539,796
2022-07-29,70055,70041,Blue,0,21024,21787,763
2022-11-04,70054,70056,Blue,1,24652,24716,64
2022-01-02,70048,70058,Blue,1,56028,56560,532
2022-08-03,70042,70058,Blue,1,82989,83844,855
2022-08-20,70042,70050,Blue,1,67597,67997,400
2022-04-19,70058,70060,Blue,1,27619,27806,187
2022-01-24,70050,70058,Blue,1,32757,33162,405
2022-01-21,70038,70052,Blue,1,26657,27390,733
2022-06-23,70040,70060,Blue,1,72858,74049,1191
2022-06-04,70042,70048,Blue,1,29197,29500,303
2022-07-28,70057,70055,Blue,0,61854,61925,71
2022-08-07,70051,70049,Blue,0,43152,43260,108
2022-08-14,70044,70048,Blue,1,67448,67682,234
2022-02-19,70049,70039,Blue,0,21380,21929,549
2022-02-19,70048,70058,Blue,1,48620,49120,500
2022-12-06,70040,70056,Blue,1,26372,27203,831
2022-04-10,70042,70050,Blue,1,42455,42878,423
2022-05-05,70053,70051,Blue,0,32514,32562,48
2022-12-02,70059,70047,Blue,0,46276,46834,558
2022-03-13,70038,70046,Blue,1,55336,55680,344
2022-01-26,70059,70838,Blue,0,30103,31365,1262
2022-08-03,70057,70838,Blue,0,58529,59529,1000
2022-05-05,70052,70060,Blue,1,32086,32445,359
2022-06-12,70052,70054,Blue,1,48564,48616,52
2022-02-19,70038,70044,Blue,1,55063,55269,206
2022-11-05,70057,70041,Blue,0,58471,59313,842
2022-10-20,70042,70044,Blue,1,25026,25056,30
2022-12-27,70059,70057,Blue,0,22978,23014,36
2022-10-20,70050,70060,Blue,1,37983,38495,512
2022-07-19,70048,70054,Blue,1,53396,53717,321
2022-02-19,70046,70052,Blue,1,24049,24443,394
2022-02-18,70048,70060,Blue,1,30770,31415,645
2022-03-24,70049,70041,Blue,0,67430,67855,425
2022-08-31,70057,70043,Blue,0,45821,46548,727
2022-01-05,70055,70041,Blue,0,84232,85051,819
2022-03-08,70044,70052,Blue,1,68175,68692,517
2022-11-03,70057,70055,Blue,0,61482,61551,69
2022-01-11,70057,70051,Blue,0,78989,79224,235
2022-04-06,70059,70045,Blue,0,35246,35991,745
2022-06-12,70042,70046,Blue,1,38475,38659,184
2022-01-27,70051,70043,Blue,0,22824,23340,516
2022-02-05,70050,70060,Blue,1,28051,28546,495
2022-12-23,70044,70054,Blue,1,78229,79310,1081
2022-11-19,70051,70041,Blue,0,49570,50163,593
2022-10-22,70042,70046,Blue,1,51948,52125,177
2022-03-05,70058,70060,Blue,1,36228,36289,61
2022-06-19,70057,70041,Blue,0,25555,26492,937
2022-10-02,70047,70045,Blue,0,33805,33894,89
2022-06-15,70043,70838,Blue,0,56076,56263,187
2022-08-08,70038,70058,Blue,1,56661,57692,1031
2022-10-29,70056,70058,Blue,1,30615,30687,72
2022-04-10,70054,70060,Blue,1,29272,29518,246
2022-02-04,70040,70056,Blue,1,45859,46794,935
2022-11-27,70047,70039,Blue,0,72822,73185,363
2022-03-29,70059,70045,Blue,0,55096,55753,657
2022-10-25,70043,70838,Blue,0,20756,21013,257
2022-10-14,70047,70045,Blue,0,69751,69850,99
2022-03-21,70057,70838,Blue,0,70593,71653,1060
2022-02-24,70053,70043,Blue,0,68182,68834,652
2022-08-18,70050,70052,Blue,1,32418,32539,121
2022-11-11,70045,70043,Blue,0,26419,26504,85
2022-06-19,70040,70056,Blue,1,65201,66102,901
2022-12-30,70050,70060,Blue,1,70490,71010,520
2022-10-15,70046,70060,Blue,1,73212,73924,712
2022-10-22,70058,70060,Blue,1,40970,41039,69
2022-12-29,70056,70060,Blue,1,47231,47447,216
2022-06-16,70044,70052,Blue,1,39326,40230,904
2022-03-19,70049,70047,Blue,0,57815,57869,54
2022-11-24,70040,70046,Blue,1,79754,80014,260
2022-02-14,70042,70058,Blue,1,52914,53870,956
2022-07-21,70050,70054,Blue,1,62868,63088,220
2022-11-08,70038,70050,Blue,1,56569,57161,592
2022-06-11,70057,70051,Blue,0,71976,72206,230
2022-12-10,70046,70060,Blue,1,45686,46394,708
2022-09-24,70044,70048,Blue,1,78877,79099,222
2022-09-22,70044,70060,Blue,1,46397,47303,906
2022-02-11,70046,70052,Blue,1,38324,38690,366
2022-03-01,70043,70838,Blue,0,79961,80165,204
2022-10-17,70057,70041,Blue,0,48459,49354,895
2022-06-03,70040,70042,Blue,1,81673,81704,31
2022-03-29,70059,70045,Blue,0,86298,87038,740
2022-01-17,70040,70054,Blue,1,36736,37538,802
2022-09-17,70059,70051,Blue,0,72976,73286,310
2022-05-20,70040,70048,Blue,1,87826,88236,410
2022-06-16,70044,70050,Blue,1,80083,80463,380
2022-10-25,70059,70838,Blue,0,85797,86856,1059
2022-06-13,70044,70060,Blue,1,23848,24793,945
2022-08-01,70042,70046,Blue,1,23504,23692,188
2022-03-09,70057,70838,Blue,0,21051,22139,1088
2022-04-30,70057,70055,Blue,0,67286,67355,69
2022-09-28,70057,70051,Blue,0,62504,62740,236
2022-01-07,70055,70047,Blue,0,63976,64368,392
2022-08-03,70059,70049,Blue,0,62413,62865,452
2022-03-25,70059,70049,Blue,0,51681,52195,514
2022-10-15,70046,70050,Blue,1,24674,24858,184
2022-01-07,70046,70054,Blue,1,29158,29654,496
2022-02-07,70044,70052,Blue,1,27178,27662,484
2022-03-07,70059,70049,Blue,0,53104,53636,532
2022-08-15,70059,70055,Blue,0,23417,23558,141
2022-02-13,70038,70056,Blue,1,65713,66689,976
2022-12-19,70045,70838,Blue,0,88870,89760,890
2022-09-13,70053,70049,Blue,0,40852,41072,220
2022-09-07,70038,70052,Blue,1,85688,86425,737
2022-11-05,70053,70041,Blue,0,69009,69786,777
2022-09-06,70042,70050,Blue,1,87499,87879,380
2022-12-29,70051,70043,Blue,0,75389,75860,471
2022-12-11,70057,70049,Blue,0,69052,69437,385
2022-06-28,70049,70039,Blue,0,67921,68431,510
2022-06-26,70057,70043,Blue,0,81021,81827,806
2022-06-17,70059,70057,Blue,0,39263,39306,43
2022-04-24,70042,70054,Blue,1,73266,73934,668
2022-10-25,70053,70045,Blue,0,60791,61282,491
2022-03-01,70044,70052,Blue,1,73200,73713,513
2022-03-02,70040,70058,Blue,1,78243,79346,1103
2022-07-18,70055,70047,Blue,0,43886,44271,385
2022-04-06,70045,70039,Blue,0,59654,59896,242
2022-09-10,70042,70054,Blue,1,37896,38559,663
2022-02-18,70049,70039,Blue,0,57753,58314,561
2022-10-09,70041,70838,Blue,0,64659,64781,122
2022-12-15,70057,70049,Blue,0,69757,70172,415
2022-09-14,70042,70054,Blue,1,62895,63609,714
2022-09-24,70057,70045,Blue,0,56857,57476,619
2022-01-26,70042,70052,Blue,1,66299,66903,604
2022-09-04,70048,70050,Blue,1,72080,72136,56
2022-03-14,70055,70053,Blue,0,67735,67787,52
2022-07-03,70038,70042,Blue,1,66128,66238,110
2022-10-08,70059,70045,Blue,0,70270,71007,737
2022-07-10,70040,70044,Blue,1,58656,58770,114
2022-10-26,70057,70039,Blue,0,50488,51401,913
2022-06-15,70051,70838,Blue,0,78151,78972,821
2022-06-28,70049,70838,Blue,0,18948,19633,685
2022-03-12,70057,70045,Blue,0,79172,79780,608
2022-01-23,70038,70056,Blue,1,78005,78831,826
2022-08-16,70059,70051,Blue,0,68655,68960,305
2022-12-06,70047,70838,Blue,0,24564,25119,555
2022-02-19,70059,70043,Blue,0,52993,53896,903
2022-03-18,70042,70044,Blue,1,26528,26561,33
2022-07-01,70046,70052,Blue,1,48995,49404,409
2022-06-08,70044,70046,Blue,1,22123,22254,131
2022-10-11,70044,70052,Blue,1,43724,44224,500
2022-03-20,70052,70056,Blue,1,64768,64913,145
2022-12-19,70059,70047,Blue,0,70518,71150,632
2022-06-19,70046,70048,Blue,1,59560,59651,91
2022-12-16,70045,70039,Blue,0,64190,64426,236
2022-05-17,70050,70056,Blue,1,54788,55115,327
2022-09-02,70047,70043,Blue,0,50543,50785,242
2022-11-05,70052,70056,Blue,1,55292,55433,141
2022-10-02,70046,70054,Blue,1,75167,75605,438
2022-02-16,70040,70046,Blue,1,65310,65564,254
2022-01-17,70044,70060,Blue,1,43444,44446,1002
2022-08-03,70046,70054,Blue,1,21920,22378,458
2022-06-24,70044,70048,Blue,1,53884,54165,281
2022-09-14,70059,70055,Blue,0,22155,22302,147
2022-08-29,70046,70048,Blue,1,40228,40307,79
2022-04-15,70042,70058,Blue,1,58825,59749,924
2022-02-24,70057,70045,Blue,0,51294,52453,1159
2022-08-09,70040,70060,Blue,1,29047,30078,1031
2022-02-17,70042,70054,Blue,1,30743,31430,687
2022-09-27,70046,70054,Blue,1,29341,29783,442
2022-11-05,70038,70052,Blue,1,77296,78062,766
2022-12-02,70052,70056,Blue,1,24463,24610,147
2022-07-15,70053,70049,Blue,0,51762,51953,191
2022-09-23,70040,70044,Blue,1,34760,34859,99
2022-08-16,70055,70838,Blue,0,46455,47499,1044
2022-01-03,70048,70060,Blue,1,89628,90255,627
2022-05-11,70054,70058,Blue,1,81982,82140,158
2022-11-10,70049,70047,Blue,0,63270,63327,57
2022-07-07,70055,70051,Blue,0,73510,73645,135
2022-10-13,70049,70838,Blue,0,28593,29280,687
2022-11-22,70055,70041,Blue,0,87493,88219,726
2022-07-11,70042,70046,Blue,1,37423,37625,202
2022-07-05,70052,70060,Blue,1,47058,47415,357
2022-02-10,70053,70041,Blue,0,31745,32402,657
2022-08-05,70040,70046,Blue,1,30831,31076,245
2022-08-08,70051,70041,Blue,0,35514,36105,591
2022-12-30,70041,70039,Blue,0,21954,21997,43
2022-10-19,70046,70048,Blue,1,81551,81619,68
2022-10-25,70042,70058,Blue,1,28439,29329,890
2022-01-25,70041,70039,Blue,0,28115,28152,37
2022-09-15,70044,70060,Blue,1,64729,65770,1041
2022-09-20,70050,70060,Blue,1,68166,68723,557
2022-07-22,70040,70052,Blue,1,42658,43341,683
2022-09-30,70048,70056,Blue,1,29962,30359,397
2022-11-13,70054,70056,Blue,1,49124,49171,47
2022-09-05,70040,70042,Blue,1,40408,40446,38
2022-07-19,70042,70048,Blue,1,37654,38040,386
2022-07-04,70045,70039,Blue,0,66651,66933,282
2022-09-12,70042,70044,Blue,1,47800,47829,29
2022-08-31,70046,70050,Blue,1,78729,78909,180
2022-04-24,70053,70838,Blue,0,51952,52835,883
2022-03-13,70055,70838,Blue,0,40322,41202,880
2022-09-07,70052,70060,Blue,1,89847,90219,372
2022-03-21,70048,70050,Blue,1,27188,27249,61
2022-12-20,70052,70056,Blue,1,33207,33382,175
2022-06-24,70049,70041,Blue,0,62366,62794,428
2022-09-16,70058,70060,Blue,1,40890,40955,65
2022-02-18,70044,70052,Blue,1,54759,55282,523
2022-04-06,70040,70042,Blue,1,57104,57142,38
2022-07-25,70059,70049,Blue,0,63371,63843,472
2022-01-04,70049,70838,Blue,0,50392,50987,595
2022-10-20,70049,70041,Blue,0,40680,41175,495
2022-06-26,70053,70043,Blue,0,32722,33313,591
2022-04-15,70049,70039,Blue,0,66071,66534,463
2022-11-09,70049,70047,Blue,0,60272,60329,57
2022-09-23,70054,70058,Blue,1,42501,42668,167
2022-11-14,70053,70049,Blue,0,39661,39861,200
2022-02-25,70044,70060,Blue,1,23581,24559,978
2022-04-19,70051,70043,Blue,0,66267,66818,551
2022-01-05,70044,70058,Blue,1,33362,34117,755
2022-11-08,70040,70044,Blue,1,22318,22447,129
2022-06-19,70046,70060,Blue,1,67377,68177,800
2022-11-08,70055,70041,Blue,0,73998,74711,713
2022-02-11,70048,70054,Blue,1,33134,33442,308
2022-10-14,70057,70051,Blue,0,57051,57303,252
2022-07-07,70057,70039,Blue,0,34968,36067,1099
2022-12-27,70055,70051,Blue,0,73395,73539,144
2022-09-10,70042,70044,Blue,1,49787,49816,29
2022-08-15,70048,70054,Blue,1,67873,68201,328
2022-06-15,70059,70838,Blue,0,23958,25187,1229
2022-12-11,70057,70041,Blue,0,60409,61383,974
2022-12-21,70042,70058,Blue,1,37544,38551,1007
2022-05-24,70038,70052,Blue,1,40108,41052,944
2022-03-24,70038,70050,Blue,1,46940,47535,595
2022-08-29,70051,70045,Blue,0,46633,46974,341
2022-11-25,70044,70052,Blue,1,67591,68069,478
2022-06-02,70049,70043,Blue,0,44470,44898,428
2022-02-07,70059,70055,Blue,0,60496,60645,149
2022-06-09,70059,70053,Blue,0,42758,43012,254
2022-07-18,70038,70058,Blue,1,43573,44743,1170
2022-03-17,70042,70052,Blue,1,31606,32197,591
2022-01-05,70057,70047,Blue,0,55787,56315,528
2022-07-17,70038,70052,Blue,1,89114,89866,752
2022-12-22,70047,70045,Blue,0,27420,27517,97
2022-04-19,70048,70060,Blue,1,79274,79941,667
2022-02-22,70038,70050,Blue,1,59251,59867,616
2022-09-30,70053,70039,Blue,0,40436,41281,845
2022-12-30,70059,70057,Blue,0,34942,34977,35
2022-06-09,70041,70838,Blue,0,31309,31518,209
2022-09-12,70042,70058,Blue,1,57315,58200,885
2022-11-16,70042,70054,Blue,1,33340,34013,673
2022-08-13,70042,70058,Blue,1,66536,67533,997
2022-12-14,70055,70041,Blue,0,55812,56573,761
2022-08-26,70057,70039,Blue,0,25179,26237,1058
2022-11-08,70040,70044,Blue,1,74260,74369,109
2022-06-18,70047,70039,Blue,0,46033,46447,414
2022-11-12,70051,70047,Blue,0,35062,35265,203
2022-03-10,70038,70048,Blue,1,26955,27519,564
2022-12-02,70047,70039,Blue,0,79260,79642,382
2022-09-22,70049,70047,Blue,0,29040,29138,98
2022-12-27,70040,70042,Blue,1,42483,42512,29
2022-06-02,70045,70039,Blue,0,70569,70834,265
2022-01-04,70042,70054,Blue,1,65091,65745,654
2022-08-03,70038,70060,Blue,1,23543,24648,1105
2022-02-02,70042,70060,Blue,1,28027,29048,1021
2022-06-27,70051,70838,Blue,0,37952,38793,841
2022-03-31,70049,70838,Blue,0,40497,41230,733
2022-11-13,70043,70041,Blue,0,75807,75839,32
2022-09-29,70042,70048,Blue,1,45762,46087,325
2022-03-31,70040,70056,Blue,1,50842,51729,887
2022-06-15,70040,70044,Blue,1,40796,40918,122
2022-12-01,70053,70049,Blue,0,74085,74272,187
2022-06-15,70046,70048,Blue,1,55207,55314,107
2022-02-17,70059,70055,Blue,0,51657,51800,143
2022-03-29,70040,70058,Blue,1,83956,84942,986
2022-06-29,70055,70041,Blue,0,49053,49792,739
2022-11-04,70038,70040,Blue,1,21926,21944,18
2022-05-23,70038,70052,Blue,1,83420,84373,953
2022-04-26,70052,70060,Blue,1,39230,39597,367
2022-01-12,70048,70052,Blue,1,60910,61114,204
2022-02-07,70059,70043,Blue,0,45497,46459,962
2022-02-17,70046,70052,Blue,1,26470,26804,334
2022-09-03,70057,70045,Blue,0,87496,88102,606
2022-02-06,70057,70051,Blue,0,31086,31333,247
2022-01-03,70048,70056,Blue,1,74051,74432,381
2022-06-18,70047,70838,Blue,0,75174,75651,477
2022-10-04,70057,70049,Blue,0,59863,60271,408
2022-11-23,70055,70838,Blue,0,56833,57748,915
2022-07-21,70045,70039,Blue,0,49144,49414,270
2022-09-15,70042,70058,Blue,1,48422,49327,905
2022-06-04,70038,70050,Blue,1,84847,85554,707
2022-01-25,70055,70049,Blue,0,65774,66100,326
2022-07-11,70057,70055,Blue,0,74444,74518,74
2022-05-12,70050,70054,Blue,1,49518,49709,191
2022-12-19,70044,70046,Blue,1,34383,34519,136
2022-05-28,70049,70041,Blue,0,62844,63346,502
2022-01-26,70040,70046,Blue,1,74791,75057,266
2022-09-21,70052,70054,Blue,1,66711,66757,46
2022-12-16,70054,70060,Blue,1,52603,52866,263
2022-09-15,70045,70039,Blue,0,58976,59228,252
2022-12-31,70045,70039,Blue,0,49493,49754,261
2022-10-07,70038,70054,Blue,1,51984,52813,829
2022-04-21,70038,70040,Blue,1,51953,51967,14
2022-02-04,70040,70046,Blue,1,53772,54015,243
2022-06-13,70047,70041,Blue,0,68490,68844,354
2022-07-09,70058,70060,Blue,1,34889,34967,78
2022-09-05,70040,70052,Blue,1,36328,36994,666
2022-12-15,70054,70058,Blue,1,57385,57545,160
2022-06-07,70049,70045,Blue,0,27058,27276,218
2022-02-16,70055,70041,Blue,0,80772,81471,699
2022-09-08,70040,70050,Blue,1,48784,49255,471
2022-01-17,70049,70041,Blue,0,37474,37913,439
2022-07-18,70054,70056,Blue,1,68667,68714,47
2022-07-05,70057,70047,Blue,0,27701,28178,477
2022-01-15,70055,70053,Blue,0,83448,83530,82
2022-02-18,70045,70041,Blue,0,58216,58419,203
2022-09-02,70051,70039,Blue,0,48201,48848,647
2022-06-28,70052,70060,Blue,1,50137,50535,398
2022-09-03,70039,70838,Blue,0,60660,60694,34
2022-03-29,70047,70039,Blue,0,55672,56041,369
2022-03-11,70059,70055,Blue,0,20953,21104,151
2022-01-28,70046,70054,Blue,1,23719,24184,465
2022-11-25,70038,70040,Blue,1,81339,81355,16
2022-01-20,70059,70043,Blue,0,61396,62269,873
2022-03-03,70038,70040,Blue,1,68594,68612,18
2022-08-06,70051,70043,Blue,0,38767,39284,517
2022-08-05,70053,70039,Blue,0,48743,49518,775
2022-08-09,70056,70060,Blue,1,67011,67184,173
2022-11-16,70045,70838,Blue,0,52187,52525,338
2022-08-18,70040,70048,Blue,1,48737,49155,418
2022-05-31,70040,70050,Blue,1,58011,58583,572
2022-01-16,70044,70050,Blue,1,56632,57019,387
2022-07-11,70057,70045,Blue,0,40370,41257,887
2022-11-30,70038,70046,Blue,1,74280,74587,307
2022-03-01,70054,70058,Blue,1,62712,63004,292
2022-01-29,70042,70052,Blue,1,25185,26078,893
2022-02-24,70051,70045,Blue,0,52042,52950,908
2022-01-25,70050,70060,Blue,1,74070,74566,496
2022-03-10,70044,70058,Blue,1,54766,55732,966
2022-12-11,70051,70838,Blue,0,63083,63820,737
2022-09-08,70049,70043,Blue,0,28166,28540,374
2022-10-24,70057,70838,Blue,0,26020,27137,1117
2022-12-19,70038,70042,Blue,1,68139,68227,88
2022-07-23,70041,70838,Blue,0,34555,34676,121
2022-11-17,70055,70049,Blue,0,30805,31114,309
2022-07-18,70040,70056,Blue,1,42613,43508,895
2022-03-26,70054,70058,Blue,1,51247,51408,161
2022-03-19,70046,70056,Blue,1,70557,71096,539
2022-03-23,70042,70048,Blue,1,24169,24552,383
2022-03-11,70059,70045,Blue,0,35835,36597,762
2022-07-04,70040,70054,Blue,1,83487,84305,818
2022-04-08,70050,70058,Blue,1,61963,62374,411
2022-04-20,70053,70041,Blue,0,27248,27961,713
2022-06-21,70058,70060,Blue,1,52274,52395,121
2022-08-19,70051,70043,Blue,0,41864,42411,547
2022-06-26,70049,70039,Blue,0,55657,56260,603
2022-04-19,70048,70058,Blue,1,26531,27005,474
2022-04-17,70057,70047,Blue,0,66871,67361,490
2022-11-04,70038,70044,Blue,1,74827,74979,152
2022-02-19,70041,70039,Blue,0,80889,80920,31
2022-12-03,70049,70047,Blue,0,20077,20139,62
2022-09-09,70040,70050,Blue,1,58174,58680,506
2022-10-07,70049,70043,Blue,0,22129,22504,375
2022-07-28,70042,70048,Blue,1,51042,51436,394
2022-11-21,70051,70041,Blue,0,57018,57589,571
2022-03-21,70050,70060,Blue,1,66428,67184,756
2022-10-30,70057,70045,Blue,0,64168,64777,609
2022-10-28,70044,70060,Blue,1,83577,84464,887
2022-08-14,70058,70060,Blue,1,79651,79714,63
2022-02-20,70043,70041,Blue,0,38448,38479,31
2022-03-18,70045,70838,Blue,0,65107,65488,381
2022-02-18,70039,70838,Blue,0,68945,68975,30
2022-03-27,70052,70056,Blue,1,80556,80699,143
2022-08-29,70059,70838,Blue,0,37992,39179,1187
2022-07-06,70038,70044,Blue,1,26125,26332,207
2022-07-05,70048,70052,Blue,1,63257,63462,205
2022-09-11,70046,70060,Blue,1,44184,44987,803
2022-04-02,70047,70039,Blue,0,61137,61547,410
2022-06-10,70040,70048,Blue,1,73561,74018,457
2022-10-02,70055,70838,Blue,0,68040,68951,911
2022-09-30,70038,70040,Blue,1,76817,76833,16
2022-03-01,70047,70039,Blue,0,47197,47609,412
2022-12-05,70051,70039,Blue,0,46080,46685,605
2022-03-15,70049,70838,Blue,0,59327,60020,693
2022-12-23,70045,70043,Blue,0,59762,59848,86
2022-06-09,70038,70050,Blue,1,72982,73646,664
2022-12-06,70054,70056,Blue,1,27879,27926,47
2022-11-08,70050,70056,Blue,1,85516,85801,285
2022-08-09,70044,70058,Blue,1,45357,46148,791
2022-09-18,70042,70044,Blue,1,40477,40510,33
2022-07-12,70045,70043,Blue,0,38340,38430,90
2022-08-05,70049,70043,Blue,0,66554,66901,347
2022-09-09,70047,70838,Blue,0,52567,53069,502
2022-01-05,70047,70043,Blue,0,30595,30851,256
2022-10-20,70038,70052,Blue,1,61694,62611,917
2022-01-19,70053,70041,Blue,0,52790,53486,696
2022-05-09,70055,70053,Blue,0,81187,81232,45
2022-03-10,70050,70052,Blue,1,61067,61191,124
2022-06-19,70043,70041,Blue,0,50438,50466,28
2022-02-04,70046,70052,Blue,1,86621,86989,368
2022-02-14,70047,70043,Blue,0,29055,29286,231
2022-08-12,70044,70058,Blue,1,73569,74380,811
2022-10-12,70053,70049,Blue,0,31692,31928,236
2022-07-22,70049,70045,Blue,0,30271,30479,208
2022-06-16,70040,70044,Blue,1,55079,55198,119
2022-10-25,70048,70058,Blue,1,58569,59078,509
2022-05-20,70041,70039,Blue,0,83439,83470,31
2022-02-20,70038,70042,Blue,1,33906,34034,128
2022-10-27,70051,70838,Blue,0,62092,62848,756
2022-02-10,70042,70046,Blue,1,52322,52494,172
2022-02-08,70040,70060,Blue,1,29758,31336,1578
2022-09-22,70059,70041,Blue,0,59774,60764,990
2022-02-18,70040,70054,Blue,1,53139,54091,952
2022-02-19,70042,70060,Blue,1,29827,30799,972
2022-12-19,70055,70039,Blue,0,58045,59224,1179
2022-08-03,70057,70055,Blue,0,79584,79655,71
2022-05-18,70059,70043,Blue,0,55735,56768,1033
2022-01-14,70047,70039,Blue,0,24615,25062,447
2022-07-04,70046,70056,Blue,1,59646,60252,606
2022-07-15,70042,70046,Blue,1,56784,56991,207
2022-05-28,70038,70044,Blue,1,54254,54447,193
2022-01-31,70047,70838,Blue,0,56316,56861,545
2022-12-29,70038,70044,Blue,1,75792,75950,158
2022-08-29,70040,70044,Blue,1,52935,53042,107
2022-06-18,70053,70045,Blue,0,39822,40294,472
2022-11-30,70040,70052,Blue,1,26549,27184,635
2022-12-21,70053,70041,Blue,0,29521,30231,710
2022-02-21,70038,70044,Blue,1,68631,68834,203
2022-03-30,70052,70060,Blue,1,34408,34823,415
2022-06-05,70047,70041,Blue,0,46816,47208,392
2022-03-04,70046,70048,Blue,1,59286,59378,92
2022-10-25,70057,70043,Blue,0,28562,29468,906
2022-08-08,70039,70838,Blue,0,76477,76508,31
2022-04-18,70040,70044,Blue,1,83326,83449,123
2022-02-07,70045,70043,Blue,0,51680,51815,135
2022-10-29,70039,70838,Blue,0,74638,74673,35
2022-12-14,70038,70042,Blue,1,43527,43621,94
2022-02-23,70055,70041,Blue,0,85932,86630,698
2022-03-11,70049,70039,Blue,0,24197,24772,575
2022-04-23,70059,70838,Blue,0,72426,73469,1043
2022-12-03,70055,70039,Blue,0,85889,86747,858
2022-06-13,70040,70042,Blue,1,87198,87239,41
2022-09-18,70053,70041,Blue,0,31937,32636,699
2022-01-10,70052,70060,Blue,1,62210,62586,376
2022-04-11,70038,70056,Blue,1,58630,59581,951
2022-10-25,70044,70060,Blue,1,82908,83856,948
2022-10-27,70051,70039,Blue,0,76794,77409,615
2022-09-26,70059,70055,Blue,0,59293,59436,143
2022-01-07,70044,70050,Blue,1,32274,32611,337
2022-08-08,70042,70050,Blue,1,45232,45658,426
2022-04-24,70053,70051,Blue,0,75164,75219,55
2022-10-12,70053,70041,Blue,0,23926,24926,1000
2022-09-23,70042,70044,Blue,1,39885,39926,41
2022-03-28,70043,70041,Blue,0,20174,20205,31
2022-02-16,70038,70056,Blue,1,61644,62518,874
2022-11-28,70057,70051,Blue,0,20396,20691,295
2022-03-17,70051,70039,Blue,0,59085,59809,724
2022-01-30,70046,70050,Blue,1,74845,75139,294
2022-05-19,70055,70039,Blue,0,77360,78351,991
2022-07-05,70050,70060,Blue,1,31646,32168,522
2022-06-14,70057,70039,Blue,0,52171,53115,944
2022-10-03,70054,70058,Blue,1,48612,48769,157
2022-01-07,70040,70042,Blue,1,54074,54109,35
2022-05-11,70054,70058,Blue,1,65612,65785,173
2022-04-04,70057,70838,Blue,0,26141,27242,1101
2022-10-19,70051,70045,Blue,0,50316,50652,336
2022-10-26,70042,70046,Blue,1,47980,48171,191
2022-07-29,70046,70050,Blue,1,88060,88264,204
2022-01-14,70043,70041,Blue,0,66218,66245,27
2022-10-22,70046,70048,Blue,1,72728,72797,69
2022-07-12,70057,70041,Blue,0,75450,76313,863
2022-08-10,70051,70041,Blue,0,66933,67511,578
2022-02-09,70040,70042,Blue,1,27620,27661,41
2022-03-15,70040,70052,Blue,1,76394,77060,666
2022-09-27,70044,70058,Blue,1,72305,73099,794
2022-07-29,70059,70045,Blue,0,31409,32142,733
2022-06-28,70055,70047,Blue,0,27793,28172,379
2022-02-02,70055,70045,Blue,0,38853,39408,555
2022-06-16,70057,70047,Blue,0,85237,85736,499
2022-11-26,70055,70041,Blue,0,32103,32802,699
2022-09-05,70051,70043,Blue,0,52638,53146,508
2022-12-24,70059,70057,Blue,0,65416,65452,36
2022-12-28,70057,70049,Blue,0,52592,52973,381
2022-02-19,70047,70043,Blue,0,61710,61968,258
2022-03-03,70038,70042,Blue,1,80364,80478,114
2022-02-08,70059,70055,Blue,0,48195,48341,146
2022-12-17,70055,70053,Blue,0,57578,57623,45
2022-03-30,70048,70050,Blue,1,52699,52762,63
2022-09-07,70040,70046,Blue,1,84205,84474,269
2022-10-06,70052,70060,Blue,1,89899,90285,386
2022-11-15,70047,70041,Blue,0,32729,33041,312
2022-06-25,70050,70056,Blue,1,62177,62478,301
2022-12-14,70059,70049,Blue,0,34835,35422,587
2022-07-15,70038,70040,Blue,1,21896,21915,19
2022-08-20,70042,70052,Blue,1,35248,35895,647
2022-11-20,70059,70041,Blue,0,39384,40400,1016
2022-09-01,70043,70041,Blue,0,55508,55535,27
2022-01-05,70059,70838,Blue,0,80062,81262,1200
2022-12-03,70038,70040,Blue,1,85515,85531,16
2022-08-31,70048,70054,Blue,1,27799,28144,345
2022-07-05,70057,70047,Blue,0,40651,41180,529
2022-01-14,70048,70056,Blue,1,33401,33777,376
2022-09-16,70044,70060,Blue,1,29727,30666,939
2022-01-05,70058,70060,Blue,1,80878,80947,69
2022-08-17,70057,70055,Blue,0,70766,70833,67
2022-01-06,70040,70050,Blue,1,33304,33782,478
2022-06-11,70045,70838,Blue,0,85100,85511,411
2022-09-10,70053,70838,Blue,0,74856,75700,844
2022-08-01,70040,70048,Blue,1,67710,68143,433
2022-10-15,70049,70039,Blue,0,64861,65360,499
2022-07-08,70044,70054,Blue,1,73004,73647,643
2022-09-26,70053,70043,Blue,0,24115,24809,694
2022-08-15,70057,70055,Blue,0,44792,44860,68
2022-10-20,70038,70060,Blue,1,81249,82404,1155
2022-07-08,70051,70045,Blue,0,39699,40056,357
2022-10-02,70040,70042,Blue,1,48433,48465,32
2022-07-04,70051,70041,Blue,0,21846,22404,558
2022-01-25,70040,70048,Blue,1,52891,53366,475
2022-02-24,70044,70056,Blue,1,54511,55177,666
2022-06-27,70053,70047,Blue,0,42617,42962,345
2022-05-20,70059,70057,Blue,0,53602,53637,35
2022-11-29,70049,70039,Blue,0,30988,31579,591
2022-06-07,70047,70838,Blue,0,54982,55542,560
2022-07-23,70038,70048,Blue,1,48017,48550,533
2022-12-13,70049,70039,Blue,0,61159,61630,471
2022-09-22,70038,70056,Blue,1,26611,27540,929
2022-09-14,70038,70054,Blue,1,82629,83467,838
2022-04-19,70039,70838,Blue,0,64271,64306,35
2022-12-22,70045,70043,Blue,0,64917,65008,91
2022-01-24,70055,70041,Blue,0,30452,31320,868
2022-04-08,70039,70838,Blue,0,32927,32959,32
2022-03-02,70042,70054,Blue,1,70155,70906,751
2022-04-17,70057,70051,Blue,0,31714,31948,234
2022-08-19,70042,70046,Blue,1,59487,59676,189
2022-10-14,70052,70058,Blue,1,61039,61309,270
2022-07-02,70055,70053,Blue,0,76641,76689,48
2022-07-29,70044,70050,Blue,1,63517,63880,363
2022-10-18,70051,70047,Blue,0,55468,55660,192
2022-03-05,70044,70058,Blue,1,57458,58220,762
2022-11-24,70048,70050,Blue,1,62295,62353,58
2022-08-07,70040,70060,Blue,1,66301,67396,1095
2022-03-18,70048,70058,Blue,1,58010,58517,507
2022-09-13,70053,70051,Blue,0,19832,19890,58
2022-01-17,70050,70056,Blue,1,56782,57066,284
2022-06-17,70040,70046,Blue,1,69935,70202,267
2022-07-14,70045,70041,Blue,0,35798,35993,195
2022-03-29,70054,70060,Blue,1,26517,26862,345
2022-10-07,70051,70045,Blue,0,29699,30054,355
2022-06-13,70051,70041,Blue,0,51917,52511,594
2022-02-07,70038,70044,Blue,1,60732,60920,188
2022-03-19,70042,70060,Blue,1,26564,27550,986
2022-01-06,70058,70060,Blue,1,64517,64805,288
2022-08-13,70048,70052,Blue,1,86102,86315,213
2022-08-23,70044,70054,Blue,1,61998,62666,668
2022-04-22,70059,70039,Blue,0,57794,58766,972
2022-12-28,70046,70052,Blue,1,54646,54988,342
2022-11-13,70057,70043,Blue,0,51771,52519,748
2022-05-27,70044,70050,Blue,1,67263,67658,395
2022-11-15,70051,70045,Blue,0,58344,58696,352
2022-06-04,70038,70042,Blue,1,72278,72380,102
2022-12-28,70040,70056,Blue,1,21244,22034,790
2022-11-06,70054,70060,Blue,1,89071,89326,255
2022-05-27,70040,70048,Blue,1,43943,44670,727
2022-02-14,70038,70060,Blue,1,40835,41870,1035
2022-04-07,70059,70051,Blue,0,19880,20228,348
2022-04-15,70042,70046,Blue,1,76611,76790,179
2022-12-30,70055,70039,Blue,0,81392,82304,912
2022-06-26,70042,70044,Blue,1,52803,52834,31
2022-10-24,70048,70054,Blue,1,29538,29848,310
2022-04-14,70057,70053,Blue,0,30054,30217,163
2022-02-21,70053,70041,Blue,0,27365,28048,683
2022-10-09,70057,70055,Blue,0,56102,56172,70
2022-07-09,70042,70052,Blue,1,46007,46626,619
2022-10-31,70053,70838,Blue,0,84652,85454,802
2022-10-24,70046,70048,Blue,1,71413,71485,72
2022-08-06,70050,70056,Blue,1,72898,73208,310
2022-03-31,70057,70039,Blue,0,78387,79369,982
2022-02-18,70057,70051,Blue,0,53965,54199,234
2022-02-19,70057,70047,Blue,0,39183,39667,484
2022-01-11,70058,70060,Blue,1,63967,64098,131
2022-02-16,70059,70039,Blue,0,29962,31103,1141
2022-10-01,70049,70047,Blue,0,35684,35739,55
2022-04-20,70046,70054,Blue,1,46377,46880,503
2022-06-15,70044,70060,Blue,1,31771,32830,1059
2022-12-02,70049,70041,Blue,0,87812,88235,423
2022-06-18,70051,70047,Blue,0,45305,45496,191
2022-04-22,70051,70049,Blue,0,57834,57935,101
2022-12-22,70046,70056,Blue,1,53602,54106,504
2022-07-01,70045,70838,Blue,0,48250,48613,363
2022-03-19,70043,70039,Blue,0,39900,40018,118
2022-07-08,70059,70045,Blue,0,63587,64278,691
2022-09-30,70040,70048,Blue,1,70101,70537,436
2022-09-13,70053,70047,Blue,0,57494,57789,295
2022-07-14,70057,70045,Blue,0,24503,25213,710
2022-11-08,70052,70060,Blue,1,37492,37889,397
2022-03-17,70057,70043,Blue,0,74967,75744,777
2022-12-02,70038,70058,Blue,1,52872,53839,967
2022-12-06,70044,70058,Blue,1,86010,86803,793
2022-02-02,70059,70838,Blue,0,87485,88540,1055
2022-11-26,70053,70047,Blue,0,78688,78964,276
2022-09-06,70053,70043,Blue,0,36644,37238,594
2022-03-21,70051,70041,Blue,0,55690,56290,600
2022-07-03,70041,70039,Blue,0,23292,23325,33
2022-09-09,70048,70056,Blue,1,46632,47046,414
2022-07-23,70048,70060,Blue,1,67967,68749,782
2022-08-04,70046,70056,Blue,1,82638,83172,534
2022-10-05,70057,70049,Blue,0,28178,28627,449
2022-10-25,70059,70051,Blue,0,19942,20318,376
2022-01-25,70040,70058,Blue,1,54139,55031,892
2022-12-09,70046,70052,Blue,1,54324,55089,765
2022-06-12,70055,70043,Blue,0,55123,55899,776
2022-10-20,70040,70060,Blue,1,45618,46625,1007
2022-02-12,70059,70041,Blue,0,33013,33981,968
2022-10-26,70040,70046,Blue,1,75343,75659,316
2022-09-12,70059,70047,Blue,0,67095,67648,553
2022-03-09,70049,70047,Blue,0,54726,54785,59
2022-12-19,70055,70039,Blue,0,55573,56493,920
2022-03-08,70058,70060,Blue,1,21800,21894,94
2022-11-12,70059,70043,Blue,0,28163,29037,874
2022-06-20,70046,70058,Blue,1,31062,31719,657
2022-06-17,70049,70045,Blue,0,55918,56125,207
2022-12-21,70054,70060,Blue,1,23889,24197,308
2022-09-29,70058,70060,Blue,1,67431,67506,75
2022-12-01,70049,70838,Blue,0,70146,70693,547
2022-07-04,70038,70046,Blue,1,42084,42439,355
2022-06-21,70057,70041,Blue,0,33185,34208,1023
2022-11-11,70045,70041,Blue,0,47623,47792,169
2022-11-27,70038,70056,Blue,1,67210,68099,889
2022-04-14,70053,70041,Blue,0,19783,20666,883
2022-11-05,70057,70053,Blue,0,26622,26776,154
2022-06-11,70053,70039,Blue,0,80266,81020,754
2022-10-11,70052,70054,Blue,1,35263,35342,79
2022-06-30,70043,70041,Blue,0,48667,48695,28
2022-08-23,70046,70056,Blue,1,53341,53918,577
2022-09-24,70042,70060,Blue,1,27646,28590,944
2022-09-17,70051,70049,Blue,0,65294,65396,102
2022-10-25,70042,70054,Blue,1,30224,30917,693
2022-10-02,70051,70043,Blue,0,69312,69830,518
2022-04-13,70050,70060,Blue,1,35978,36604,626
2022-07-04,70049,70838,Blue,0,79514,80250,736
2022-10-21,70052,70056,Blue,1,65514,65675,161
2022-11-27,70055,70838,Blue,0,70236,71141,905
2022-02-26,70040,70044,Blue,1,71841,71949,108
2022-12-16,70054,70060,Blue,1,42261,42544,283
2022-03-09,70049,70043,Blue,0,20772,21126,354
2022-11-25,70050,70054,Blue,1,59286,59507,221
2022-12-02,70038,70060,Blue,1,39855,41108,1253
2022-07-28,70043,70041,Blue,0,28835,28870,35
2022-04-16,70045,70043,Blue,0,75325,75414,89
2022-03-16,70059,70053,Blue,0,61396,61617,221
2022-12-14,70038,70054,Blue,1,84951,85778,827
2022-11-12,70047,70041,Blue,0,59657,60017,360
2022-08-09,70050,70054,Blue,1,70233,70478,245
2022-03-24,70055,70049,Blue,0,84799,85081,282
2022-06-13,70057,70055,Blue,0,50809,50879,70
2022-01-06,70055,70053,Blue,0,69292,69355,63
2022-12-24,70053,70041,Blue,0,65160,65824,664
2022-10-25,70056,70060,Blue,1,24619,24940,321
2022-03-10,70057,70051,Blue,0,54268,54508,240
2022-01-11,70059,70055,Blue,0,61394,61543,149
2022-07-14,70044,70054,Blue,1,68172,69058,886
2022-05-18,70047,70043,Blue,0,54297,54691,394
2022-01-03,70038,70042,Blue,1,33547,33635,88
2022-05-06,70053,70051,Blue,0,37196,37261,65
2022-10-21,70053,70043,Blue,0,78267,78835,568
2022-02-05,70057,70053,Blue,0,75866,76034,168
2022-06-12,70045,70043,Blue,0,65462,65574,112
2022-12-21,70055,70051,Blue,0,87836,87995,159
2022-11-22,70048,70050,Blue,1,23643,23705,62
2022-03-01,70055,70051,Blue,0,72246,72413,167
2022-07-28,70053,70041,Blue,0,50532,51278,746
2022-02-15,70044,70052,Blue,1,25670,26204,534
2022-03-06,70040,70048,Blue,1,85583,86003,420
2022-11-25,70057,70053,Blue,0,39569,39741,172
2022-06-19,70038,70042,Blue,1,39677,39784,107
2022-02-03,70045,70838,Blue,0,30531,30928,397
2022-09-20,70059,70039,Blue,0,32225,33361,1136
2022-12-28,70045,70043,Blue,0,81323,81412,89
2022-10-01,70038,70042,Blue,1,54000,54099,99
2022-03-30,70040,70058,Blue,1,83832,84844,1012
2022-12-12,70053,70043,Blue,0,57472,58060,588
2022-06-21,70040,70052,Blue,1,51461,52180,719
2022-11-19,70055,70039,Blue,0,72064,72828,764
2022-04-10,70038,70046,Blue,1,41006,41338,332
2022-11-27,70040,70058,Blue,1,60265,61288,1023
2022-01-22,70059,70041,Blue,0,77271,78257,986
2022-02-17,70044,70060,Blue,1,28628,29649,1021
2022-09-10,70057,70041,Blue,0,81575,82445,870
2022-09-28,70042,70054,Blue,1,20049,20740,691
2022-07-09,70044,70054,Blue,1,36930,37580,650
2022-12-05,70046,70056,Blue,1,20360,20929,569
2022-07-16,70049,70047,Blue,0,55650,55706,56
2022-11-06,70052,70060,Blue,1,26152,26518,366
2022-04-06,70059,70055,Blue,0,38658,38804,146
2022-04-02,70040,70046,Blue,1,61572,61872,300
2022-10-14,70059,70838,Blue,0,35898,37015,1117
2022-06-19,70046,70048,Blue,1,38074,38176,102
2022-12-17,70040,70044,Blue,1,54046,54155,109
2022-03-28,70051,70043,Blue,0,30139,30759,620
2022-01-11,70048,70050,Blue,1,80361,80425,64
2022-08-20,70041,70838,Blue,0,25754,25890,136
2022-07-17,70055,70051,Blue,0,69140,69391,251
2022-03-11,70042,70044,Blue,1,33516,33545,29
2022-07-02,70045,70043,Blue,0,23524,23614,90
2022-01-23,70054,70060,Blue,1,52423,52673,250
2022-02-28,70042,70060,Blue,1,73670,74655,985
2022-06-27,70046,70056,Blue,1,75318,75891,573
2022-02-21,70038,70054,Blue,1,87312,88149,837
2022-03-12,70057,70055,Blue,0,67818,67887,69
2022-03-18,70059,70045,Blue,0,48668,49344,676
2022-09-08,70038,70048,Blue,1,31557,32050,493
2022-09-18,70048,70054,Blue,1,69424,69707,283
2022-04-13,70052,70054,Blue,1,89222,89266,44
2022-07-24,70055,70041,Blue,0,58107,58884,777
2022-03-07,70044,70060,Blue,1,46577,47427,850
2022-10-21,70044,70056,Blue,1,84634,85361,727
2022-05-18,70040,70044,Blue,1,33610,33716,106
2022-08-23,70054,70058,Blue,1,32950,33116,166
2022-03-02,70049,70043,Blue,0,20782,21169,387
2022-01-15,70049,70041,Blue,0,87980,88435,455
2022-09-11,70056,70058,Blue,1,46554,46624,70
2022-03-31,70055,70039,Blue,0,67704,68534,830
2022-02-09,70051,70838,Blue,0,28898,29700,802
2022-01-04,70042,70054,Blue,1,28005,28694,689
2022-03-06,70043,70039,Blue,0,73611,73719,108
2022-10-03,70057,70051,Blue,0,66544,66772,228
2022-11-22,70051,70045,Blue,0,59691,60035,344
2022-12-23,70055,70053,Blue,0,58652,58699,47
2022-10-23,70038,70040,Blue,1,29231,29251,20
2022-09-29,70047,70041,Blue,0,63655,64001,346
2022-02-23,70040,70050,Blue,1,43022,43509,487
2022-04-22,70057,70053,Blue,0,59667,59815,148
2022-08-13,70046,70048,Blue,1,66771,66855,84
2022-06-18,70051,70043,Blue,0,46379,46897,518
2022-09-22,70042,70044,Blue,1,58753,58788,35
2022-10-13,70044,70046,Blue,1,61596,61701,105
2022-10-02,70053,70043,Blue,0,64887,65482,595
2022-04-18,70040,70048,Blue,1,74743,75381,638
2022-03-03,70049,70039,Blue,0,84545,85083,538
2022-06-22,70038,70044,Blue,1,62707,62941,234
2022-12-29,70055,70047,Blue,0,28108,28474,366
2022-11-05,70048,70056,Blue,1,69514,69901,387
2022-11-04,70045,70041,Blue,0,39617,39792,175
2022-09-26,70047,70838,Blue,0,77646,78128,482
2022-09-20,70051,70039,Blue,0,49741,50375,634
2022-12-24,70040,70060,Blue,1,57252,58305,1053
2022-06-22,70052,70058,Blue,1,50672,50917,245
2022-12-28,70044,70046,Blue,1,63654,63764,110
2022-01-04,70046,70052,Blue,1,67673,67999,326
2022-01-20,70051,70043,Blue,0,30392,30977,585
2022-03-22,70040,70048,Blue,1,58413,58877,464
2022-12-07,70055,70049,Blue,0,37512,37788,276
2022-10-29,70051,70838,Blue,0,67438,68234,796
2022-04-16,70059,70055,Blue,0,68114,68252,138
2022-11-14,70051,70045,Blue,0,57823,58141,318
2022-05-02,70057,70047,Blue,0,64084,64901,817
2022-11-08,70050,70054,Blue,1,37309,37551,242
2022-09-07,70051,70049,Blue,0,35720,35822,102
2022-11-09,70057,70045,Blue,0,32600,33243,643
2022-04-07,70045,70838,Blue,0,26550,26884,334
2022-07-23,70041,70039,Blue,0,68772,68808,36
2022-05-20,70050,70060,Blue,1,48997,49564,567
2022-01-17,70053,70051,Blue,0,52210,52272,62
2022-02-03,70058,70060,Blue,1,63511,63767,256
2022-12-30,70050,70056,Blue,1,75895,76205,310
2022-12-11,70055,70838,Blue,0,46466,47371,905
2022-04-24,70042,70054,Blue,1,83200,83887,687
2022-04-12,70059,70838,Blue,0,35926,37253,1327
2022-06-11,70056,70060,Blue,1,70602,70791,189
2022-12-29,70049,70045,Blue,0,74617,74811,194
2022-02-10,70040,70042,Blue,1,43571,43605,34
2022-07-10,70049,70838,Blue,0,40663,41288,625
2022-06-19,70050,70058,Blue,1,29887,30309,422
2022-05-21,70038,70050,Blue,1,52914,53593,679
2022-10-02,70040,70052,Blue,1,31618,32205,587
2022-12-25,70042,70060,Blue,1,72260,73251,991
2022-11-29,70054,70056,Blue,1,56050,56096,46
2022-09-11,70056,70060,Blue,1,50819,50990,171
2022-11-21,70051,70039,Blue,0,48760,49428,668
2022-09-14,70052,70056,Blue,1,54147,54308,161
2022-08-24,70051,70045,Blue,0,29289,29677,388
2022-10-27,70057,70055,Blue,0,56734,56806,72
2022-10-01,70044,70052,Blue,1,82420,82974,554
2022-02-28,70051,70049,Blue,0,35265,35368,103
2022-09-19,70052,70060,Blue,1,39737,40130,393
2022-08-13,70040,70056,Blue,1,61585,62424,839
2022-09-26,70046,70056,Blue,1,37720,38267,547
2022-04-04,70050,70054,Blue,1,83253,83462,209
2022-01-10,70048,70052,Blue,1,64325,64527,202
2022-03-28,70053,70045,Blue,0,22690,23175,485
2022-01-03,70059,70055,Blue,0,60016,60170,154
2022-05-29,70039,70838,Blue,0,35759,35806,47
2022-03-10,70059,70053,Blue,0,52104,52339,235
2022-11-14,70043,70039,Blue,0,48200,48313,113
2022-05-20,70042,70056,Blue,1,36927,37787,860
2022-04-07,70043,70838,Blue,0,20853,21084,231
2022-02-05,70048,70056,Blue,1,76003,76375,372
2022-03-25,70052,70060,Blue,1,31909,32271,362
2022-07-12,70047,70838,Blue,0,44846,45324,478
2022-04-14,70044,70058,Blue,1,61345,62146,801
2022-10-15,70038,70044,Blue,1,64209,64381,172
2022-06-10,70041,70039,Blue,0,54667,54699,32
2022-12-06,70038,70054,Blue,1,34874,35665,791
2022-02-01,70055,70041,Blue,0,87058,87792,734
2022-10-29,70046,70052,Blue,1,30597,30936,339
2022-03-02,70046,70050,Blue,1,58784,59010,226
2022-09-09,70059,70049,Blue,0,83092,83544,452
2022-04-10,70040,70060,Blue,1,73214,74293,1079
2022-08-28,70057,70053,Blue,0,26262,26411,149
2022-12-09,70050,70054,Blue,1,87166,87409,243
2022-10-07,70053,70838,Blue,0,41409,42301,892
2022-12-24,70047,70838,Blue,0,51987,52466,479
2022-11-25,70044,70054,Blue,1,62614,63249,635
2022-11-09,70040,70060,Blue,1,30311,31301,990
2022-07-03,70051,70047,Blue,0,69324,69521,197
2022-07-14,70051,70043,Blue,0,76855,77338,483
2022-07-04,70055,70047,Blue,0,83960,84326,366
2022-04-23,70051,70049,Blue,0,68502,68605,103
2022-11-21,70059,70055,Blue,0,36122,36261,139
2022-03-28,70040,70058,Blue,1,58087,58995,908
2022-09-22,70049,70838,Blue,0,58550,59158,608
2022-01-21,70045,70041,Blue,0,23577,23818,241
2022-05-27,70041,70039,Blue,0,53520,53554,34
2022-01-23,70038,70058,Blue,1,37776,38834,1058
2022-06-10,70055,70049,Blue,0,34353,34702,349
2022-11-19,70053,70041,Blue,0,51723,52349,626
2022-06-29,70053,70043,Blue,0,66915,67504,589
2022-04-12,70057,70049,Blue,0,30928,31312,384
2022-11-21,70053,70039,Blue,0,41200,42049,849
2022-04-22,70051,70043,Blue,0,54556,55045,489
2022-10-29,70044,70058,Blue,1,79516,80321,805
2022-11-26,70057,70055,Blue,0,35240,35309,69
2022-10-27,70050,70052,Blue,1,73225,73330,105
2022-08-03,70052,70060,Blue,1,67720,68078,358
2022-03-19,70056,70058,Blue,1,63610,63682,72
2022-01-10,70059,70055,Blue,0,51561,51698,137
2022-03-05,70053,70043,Blue,0,37093,37743,650
2022-11-09,70055,70045,Blue,0,69332,69846,514
2022-11-04,70059,70043,Blue,0,30293,31224,931
2022-01-17,70040,70050,Blue,1,71290,71783,493
2022-12-25,70044,70058,Blue,1,53921,54713,792
2022-02-28,70050,70058,Blue,1,71173,71568,395
2022-12-31,70049,70041,Blue,0,89049,89529,480
2022-01-14,70051,70039,Blue,0,55139,55774,635
2022-02-07,70048,70058,Blue,1,62702,63282,580
2022-12-01,70051,70039,Blue,0,23415,24264,849
2022-02-07,70042,70058,Blue,1,63061,64156,1095
2022-12-25,70043,70039,Blue,0,30967,31071,104
2022-02-15,70042,70050,Blue,1,23818,24257,439
2022-11-15,70050,70052,Blue,1,43637,43753,116
2022-11-13,70051,70043,Blue,0,29650,30112,462
2022-09-22,70040,70046,Blue,1,62470,62731,261
2022-08-30,70042,70046,Blue,1,21968,22139,171
2022-11-30,70050,70052,Blue,1,89642,89753,111
2022-06-22,70047,70043,Blue,0,74420,74683,263
2022-01-22,70040,70048,Blue,1,78868,79283,415
2022-10-25,70040,70058,Blue,1,51866,52813,947
2022-02-09,70057,70055,Blue,0,45577,45652,75
2022-04-07,70059,70055,Blue,0,78909,79049,140
2022-06-17,70050,70052,Blue,1,46406,46519,113
2022-05-19,70056,70058,Blue,1,38723,38795,72
2022-11-13,70044,70058,Blue,1,52829,53565,736
2022-07-15,70038,70042,Blue,1,48356,48454,98
2022-12-06,70039,70838,Blue,0,74897,74927,30
2022-09-01,70052,70060,Blue,1,22952,23303,351
2022-11-25,70057,70053,Blue,0,26020,26182,162
2022-01-16,70044,70060,Blue,1,59324,60225,901
2022-09-14,70046,70050,Blue,1,46437,46603,166
2022-10-01,70050,70054,Blue,1,86166,86395,229
2022-04-08,70055,70041,Blue,0,60673,61472,799
2022-12-28,70049,70045,Blue,0,23142,23349,207
2022-01-07,70055,70051,Blue,0,46271,46405,134
2022-09-06,70050,70052,Blue,1,50472,50584,112
2022-06-29,70051,70041,Blue,0,63714,64298,584
2022-11-05,70059,70051,Blue,0,33689,34023,334
2022-08-19,70045,70838,Blue,0,53330,53947,617
2022-06-04,70038,70052,Blue,1,26059,26906,847
2022-06-25,70046,70060,Blue,1,37122,37837,715
2022-02-04,70059,70055,Blue,0,72729,72875,146
2022-11-04,70046,70058,Blue,1,36157,36930,773
2022-02-27,70038,70044,Blue,1,74773,74939,166
2022-08-26,70044,70054,Blue,1,45399,46009,610
2022-06-04,70048,70050,Blue,1,42225,42294,69
2022-11-22,70047,70045,Blue,0,20542,20643,101
2022-11-30,70042,70060,Blue,1,27444,28400,956
2022-10-06,70050,70052,Blue,1,69917,70032,115
2022-07-11,70046,70052,Blue,1,57129,57457,328
2022-10-17,70038,70054,Blue,1,41665,42573,908
2022-04-01,70038,70044,Blue,1,78553,78745,192
2022-03-23,70044,70058,Blue,1,78337,79083,746
2022-12-13,70041,70838,Blue,0,72751,72866,115
2022-11-03,70038,70044,Blue,1,86650,86847,197
2022-04-22,70038,70056,Blue,1,31753,32593,840
2022-06-30,70046,70056,Blue,1,67235,67771,536
2022-02-01,70050,70060,Blue,1,64692,65312,620
2022-08-25,70042,70058,Blue,1,32977,33845,868
2022-07-05,70047,70838,Blue,0,85637,86128,491
2022-09-14,70053,70041,Blue,0,86092,86717,625
2022-04-01,70039,70838,Blue,0,38129,38163,34
2022-09-20,70052,70058,Blue,1,45944,46195,251
2022-02-23,70038,70060,Blue,1,49247,50489,1242
2022-03-04,70057,70043,Blue,0,35933,36803,870
2022-02-23,70038,70048,Blue,1,48089,48537,448
2022-12-04,70054,70058,Blue,1,62872,63038,166
2022-10-27,70047,70045,Blue,0,23254,23359,105
2022-11-08,70048,70052,Blue,1,77214,77405,191
2022-12-06,70043,70041,Blue,0,60167,60195,28
2022-10-09,70059,70049,Blue,0,73813,74449,636
2022-02-25,70052,70060,Blue,1,59044,59581,537
2022-11-27,70050,70060,Blue,1,72601,73085,484
2022-08-02,70038,70058,Blue,1,59833,60848,1015
2022-12-21,70047,70045,Blue,0,18990,19086,96
2022-11-16,70054,70060,Blue,1,61297,61589,292
2022-09-10,70045,70043,Blue,0,67816,67918,102
2022-12-29,70044,70060,Blue,1,80315,81168,853
2022-01-16,70055,70838,Blue,0,49159,50102,943
2022-11-22,70046,70052,Blue,1,68826,69142,316
2022-01-24,70053,70051,Blue,0,87763,87820,57
2022-06-24,70051,70045,Blue,0,63547,63888,341
2022-01-25,70055,70043,Blue,0,28308,29073,765
2022-12-29,70057,70045,Blue,0,35013,35645,632
2022-12-13,70051,70047,Blue,0,52350,52587,237
2022-02-24,70059,70041,Blue,0,29059,30095,1036
2022-01-15,70043,70838,Blue,0,20401,20603,202
2022-09-27,70040,70042,Blue,1,43709,43742,33
2022-10-02,70039,70838,Blue,0,52788,52821,33
2022-10-04,70040,70046,Blue,1,25019,25278,259
2022-08-08,70057,70045,Blue,0,80550,81163,613
2022-07-11,70043,70838,Blue,0,28164,28371,207
2022-07-07,70051,70039,Blue,0,66557,67244,687
2022-08-06,70049,70047,Blue,0,69151,69208,57
2022-02-04,70044,70054,Blue,1,53280,54162,882
2022-11-01,70038,70056,Blue,1,83756,84695,939
2022-05-11,70057,70055,Blue,0,27276,27343,67
2022-10-26,70053,70041,Blue,0,45646,46298,652
2022-09-14,70040,70048,Blue,1,56547,56956,409
2022-02-15,70057,70041,Blue,0,59067,60007,940
2022-07-16,70044,70056,Blue,1,49893,50631,738
2022-03-31,70049,70045,Blue,0,59798,59997,199
2022-01-23,70055,70051,Blue,0,58345,58485,140
2022-11-17,70049,70043,Blue,0,45231,45582,351
2022-03-03,70046,70050,Blue,1,54721,54953,232
2022-11-15,70055,70041,Blue,0,55500,56577,1077
2022-05-31,70039,70838,Blue,0,88018,88054,36
2022-01-06,70054,70060,Blue,1,76641,76915,274
2022-07-24,70051,70838,Blue,0,44469,45231,762
2022-11-22,70055,70041,Blue,0,57097,57766,669
2022-07-28,70038,70058,Blue,1,24914,25939,1025
2022-08-27,70059,70057,Blue,0,20177,20215,38
2022-10-04,70038,70040,Blue,1,46166,46183,17
2022-08-22,70040,70048,Blue,1,47268,47664,396
2022-03-01,70038,70050,Blue,1,48071,48638,567
2022-08-11,70040,70052,Blue,1,44267,44965,698
2022-04-16,70053,70039,Blue,0,72209,72934,725
2022-04-07,70046,70056,Blue,1,85385,85891,506
2022-04-01,70044,70054,Blue,1,78791,79390,599
2022-01-28,70051,70045,Blue,0,28585,28912,327
2022-07-29,70051,70045,Blue,0,25883,26231,348
2022-03-21,70047,70041,Blue,0,33264,33603,339
2022-05-05,70050,70054,Blue,1,41017,41286,269
2022-08-22,70047,70039,Blue,0,56052,56475,423
2022-03-16,70051,70043,Blue,0,36199,36754,555
2022-12-23,70040,70054,Blue,1,62116,62939,823
2022-08-28,70057,70838,Blue,0,38918,40071,1153
2022-05-02,70050,70056,Blue,1,26901,27196,295
2022-02-19,70038,70044,Blue,1,69071,69236,165
2022-02-13,70038,70060,Blue,1,82329,83454,1125
2022-07-30,70059,70045,Blue,0,29791,30462,671
2022-02-15,70057,70053,Blue,0,80132,80297,165
2022-01-31,70059,70057,Blue,0,33045,33094,49
2022-08-20,70056,70060,Blue,1,57641,57820,179
2022-07-13,70055,70053,Blue,0,25284,25329,45
2022-08-01,70057,70053,Blue,0,31053,31199,146
2022-08-08,70044,70046,Blue,1,87967,88067,100
2022-06-17,70051,70041,Blue,0,35156,35809,653
2022-04-10,70057,70045,Blue,0,57146,57766,620
2022-03-26,70050,70052,Blue,1,61106,61282,176
2022-08-25,70047,70838,Blue,0,52557,53092,535
2022-07-02,70044,70050,Blue,1,73687,74074,387
2022-11-09,70049,70039,Blue,0,29892,30486,594
2022-10-19,70057,70049,Blue,0,34472,34844,372
2022-04-20,70053,70039,Blue,0,65874,66619,745
2022-07-02,70044,70048,Blue,1,60670,60974,304
2022-03-16,70040,70056,Blue,1,75242,76116,874
2022-03-06,70050,70058,Blue,1,31346,31732,386
2022-11-02,70040,70048,Blue,1,77398,77819,421
2022-12-05,70041,70838,Blue,0,33990,34104,114
2022-03-28,70038,70040,Blue,1,26355,26375,20
2022-02-01,70042,70058,Blue,1,67474,68483,1009
2022-12-29,70059,70053,Blue,0,26548,26786,238
2022-04-01,70053,70045,Blue,0,38406,38863,457
2022-09-16,70049,70047,Blue,0,29005,29062,57
2022-01-24,70057,70047,Blue,0,57571,58066,495
2022-08-24,70057,70047,Blue,0,45327,45912,585
2022-10-14,70049,70039,Blue,0,55145,55665,520
2022-01-04,70059,70039,Blue,0,25768,27084,1316
2022-03-12,70042,70058,Blue,1,56419,57336,917
2022-12-23,70055,70045,Blue,0,52135,52722,587
2022-06-11,70046,70052,Blue,1,77689,78030,341
2022-03-18,70049,70039,Blue,0,30167,30675,508
2022-02-03,70040,70046,Blue,1,31829,32117,288
2022-06-12,70045,70039,Blue,0,76328,76600,272
2022-01-14,70038,70044,Blue,1,22756,22940,184
2022-02-18,70048,70050,Blue,1,80819,80876,57
2022-12-03,70049,70838,Blue,0,61127,61745,618
2022-11-01,70057,70055,Blue,0,41234,41304,70
2022-08-05,70052,70060,Blue,1,34347,34776,429
2022-10-09,70042,70056,Blue,1,75448,76188,740
2022-01-27,70059,70041,Blue,0,32657,33668,1011
2022-09-15,70038,70046,Blue,1,71880,72223,343
2022-12-07,70049,70043,Blue,0,48901,49273,372
2022-05-08,70059,70057,Blue,0,51017,51055,38
2022-05-28,70049,70039,Blue,0,43536,44125,589
2022-01-09,70049,70043,Blue,0,62424,62743,319
2022-08-27,70041,70838,Blue,0,28036,28153,117
2022-05-31,70045,70039,Blue,0,82194,82468,274
2022-07-13,70053,70045,Blue,0,45280,45815,535
2022-11-03,70043,70838,Blue,0,34383,34583,200
2022-11-29,70050,70056,Blue,1,70726,71020,294
2022-10-19,70051,70049,Blue,0,77296,77403,107
2022-07-05,70059,70043,Blue,0,43836,44762,926
2022-06-16,70051,70039,Blue,0,79289,79978,689
2022-11-20,70042,70048,Blue,1,52768,53069,301
2022-12-28,70055,70043,Blue,0,24643,25348,705
2022-02-22,70056,70058,Blue,1,65899,65974,75
2022-02-23,70048,70052,Blue,1,21581,21819,238
2022-04-12,70055,70041,Blue,0,31937,32726,789
2022-10-29,70055,70053,Blue,0,67754,67798,44
2022-08-15,70042,70050,Blue,1,80248,80786,538
2022-11-16,70048,70050,Blue,1,21929,22000,71
2022-08-11,70050,70060,Blue,1,41250,41832,582
2022-02-23,70038,70050,Blue,1,46392,46939,547
2022-07-16,70040,70044,Blue,1,37826,37938,112
2022-09-15,70057,70047,Blue,0,63256,63736,480
2022-01-18,70055,70043,Blue,0,73412,74312,900
2022-10-15,70055,70838,Blue,0,41861,42897,1036
2022-07-04,70046,70050,Blue,1,59158,59348,190
2022-04-03,70046,70050,Blue,1,47628,47841,213
2022-08-23,70038,70040,Blue,1,68221,68238,17
2022-03-05,70045,70043,Blue,0,49453,49560,107
2022-12-23,70055,70045,Blue,0,55656,56173,517
2022-11-23,70049,70838,Blue,0,49397,50031,634
2022-06-06,70046,70048,Blue,1,45530,45638,108
2022-05-01,70050,70058,Blue,1,86566,86996,430
2022-12-24,70057,70049,Blue,0,61708,62104,396
2022-04-15,70048,70060,Blue,1,25010,25691,681
2022-07-24,70038,70054,Blue,1,51580,52437,857
2022-04-22,70057,70047,Blue,0,46739,47266,527
2022-02-12,70039,70838,Blue,0,56291,56331,40
2022-01-09,70045,70041,Blue,0,32369,32521,152
2022-08-09,70044,70056,Blue,1,31061,31745,684
2022-09-21,70057,70045,Blue,0,87391,88046,655
2022-10-21,70046,70056,Blue,1,31519,32038,519
2022-12-31,70040,70050,Blue,1,43212,43684,472
2022-08-02,70053,70047,Blue,0,42894,43217,323
2022-12-08,70059,70045,Blue,0,52824,53594,770
2022-10-13,70055,70049,Blue,0,61304,61641,337
2022-03-16,70055,70838,Blue,0,53760,54648,888
2022-05-19,70052,70054,Blue,1,31496,31565,69
2022-07-16,70059,70041,Blue,0,69217,70137,920
2022-08-13,70048,70058,Blue,1,64274,64803,529
2022-09-07,70050,70058,Blue,1,40862,42089,1227
2022-07-19,70055,70045,Blue,0,74249,74763,514
2022-01-16,70055,70041,Blue,0,39679,40518,839
2022-07-12,70046,70054,Blue,1,52171,52603,432
2022-06-28,70048,70058,Blue,1,79879,80437,558
2022-10-28,70055,70041,Blue,0,67767,68489,722
2022-12-27,70044,70050,Blue,1,21081,21409,328
2022-07-25,70040,70048,Blue,1,32011,32449,438
2022-11-03,70055,70043,Blue,0,71415,72068,653
2022-09-13,70057,70051,Blue,0,36986,37226,240
2022-08-26,70046,70052,Blue,1,54657,54977,320
2022-02-02,70057,70053,Blue,0,67566,67717,151
2022-12-01,70047,70838,Blue,0,23716,24369,653
2022-12-14,70049,70045,Blue,0,37268,37468,200
2022-03-11,70038,70048,Blue,1,58578,59043,465
2022-08-05,70038,70056,Blue,1,74818,75763,945
2022-11-29,70038,70056,Blue,1,58035,58952,917
2022-07-09,70044,70052,Blue,1,52572,53092,520
2022-07-21,70057,70041,Blue,0,58902,59774,872
2022-07-27,70050,70060,Blue,1,22516,23058,542
2022-11-26,70057,70049,Blue,0,43349,43762,413
2022-01-21,70052,70054,Blue,1,56081,56131,50
2022-12-11,70048,70052,Blue,1,65573,65791,218
2022-07-26,70040,70052,Blue,1,76818,77453,635
2022-09-15,70051,70039,Blue,0,36266,36968,702
2022-07-29,70047,70039,Blue,0,75156,75627,471
2022-11-07,70051,70047,Blue,0,83465,83656,191
2022-10-23,70038,70046,Blue,1,28450,28765,315
2022-08-02,70051,70041,Blue,0,31351,32013,662
2022-01-18,70055,70047,Blue,0,37350,37770,420
2022-03-02,70042,70054,Blue,1,88499,89221,722
2022-08-09,70048,70058,Blue,1,30435,30946,511
2022-08-31,70042,70044,Blue,1,26090,26118,28
2022-03-29,70044,70046,Blue,1,31959,32064,105
2022-04-18,70053,70041,Blue,0,48948,49642,694
2022-03-08,70044,70048,Blue,1,67582,67801,219
2022-08-03,70051,70043,Blue,0,73189,73680,491
2022-06-30,70053,70045,Blue,0,77588,78034,446
2022-01-28,70052,70056,Blue,1,65727,65858,131
2022-01-13,70046,70052,Blue,1,33417,33831,414
2022-03-19,70038,70044,Blue,1,34510,34683,173
2022-03-17,70057,70055,Blue,0,24959,25043,84
2022-10-24,70059,70049,Blue,0,67577,68031,454
2022-03-09,70052,70058,Blue,1,73551,73816,265
2022-12-11,70041,70838,Blue,0,25660,25791,131
2022-08-07,70057,70045,Blue,0,61666,62354,688
2022-07-23,70059,70039,Blue,0,55157,56177,1020
2022-07-20,70057,70039,Blue,0,37530,39496,1966
2022-11-20,70059,70838,Blue,0,78916,79990,1074
2022-08-27,70051,70047,Blue,0,25794,25982,188
2022-12-20,70050,70058,Blue,1,50702,51472,770
2022-07-07,70052,70058,Blue,1,41892,42135,243
2022-11-25,70057,70039,Blue,0,57671,58536,865
2022-06-22,70059,70043,Blue,0,27256,28277,1021
2022-12-15,70042,70050,Blue,1,74389,74823,434
2022-05-18,70051,70039,Blue,0,63891,64873,982
2022-06-23,70052,70054,Blue,1,86065,86198,133
2022-08-05,70052,70060,Blue,1,47073,47439,366
2022-10-07,70040,70046,Blue,1,50322,50571,249
2022-03-06,70040,70054,Blue,1,81074,81841,767
2022-03-04,70042,70056,Blue,1,38035,38842,807
2022-10-11,70059,70045,Blue,0,24259,24975,716
2022-07-29,70038,70056,Blue,1,46180,47154,974
2022-03-25,70038,70058,Blue,1,24949,25986,1037
2022-02-20,70048,70056,Blue,1,73098,73472,374
2022-02-15,70053,70043,Blue,0,50512,51082,570
2022-02-27,70040,70058,Blue,1,61351,62305,954
2022-04-05,70055,70047,Blue,0,21946,22366,420
2022-07-25,70048,70052,Blue,1,81069,81354,285
2022-03-23,70045,70041,Blue,0,78564,78743,179
2022-06-16,70038,70054,Blue,1,30154,31077,923
2022-04-23,70053,70045,Blue,0,19796,20244,448
2022-01-21,70048,70056,Blue,1,33489,33869,380
2022-11-28,70052,70056,Blue,1,46851,46990,139
2022-11-26,70057,70045,Blue,0,35801,36410,609
2022-06-18,70038,70060,Blue,1,79267,80344,1077
2022-02-13,70053,70039,Blue,0,39190,40002,812
2022-11-22,70040,70048,Blue,1,65493,65867,374
2022-03-11,70044,70058,Blue,1,24524,25403,879
2022-08-15,70055,70047,Blue,0,59955,60306,351
2022-03-03,70040,70042,Blue,1,61462,61496,34
2022-01-25,70049,70838,Blue,0,59845,60432,587
2022-02-20,70046,70058,Blue,1,50338,51008,670
2022-12-06,70046,70060,Blue,1,80941,81696,755
2022-09-20,70058,70060,Blue,1,73125,73184,59
2022-07-16,70044,70060,Blue,1,30376,31224,848
2022-12-01,70038,70050,Blue,1,52339,52911,572
2022-10-19,70059,70039,Blue,0,25102,26238,1136
2022-07-05,70044,70046,Blue,1,33864,33987,123
2022-12-31,70049,70045,Blue,0,78768,78968,200
2022-09-23,70044,70050,Blue,1,79090,79444,354
2022-08-15,70059,70049,Blue,0,76967,77463,496
2022-11-12,70039,70838,Blue,0,50421,50457,36
2022-06-17,70052,70056,Blue,1,67179,67309,130
2022-03-02,70049,70043,Blue,0,84094,84504,410
2022-10-14,70048,70060,Blue,1,28732,29398,666
2022-12-18,70054,70058,Blue,1,41159,41310,151
2022-03-21,70048,70058,Blue,1,25445,25982,537
2022-12-10,70040,70050,Blue,1,51318,51809,491
2022-10-27,70044,70050,Blue,1,76958,77284,326
2022-05-20,70050,70058,Blue,1,25614,26047,433
2022-05-11,70050,70058,Blue,1,25998,26378,380
2022-05-21,70038,70048,Blue,1,54741,55280,539
2022-02-02,70057,70041,Blue,0,83634,84688,1054
2022-07-06,70047,70039,Blue,0,50270,50773,503
2022-12-24,70040,70044,Blue,1,55655,55772,117
2022-01-21,70046,70050,Blue,1,36610,36829,219
2022-02-17,70051,70041,Blue,0,33384,34029,645
2022-04-08,70058,70060,Blue,1,53534,53785,251
2022-08-01,70052,70056,Blue,1,63564,63717,153
2022-01-12,70038,70058,Blue,1,75786,76718,932
2022-01-10,70047,70043,Blue,0,61740,62007,267
2022-04-07,70046,70058,Blue,1,70891,71525,634
2022-01-17,70038,70054,Blue,1,63189,64025,836
2022-03-08,70048,70050,Blue,1,28095,28156,61
2022-04-01,70050,70060,Blue,1,30898,31418,520
2022-10-13,70045,70838,Blue,0,45128,45448,320
2022-10-25,70051,70838,Blue,0,81561,82288,727
2022-02-15,70047,70043,Blue,0,36476,36753,277
2022-09-20,70042,70046,Blue,1,25772,25945,173
2022-07-11,70055,70041,Blue,0,39868,40708,840
2022-02-26,70059,70053,Blue,0,37878,38109,231
2022-04-23,70048,70056,Blue,1,26120,26607,487
2022-11-14,70053,70041,Blue,0,59081,59784,703
2022-05-20,70039,70838,Blue,0,33553,33588,35
2022-10-01,70059,70043,Blue,0,28694,29493,799
2022-11-28,70044,70050,Blue,1,33414,33745,331
2022-08-10,70038,70060,Blue,1,61191,62449,1258
2022-10-24,70046,70050,Blue,1,54960,55144,184
2022-07-21,70045,70043,Blue,0,24562,24664,102
2022-07-20,70059,70041,Blue,0,29317,30328,1011
2022-03-23,70055,70041,Blue,0,28684,29507,823
2022-02-02,70050,70054,Blue,1,20493,20781,288
2022-01-01,70055,70041,Blue,0,74106,74956,850
2022-07-13,70038,70040,Blue,1,70614,70628,14
2022-07-09,70038,70054,Blue,1,24309,25187,878
2022-04-20,70044,70054,Blue,1,41474,42025,551
2022-04-26,70058,70060,Blue,1,41386,41443,57
2022-03-29,70057,70055,Blue,0,65376,65445,69
2022-11-17,70048,70052,Blue,1,25145,25350,205
2022-12-06,70059,70053,Blue,0,52524,52748,224
2022-03-13,70054,70056,Blue,1,62661,62708,47
2022-02-10,70047,70041,Blue,0,27344,27765,421
2022-03-06,70054,70058,Blue,1,83139,83290,151
2022-02-15,70049,70047,Blue,0,53922,53977,55
2022-10-29,70051,70047,Blue,0,19907,20109,202
2022-07-23,70044,70054,Blue,1,70871,71501,630
2022-11-23,70056,70058,Blue,1,58696,58766,70
2022-03-23,70050,70054,Blue,1,64411,64621,210
2022-01-24,70047,70838,Blue,0,30615,31192,577
2022-04-04,70038,70054,Blue,1,24934,25767,833
2022-11-01,70047,70838,Blue,0,74406,74864,458
2022-06-26,70053,70838,Blue,0,32722,33610,888
2022-01-23,70038,70058,Blue,1,67206,68143,937
2022-12-10,70038,70042,Blue,1,29113,29224,111
2022-10-03,70057,70047,Blue,0,53893,54382,489
2022-04-02,70046,70048,Blue,1,82544,82625,81
2022-05-09,70050,70054,Blue,1,55623,55869,246
2022-07-05,70045,70838,Blue,0,68152,68507,355
2022-01-02,70045,70039,Blue,0,53157,53439,282
2022-08-04,70040,70042,Blue,1,27572,27607,35
2022-12-01,70040,70042,Blue,1,67176,67208,32
2022-05-18,70049,70047,Blue,0,46731,46789,58
2022-10-31,70053,70039,Blue,0,36670,37426,756
2022-07-29,70055,70043,Blue,0,74706,75444,738
2022-07-25,70038,70048,Blue,1,40163,40655,492
2022-10-24,70055,70051,Blue,0,55293,55431,138
2022-09-20,70050,70058,Blue,1,54450,54918,468
2022-11-19,70049,70047,Blue,0,23999,24055,56
2022-06-22,70044,70060,Blue,1,60656,61643,987
2022-08-14,70042,70046,Blue,1,69529,69736,207
2022-07-01,70057,70838,Blue,0,67176,68195,1019
2022-10-29,70049,70039,Blue,0,60010,60528,518
2022-12-03,70052,70060,Blue,1,49307,49697,390
2022-06-14,70039,70838,Blue,0,20783,20819,36
2022-06-27,70046,70052,Blue,1,87060,87411,351
2022-01-26,70055,70045,Blue,0,60141,60669,528
2022-10-14,70055,70039,Blue,0,77120,77930,810
2022-02-09,70059,70838,Blue,0,58091,59220,1129
2022-11-08,70059,70047,Blue,0,75372,75904,532
2022-05-19,70047,70045,Blue,0,56289,56488,199
2022-01-20,70059,70047,Blue,0,71558,72144,586
2022-07-09,70053,70047,Blue,0,42999,43290,291
2022-04-22,70057,70043,Blue,0,65371,66179,808
2022-10-22,70046,70054,Blue,1,72174,72685,511
2022-02-07,70049,70045,Blue,0,48679,48857,178
2022-10-23,70044,70048,Blue,1,67981,68219,238
2022-12-23,70050,70052,Blue,1,54290,54573,283
2022-12-09,70059,70049,Blue,0,44777,45257,480
2022-06-18,70046,70060,Blue,1,52181,53082,901
2022-08-25,70052,70060,Blue,1,65736,66093,357
2022-01-07,70057,70053,Blue,0,22193,22414,221
2022-06-21,70045,70039,Blue,0,39861,40154,293
2022-10-31,70052,70060,Blue,1,50543,50888,345
2022-04-19,70051,70041,Blue,0,37481,38149,668
2022-04-07,70055,70049,Blue,0,58896,59210,314
2022-04-25,70059,70053,Blue,0,41715,41959,244
2022-08-16,70055,70041,Blue,0,55246,56024,778
2022-10-25,70055,70047,Blue,0,39711,40094,383
2022-01-13,70053,70047,Blue,0,52799,53109,310
2022-06-12,70048,70058,Blue,1,53234,53769,535
2022-06-26,70040,70060,Blue,1,59391,60640,1249
2022-05-28,70049,70838,Blue,0,29722,30430,708
2022-11-14,70053,70047,Blue,0,69956,70259,303
2022-08-06,70059,70838,Blue,0,48684,49770,1086
2022-11-07,70042,70060,Blue,1,47841,48933,1092
2022-04-05,70044,70050,Blue,1,24511,24897,386
2022-09-07,70053,70043,Blue,0,27134,27786,652
2022-02-11,70042,70048,Blue,1,83896,84203,307
2022-07-23,70059,70045,Blue,0,30858,31610,752
2022-07-11,70057,70043,Blue,0,59183,59954,771
2022-02-10,70053,70049,Blue,0,68735,68928,193
2022-06-25,70043,70838,Blue,0,80753,80955,202
2022-11-20,70047,70039,Blue,0,63671,64109,438
2022-09-20,70038,70054,Blue,1,51811,52664,853
2022-07-14,70044,70046,Blue,1,52455,52564,109
2022-12-22,70041,70039,Blue,0,65126,65159,33
2022-07-31,70053,70039,Blue,0,83287,84000,713
2022-12-22,70042,70058,Blue,1,61252,62127,875
2022-02-15,70042,70048,Blue,1,30709,31016,307
2022-10-15,70058,70060,Blue,1,68520,68579,59
2022-06-16,70041,70039,Blue,0,31677,31710,33
2022-03-28,70042,70058,Blue,1,52588,53607,1019
2022-08-23,70038,70058,Blue,1,29492,30543,1051
2022-09-27,70042,70046,Blue,1,87522,87708,186
2022-07-15,70040,70058,Blue,1,42503,43619,1116
2022-10-07,70051,70049,Blue,0,36288,36395,107
2022-09-22,70047,70838,Blue,0,55447,55911,464
2022-05-30,70040,70042,Blue,1,22960,22994,34
2022-08-02,70057,70049,Blue,0,30217,30667,450
2022-11-11,70057,70041,Blue,0,55716,56717,1001
2022-11-02,70040,70052,Blue,1,77398,78069,671
2022-10-19,70055,70838,Blue,0,53260,54206,946
2022-05-21,70055,70049,Blue,0,56478,56757,279
2022-09-27,70059,70041,Blue,0,68086,69024,938
2022-12-05,70038,70050,Blue,1,36540,37134,594
2022-11-26,70052,70056,Blue,1,56334,56461,127
2022-01-07,70059,70041,Blue,0,74356,75279,923
2022-08-09,70051,70049,Blue,0,19128,19246,118
2022-04-08,70042,70046,Blue,1,53515,53697,182
2022-01-03,70059,70057,Blue,0,75257,75303,46
2022-01-17,70040,70056,Blue,1,30793,31679,886
2022-08-31,70059,70053,Blue,0,52218,52439,221
2022-07-22,70050,70058,Blue,1,64267,64693,426
2022-08-16,70057,70047,Blue,0,52917,53404,487
2022-02-11,70046,70058,Blue,1,26104,26674,570
2022-01-13,70050,70056,Blue,1,55756,56042,286
2022-11-16,70038,70042,Blue,1,64550,64646,96
2022-02-05,70046,70052,Blue,1,61957,62287,330
2022-03-14,70049,70043,Blue,0,36917,37293,376
2022-08-26,70046,70052,Blue,1,60609,60972,363
2022-09-16,70044,70058,Blue,1,67702,68640,938
2022-08-23,70040,70052,Blue,1,56085,56748,663
2022-01-24,70053,70838,Blue,0,57763,58689,926
2022-08-27,70038,70040,Blue,1,63135,63150,15
2022-02-16,70051,70041,Blue,0,69445,70017,572
2022-09-23,70044,70048,Blue,1,35298,35545,247
2022-08-24,70042,70054,Blue,1,74427,75085,658
2022-02-06,70057,70053,Blue,0,25045,25211,166
2022-01-04,70059,70051,Blue,0,40610,40965,355
2022-02-17,70057,70055,Blue,0,51298,51366,68
2022-11-15,70040,70052,Blue,1,63639,64451,812
2022-06-09,70045,70838,Blue,0,25426,25826,400
2022-06-29,70047,70838,Blue,0,64776,65303,527
2022-11-21,70058,70060,Blue,1,68425,68486,61
2022-07-04,70057,70053,Blue,0,39031,39180,149
2022-09-29,70048,70058,Blue,1,72106,72595,489
2022-12-15,70057,70047,Blue,0,82904,83681,777
2022-03-11,70059,70838,Blue,0,24860,26030,1170
2022-10-24,70038,70050,Blue,1,33290,33894,604
2022-03-13,70044,70050,Blue,1,83252,83638,386
2022-12-25,70059,70057,Blue,0,65714,65751,37
2022-02-01,70040,70044,Blue,1,83209,83322,113
2022-11-01,70055,70053,Blue,0,87485,87531,46
2022-01-21,70049,70838,Blue,0,59863,60698,835
2022-01-10,70042,70052,Blue,1,68374,69121,747
2022-09-06,70040,70042,Blue,1,66713,66747,34
2022-01-12,70046,70052,Blue,1,42033,42530,497
2022-08-18,70057,70039,Blue,0,21772,22818,1046
2022-04-23,70057,70039,Blue,0,80729,81667,938
2022-09-30,70050,70056,Blue,1,74466,74752,286
2022-12-26,70046,70052,Blue,1,49756,50075,319
2022-07-24,70050,70054,Blue,1,78047,78265,218
2022-02-25,70052,70060,Blue,1,36866,38597,1731
2022-11-17,70058,70060,Blue,1,85269,85335,66
2022-01-31,70038,70050,Blue,1,55739,56366,627
2022-11-13,70055,70045,Blue,0,68065,68559,494
2022-11-25,70049,70838,Blue,0,41917,42536,619
2022-12-01,70057,70039,Blue,0,45812,46717,905
2022-08-03,70051,70043,Blue,0,50300,50820,520
2022-09-21,70038,70048,Blue,1,58124,58604,480
2022-02-22,70044,70058,Blue,1,52985,53738,753
2022-09-19,70041,70039,Blue,0,57344,57375,31
2022-11-14,70053,70047,Blue,0,23170,23483,313
2022-03-31,70059,70055,Blue,0,59605,59749,144
2022-06-06,70049,70838,Blue,0,67324,67921,597
2022-07-14,70038,70058,Blue,1,79127,80316,1189
2022-08-21,70049,70039,Blue,0,58708,59224,516
2022-08-13,70051,70039,Blue,0,23162,23796,634
2022-02-14,70038,70048,Blue,1,21004,21477,473
2022-04-27,70059,70057,Blue,0,65235,65270,35
2022-06-18,70042,70048,Blue,1,62888,63222,334
2022-07-01,70038,70048,Blue,1,69092,69589,497
2022-02-22,70054,70056,Blue,1,79137,79185,48
2022-06-04,70044,70052,Blue,1,63532,64191,659
2022-10-24,70054,70060,Blue,1,65976,66241,265
2022-11-19,70043,70838,Blue,0,22443,22643,200
2022-10-11,70051,70045,Blue,0,80838,81199,361
2022-06-27,70042,70060,Blue,1,89230,90203,973
2022-09-08,70043,70041,Blue,0,70234,70262,28
2022-06-14,70059,70053,Blue,0,59294,59529,235
2022-03-29,70049,70047,Blue,0,31934,31988,54
2022-08-14,70052,70056,Blue,1,71752,71911,159
2022-04-10,70042,70046,Blue,1,37852,38026,174
2022-08-17,70045,70039,Blue,0,77661,77898,237
2022-09-28,70046,70048,Blue,1,31197,31270,73
2022-12-21,70055,70838,Blue,0,20603,21626,1023
2022-01-08,70053,70051,Blue,0,39877,39934,57
2022-05-18,70042,70058,Blue,1,61501,62492,991
2022-04-24,70045,70838,Blue,0,82365,82731,366
2022-11-20,70041,70838,Blue,0,63452,63566,114
2022-06-10,70042,70046,Blue,1,49908,50117,209
2022-07-02,70050,70056,Blue,1,78581,78894,313
2022-01-07,70046,70054,Blue,1,33588,34020,432
2022-01-14,70057,70047,Blue,0,58767,59263,496
2022-08-12,70054,70056,Blue,1,41521,41579,58
2022-12-20,70040,70058,Blue,1,26587,27533,946
2022-04-04,70040,70050,Blue,1,84448,85013,565
2022-05-18,70059,70043,Blue,0,54801,55969,1168
2022-12-16,70050,70060,Blue,1,42668,43194,526
2022-04-05,70041,70838,Blue,0,61710,61845,135
2022-06-09,70044,70060,Blue,1,55572,56895,1323
2022-05-19,70038,70050,Blue,1,26073,26724,651
2022-03-12,70045,70039,Blue,0,77189,77437,248
2022-08-29,70043,70838,Blue,0,46627,46826,199
2022-07-20,70047,70043,Blue,0,59253,59524,271
2022-06-12,70053,70838,Blue,0,80504,81352,848
2022-02-24,70038,70058,Blue,1,68594,69592,998
2022-06-02,70044,70048,Blue,1,54805,55129,324
2022-08-05,70044,70060,Blue,1,65805,66743,938
2022-09-22,70057,70041,Blue,0,27697,28722,1025
2022-01-17,70038,70060,Blue,1,25057,26336,1279
2022-02-15,70053,70045,Blue,0,55362,55812,450
2022-10-30,70046,70052,Blue,1,31929,32236,307
2022-10-26,70046,70048,Blue,1,60699,60770,71
2022-05-12,70050,70056,Blue,1,26102,26393,291
2022-08-30,70047,70045,Blue,0,23191,23287,96
2022-04-05,70041,70039,Blue,0,31088,31124,36
2022-02-24,70059,70057,Blue,0,42684,42719,35
2022-03-01,70056,70060,Blue,1,30895,31132,237
2022-02-25,70053,70838,Blue,0,64395,65224,829
2022-03-16,70044,70058,Blue,1,52430,53236,806
2022-11-20,70038,70050,Blue,1,84661,85208,547
2022-02-07,70055,70049,Blue,0,58153,58438,285
2022-12-21,70053,70045,Blue,0,26961,27382,421
2022-06-25,70046,70056,Blue,1,43048,43593,545
2022-08-27,70057,70043,Blue,0,50375,51164,789
2022-07-11,70057,70051,Blue,0,47825,48079,254
2022-06-14,70057,70047,Blue,0,81829,82515,686
2022-08-26,70048,70052,Blue,1,39389,39589,200
2022-11-23,70056,70058,Blue,1,32844,32921,77
2022-03-30,70038,70050,Blue,1,79244,79869,625
2022-01-19,70058,70060,Blue,1,49692,49841,149
2022-03-24,70050,70058,Blue,1,22704,23155,451
2022-12-28,70053,70045,Blue,0,53281,53733,452
2022-07-22,70047,70043,Blue,0,36574,36844,270
2022-03-11,70055,70041,Blue,0,74540,75284,744
2022-04-18,70046,70060,Blue,1,52214,52930,716
2022-03-06,70057,70051,Blue,0,72810,73062,252
2022-03-25,70042,70052,Blue,1,59989,60842,853
2022-11-30,70050,70052,Blue,1,32906,33023,117
2022-01-24,70045,70838,Blue,0,27463,27858,395
2022-09-17,70054,70058,Blue,1,63378,63528,150
2022-03-25,70046,70052,Blue,1,88104,88414,310
2022-01-07,70055,70051,Blue,0,28147,28310,163
2022-11-05,70040,70056,Blue,1,65961,66799,838
2022-06-27,70047,70043,Blue,0,61101,61357,256
2022-01-05,70038,70040,Blue,1,72977,72993,16
2022-06-09,70044,70054,Blue,1,71725,72377,652
2022-04-19,70054,70056,Blue,1,77787,77834,47
2022-03-13,70042,70048,Blue,1,43776,44079,303
2022-11-13,70040,70046,Blue,1,57018,57258,240
2022-10-14,70038,70048,Blue,1,66120,66632,512
2022-09-16,70047,70039,Blue,0,60558,61047,489
2022-09-06,70044,70050,Blue,1,45355,45695,340
2022-12-29,70046,70056,Blue,1,67430,68014,584
2022-01-06,70054,70056,Blue,1,83507,83554,47
2022-06-21,70038,70044,Blue,1,72074,72255,181
2022-12-28,70045,70039,Blue,0,26568,26829,261
2022-06-18,70055,70039,Blue,0,84194,85063,869
2022-06-02,70042,70050,Blue,1,60035,60557,522
2022-07-19,70055,70041,Blue,0,52716,53528,812
2022-11-16,70047,70043,Blue,0,47779,48013,234
2022-02-24,70052,70058,Blue,1,60260,60514,254
2022-12-11,70051,70043,Blue,0,85244,85714,470
2022-06-10,70059,70047,Blue,0,63037,63558,521
2022-10-25,70057,70053,Blue,0,61408,61560,152
2022-02-20,70040,70050,Blue,1,87386,87875,489
2022-07-21,70043,70039,Blue,0,74635,74737,102
2022-08-05,70057,70043,Blue,0,81332,82146,814
2022-09-18,70049,70041,Blue,0,55936,56392,456
2022-09-19,70058,70060,Blue,1,24441,24586,145
2022-06-17,70054,70060,Blue,1,88610,88869,259
2022-04-20,70047,70041,Blue,0,64124,64495,371
2022-04-22,70042,70044,Blue,1,67793,67828,35
2022-04-01,70040,70048,Blue,1,63487,63904,417
2022-03-28,70049,70047,Blue,0,39215,39271,56
2022-08-23,70038,70044,Blue,1,41794,42008,214
2022-02-24,70047,70838,Blue,0,71091,71560,469
2022-06-12,70044,70058,Blue,1,88449,89348,899
2022-03-25,70055,70045,Blue,0,38846,39370,524
2022-10-27,70048,70058,Blue,1,63334,63827,493
2022-03-03,70058,70060,Blue,1,35238,35362,124
2022-07-27,70042,70060,Blue,1,31690,32707,1017
2022-04-11,70059,70057,Blue,0,59896,59931,35
2022-02-19,70040,70044,Blue,1,31321,31428,107
2022-02-05,70040,70046,Blue,1,62111,62378,267
2022-02-12,70057,70051,Blue,0,46049,46310,261
2022-07-30,70055,70043,Blue,0,85041,85716,675
2022-01-22,70046,70050,Blue,1,25993,26183,190
2022-12-04,70042,70046,Blue,1,29525,29714,189
2022-04-01,70042,70046,Blue,1,47165,47343,178
2022-02-13,70043,70838,Blue,0,44480,44677,197
2022-09-16,70059,70043,Blue,0,28877,29735,858
2022-03-05,70038,70048,Blue,1,66384,66846,462
2022-01-23,70044,70052,Blue,1,76622,77137,515
2022-03-22,70053,70045,Blue,0,84262,84671,409
2022-05-25,70049,70838,Blue,0,62050,62714,664
2022-10-10,70040,70048,Blue,1,47912,48313,401
2022-12-28,70053,70047,Blue,0,20019,20308,289
2022-04-05,70040,70050,Blue,1,40224,40724,500
2022-10-17,70059,70041,Blue,0,60863,61780,917
2022-02-09,70051,70039,Blue,0,25534,26243,709
2022-07-21,70047,70045,Blue,0,33791,33885,94
2022-02-19,70043,70838,Blue,0,73865,74039,174
2022-07-28,70055,70043,Blue,0,84970,85648,678
2022-03-24,70042,70056,Blue,1,61880,62694,814
2022-03-11,70047,70043,Blue,0,35821,36064,243
2022-08-11,70040,70060,Blue,1,47227,48325,1098
2022-01-09,70053,70049,Blue,0,48713,48941,228
2022-10-16,70038,70042,Blue,1,61289,61384,95
2022-06-20,70055,70053,Blue,0,58122,58168,46
2022-03-24,70042,70056,Blue,1,65016,65832,816
2022-10-23,70046,70050,Blue,1,39362,39533,171
2022-02-11,70040,70052,Blue,1,50374,51017,643
2022-10-21,70047,70039,Blue,0,28224,28653,429
2022-08-09,70058,70060,Blue,1,23288,23357,69
2022-12-09,70050,70052,Blue,1,66990,67097,107
2022-12-30,70046,70060,Blue,1,81756,82508,752
2022-02-15,70048,70054,Blue,1,79682,80013,331
2022-02-16,70053,70039,Blue,0,28440,29253,813
2022-02-09,70042,70044,Blue,1,83880,83909,29
2022-07-09,70043,70041,Blue,0,85788,85815,27
2022-07-02,70052,70054,Blue,1,65070,65128,58
2022-10-14,70051,70043,Blue,0,86872,87336,464
2022-02-11,70051,70047,Blue,0,78127,78319,192
2022-08-31,70043,70838,Blue,0,74720,74915,195
2022-06-17,70051,70045,Blue,0,21368,21712,344
2022-12-30,70053,70047,Blue,0,55115,55394,279
2022-04-01,70050,70054,Blue,1,86546,86744,198
2022-10-07,70040,70058,Blue,1,81980,82983,1003
2022-08-04,70039,70838,Blue,0,78639,78675,36
2022-07-13,70046,70056,Blue,1,64477,65006,529
2022-01-05,70046,70060,Blue,1,65289,66170,881
2022-07-22,70048,70050,Blue,1,64169,64227,58
2022-04-10,70056,70060,Blue,1,29351,29518,167
2022-06-21,70053,70039,Blue,0,77492,78303,811
2022-01-17,70046,70056,Blue,1,35984,36531,547
2022-06-10,70050,70054,Blue,1,40285,40483,198
2022-08-03,70055,70838,Blue,0,28659,29642,983
2022-02-22,70040,70052,Blue,1,41437,42122,685
2022-09-05,70040,70060,Blue,1,71589,72571,982
2022-01-04,70038,70042,Blue,1,29056,29149,93
2022-03-21,70040,70054,Blue,1,56571,57287,716
2022-12-28,70038,70044,Blue,1,42519,42703,184
2022-11-19,70051,70039,Blue,0,37717,38390,673
2022-01-05,70055,70043,Blue,0,81399,82063,664
2022-12-27,70059,70039,Blue,0,46761,47773,1012
2022-07-31,70057,70838,Blue,0,57149,58167,1018
2022-08-13,70051,70039,Blue,0,53924,54621,697
2022-02-28,70044,70060,Blue,1,67248,68152,904
2022-02-22,70057,70049,Blue,0,44424,44841,417
2022-12-15,70052,70054,Blue,1,37121,37178,57
2022-08-01,70038,70044,Blue,1,41520,41692,172
2022-04-08,70043,70838,Blue,0,60833,61031,198
2022-05-22,70042,70048,Blue,1,53889,54410,521
2022-12-06,70043,70041,Blue,0,81743,81772,29
2022-02-07,70044,70052,Blue,1,31640,32102,462
2022-11-21,70049,70045,Blue,0,34938,35142,204
2022-01-10,70044,70058,Blue,1,62859,63710,851
2022-12-22,70053,70043,Blue,0,21347,21994,647
2022-12-23,70057,70051,Blue,0,88392,88670,278
2022-02-26,70041,70039,Blue,0,80037,80068,31
2022-04-04,70047,70043,Blue,0,51393,51660,267
2022-07-17,70057,70053,Blue,0,36934,37092,158
2022-01-20,70038,70052,Blue,1,21706,22538,832
2022-04-19,70047,70041,Blue,0,33035,33377,342
2022-02-17,70047,70043,Blue,0,75510,75802,292
2022-09-14,70058,70060,Blue,1,31038,31097,59
2022-01-07,70059,70053,Blue,0,29054,29392,338
2022-02-11,70042,70056,Blue,1,75939,76639,700
2022-03-06,70053,70047,Blue,0,23370,23667,297
2022-06-29,70047,70039,Blue,0,24183,24696,513
2022-07-14,70052,70060,Blue,1,43694,44088,394
2022-12-03,70053,70041,Blue,0,42288,42974,686
2022-06-21,70050,70060,Blue,1,76482,77010,528
2022-08-23,70057,70051,Blue,0,78487,78727,240
2022-01-21,70040,70058,Blue,1,33696,34773,1077
2022-03-31,70051,70043,Blue,0,24028,24572,544
2022-10-08,70040,70054,Blue,1,47621,48439,818
2022-04-09,70040,70056,Blue,1,79360,80229,869
2022-12-22,70052,70056,Blue,1,55369,55503,134
2022-06-09,70057,70838,Blue,0,24338,25398,1060
2022-07-24,70051,70838,Blue,0,85904,86636,732
2022-06-30,70057,70051,Blue,0,88343,88593,250
2022-01-18,70048,70052,Blue,1,71483,71739,256
2022-07-17,70057,70049,Blue,0,69570,70127,557
2022-07-25,70038,70046,Blue,1,54954,55304,350
2022-11-09,70042,70046,Blue,1,81385,81571,186
2022-03-09,70045,70039,Blue,0,87777,88036,259
2022-06-22,70045,70043,Blue,0,75323,75444,121
2022-04-13,70044,70060,Blue,1,50522,51457,935
2022-02-03,70038,70050,Blue,1,23048,23562,514
2022-09-07,70046,70060,Blue,1,55111,55855,744
2022-06-22,70046,70052,Blue,1,55190,55537,347
2022-01-08,70042,70050,Blue,1,56271,56693,422
2022-01-09,70043,70041,Blue,0,44344,44371,27
2022-12-14,70059,70039,Blue,0,88138,89388,1250
2022-08-16,70053,70051,Blue,0,27905,27967,62
2022-12-15,70053,70838,Blue,0,61605,62439,834
2022-09-20,70054,70060,Blue,1,77206,77473,267
2022-10-17,70040,70042,Blue,1,29052,29081,29
2022-10-05,70051,70039,Blue,0,72141,72788,647
2022-12-31,70055,70047,Blue,0,47771,48162,391
2022-04-15,70046,70052,Blue,1,20245,20618,373
2022-11-04,70048,70050,Blue,1,67038,67095,57
2022-10-12,70040,70044,Blue,1,27167,27288,121
2022-06-30,70038,70048,Blue,1,71764,72320,556
2022-08-20,70044,70054,Blue,1,76845,77494,649
2022-10-06,70046,70056,Blue,1,86921,87424,503
2022-01-27,70041,70039,Blue,0,86697,86727,30
2022-07-05,70049,70047,Blue,0,71738,71793,55
2022-08-01,70051,70039,Blue,0,23798,24523,725
2022-10-25,70053,70045,Blue,0,45534,46009,475
2022-07-11,70055,70039,Blue,0,58127,58972,845
2022-02-23,70053,70045,Blue,0,19506,20021,515
2022-11-07,70053,70051,Blue,0,30528,30595,67
2022-08-29,70053,70041,Blue,0,20700,21413,713
2022-10-20,70053,70041,Blue,0,65340,66001,661
2022-02-19,70042,70048,Blue,1,83152,83479,327
2022-11-23,70057,70049,Blue,0,59384,59792,408
2022-06-10,70048,70054,Blue,1,57711,58057,346
2022-06-19,70040,70052,Blue,1,73778,74490,712
2022-04-06,70048,70060,Blue,1,24832,25498,666
2022-03-31,70059,70049,Blue,0,80596,81060,464
2022-03-09,70059,70045,Blue,0,32060,32799,739
2022-01-17,70046,70056,Blue,1,48429,48960,531
2022-09-22,70045,70838,Blue,0,80671,80992,321
2022-12-09,70041,70039,Blue,0,47250,47281,31
2022-04-24,70046,70060,Blue,1,29682,30519,837
2022-10-27,70057,70045,Blue,0,40176,40826,650
2022-06-13,70053,70049,Blue,0,37824,38035,211
2022-01-13,70051,70041,Blue,0,47032,47604,572
2022-05-31,70040,70050,Blue,1,36020,36557,537
2022-07-04,70050,70054,Blue,1,86754,86998,244
2022-12-27,70040,70042,Blue,1,22926,22959,33
2022-11-10,70041,70838,Blue,0,74389,74507,118
2022-04-06,70048,70050,Blue,1,83162,83220,58
2022-06-30,70050,70060,Blue,1,33603,34242,639
2022-04-19,70059,70057,Blue,0,46108,46142,34
2022-12-26,70048,70058,Blue,1,56436,56962,526
2022-11-27,70046,70056,Blue,1,60589,61169,580
2022-09-09,70042,70052,Blue,1,54747,55366,619
2022-04-21,70051,70047,Blue,0,46507,46696,189
2022-05-06,70053,70047,Blue,0,80253,80619,366
2022-07-18,70044,70048,Blue,1,52735,53011,276
2022-11-12,70040,70054,Blue,1,30250,30942,692
2022-03-22,70044,70056,Blue,1,62143,62864,721
2022-09-20,70045,70838,Blue,0,28023,28389,366
2022-04-13,70040,70050,Blue,1,91212,91781,569
2022-08-01,70053,70041,Blue,0,64715,65354,639
2022-04-18,70054,70056,Blue,1,57795,57843,48
2022-02-15,70053,70049,Blue,0,38428,38655,227
2022-10-02,70042,70044,Blue,1,47918,47946,28
2022-06-20,70040,70058,Blue,1,66464,67498,1034
2022-03-30,70055,70047,Blue,0,43385,43774,389
2022-03-20,70040,70048,Blue,1,56571,57040,469
2022-06-15,70038,70058,Blue,1,47005,48179,1174
2022-10-17,70054,70060,Blue,1,81210,81475,265
2022-07-08,70055,70051,Blue,0,60292,60430,138
2022-03-09,70051,70049,Blue,0,34220,34329,109
2022-07-11,70050,70056,Blue,1,61464,61773,309
2022-08-10,70048,70060,Blue,1,27134,27739,605
2022-12-30,70049,70041,Blue,0,35442,35836,394
2022-04-29,70057,70051,Blue,0,75085,75330,245
2022-11-03,70044,70050,Blue,1,54795,55151,356
2022-04-13,70040,70056,Blue,1,35724,36662,938
2022-10-04,70045,70838,Blue,0,78950,79271,321
2022-03-12,70053,70043,Blue,0,55967,56539,572
2022-07-04,70052,70060,Blue,1,62866,63284,418
2022-07-03,70057,70838,Blue,0,74978,76024,1046
2022-02-01,70057,70051,Blue,0,60276,60537,261
2022-02-24,70050,70060,Blue,1,26334,26904,570
2022-02-11,70047,70838,Blue,0,21590,22145,555
2022-01-23,70051,70838,Blue,0,33517,34173,656
2022-06-16,70040,70050,Blue,1,52198,52790,592
2022-02-04,70047,70045,Blue,0,56007,56100,93
2022-11-03,70055,70043,Blue,0,66190,66858,668
2022-06-25,70042,70048,Blue,1,48259,48683,424
2022-11-20,70044,70058,Blue,1,31757,32473,716
2022-12-28,70055,70838,Blue,0,41842,42693,851
2022-10-25,70045,70043,Blue,0,76630,76721,91
2022-11-16,70049,70045,Blue,0,37826,38020,194
2022-03-26,70040,70044,Blue,1,38356,38458,102
2022-06-22,70051,70838,Blue,0,27987,28790,803
2022-04-17,70059,70051,Blue,0,49519,49845,326
2022-02-09,70055,70039,Blue,0,70168,71054,886
2022-04-23,70055,70041,Blue,0,73154,73930,776
2022-09-07,70059,70043,Blue,0,61802,62637,835
2022-03-28,70053,70043,Blue,0,39569,40246,677
2022-07-11,70057,70838,Blue,0,85473,86453,980
2022-08-05,70057,70055,Blue,0,27704,27771,67
2022-12-21,70046,70048,Blue,1,83928,84018,90
2022-07-17,70055,70053,Blue,0,46983,47028,45
2022-11-29,70042,70050,Blue,1,50915,51323,408
2022-08-01,70042,70046,Blue,1,60831,61009,178
2022-08-24,70043,70039,Blue,0,22695,22811,116
2022-10-19,70039,70838,Blue,0,53511,53544,33
2022-04-12,70040,70044,Blue,1,61692,61879,187
2022-03-08,70047,70041,Blue,0,50862,51178,316
2022-04-06,70038,70044,Blue,1,57019,57235,216
2022-07-04,70056,70058,Blue,1,26604,26674,70
2022-12-15,70053,70043,Blue,0,26141,26750,609
2022-07-09,70048,70050,Blue,1,37259,37319,60
2022-10-15,70047,70043,Blue,0,44952,45191,239
2022-01-20,70050,70058,Blue,1,20504,20982,478
2022-06-05,70049,70039,Blue,0,30377,30987,610
2022-07-02,70059,70049,Blue,0,33014,33531,517
2022-08-16,70042,70058,Blue,1,71202,72097,895
2022-09-20,70038,70042,Blue,1,44581,44673,92
2022-11-10,70059,70057,Blue,0,37880,37918,38
2022-09-25,70049,70041,Blue,0,42613,43215,602
2022-02-28,70044,70060,Blue,1,34685,35671,986
2022-07-12,70057,70041,Blue,0,20012,20932,920
2022-01-31,70051,70838,Blue,0,87859,88710,851
2022-12-30,70047,70039,Blue,0,66792,67261,469
2022-10-13,70049,70043,Blue,0,29901,30266,365
2022-05-20,70055,70049,Blue,0,42331,42616,285
2022-10-09,70046,70058,Blue,1,64478,65099,621
2022-06-17,70052,70054,Blue,1,70624,70672,48
2022-08-02,70040,70050,Blue,1,59891,60372,481
2022-07-11,70040,70052,Blue,1,58877,59549,672
2022-12-01,70057,70043,Blue,0,79442,80201,759
2022-10-28,70052,70058,Blue,1,41441,41716,275
2022-12-10,70048,70050,Blue,1,25463,25520,57
2022-02-05,70053,70043,Blue,0,68513,69151,638
2022-03-16,70053,70043,Blue,0,64072,64706,634
2022-03-22,70046,70048,Blue,1,58412,58506,94
2022-03-13,70053,70047,Blue,0,52492,52786,294
2022-10-09,70045,70041,Blue,0,58895,59069,174
2022-04-10,70055,70053,Blue,0,48090,48135,45
2022-11-18,70050,70060,Blue,1,58425,59040,615
2022-03-27,70049,70039,Blue,0,23543,24125,582
2022-07-04,70048,70060,Blue,1,83148,83803,655
2022-09-23,70057,70051,Blue,0,23501,23802,301
2022-04-18,70049,70047,Blue,0,56216,56271,55
2022-06-01,70038,70048,Blue,1,78254,79080,826
2022-04-14,70057,70043,Blue,0,53185,53920,735
2022-09-15,70050,70054,Blue,1,27169,27401,232
2022-02-10,70051,70838,Blue,0,32719,33493,774
2022-08-25,70042,70046,Blue,1,56686,56862,176
2022-04-05,70059,70055,Blue,0,26654,26802,148
2022-04-10,70050,70060,Blue,1,25225,25739,514
2022-01-12,70046,70054,Blue,1,44529,44964,435
2022-08-01,70053,70043,Blue,0,41877,42448,571
2022-07-08,70038,70042,Blue,1,65625,65715,90
2022-01-16,70040,70050,Blue,1,59175,59673,498
2022-01-15,70050,70060,Blue,1,28591,29079,488
2022-11-13,70053,70051,Blue,0,57873,57929,56
2022-11-15,70044,70052,Blue,1,23861,24334,473
2022-10-14,70046,70048,Blue,1,26600,26683,83
2022-01-21,70041,70039,Blue,0,24588,24621,33
2022-03-30,70055,70047,Blue,0,23231,23599,368
2022-12-13,70059,70051,Blue,0,21751,22114,363
2022-03-31,70055,70049,Blue,0,62783,63055,272
2022-06-18,70059,70055,Blue,0,78437,78586,149
2022-07-18,70041,70838,Blue,0,24088,24225,137
2022-04-14,70044,70052,Blue,1,44427,44999,572
2022-05-18,70047,70041,Blue,0,25568,26040,472
2022-03-08,70059,70043,Blue,0,59895,60677,782
2022-03-24,70047,70039,Blue,0,76096,76459,363
2022-04-22,70057,70045,Blue,0,50789,51419,630
2022-09-01,70051,70049,Blue,0,31337,31437,100
2022-10-07,70047,70838,Blue,0,19096,19691,595
2022-10-27,70044,70056,Blue,1,40756,41545,789
2022-08-28,70055,70049,Blue,0,42975,43297,322
2022-09-04,70057,70039,Blue,0,60408,61368,960
2022-03-14,70040,70052,Blue,1,52810,53467,657
2022-09-10,70040,70058,Blue,1,77373,78384,1011
2022-09-01,70058,70060,Blue,1,56226,56285,59
2022-06-14,70051,70043,Blue,0,60245,60752,507
2022-08-21,70055,70039,Blue,0,45917,46767,850
2022-12-21,70052,70056,Blue,1,43176,43318,142
2022-12-13,70049,70838,Blue,0,87845,88433,588
2022-10-29,70046,70056,Blue,1,87791,88321,530
2022-03-01,70047,70043,Blue,0,20193,20489,296
2022-02-02,70045,70041,Blue,0,53111,53323,212
2022-12-21,70038,70050,Blue,1,76406,77004,598
2022-02-23,70059,70047,Blue,0,29959,30565,606
2022-01-05,70047,70039,Blue,0,34424,34817,393
2022-09-10,70059,70049,Blue,0,24132,24606,474
2022-05-26,70046,70052,Blue,1,41352,41795,443
2022-12-22,70057,70041,Blue,0,52876,53805,929
2022-06-13,70059,70055,Blue,0,22403,22572,169
2022-10-01,70051,70043,Blue,0,33411,33912,501
2022-12-29,70043,70039,Blue,0,58010,58117,107
2022-09-19,70040,70044,Blue,1,54197,54332,135
2022-01-26,70046,70060,Blue,1,57081,58242,1161
2022-06-29,70047,70045,Blue,0,29125,29239,114
2022-08-19,70059,70043,Blue,0,23862,24825,963
2022-08-13,70049,70047,Blue,0,64326,64381,55
2022-06-26,70038,70044,Blue,1,29376,29544,168
2022-01-11,70042,70058,Blue,1,70046,70890,844
2022-10-10,70042,70050,Blue,1,48376,48781,405
2022-08-18,70040,70056,Blue,1,46847,47717,870
2022-07-25,70059,70838,Blue,0,21788,23056,1268
2022-06-25,70055,70045,Blue,0,79952,80517,565
2022-07-01,70059,70055,Blue,0,70491,70621,130
2022-10-15,70038,70054,Blue,1,50712,51501,789
2022-04-21,70040,70046,Blue,1,77593,77874,281
2022-12-06,70057,70051,Blue,0,73408,73643,235
2022-01-18,70051,70045,Blue,0,56326,56640,314
2022-12-28,70055,70043,Blue,0,88302,88988,686
2022-02-07,70040,70060,Blue,1,57833,59034,1201
2022-10-27,70046,70050,Blue,1,65310,65505,195
2022-11-20,70043,70041,Blue,0,53707,53736,29
2022-04-02,70049,70838,Blue,0,40659,41294,635
2022-03-01,70040,70056,Blue,1,55094,55873,779
2022-05-04,70054,70056,Blue,1,22084,22132,48
2022-09-21,70041,70838,Blue,0,23281,23407,126
2022-08-26,70049,70041,Blue,0,74260,74709,449
2022-09-16,70051,70045,Blue,0,72165,72514,349
2022-11-01,70055,70049,Blue,0,26149,26635,486
2022-03-13,70040,70052,Blue,1,79758,80433,675
2022-08-13,70058,70060,Blue,1,64246,64311,65
2022-09-13,70044,70048,Blue,1,54088,54314,226
2022-04-21,70051,70047,Blue,0,28846,29080,234
2022-01-17,70048,70058,Blue,1,59937,60495,558
2022-06-21,70059,70051,Blue,0,27847,28211,364
2022-02-04,70040,70050,Blue,1,39804,40402,598
2022-01-28,70048,70058,Blue,1,71964,72473,509
2022-07-04,70038,70058,Blue,1,51209,52591,1382
2022-08-22,70042,70060,Blue,1,54473,55534,1061
2022-07-15,70040,70046,Blue,1,26130,26390,260
2022-03-23,70057,70055,Blue,0,38213,38285,72
2022-02-08,70059,70049,Blue,0,31826,32299,473
2022-10-26,70057,70047,Blue,0,35887,36410,523
2022-10-04,70057,70838,Blue,0,40782,41881,1099
2022-03-07,70053,70051,Blue,0,33862,33939,77
2022-09-04,70040,70046,Blue,1,23833,24075,242
2022-11-11,70047,70043,Blue,0,32452,32688,236
2022-01-04,70059,70057,Blue,0,31156,31202,46
2022-07-29,70059,70049,Blue,0,23434,23905,471
2022-02-28,70042,70052,Blue,1,25036,25665,629
2022-02-17,70048,70054,Blue,1,56841,57142,301
2022-01-12,70042,70060,Blue,1,85122,86315,1193
2022-11-25,70040,70060,Blue,1,46718,47770,1052
2022-03-15,70054,70056,Blue,1,30876,30922,46
2022-01-10,70042,70056,Blue,1,57402,58247,845
2022-09-23,70056,70060,Blue,1,74054,74218,164
2022-12-03,70051,70838,Blue,0,36066,36828,762
2022-10-25,70038,70054,Blue,1,76004,76840,836
2022-06-18,70040,70052,Blue,1,78720,79482,762
2022-11-29,70057,70053,Blue,0,59842,59990,148
2022-12-09,70050,70054,Blue,1,69092,69319,227
2022-09-28,70055,70039,Blue,0,87494,88343,849
2022-07-09,70040,70052,Blue,1,30784,31413,629
2022-03-08,70040,70056,Blue,1,60241,61061,820
2022-02-15,70052,70060,Blue,1,26480,26880,400
2022-01-27,70046,70060,Blue,1,46223,47048,825
2022-11-14,70059,70039,Blue,0,49400,50428,1028
2022-05-16,70059,70049,Blue,0,80416,80913,497
2022-11-14,70055,70051,Blue,0,55884,56029,145
2022-07-02,70044,70052,Blue,1,48779,49313,534
2022-05-22,70038,70046,Blue,1,51919,52334,415
2022-10-03,70059,70838,Blue,0,86068,87520,1452
2022-04-04,70048,70060,Blue,1,39639,40300,661
2022-04-23,70045,70039,Blue,0,55930,56198,268
2022-07-13,70053,70041,Blue,0,36639,37348,709
2022-08-30,70040,70050,Blue,1,87429,87873,444
2022-01-18,70044,70050,Blue,1,54228,54552,324
2022-04-16,70041,70039,Blue,0,25910,25941,31
2022-04-29,70051,70049,Blue,0,55109,55212,103
2022-04-19,70059,70039,Blue,0,86935,87993,1058
2022-09-12,70055,70053,Blue,0,88295,88341,46
2022-08-27,70038,70040,Blue,1,78219,78239,20
2022-07-20,70055,70838,Blue,0,31582,32605,1023
2022-06-25,70048,70052,Blue,1,40591,40788,197
2022-11-09,70038,70040,Blue,1,67936,67950,14
2022-10-20,70057,70049,Blue,0,33095,33649,554
2022-09-25,70048,70058,Blue,1,28164,28658,494
2022-09-30,70040,70056,Blue,1,25263,26063,800
2022-10-12,70054,70058,Blue,1,77542,77695,153
2022-09-08,70045,70838,Blue,0,54278,54611,333
2022-08-19,70052,70054,Blue,1,43726,43784,58
2022-09-01,70059,70049,Blue,0,56955,57419,464
2022-04-13,70038,70054,Blue,1,20737,21677,940
2022-08-07,70038,70050,Blue,1,68826,69339,513
2022-12-31,70059,70047,Blue,0,30327,30909,582
2022-07-01,70044,70054,Blue,1,59144,59784,640
2022-03-30,70046,70056,Blue,1,41118,41682,564
2022-11-05,70053,70049,Blue,0,72236,72446,210
2022-05-17,70052,70058,Blue,1,38863,39106,243
2022-08-13,70054,70058,Blue,1,87574,88193,619
2022-05-28,70042,70052,Blue,1,70606,71278,672
2022-07-26,70050,70056,Blue,1,55495,55857,362
2022-03-08,70057,70047,Blue,0,65667,66158,491
2022-08-19,70048,70054,Blue,1,33509,33847,338
2022-04-18,70053,70039,Blue,0,65854,66608,754
2022-01-01,70055,70051,Blue,0,71302,71462,160
2022-04-01,70054,70056,Blue,1,65431,65478,47
2022-06-24,70045,70041,Blue,0,64222,64406,184
2022-05-19,70055,70043,Blue,0,23236,24073,837
2022-03-07,70058,70060,Blue,1,27983,28074,91
2022-04-12,70055,70039,Blue,0,57671,58529,858
2022-01-25,70059,70043,Blue,0,19162,20131,969
2022-11-04,70040,70050,Blue,1,61206,61686,480
2022-07-29,70038,70048,Blue,1,24872,25301,429
2022-11-17,70046,70060,Blue,1,71489,72255,766
2022-12-29,70042,70052,Blue,1,60699,61248,549
2022-03-12,70046,70054,Blue,1,27835,28259,424
2022-10-15,70050,70056,Blue,1,38348,38636,288
2022-04-29,70052,70054,Blue,1,31234,31287,53
2022-09-22,70053,70051,Blue,0,67360,67407,47
2022-04-06,70043,70838,Blue,0,22666,22879,213
2022-08-17,70044,70058,Blue,1,79042,79804,762
2022-06-10,70042,70060,Blue,1,78819,79866,1047
2022-06-21,70048,70056,Blue,1,29975,30420,445
2022-08-22,70044,70058,Blue,1,61064,61904,840
2022-04-21,70040,70060,Blue,1,26102,27183,1081
2022-01-25,70038,70050,Blue,1,30550,31137,587
2022-07-17,70040,70046,Blue,1,71590,71844,254
2022-12-24,70043,70039,Blue,0,58214,58323,109
2022-12-21,70038,70046,Blue,1,68713,69079,366
2022-03-07,70059,70043,Blue,0,24252,25067,815
2022-12-02,70053,70051,Blue,0,38384,38434,50
2022-10-30,70052,70060,Blue,1,53356,53693,337
2022-02-17,70048,70058,Blue,1,73495,73992,497
2022-06-17,70046,70048,Blue,1,85496,85576,80
2022-12-19,70042,70056,Blue,1,28395,29190,795
2022-12-02,70049,70838,Blue,0,23106,23734,628
2022-03-30,70051,70043,Blue,0,35067,35576,509
2022-05-20,70054,70058,Blue,1,26635,26786,151
2022-07-23,70040,70052,Blue,1,82153,82825,672
2022-02-27,70045,70041,Blue,0,75663,75837,174
2022-03-31,70045,70041,Blue,0,40822,41042,220
2022-12-06,70059,70043,Blue,0,61943,62763,820
2022-11-13,70049,70045,Blue,0,67282,67483,201
2022-05-19,70059,70053,Blue,0,42679,42938,259
2022-07-22,70057,70053,Blue,0,20492,20640,148
2022-06-30,70050,70060,Blue,1,56136,56676,540
2022-03-30,70039,70838,Blue,0,32817,32850,33
2022-06-23,70057,70049,Blue,0,56198,56592,394
2022-04-21,70054,70056,Blue,1,58620,58668,48
2022-06-15,70056,70058,Blue,1,40631,40703,72
2022-08-30,70038,70056,Blue,1,51539,52446,907
2022-05-27,70044,70052,Blue,1,31235,31852,617
2022-12-13,70052,70058,Blue,1,67793,68047,254
2022-03-08,70058,70060,Blue,1,48038,48105,67
2022-09-13,70056,70060,Blue,1,48270,48453,183
2022-08-18,70038,70044,Blue,1,24048,24227,179
2022-06-16,70058,70060,Blue,1,42455,42591,136
2022-06-14,70056,70060,Blue,1,55307,55514,207
2022-03-15,70055,70041,Blue,0,49402,50172,770
2022-11-10,70048,70056,Blue,1,69133,69546,413
2022-02-15,70038,70048,Blue,1,33880,34370,490
2022-12-19,70051,70041,Blue,0,29890,30539,649
2022-02-08,70053,70045,Blue,0,75208,75633,425
2022-02-10,70055,70043,Blue,0,61883,62605,722
2022-09-05,70057,70041,Blue,0,73347,74427,1080
2022-08-05,70040,70046,Blue,1,38967,39231,264
2022-09-08,70042,70048,Blue,1,31343,31672,329
2022-04-06,70057,70051,Blue,0,82962,83222,260
2022-01-15,70057,70838,Blue,0,74542,75608,1066
2022-01-04,70040,70046,Blue,1,74713,74989,276
2022-07-08,70049,70039,Blue,0,56359,56891,532
2022-09-20,70055,70039,Blue,0,44412,45303,891
2022-06-18,70053,70039,Blue,0,72684,73457,773
2022-03-07,70058,70060,Blue,1,55703,55763,60
2022-06-22,70055,70039,Blue,0,58802,59671,869
2022-07-08,70038,70042,Blue,1,66075,66179,104
2022-11-27,70049,70043,Blue,0,71595,71921,326
2022-07-21,70038,70048,Blue,1,65560,66045,485
2022-06-27,70055,70043,Blue,0,76655,77288,633
2022-09-17,70048,70058,Blue,1,70101,70612,511
2022-06-27,70049,70047,Blue,0,71072,71127,55
2022-07-27,70046,70056,Blue,1,66303,66838,535
2022-11-17,70051,70838,Blue,0,60433,61131,698
2022-02-01,70038,70050,Blue,1,27780,28415,635
2022-10-10,70046,70052,Blue,1,39171,39534,363
2022-01-27,70048,70058,Blue,1,84177,84664,487
2022-01-06,70053,70838,Blue,0,58680,59591,911
2022-03-22,70040,70048,Blue,1,61398,61822,424
2022-01-02,70058,70060,Blue,1,36499,36565,66
2022-11-16,70054,70060,Blue,1,22049,22336,287
2022-07-11,70051,70041,Blue,0,41481,42138,657
2022-08-05,70038,70042,Blue,1,42482,42579,97
2022-12-30,70038,70042,Blue,1,43699,43799,100
2022-02-08,70044,70058,Blue,1,51616,52451,835
2022-08-16,70057,70047,Blue,0,65621,66120,499
2022-03-18,70059,70043,Blue,0,47113,48051,938
2022-10-24,70053,70838,Blue,0,88380,89720,1340
2022-12-23,70046,70054,Blue,1,36994,37464,470
2022-10-14,70044,70054,Blue,1,74987,75627,640
2022-07-11,70049,70041,Blue,0,46797,47535,738
2022-03-11,70051,70838,Blue,0,51315,52071,756
2022-01-08,70044,70052,Blue,1,63872,64341,469
2022-04-13,70043,70039,Blue,0,33059,33173,114
2022-03-09,70058,70060,Blue,1,31630,31706,76
2022-12-21,70047,70045,Blue,0,34938,35036,98
2022-11-19,70044,70056,Blue,1,51474,52113,639
2022-03-24,70043,70041,Blue,0,69325,69352,27
2022-05-19,70059,70053,Blue,0,27269,27513,244
2022-02-14,70040,70058,Blue,1,34563,35576,1013
2022-07-12,70055,70045,Blue,0,54908,55427,519
2022-03-14,70038,70048,Blue,1,21859,22354,495
2022-11-08,70059,70043,Blue,0,49937,50791,854
2022-02-02,70055,70045,Blue,0,67662,68160,498
2022-08-25,70048,70060,Blue,1,72606,73231,625
2022-12-31,70045,70039,Blue,0,58558,58806,248
2022-01-20,70044,70054,Blue,1,64562,65165,603
2022-07-06,70043,70039,Blue,0,22689,22799,110
2022-10-31,70057,70049,Blue,0,51039,51409,370
2022-08-28,70052,70060,Blue,1,66899,67256,357
2022-06-01,70047,70043,Blue,0,76717,77043,326
2022-06-10,70042,70044,Blue,1,43747,43778,31
2022-06-30,70057,70838,Blue,0,34971,36248,1277
2022-01-12,70058,70060,Blue,1,67027,67102,75
2022-01-21,70055,70053,Blue,0,67700,67755,55
2022-01-24,70038,70050,Blue,1,35702,36307,605
2022-03-20,70052,70054,Blue,1,35441,35495,54
2022-12-31,70053,70045,Blue,0,64801,65248,447
2022-07-26,70051,70041,Blue,0,57035,57742,707
2022-12-28,70059,70053,Blue,0,71960,72245,285
2022-08-18,70043,70838,Blue,0,74365,74546,181
2022-12-03,70059,70049,Blue,0,45435,45951,516
2022-12-30,70044,70046,Blue,1,56300,56409,109
2022-12-05,70055,70051,Blue,0,59968,60105,137
2022-11-22,70041,70039,Blue,0,74705,74734,29
2022-02-08,70049,70838,Blue,0,82262,82846,584
2022-11-16,70051,70041,Blue,0,41278,41828,550
2022-07-28,70059,70045,Blue,0,71236,71940,704
2022-04-21,70047,70838,Blue,0,88688,89411,723
2022-05-22,70047,70838,Blue,0,28097,28731,634
2022-06-27,70040,70048,Blue,1,34674,35074,400
2022-12-31,70042,70052,Blue,1,38422,38982,560
2022-03-09,70053,70045,Blue,0,86020,86420,400
2022-09-28,70044,70058,Blue,1,69818,70613,795
2022-12-12,70047,70838,Blue,0,66860,67349,489
2022-03-18,70045,70041,Blue,0,64823,65058,235
2022-08-28,70049,70039,Blue,0,58133,58631,498
2022-12-22,70050,70054,Blue,1,71104,71338,234
2022-10-18,70044,70058,Blue,1,54126,54927,801
2022-08-27,70057,70043,Blue,0,67123,67911,788
2022-08-18,70048,70056,Blue,1,79362,79769,407
2022-10-03,70040,70058,Blue,1,59174,60153,979
2022-01-02,70038,70058,Blue,1,63972,64972,1000
2022-12-31,70059,70045,Blue,0,36256,36961,705
2022-05-09,70052,70058,Blue,1,23244,23491,247
2022-04-05,70055,70053,Blue,0,46275,46323,48
2022-07-25,70052,70058,Blue,1,48728,48989,261
2022-10-02,70042,70052,Blue,1,83864,84453,589
2022-12-19,70038,70054,Blue,1,28620,29428,808
2022-04-18,70057,70039,Blue,0,37162,38258,1096
2022-01-31,70051,70838,Blue,0,76464,77215,751
2022-07-25,70038,70050,Blue,1,43166,43703,537
2022-08-31,70038,70048,Blue,1,38052,38466,414
2022-04-06,70048,70052,Blue,1,40237,40453,216
2022-07-27,70044,70056,Blue,1,84962,85772,810
2022-08-27,70046,70048,Blue,1,53917,53998,81
2022-04-03,70042,70044,Blue,1,31729,31759,30
2022-06-13,70046,70050,Blue,1,35572,35771,199
2022-03-01,70038,70050,Blue,1,57634,58194,560
2022-10-29,70053,70039,Blue,0,74863,75643,780
2022-11-21,70051,70039,Blue,0,55463,56112,649
2022-12-29,70050,70060,Blue,1,64598,65135,537
2022-08-26,70038,70052,Blue,1,29859,30597,738
2022-11-19,70046,70050,Blue,1,35957,36139,182
2022-10-31,70038,70042,Blue,1,70040,70145,105
2022-01-11,70053,70838,Blue,0,30920,31799,879
2022-09-20,70047,70838,Blue,0,65642,66105,463
2022-07-04,70054,70060,Blue,1,43000,43269,269
2022-12-30,70046,70048,Blue,1,69103,69185,82
2022-01-14,70056,70060,Blue,1,58581,58758,177
2022-11-17,70054,70058,Blue,1,30536,30713,177
2022-07-20,70055,70051,Blue,0,59627,59769,142
2022-07-19,70042,70048,Blue,1,30011,30338,327
2022-08-21,70059,70039,Blue,0,71115,72126,1011
2022-03-12,70040,70054,Blue,1,47572,48281,709
2022-04-13,70056,70060,Blue,1,23700,23885,185
2022-06-26,70052,70056,Blue,1,41099,41249,150
2022-08-06,70059,70043,Blue,0,74596,75493,897
2022-10-18,70040,70042,Blue,1,84990,85023,33
2022-01-10,70040,70058,Blue,1,56578,57794,1216
2022-11-21,70050,70056,Blue,1,74130,74436,306
2022-03-01,70051,70043,Blue,0,45866,46383,517
2022-02-17,70053,70041,Blue,0,69401,70161,760
2022-12-24,70051,70043,Blue,0,61999,62553,554
2022-05-26,70046,70050,Blue,1,55039,55251,212
2022-03-03,70045,70041,Blue,0,84319,84524,205
2022-05-21,70046,70048,Blue,1,26190,26291,101
2022-10-19,70038,70054,Blue,1,62686,63565,879
2022-10-22,70040,70048,Blue,1,61570,61981,411
2022-01-06,70040,70046,Blue,1,64697,64952,255
2022-10-23,70044,70048,Blue,1,42520,42751,231
2022-04-02,70040,70044,Blue,1,47535,47651,116
2022-10-22,70053,70051,Blue,0,52728,52780,52
2022-04-21,70059,70057,Blue,0,78913,78948,35
2022-04-13,70052,70060,Blue,1,81072,81438,366
2022-03-06,70042,70054,Blue,1,84761,85424,663
2022-10-06,70059,70039,Blue,0,63443,64451,1008
2022-10-16,70057,70055,Blue,0,42873,42943,70
2022-09-28,70055,70047,Blue,0,45461,45871,410
2022-01-21,70049,70838,Blue,0,25782,26439,657
2022-04-29,70055,70053,Blue,0,31586,31632,46
2022-01-29,70048,70058,Blue,1,59263,60858,1595
2022-11-08,70045,70838,Blue,0,24552,24894,342
2022-07-08,70057,70049,Blue,0,52882,53265,383
2022-11-16,70053,70045,Blue,0,67411,67806,395
2022-09-24,70049,70047,Blue,0,23348,23424,76
2022-07-10,70051,70041,Blue,0,55858,56494,636
2022-03-02,70040,70054,Blue,1,75871,76687,816
2022-03-03,70053,70043,Blue,0,29665,30299,634
2022-10-10,70038,70044,Blue,1,89112,89293,181
2022-07-14,70050,70060,Blue,1,21806,22380,574
2022-03-31,70052,70054,Blue,1,73239,73297,58
2022-03-31,70057,70051,Blue,0,60268,60500,232
2022-09-11,70048,70054,Blue,1,36718,36981,263
2022-09-06,70045,70041,Blue,0,84316,84488,172
2022-04-18,70046,70060,Blue,1,32105,32863,758
2022-01-21,70045,70838,Blue,0,33219,33613,394
2022-02-03,70057,70043,Blue,0,59133,60334,1201
2022-03-17,70057,70047,Blue,0,24332,24792,460
2022-10-08,70050,70056,Blue,1,58380,58663,283
2022-03-29,70054,70060,Blue,1,64974,65301,327
2022-11-14,70054,70058,Blue,1,79750,79922,172
2022-10-11,70046,70060,Blue,1,30218,30999,781
2022-12-08,70046,70056,Blue,1,63358,63900,542
2022-02-24,70038,70044,Blue,1,69434,69650,216
2022-06-27,70051,70045,Blue,0,87338,87683,345
2022-08-30,70058,70060,Blue,1,36038,36105,67
2022-03-29,70057,70838,Blue,0,82964,84075,1111
2022-06-01,70038,70052,Blue,1,53112,53943,831
2022-07-13,70059,70041,Blue,0,22582,23689,1107
2022-10-15,70052,70060,Blue,1,71447,71797,350
2022-07-21,70057,70838,Blue,0,53133,54239,1106
2022-01-03,70046,70052,Blue,1,47861,48167,306
2022-06-10,70040,70054,Blue,1,37933,38704,771
2022-10-04,70055,70039,Blue,0,42877,43811,934
2022-07-16,70040,70056,Blue,1,64282,65142,860
2022-08-03,70040,70060,Blue,1,69185,70267,1082
2022-09-22,70049,70045,Blue,0,52224,52442,218
2022-07-12,70050,70052,Blue,1,86332,86439,107
2022-02-26,70043,70039,Blue,0,62056,62164,108
2022-09-23,70040,70042,Blue,1,55611,55645,34
2022-08-16,70040,70054,Blue,1,53042,53864,822
2022-04-02,70045,70041,Blue,0,49980,50161,181
2022-07-05,70055,70838,Blue,0,26979,27953,974
2022-09-22,70049,70043,Blue,0,46449,46772,323
2022-01-04,70038,70046,Blue,1,66732,67081,349
2022-10-14,70055,70039,Blue,0,36091,36933,842
2022-12-27,70044,70050,Blue,1,53576,53914,338
2022-04-27,70057,70051,Blue,0,86551,86839,288
2022-12-16,70045,70838,Blue,0,85743,86057,314
2022-02-15,70045,70043,Blue,0,41213,41304,91
2022-10-11,70045,70041,Blue,0,57391,57566,175
2022-01-24,70046,70060,Blue,1,64123,64926,803
2022-06-18,70046,70052,Blue,1,35443,35802,359
2022-02-19,70057,70039,Blue,0,83255,84225,970
2022-08-27,70059,70838,Blue,0,24801,25912,1111
2022-03-11,70053,70045,Blue,0,59248,59701,453
2022-02-22,70044,70048,Blue,1,35335,35580,245
2022-03-20,70049,70045,Blue,0,87810,88039,229
2022-09-10,70051,70047,Blue,0,77470,77659,189
2022-09-25,70041,70838,Blue,0,55986,56103,117
2022-10-28,70057,70053,Blue,0,29853,30017,164
2022-06-13,70046,70054,Blue,1,79558,80028,470
2022-06-30,70053,70047,Blue,0,55565,55876,311
2022-10-22,70047,70041,Blue,0,59535,59857,322
2022-04-24,70059,70041,Blue,0,23053,23947,894
2022-02-04,70050,70056,Blue,1,29639,29974,335
2022-01-18,70056,70060,Blue,1,34856,35181,325
2022-10-05,70053,70838,Blue,0,21753,22686,933
2022-02-04,70050,70060,Blue,1,80931,81503,572
2022-03-11,70049,70047,Blue,0,35721,35775,54
2022-03-22,70055,70049,Blue,0,21327,21685,358
2022-03-11,70053,70039,Blue,0,64300,65015,715
2022-04-14,70048,70054,Blue,1,28978,29308,330
2022-12-02,70038,70046,Blue,1,74790,75112,322
2022-09-28,70046,70056,Blue,1,35721,36217,496
2022-04-01,70059,70049,Blue,0,68586,69065,479
2022-06-12,70042,70058,Blue,1,24720,25610,890
2022-09-14,70057,70039,Blue,0,63009,64011,1002
2022-12-26,70042,70054,Blue,1,60354,61042,688
2022-03-23,70042,70052,Blue,1,34302,35278,976
2022-09-08,70048,70054,Blue,1,40053,40406,353
2022-12-11,70047,70043,Blue,0,72269,72501,232
2022-03-15,70042,70056,Blue,1,73650,74360,710
2022-09-10,70050,70058,Blue,1,25563,26308,745
2022-05-21,70052,70056,Blue,1,60264,60421,157
2022-08-17,70053,70047,Blue,0,35714,36018,304
2022-04-12,70048,70052,Blue,1,36408,36773,365
2022-10-19,70053,70838,Blue,0,19807,20753,946
2022-10-17,70057,70055,Blue,0,26434,26506,72
2022-10-09,70046,70050,Blue,1,42010,42184,174
2022-02-27,70044,70058,Blue,1,45856,46760,904
2022-12-16,70038,70040,Blue,1,67700,67716,16
2022-03-15,70049,70043,Blue,0,36416,36782,366
2022-10-31,70051,70049,Blue,0,31794,31897,103
2022-07-21,70047,70039,Blue,0,43851,44309,458
2022-08-24,70059,70053,Blue,0,42950,43189,239
2022-04-20,70040,70050,Blue,1,85447,85952,505
2022-10-21,70050,70058,Blue,1,62361,62771,410
2022-02-03,70048,70054,Blue,1,51288,51614,326
2022-03-24,70047,70043,Blue,0,69056,69283,227
2022-08-30,70042,70060,Blue,1,55620,56594,974
2022-01-11,70048,70058,Blue,1,63046,63563,517
2022-09-11,70040,70048,Blue,1,52727,53103,376
2022-06-09,70059,70043,Blue,0,36428,37340,912
2022-12-28,70038,70054,Blue,1,22717,23506,789
2022-01-04,70040,70052,Blue,1,79222,80238,1016
2022-08-28,70053,70045,Blue,0,21774,22256,482
2022-07-07,70056,70060,Blue,1,59264,59540,276
2022-01-26,70059,70053,Blue,0,26950,27218,268
2022-10-16,70055,70838,Blue,0,83954,84885,931
2022-08-22,70045,70041,Blue,0,21204,21382,178
2022-04-11,70055,70838,Blue,0,62557,63595,1038
2022-04-19,70044,70052,Blue,1,62505,63008,503
2022-08-21,70047,70045,Blue,0,88966,89075,109
2022-07-20,70042,70050,Blue,1,23591,24010,419
2022-01-11,70049,70045,Blue,0,64908,65131,223
2022-12-30,70040,70060,Blue,1,72898,73963,1065
2022-12-04,70038,70050,Blue,1,42904,43488,584
2022-03-17,70051,70041,Blue,0,45303,45846,543
2022-07-25,70047,70039,Blue,0,55727,56198,471
2022-08-03,70059,70039,Blue,0,68471,69493,1022
2022-10-14,70045,70043,Blue,0,28379,28471,92
2022-08-28,70046,70052,Blue,1,58474,58800,326
2022-12-21,70038,70052,Blue,1,42433,43138,705
2022-01-19,70038,70052,Blue,1,59876,60616,740
2022-06-20,70044,70050,Blue,1,82523,82940,417
2022-12-30,70049,70041,Blue,0,37635,38091,456
2022-03-09,70046,70052,Blue,1,80184,80538,354
2022-12-30,70042,70048,Blue,1,43269,43593,324
2022-02-25,70044,70058,Blue,1,89374,90153,779
2022-03-04,70038,70060,Blue,1,54078,55412,1334
2022-07-04,70044,70060,Blue,1,26502,27427,925
2022-03-10,70040,70046,Blue,1,83857,84137,280
2022-04-07,70040,70048,Blue,1,53426,53923,497
2022-06-17,70040,70048,Blue,1,25516,25937,421
2022-07-31,70051,70838,Blue,0,35892,36659,767
2022-01-10,70059,70047,Blue,0,61694,62272,578
2022-09-04,70055,70041,Blue,0,39793,40554,761
2022-08-04,70043,70039,Blue,0,65652,65750,98
2022-04-05,70038,70042,Blue,1,82585,82682,97
2022-01-18,70055,70053,Blue,0,30087,30189,102
2022-09-11,70053,70039,Blue,0,62217,63017,800
2022-01-18,70045,70039,Blue,0,54307,54645,338
2022-11-18,70057,70051,Blue,0,84350,84590,240
2022-02-14,70055,70043,Blue,0,41708,42443,735
2022-12-08,70055,70049,Blue,0,27675,27962,287
2022-06-28,70053,70041,Blue,0,82242,82878,636
2022-01-31,70059,70039,Blue,0,26346,27679,1333
2022-08-25,70054,70056,Blue,1,24411,24458,47
2022-04-09,70052,70054,Blue,1,51508,51560,52
2022-07-18,70055,70043,Blue,0,34087,34734,647
2022-02-13,70051,70049,Blue,0,45004,45110,106
2022-06-15,70052,70058,Blue,1,85651,85894,243
2022-07-22,70054,70060,Blue,1,59277,59547,270
2022-01-14,70059,70053,Blue,0,82876,83139,263
2022-03-22,70042,70050,Blue,1,62873,63291,418
2022-02-07,70050,70052,Blue,1,52379,52551,172
2022-03-29,70046,70048,Blue,1,28857,28958,101
2022-04-11,70051,70041,Blue,0,39055,39635,580
2022-08-13,70056,70060,Blue,1,27855,28017,162
2022-03-16,70050,70060,Blue,1,28162,28680,518
2022-12-29,70047,70039,Blue,0,22449,22842,393
2022-07-06,70044,70048,Blue,1,58577,58847,270
2022-05-20,70055,70043,Blue,0,58576,59473,897
2022-07-08,70050,70052,Blue,1,82665,82800,135
2022-09-03,70041,70838,Blue,0,66476,66598,122
2022-06-22,70050,70058,Blue,1,40168,40668,500
2022-09-26,70046,70054,Blue,1,77723,78139,416
2022-09-08,70051,70039,Blue,0,52884,53548,664
2022-08-12,70056,70060,Blue,1,32894,33060,166
2022-01-27,70057,70838,Blue,0,69676,70923,1247
2022-10-04,70042,70044,Blue,1,25832,25861,29
2022-04-03,70044,70056,Blue,1,27899,28564,665
2022-06-27,70040,70060,Blue,1,26228,27584,1356
2022-04-05,70053,70045,Blue,0,67411,67830,419
2022-08-10,70059,70045,Blue,0,71249,71934,685
2022-03-02,70057,70049,Blue,0,80142,80591,449
2022-06-16,70050,70052,Blue,1,41911,42026,115
2022-03-24,70057,70838,Blue,0,59371,60566,1195
2022-11-26,70046,70052,Blue,1,60283,60608,325
2022-08-30,70040,70042,Blue,1,34527,34559,32
2022-10-29,70040,70042,Blue,1,82292,82330,38
2022-11-17,70045,70039,Blue,0,60813,61038,225
2022-02-11,70038,70040,Blue,1,42429,42451,22
2022-10-12,70050,70054,Blue,1,51548,51762,214
2022-12-27,70057,70045,Blue,0,68599,69214,615
2022-12-21,70053,70043,Blue,0,57816,58378,562
2022-02-15,70051,70047,Blue,0,70894,71093,199
2022-01-29,70052,70056,Blue,1,43642,44072,430
2022-12-18,70054,70060,Blue,1,40430,40675,245
2022-02-15,70050,70054,Blue,1,21438,21646,208
2022-01-22,70055,70047,Blue,0,69383,69754,371
2022-03-03,70051,70049,Blue,0,35594,35696,102
2022-02-19,70055,70041,Blue,0,26173,27005,832
2022-03-31,70055,70053,Blue,0,48855,48902,47
2022-02-18,70038,70050,Blue,1,56237,56772,535
2022-02-04,70053,70041,Blue,0,57693,58358,665
2022-01-13,70046,70050,Blue,1,33633,33823,190
2022-07-05,70059,70057,Blue,0,60630,60665,35
2022-04-11,70045,70043,Blue,0,33434,33528,94
2022-11-18,70040,70056,Blue,1,46229,47494,1265
2022-12-12,70059,70049,Blue,0,44787,45297,510
2022-11-07,70046,70052,Blue,1,27463,27854,391
2022-07-08,70040,70054,Blue,1,83862,84656,794
2022-02-28,70040,70044,Blue,1,68673,68780,107
2022-02-12,70059,70045,Blue,0,45973,46678,705
2022-01-15,70038,70048,Blue,1,62984,63503,519
2022-11-12,70040,70048,Blue,1,71833,72230,397
2022-06-26,70055,70045,Blue,0,58571,59099,528
2022-03-16,70044,70052,Blue,1,32545,32992,447
2022-09-17,70040,70050,Blue,1,38013,38889,876
2022-03-12,70055,70053,Blue,0,52108,52154,46
2022-11-25,70057,70047,Blue,0,40698,41572,874
2022-09-24,70040,70060,Blue,1,78026,79073,1047
2022-11-17,70046,70056,Blue,1,37667,38214,547
2022-04-14,70046,70058,Blue,1,55458,56112,654
2022-03-04,70042,70054,Blue,1,71153,71909,756
2022-11-15,70051,70039,Blue,0,25798,26471,673
2022-04-06,70051,70838,Blue,0,33076,34050,974
2022-07-13,70050,70058,Blue,1,64704,65127,423
2022-12-06,70038,70060,Blue,1,27838,29017,1179
2022-11-08,70047,70838,Blue,0,25643,26179,536
2022-09-28,70051,70047,Blue,0,36276,36503,227
2022-09-04,70049,70047,Blue,0,75919,75978,59
2022-10-24,70050,70060,Blue,1,86582,87126,544
2022-04-29,70056,70058,Blue,1,87229,87300,71
2022-11-10,70044,70056,Blue,1,56074,56751,677
2022-08-03,70057,70045,Blue,0,27689,28315,626
2022-12-02,70038,70042,Blue,1,56740,56848,108
2022-04-12,70055,70049,Blue,0,59478,59788,310
2022-03-30,70050,70056,Blue,1,24929,25248,319
2022-10-30,70038,70046,Blue,1,37694,38009,315
2022-11-25,70046,70058,Blue,1,29797,30418,621
2022-04-12,70042,70048,Blue,1,60587,60890,303
2022-09-27,70043,70838,Blue,0,74181,74350,169
2022-07-06,70040,70056,Blue,1,52306,53366,1060
2022-08-08,70038,70046,Blue,1,23959,24270,311
2022-09-30,70039,70838,Blue,0,21491,21525,34
2022-05-22,70050,70052,Blue,1,40549,40733,184
2022-07-06,70044,70050,Blue,1,26374,26739,365
2022-07-08,70042,70050,Blue,1,63362,63821,459
2022-07-10,70041,70039,Blue,0,67836,67867,31
2022-01-06,70040,70042,Blue,1,59939,59976,37
2022-07-26,70055,70041,Blue,0,79338,80112,774
2022-02-10,70052,70056,Blue,1,43544,43687,143
2022-07-05,70058,70060,Blue,1,37915,37983,68
2022-11-17,70048,70058,Blue,1,46626,47181,555
2022-07-08,70044,70054,Blue,1,25312,25956,644
2022-09-04,70045,70039,Blue,0,68630,68871,241
2022-02-21,70041,70838,Blue,0,49185,49309,124
2022-01-24,70059,70057,Blue,0,46092,46126,34
2022-07-13,70044,70054,Blue,1,65930,66627,697
2022-07-02,70043,70039,Blue,0,36091,36213,122
2022-10-29,70048,70054,Blue,1,44241,44556,315
2022-04-24,70048,70054,Blue,1,58026,58375,349
2022-04-18,70051,70043,Blue,0,58444,58965,521
2022-05-06,70052,70054,Blue,1,49651,49699,48
2022-11-30,70045,70838,Blue,0,53462,53904,442
2022-09-11,70038,70042,Blue,1,78549,78641,92
2022-07-24,70055,70051,Blue,0,77240,77376,136
2022-04-26,70057,70051,Blue,0,71802,72054,252
2022-04-14,70049,70838,Blue,0,81721,82332,611
2022-09-22,70040,70044,Blue,1,34975,35084,109
2022-03-03,70042,70046,Blue,1,41094,41281,187
2022-03-16,70053,70043,Blue,0,53839,54379,540
2022-07-22,70052,70054,Blue,1,73213,73293,80
2022-08-09,70040,70050,Blue,1,49442,49957,515
2022-03-28,70055,70041,Blue,0,69268,69990,722
2022-03-25,70043,70838,Blue,0,37316,37508,192
2022-03-10,70045,70043,Blue,0,19460,19564,104
2022-10-30,70057,70045,Blue,0,71729,72370,641
2022-11-19,70041,70838,Blue,0,56720,56842,122
2022-08-10,70043,70041,Blue,0,40053,40085,32
2022-01-26,70054,70056,Blue,1,25440,25487,47
2022-12-21,70040,70052,Blue,1,68127,68787,660
2022-01-02,70038,70046,Blue,1,70996,71325,329
2022-04-15,70044,70052,Blue,1,68186,68698,512
2022-07-04,70051,70049,Blue,0,85031,85135,104
2022-07-06,70054,70058,Blue,1,70808,70963,155
2022-03-30,70046,70054,Blue,1,20742,21193,451
2022-04-14,70053,70041,Blue,0,56262,56902,640
2022-11-14,70048,70054,Blue,1,38218,38499,281
2022-07-20,70040,70048,Blue,1,33356,33751,395
2022-02-22,70038,70042,Blue,1,86020,86112,92
2022-07-04,70039,70838,Blue,0,75913,75997,84
2022-04-14,70048,70052,Blue,1,54533,54734,201
2022-09-16,70057,70055,Blue,0,61719,61789,70
2022-09-30,70046,70048,Blue,1,54895,54973,78
2022-11-14,70052,70060,Blue,1,31882,32268,386
2022-01-26,70048,70052,Blue,1,35913,36135,222
2022-10-06,70057,70053,Blue,0,39581,39734,153
2022-03-07,70059,70053,Blue,0,38122,38418,296
2022-06-19,70042,70052,Blue,1,66817,67414,597
2022-02-03,70052,70060,Blue,1,34737,35091,354
2022-09-18,70042,70050,Blue,1,40477,40959,482
2022-07-26,70056,70058,Blue,1,32585,32665,80
2022-09-04,70057,70051,Blue,0,47427,47665,238
2022-12-25,70052,70056,Blue,1,67395,67534,139
2022-03-01,70050,70058,Blue,1,57710,58143,433
2022-03-24,70052,70058,Blue,1,81099,81344,245
2022-01-10,70059,70041,Blue,0,46093,47414,1321
2022-04-21,70049,70041,Blue,0,56996,58099,1103
2022-12-05,70045,70041,Blue,0,84959,85118,159
2022-10-19,70050,70058,Blue,1,39394,39870,476
2022-09-11,70051,70041,Blue,0,63364,63922,558
2022-10-24,70052,70054,Blue,1,51561,51625,64
2022-10-10,70038,70050,Blue,1,71586,72126,540
2022-11-09,70040,70046,Blue,1,86620,86868,248
2022-05-11,70050,70056,Blue,1,59594,59908,314
2022-12-05,70038,70060,Blue,1,46638,47681,1043
2022-03-07,70053,70045,Blue,0,58848,59263,415
2022-10-17,70042,70052,Blue,1,65138,65723,585
2022-10-02,70053,70047,Blue,0,47094,47399,305
2022-06-18,70045,70041,Blue,0,81358,81574,216
2022-06-09,70038,70050,Blue,1,30253,30858,605
2022-06-28,70059,70053,Blue,0,45797,46048,251
2022-04-24,70048,70052,Blue,1,27371,27584,213
2022-02-20,70057,70838,Blue,0,47976,48970,994
2022-12-31,70038,70058,Blue,1,81846,82799,953
2022-03-25,70040,70048,Blue,1,44174,44579,405
2022-03-03,70046,70056,Blue,1,63310,63858,548
2022-01-20,70050,70060,Blue,1,26380,26899,519
2022-11-26,70051,70041,Blue,0,76149,76706,557
2022-07-24,70055,70049,Blue,0,24020,24308,288
2022-01-10,70053,70049,Blue,0,22380,22586,206
2022-01-22,70057,70049,Blue,0,31468,31910,442
2022-02-24,70038,70050,Blue,1,37902,38530,628
2022-02-18,70052,70054,Blue,1,34330,34389,59
2022-01-20,70053,70047,Blue,0,72864,73135,271
2022-01-10,70051,70041,Blue,0,58512,59071,559
2022-03-17,70048,70060,Blue,1,30762,31489,727
2022-07-11,70055,70053,Blue,0,60725,60771,46
2022-06-09,70048,70058,Blue,1,83196,83759,563
2022-07-01,70051,70045,Blue,0,48730,49075,345
2022-08-30,70045,70039,Blue,0,27961,28235,274
2022-12-15,70040,70054,Blue,1,72145,72911,766
2022-07-20,70039,70838,Blue,0,59761,59798,37
2022-04-09,70044,70060,Blue,1,64957,65853,896
2022-02-11,70038,70046,Blue,1,58662,58965,303
2022-03-16,70045,70041,Blue,0,35554,35726,172
2022-01-31,70042,70048,Blue,1,61790,62192,402
2022-03-17,70056,70058,Blue,1,54403,54474,71
2022-02-05,70047,70041,Blue,0,87160,87512,352
2022-01-05,70050,70054,Blue,1,71102,71308,206
2022-12-12,70051,70838,Blue,0,82613,83268,655
2022-03-18,70038,70048,Blue,1,80833,81283,450
2022-09-25,70051,70047,Blue,0,79141,79363,222
2022-07-19,70038,70056,Blue,1,44649,45570,921
2022-08-30,70055,70045,Blue,0,73479,73995,516
2022-06-15,70040,70048,Blue,1,90867,91484,617
2022-12-09,70046,70052,Blue,1,49652,50014,362
2022-06-19,70047,70043,Blue,0,81490,81744,254
2022-03-11,70049,70838,Blue,0,30268,30886,618
2022-02-01,70043,70838,Blue,0,48180,48398,218
2022-05-31,70042,70046,Blue,1,53770,53997,227
2022-11-22,70054,70060,Blue,1,58522,58790,268
2022-02-22,70038,70046,Blue,1,64045,64372,327
2022-12-09,70053,70051,Blue,0,45054,45112,58
2022-09-13,70046,70052,Blue,1,70029,70363,334
2022-07-05,70053,70051,Blue,0,87568,87626,58
2022-10-07,70059,70043,Blue,0,33082,33941,859
2022-01-29,70044,70050,Blue,1,44831,45493,662
2022-09-23,70042,70048,Blue,1,36434,36740,306
2022-09-03,70040,70042,Blue,1,46472,46502,30
2022-04-08,70049,70047,Blue,0,27509,27565,56
2022-05-18,70038,70052,Blue,1,33294,34094,800
2022-10-05,70049,70047,Blue,0,58210,58263,53
2022-02-10,70038,70042,Blue,1,31752,31865,113
2022-10-22,70038,70054,Blue,1,21019,21924,905
2022-01-24,70045,70039,Blue,0,33249,33506,257
2022-06-25,70038,70044,Blue,1,35086,35308,222
2022-03-21,70040,70050,Blue,1,65620,66198,578
2022-11-10,70051,70041,Blue,0,64908,65443,535
2022-03-18,70040,70060,Blue,1,83190,84270,1080
2022-07-11,70051,70041,Blue,0,57245,57825,580
2022-07-27,70044,70056,Blue,1,56821,57537,716
2022-01-12,70038,70042,Blue,1,29346,29430,84
2022-11-08,70053,70838,Blue,0,55375,56217,842
2022-06-22,70057,70049,Blue,0,60992,61478,486
2022-06-07,70046,70048,Blue,1,54000,54110,110
2022-09-30,70046,70052,Blue,1,39364,39698,334
2022-02-07,70057,70053,Blue,0,28844,29003,159
2022-08-05,70042,70044,Blue,1,78062,78091,29
2022-02-09,70047,70041,Blue,0,25795,26148,353
2022-11-02,70040,70042,Blue,1,24088,24121,33
2022-04-15,70053,70049,Blue,0,70773,70978,205
2022-08-02,70059,70838,Blue,0,33921,35067,1146
2022-09-23,70059,70043,Blue,0,58517,59386,869
2022-10-13,70053,70039,Blue,0,37748,38537,789
2022-06-10,70051,70047,Blue,0,64811,65001,190
2022-10-31,70051,70045,Blue,0,40549,40935,386
2022-06-26,70059,70055,Blue,0,58811,58967,156
2022-03-25,70048,70058,Blue,1,49739,50226,487
2022-08-10,70040,70046,Blue,1,42171,42434,263
2022-06-21,70043,70041,Blue,0,79648,79675,27
2022-01-15,70040,70052,Blue,1,55351,56119,768
2022-03-21,70050,70052,Blue,1,32321,32435,114
2022-11-30,70051,70041,Blue,0,21130,21689,559
2022-10-24,70048,70060,Blue,1,68693,69256,563
2022-01-03,70050,70056,Blue,1,39213,39549,336
2022-03-19,70038,70040,Blue,1,28113,28129,16
2022-02-27,70055,70051,Blue,0,76693,76853,160
2022-01-13,70047,70838,Blue,0,81196,81707,511
2022-03-29,70049,70043,Blue,0,47106,47429,323
2022-09-03,70059,70053,Blue,0,27613,27837,224
2022-07-15,70055,70049,Blue,0,62592,62869,277
2022-03-01,70042,70048,Blue,1,67469,67753,284
2022-02-03,70051,70045,Blue,0,65784,66127,343
2022-04-16,70038,70042,Blue,1,31260,31346,86
2022-10-02,70053,70041,Blue,0,62225,62967,742
2022-01-27,70055,70041,Blue,0,34879,35711,832
2022-04-06,70053,70049,Blue,0,51006,51205,199
2022-03-06,70048,70056,Blue,1,67159,67731,572
2022-04-04,70050,70056,Blue,1,61130,61436,306
2022-12-24,70038,70060,Blue,1,83220,84342,1122
2022-02-17,70054,70056,Blue,1,34886,34933,47
2022-10-05,70038,70052,Blue,1,61461,62156,695
2022-01-11,70042,70046,Blue,1,75915,76101,186
2022-03-28,70058,70060,Blue,1,65424,65578,154
2022-08-07,70048,70052,Blue,1,28949,29138,189
2022-06-30,70059,70055,Blue,0,34021,34165,144
2022-07-05,70046,70060,Blue,1,45754,46557,803
2022-10-21,70038,70058,Blue,1,23097,24100,1003
2022-02-18,70054,70056,Blue,1,35337,35385,48
2022-06-19,70046,70048,Blue,1,58458,58539,81
2022-08-19,70038,70052,Blue,1,35502,36325,823
2022-01-24,70042,70048,Blue,1,52651,52984,333
2022-03-23,70057,70053,Blue,0,56670,56826,156
2022-05-05,70053,70047,Blue,0,32908,33206,298
2022-04-03,70058,70060,Blue,1,79067,79126,59
2022-10-14,70038,70058,Blue,1,56735,57736,1001
2022-06-26,70038,70056,Blue,1,26283,27245,962
2022-11-11,70038,70042,Blue,1,34038,34133,95
2022-09-20,70054,70056,Blue,1,27007,27053,46
2022-08-11,70057,70043,Blue,0,53868,54680,812
2022-04-19,70046,70056,Blue,1,48533,49090,557
2022-12-01,70057,70043,Blue,0,73892,74649,757
2022-02-25,70046,70058,Blue,1,24366,25105,739
2022-08-19,70055,70049,Blue,0,21026,21318,292
2022-09-05,70057,70053,Blue,0,50366,50522,156
2022-12-07,70059,70838,Blue,0,49935,51062,1127
2022-06-14,70045,70041,Blue,0,31995,32207,212
2022-07-15,70049,70838,Blue,0,62128,62765,637
2022-03-14,70057,70838,Blue,0,82956,84044,1088
2022-02-20,70044,70050,Blue,1,44567,44930,363
2022-08-10,70042,70044,Blue,1,33762,33793,31
2022-10-29,70042,70050,Blue,1,53069,53517,448
2022-05-18,70055,70045,Blue,0,28681,29312,631
2022-02-28,70055,70047,Blue,0,20431,20894,463
2022-11-13,70044,70048,Blue,1,66335,66673,338
2022-09-21,70052,70060,Blue,1,44106,44466,360
2022-12-01,70042,70048,Blue,1,35442,35748,306
2022-07-23,70041,70039,Blue,0,63637,63673,36
2022-01-08,70052,70056,Blue,1,73655,73802,147
2022-07-17,70057,70053,Blue,0,52291,52441,150
2022-10-13,70053,70041,Blue,0,37748,38458,710
2022-01-10,70049,70838,Blue,0,20770,21370,600
2022-05-20,70052,70060,Blue,1,34107,34463,356
2022-06-06,70044,70050,Blue,1,55773,56287,514
2022-01-03,70059,70049,Blue,0,61513,61994,481
2022-10-31,70050,70060,Blue,1,59750,60261,511
2022-04-03,70043,70838,Blue,0,43698,43901,203
2022-02-22,70042,70056,Blue,1,57604,58408,804
2022-02-26,70046,70048,Blue,1,24041,24134,93
2022-08-09,70050,70052,Blue,1,44372,44491,119
2022-05-18,70050,70060,Blue,1,74361,74900,539
2022-09-14,70042,70046,Blue,1,46903,47065,162
2022-05-05,70055,70047,Blue,0,48491,48877,386
2022-01-12,70054,70058,Blue,1,52830,53001,171
2022-03-12,70048,70060,Blue,1,72815,73425,610
2022-06-24,70059,70838,Blue,0,34695,36133,1438
2022-10-31,70046,70056,Blue,1,76692,77198,506
2022-11-02,70042,70052,Blue,1,58758,59349,591
2022-08-04,70050,70056,Blue,1,21720,22042,322
2022-01-26,70042,70046,Blue,1,27400,27585,185
2022-05-25,70042,70044,Blue,1,25491,25525,34
2022-07-05,70053,70041,Blue,0,60616,61313,697
2022-12-23,70057,70045,Blue,0,71083,71869,786
2022-11-15,70038,70052,Blue,1,51864,52616,752
2022-11-27,70047,70045,Blue,0,86147,86249,102
2022-01-31,70040,70054,Blue,1,47412,48193,781
2022-08-10,70057,70051,Blue,0,54149,54404,255
2022-06-28,70040,70042,Blue,1,50302,50337,35
2022-12-21,70053,70047,Blue,0,34150,34436,286
2022-01-03,70057,70051,Blue,0,56692,56960,268
2022-06-29,70051,70043,Blue,0,80818,81291,473
2022-05-06,70059,70055,Blue,0,50536,50699,163
2022-07-13,70053,70045,Blue,0,56441,56936,495
2022-06-28,70049,70039,Blue,0,37666,38239,573
2022-02-09,70038,70044,Blue,1,86569,86748,179
2022-03-31,70042,70044,Blue,1,30395,30428,33
2022-07-08,70041,70838,Blue,0,55744,55859,115
2022-08-31,70046,70056,Blue,1,57124,57630,506
2022-06-20,70047,70043,Blue,0,26854,27126,272
2022-04-05,70040,70060,Blue,1,60201,61387,1186
2022-07-22,70042,70044,Blue,1,27690,27726,36
2022-03-13,70048,70054,Blue,1,87501,87851,350
2022-10-04,70042,70048,Blue,1,60900,61228,328
2022-07-27,70043,70039,Blue,0,81350,81452,102
2022-02-01,70055,70051,Blue,0,22215,22385,170
2022-09-14,70042,70052,Blue,1,32770,33374,604
2022-08-24,70040,70056,Blue,1,20024,20869,845
2022-07-30,70054,70056,Blue,1,55889,55938,49
2022-11-28,70048,70052,Blue,1,66886,67087,201
2022-07-29,70044,70058,Blue,1,58078,58905,827
2022-10-10,70038,70054,Blue,1,53349,54183,834
2022-09-18,70059,70047,Blue,0,52223,52780,557
2022-07-01,70059,70055,Blue,0,67101,67244,143
2022-01-09,70055,70051,Blue,0,22464,22609,145
2022-03-25,70055,70053,Blue,0,63684,63729,45
2022-09-07,70057,70043,Blue,0,58302,59135,833
2022-04-21,70057,70838,Blue,0,27046,28207,1161
2022-02-24,70055,70047,Blue,0,38865,39274,409
2022-04-07,70048,70058,Blue,1,23906,24408,502
2022-08-28,70056,70060,Blue,1,35628,35813,185
2022-10-11,70045,70838,Blue,0,39290,39687,397
2022-09-11,70045,70039,Blue,0,51867,52132,265
2022-07-12,70055,70047,Blue,0,36513,36959,446
2022-10-06,70042,70044,Blue,1,51954,51984,30
2022-07-09,70055,70039,Blue,0,54823,55778,955
2022-09-28,70044,70052,Blue,1,53631,54120,489
2022-12-06,70049,70045,Blue,0,50935,51140,205
2022-08-31,70042,70046,Blue,1,26349,26521,172
2022-10-01,70038,70060,Blue,1,45307,46403,1096
2022-07-26,70057,70047,Blue,0,22804,23307,503
2022-01-21,70048,70060,Blue,1,36169,36898,729
2022-06-30,70046,70048,Blue,1,58111,58207,96
2022-09-27,70043,70838,Blue,0,54089,54286,197
2022-07-23,70051,70838,Blue,0,72471,73207,736
2022-08-08,70040,70054,Blue,1,56495,57248,753
2022-05-20,70038,70044,Blue,1,51296,51483,187
2022-01-04,70046,70056,Blue,1,55999,56491,492
2022-04-22,70047,70043,Blue,0,65301,65562,261
2022-07-10,70045,70043,Blue,0,45400,45493,93
2022-04-21,70038,70060,Blue,1,62826,64039,1213
2022-02-28,70051,70049,Blue,0,77555,77663,108
2022-08-09,70045,70039,Blue,0,55857,56115,258
2022-01-19,70057,70055,Blue,0,30329,30397,68
2022-02-19,70049,70045,Blue,0,63783,63996,213
2022-07-04,70038,70044,Blue,1,59237,59413,176
2022-03-13,70047,70045,Blue,0,71206,71322,116
2022-03-23,70040,70050,Blue,1,76405,76927,522
2022-02-01,70044,70058,Blue,1,36427,37365,938
2022-10-30,70040,70058,Blue,1,71589,72582,993
2022-09-28,70038,70046,Blue,1,55519,55880,361
2022-07-18,70046,70054,Blue,1,38855,39325,470
2022-12-08,70050,70056,Blue,1,81358,82093,735
2022-12-21,70038,70042,Blue,1,57973,58080,107
2022-02-24,70057,70039,Blue,0,73320,74384,1064
2022-01-27,70038,70040,Blue,1,72096,72110,14
2022-08-13,70041,70838,Blue,0,73974,74104,130
2022-03-29,70055,70049,Blue,0,62170,62463,293
2022-02-09,70049,70041,Blue,0,47110,47522,412
2022-08-08,70051,70049,Blue,0,27967,28070,103
2022-02-25,70043,70039,Blue,0,58117,58246,129
2022-09-28,70044,70060,Blue,1,88446,89345,899
2022-09-08,70055,70039,Blue,0,28079,29000,921
2022-11-17,70042,70056,Blue,1,63506,64285,779
2022-12-09,70051,70041,Blue,0,35962,36585,623
2022-03-21,70042,70058,Blue,1,73098,73907,809
2022-04-03,70050,70056,Blue,1,84345,84656,311
2022-11-22,70044,70054,Blue,1,47915,48495,580
2022-06-16,70046,70052,Blue,1,84829,85160,331
2022-09-23,70038,70058,Blue,1,80685,81735,1050
2022-08-07,70047,70039,Blue,0,71216,71628,412
2022-06-13,70051,70039,Blue,0,50127,50813,686
2022-11-03,70038,70044,Blue,1,45097,45275,178
2022-11-20,70049,70041,Blue,0,37203,37590,387
2022-09-01,70052,70058,Blue,1,24784,25035,251
2022-12-18,70053,70045,Blue,0,51422,51889,467
2022-03-28,70059,70047,Blue,0,65593,66138,545
2022-11-15,70057,70043,Blue,0,37413,38279,866
2022-01-19,70057,70049,Blue,0,27942,28411,469
2022-03-19,70047,70045,Blue,0,35856,35959,103
2022-03-17,70049,70039,Blue,0,27805,28372,567
2022-02-04,70048,70058,Blue,1,59516,60011,495
2022-12-13,70042,70048,Blue,1,20017,20342,325
2022-07-11,70053,70051,Blue,0,55146,55207,61
2022-11-15,70044,70060,Blue,1,57394,58300,906
2022-08-16,70038,70058,Blue,1,52979,54068,1089
2022-07-16,70052,70054,Blue,1,70563,70616,53
2022-06-26,70051,70049,Blue,0,65560,65667,107
2022-07-16,70048,70054,Blue,1,70312,70616,304
2022-10-18,70038,70040,Blue,1,83345,83360,15
2022-09-26,70046,70052,Blue,1,33576,33944,368
2022-04-07,70057,70838,Blue,0,37056,38138,1082
2022-08-05,70050,70052,Blue,1,76688,76801,113
2022-12-19,70051,70041,Blue,0,28690,29428,738
2022-10-14,70051,70041,Blue,0,54128,54721,593
2022-01-30,70040,70058,Blue,1,75491,76559,1068
2022-07-09,70052,70060,Blue,1,32049,32444,395
2022-05-18,70058,70060,Blue,1,59483,59558,75
2022-12-23,70057,70053,Blue,0,30305,30472,167
2022-09-07,70045,70043,Blue,0,45057,45182,125
2022-08-30,70040,70058,Blue,1,79638,80568,930
2022-01-11,70042,70048,Blue,1,58039,58429,390
2022-05-18,70055,70838,Blue,0,75667,76687,1020
2022-05-20,70041,70838,Blue,0,61911,62034,123
2022-07-03,70039,70838,Blue,0,77605,77639,34
2022-06-22,70050,70058,Blue,1,29500,29925,425
2022-08-07,70059,70041,Blue,0,40156,41092,936
2022-12-10,70051,70041,Blue,0,66838,67344,506
2022-04-23,70048,70054,Blue,1,46376,46658,282
2022-05-18,70051,70045,Blue,0,59081,59559,478
2022-07-30,70049,70041,Blue,0,56732,57193,461
2022-10-06,70059,70045,Blue,0,20416,21087,671
2022-09-06,70042,70056,Blue,1,44494,45283,789
2022-08-24,70046,70052,Blue,1,73551,73858,307
2022-07-17,70055,70047,Blue,0,54561,54930,369
2022-11-28,70055,70039,Blue,0,80164,81033,869
2022-08-28,70046,70052,Blue,1,38048,38377,329
2022-10-26,70055,70045,Blue,0,69335,69835,500
2022-09-21,70047,70045,Blue,0,57586,57681,95
2022-09-29,70052,70056,Blue,1,33530,33676,146
2022-02-11,70045,70041,Blue,0,77921,78093,172
2022-09-05,70042,70048,Blue,1,46322,46628,306
2022-03-18,70048,70052,Blue,1,44022,44227,205
2022-06-22,70051,70045,Blue,0,60352,60723,371
2022-03-07,70051,70047,Blue,0,48534,48870,336
2022-02-24,70045,70043,Blue,0,52100,52276,176
2022-11-19,70058,70060,Blue,1,38256,38330,74
2022-01-05,70044,70058,Blue,1,58561,59384,823
2022-09-21,70042,70048,Blue,1,51569,51875,306
2022-11-13,70046,70048,Blue,1,78398,78477,79
2022-12-17,70040,70060,Blue,1,58892,59941,1049
2022-02-07,70046,70058,Blue,1,26412,27066,654
2022-04-07,70056,70058,Blue,1,75009,75096,87
2022-12-13,70042,70044,Blue,1,52368,52396,28
2022-01-04,70047,70039,Blue,0,55648,56068,420
2022-08-26,70038,70060,Blue,1,84203,85530,1327
2022-02-07,70040,70046,Blue,1,45859,46122,263
2022-11-08,70057,70043,Blue,0,79022,79771,749
2022-06-20,70049,70039,Blue,0,47297,47853,556
2022-02-23,70042,70052,Blue,1,28639,29273,634
2022-08-25,70050,70058,Blue,1,51990,52408,418
2022-11-26,70049,70047,Blue,0,43483,43546,63
2022-03-23,70044,70060,Blue,1,55441,56304,863
2022-10-05,70057,70043,Blue,0,37526,38279,753
2022-01-06,70043,70838,Blue,0,55061,55253,192
2022-04-20,70046,70052,Blue,1,80796,81152,356
2022-04-08,70053,70045,Blue,0,66714,67158,444
2022-01-13,70051,70045,Blue,0,58143,58474,331
2022-11-04,70050,70056,Blue,1,58561,58873,312
2022-09-13,70053,70043,Blue,0,83075,83635,560
2022-01-16,70049,70045,Blue,0,75989,76179,190
2022-06-11,70059,70049,Blue,0,56252,56729,477
2022-03-24,70049,70838,Blue,0,38053,38717,664
2022-11-03,70050,70054,Blue,1,88026,88227,201
2022-04-13,70038,70046,Blue,1,21012,21308,296
2022-08-14,70047,70838,Blue,0,87101,87589,488
2022-03-02,70053,70041,Blue,0,64813,65566,753
2022-12-17,70059,70053,Blue,0,68116,68337,221
2022-01-20,70051,70041,Blue,0,61790,62338,548
2022-05-23,70049,70045,Blue,0,26666,26937,271
2022-08-09,70042,70052,Blue,1,30031,30650,619
2022-10-05,70047,70045,Blue,0,75052,75165,113
2022-11-27,70038,70054,Blue,1,54266,55113,847
2022-09-01,70038,70054,Blue,1,61166,62057,891
2022-09-25,70048,70060,Blue,1,48936,49558,622
2022-09-25,70038,70050,Blue,1,45039,45634,595
2022-03-31,70038,70056,Blue,1,31752,32732,980
2022-12-22,70038,70046,Blue,1,59259,59581,322
2022-06-12,70051,70041,Blue,0,78621,79199,578
2022-06-21,70046,70060,Blue,1,63469,64305,836
2022-02-07,70048,70060,Blue,1,83622,84226,604
2022-05-19,70048,70058,Blue,1,76536,77064,528
2022-01-11,70055,70043,Blue,0,24753,25433,680
2022-11-10,70039,70838,Blue,0,24055,24092,37
2022-05-12,70052,70060,Blue,1,43814,44165,351
2022-03-31,70057,70041,Blue,0,41637,42498,861
2022-07-13,70053,70049,Blue,0,61174,61364,190
2022-05-19,70059,70045,Blue,0,29970,30816,846
2022-07-02,70040,70058,Blue,1,83835,84888,1053
2022-10-10,70059,70055,Blue,0,35893,36034,141
2022-02-09,70044,70048,Blue,1,30183,30436,253
2022-06-23,70042,70052,Blue,1,30285,30946,661
2022-12-29,70049,70039,Blue,0,53476,54069,593
2022-03-18,70055,70039,Blue,0,52704,53581,877
2022-01-20,70049,70047,Blue,0,67646,67699,53
2022-06-09,70040,70042,Blue,1,44522,44555,33
2022-04-17,70042,70052,Blue,1,50076,50667,591
2022-07-06,70050,70060,Blue,1,87988,88520,532
2022-01-28,70055,70041,Blue,0,87100,87914,814
2022-12-19,70059,70041,Blue,0,18802,19964,1162
2022-05-15,70057,70047,Blue,0,72703,73226,523
2022-02-27,70043,70838,Blue,0,61756,61964,208
2022-10-19,70048,70052,Blue,1,63989,64221,232
2022-03-09,70043,70041,Blue,0,23764,23795,31
2022-04-20,70042,70058,Blue,1,53580,54516,936
2022-06-16,70046,70048,Blue,1,26114,26190,76
2022-03-08,70042,70052,Blue,1,36861,37404,543
2022-02-07,70057,70838,Blue,0,60904,62028,1124
2022-08-21,70042,70054,Blue,1,50622,51287,665
2022-01-28,70042,70060,Blue,1,81034,82024,990
2022-04-23,70048,70060,Blue,1,81858,82463,605
2022-09-15,70059,70045,Blue,0,53066,53783,717
2022-08-23,70055,70049,Blue,0,85653,85934,281
2022-07-11,70042,70056,Blue,1,52489,53287,798
2022-10-03,70046,70060,Blue,1,34486,35206,720
2022-11-11,70044,70052,Blue,1,52814,53327,513
2022-03-23,70047,70041,Blue,0,73834,74126,292
2022-12-14,70038,70040,Blue,1,31204,31219,15
2022-09-12,70059,70055,Blue,0,85789,85932,143
2022-10-02,70051,70045,Blue,0,80634,80976,342
2022-02-25,70050,70052,Blue,1,82270,82386,116
2022-02-09,70047,70838,Blue,0,61682,62182,500
2022-10-08,70038,70050,Blue,1,42607,43154,547
2022-01-13,70044,70046,Blue,1,47147,47304,157
2022-07-31,70055,70039,Blue,0,76158,76989,831
2022-10-30,70050,70052,Blue,1,30584,30699,115
2022-02-10,70047,70043,Blue,0,31506,31764,258
2022-06-18,70044,70060,Blue,1,28360,29335,975
2022-09-20,70056,70060,Blue,1,32301,32490,189
2022-07-10,70055,70051,Blue,0,48637,48773,136
2022-03-23,70042,70054,Blue,1,59989,60705,716
2022-01-21,70042,70050,Blue,1,79919,80349,430
2022-05-20,70038,70056,Blue,1,28849,29884,1035
2022-09-23,70047,70838,Blue,0,53894,54421,527
2022-10-25,70051,70049,Blue,0,43023,43134,111
2022-06-16,70057,70039,Blue,0,31244,32288,1044
2022-07-28,70055,70049,Blue,0,82977,83257,280
2022-12-10,70048,70050,Blue,1,76083,76141,58
2022-01-13,70059,70057,Blue,0,51557,51593,36
2022-09-25,70049,70043,Blue,0,65689,66072,383
2022-02-09,70051,70039,Blue,0,79869,80608,739
2022-01-19,70045,70838,Blue,0,32707,33213,506
2022-01-28,70038,70040,Blue,1,23953,23970,17
2022-09-28,70051,70041,Blue,0,34297,34890,593
2022-03-13,70059,70039,Blue,0,78659,79750,1091
2022-10-13,70040,70052,Blue,1,42598,43271,673
2022-02-22,70048,70058,Blue,1,48193,48734,541
2022-05-02,70059,70053,Blue,0,59775,60001,226
2022-04-04,70040,70048,Blue,1,29114,29502,388
2022-05-18,70038,70044,Blue,1,81082,81303,221
2022-02-27,70057,70043,Blue,0,49055,49830,775
2022-02-04,70055,70053,Blue,0,68963,69026,63
2022-11-13,70057,70838,Blue,0,64700,65640,940
2022-08-31,70044,70056,Blue,1,55124,55814,690
2022-12-15,70039,70838,Blue,0,84169,84202,33
2022-08-14,70047,70039,Blue,0,70632,71063,431
2022-11-24,70053,70838,Blue,0,60045,60862,817
2022-11-17,70053,70045,Blue,0,33707,34147,440
2022-11-07,70059,70055,Blue,0,22995,23148,153
2022-06-13,70057,70049,Blue,0,70052,70445,393
2022-09-12,70050,70058,Blue,1,59214,59676,462
2022-02-17,70051,70039,Blue,0,54549,55178,629
2022-06-13,70050,70060,Blue,1,59247,59812,565
2022-01-15,70038,70052,Blue,1,59580,60387,807
2022-03-13,70044,70058,Blue,1,47011,47857,846
2022-12-29,70059,70039,Blue,0,29360,30313,953
2022-09-13,70048,70050,Blue,1,84686,84746,60
2022-06-18,70044,70060,Blue,1,55281,56261,980
2022-09-28,70059,70051,Blue,0,20842,21197,355
2022-09-19,70046,70056,Blue,1,58454,58965,511
2022-11-03,70048,70060,Blue,1,85462,86101,639
2022-12-18,70038,70056,Blue,1,32345,33184,839
2022-11-16,70048,70052,Blue,1,48770,48978,208
2022-04-26,70055,70051,Blue,0,82080,82235,155
2022-03-21,70046,70056,Blue,1,38942,39515,573
2022-08-11,70050,70060,Blue,1,51398,51929,531
2022-12-25,70055,70041,Blue,0,72922,73650,728
2022-08-18,70038,70056,Blue,1,48927,49862,935
2022-06-13,70048,70058,Blue,1,85922,86400,478
2022-01-05,70053,70041,Blue,0,57764,58444,680
2022-12-09,70052,70054,Blue,1,68212,68275,63
2022-07-22,70053,70039,Blue,0,74259,75023,764
2022-06-07,70047,70041,Blue,0,33353,33723,370
2022-03-07,70040,70054,Blue,1,66523,67251,728
2022-05-06,70054,70056,Blue,1,60598,60636,38
2022-08-26,70058,70060,Blue,1,74930,74991,61
2022-08-27,70050,70054,Blue,1,42101,42317,216
2022-04-18,70059,70838,Blue,0,31154,32242,1088
2022-01-06,70046,70058,Blue,1,29405,30033,628
2022-04-22,70050,70052,Blue,1,27406,27540,134
2022-08-03,70047,70043,Blue,0,61058,61313,255
2022-11-27,70057,70838,Blue,0,59309,60369,1060
2022-02-15,70045,70838,Blue,0,43988,44325,337
2022-06-24,70049,70043,Blue,0,70624,70969,345
2022-08-30,70059,70041,Blue,0,23416,24414,998
2022-01-27,70040,70060,Blue,1,63858,65011,1153
2022-07-08,70044,70058,Blue,1,50471,51267,796
2022-05-25,70045,70039,Blue,0,83147,83411,264
2022-04-15,70056,70060,Blue,1,63541,63874,333
2022-09-27,70048,70052,Blue,1,22436,22642,206
2022-07-10,70051,70047,Blue,0,68505,68700,195
2022-06-13,70040,70058,Blue,1,64099,65019,920
2022-04-20,70045,70039,Blue,0,42393,42729,336
2022-09-10,70048,70052,Blue,1,75025,75231,206
2022-09-07,70042,70048,Blue,1,29558,29878,320
2022-02-07,70047,70838,Blue,0,23995,24578,583
2022-03-14,70059,70041,Blue,0,33883,34809,926
2022-03-29,70053,70049,Blue,0,62575,62809,234
2022-12-01,70047,70045,Blue,0,61258,61373,115
2022-12-09,70042,70046,Blue,1,26201,26385,184
2022-02-13,70048,70052,Blue,1,30484,30685,201
2022-02-20,70046,70058,Blue,1,48679,49256,577
2022-07-06,70038,70056,Blue,1,63874,64929,1055
2022-01-14,70048,70050,Blue,1,67574,67636,62
2022-01-15,70040,70060,Blue,1,62416,63617,1201
2022-11-13,70044,70054,Blue,1,76058,76615,557
2022-09-13,70040,70054,Blue,1,56566,57326,760
2022-12-23,70044,70056,Blue,1,64073,64843,770
2022-09-27,70042,70048,Blue,1,65998,66303,305
2022-02-16,70059,70051,Blue,0,19526,19885,359
2022-06-09,70053,70051,Blue,0,65396,65460,64
2022-02-15,70051,70049,Blue,0,41939,42041,102
2022-08-27,70038,70052,Blue,1,26949,27601,652
2022-08-09,70051,70039,Blue,0,79618,80296,678
2022-08-19,70049,70039,Blue,0,30240,30810,570
2022-02-06,70058,70060,Blue,1,53655,53720,65
2022-01-20,70042,70052,Blue,1,34050,34877,827
2022-08-07,70057,70053,Blue,0,26252,26402,150
2022-09-14,70057,70051,Blue,0,62494,62723,229
2022-10-22,70057,70045,Blue,0,21578,22223,645
2022-04-05,70047,70039,Blue,0,59017,59416,399
2022-01-11,70059,70045,Blue,0,57195,57855,660
2022-03-30,70057,70045,Blue,0,50297,50894,597
2022-03-08,70055,70838,Blue,0,25040,25952,912
2022-04-15,70038,70054,Blue,1,79310,80162,852
2022-02-03,70042,70060,Blue,1,54155,55142,987
2022-03-26,70038,70042,Blue,1,89892,91660,1768
2022-02-18,70042,70060,Blue,1,25904,27271,1367
2022-09-29,70059,70039,Blue,0,65560,66690,1130
2022-11-03,70040,70060,Blue,1,50304,51423,1119
2022-02-04,70048,70058,Blue,1,70399,71055,656
2022-07-01,70038,70042,Blue,1,54570,54665,95
2022-02-15,70038,70050,Blue,1,22748,23320,572
2022-08-11,70042,70048,Blue,1,91377,91730,353
2022-01-12,70047,70045,Blue,0,33324,33418,94
2022-04-19,70038,70042,Blue,1,54307,54412,105
2022-10-06,70040,70054,Blue,1,75882,76858,976
2022-08-22,70050,70056,Blue,1,24098,24404,306
2022-01-31,70042,70044,Blue,1,80001,80035,34
2022-04-16,70053,70039,Blue,0,20458,21295,837
2022-07-06,70057,70055,Blue,0,61939,62006,67
2022-10-09,70048,70056,Blue,1,35143,35548,405
2022-07-05,70059,70043,Blue,0,40579,41630,1051
2022-12-05,70038,70048,Blue,1,71593,72024,431
2022-01-20,70056,70058,Blue,1,76129,76201,72
2022-08-31,70042,70058,Blue,1,67535,68408,873
2022-12-09,70041,70838,Blue,0,23702,23851,149
2022-07-16,70055,70041,Blue,0,34162,35214,1052
2022-10-16,70049,70045,Blue,0,40631,40821,190
2022-04-03,70059,70043,Blue,0,22272,23081,809
2022-03-07,70045,70039,Blue,0,51022,51269,247
2022-03-18,70046,70050,Blue,1,66233,66422,189
2022-07-05,70040,70054,Blue,1,20097,20866,769
2022-12-12,70052,70056,Blue,1,55260,55461,201
2022-02-11,70058,70060,Blue,1,52954,53045,91
2022-04-12,70055,70043,Blue,0,47501,48203,702
2022-03-02,70058,70060,Blue,1,67784,67854,70
2022-03-14,70059,70039,Blue,0,35239,36266,1027
2022-08-03,70059,70055,Blue,0,30974,31115,141
2022-03-11,70055,70039,Blue,0,32924,33766,842
2022-03-09,70049,70039,Blue,0,65515,65997,482
2022-08-03,70057,70055,Blue,0,44947,45064,117
2022-01-27,70055,70053,Blue,0,21496,21558,62
2022-12-11,70055,70047,Blue,0,41665,42030,365
2022-11-18,70057,70043,Blue,0,22954,23729,775
2022-03-23,70053,70047,Blue,0,65853,66129,276
2022-07-29,70049,70047,Blue,0,56869,56924,55
2022-04-06,70050,70056,Blue,1,46401,46682,281
2022-01-18,70049,70041,Blue,0,54679,55130,451
2022-04-22,70051,70047,Blue,0,74726,74924,198
2022-09-24,70038,70054,Blue,1,44248,45049,801
2022-10-18,70044,70054,Blue,1,39932,40551,619
2022-02-21,70056,70060,Blue,1,32218,32395,177
2022-10-02,70055,70838,Blue,0,63794,64683,889
2022-09-21,70040,70046,Blue,1,70565,70805,240
2022-06-25,70040,70054,Blue,1,55128,55947,819
2022-09-05,70049,70039,Blue,0,30562,31166,604
2022-08-21,70059,70051,Blue,0,71115,71441,326
2022-11-24,70042,70052,Blue,1,75993,76579,586
2022-03-28,70054,70060,Blue,1,64004,64719,715
2022-08-09,70055,70039,Blue,0,22786,23659,873
2022-12-24,70042,70056,Blue,1,42445,43983,1538
2022-10-24,70052,70054,Blue,1,27392,27452,60
2022-10-02,70046,70060,Blue,1,48136,48852,716
2022-03-27,70049,70039,Blue,0,86137,86613,476
2022-07-11,70051,70043,Blue,0,40046,40549,503
2022-07-02,70053,70045,Blue,0,21125,21578,453
2022-12-29,70046,70052,Blue,1,53171,53512,341
2022-07-29,70048,70060,Blue,1,62814,63477,663
2022-08-16,70053,70047,Blue,0,31703,32024,321
2022-03-11,70044,70048,Blue,1,64506,64761,255
2022-11-16,70059,70045,Blue,0,38009,38749,740
2022-10-16,70048,70052,Blue,1,49907,50114,207
2022-06-11,70058,70060,Blue,1,87139,87231,92
2022-04-28,70051,70047,Blue,0,56178,56471,293
2022-06-14,70055,70838,Blue,0,28380,29402,1022
2022-04-05,70057,70039,Blue,0,24331,25231,900
2022-12-17,70040,70060,Blue,1,72913,73943,1030
2022-12-21,70047,70039,Blue,0,60362,60757,395
2022-03-17,70050,70060,Blue,1,45330,45876,546
2022-04-13,70039,70838,Blue,0,64554,64600,46
2022-03-10,70038,70050,Blue,1,61089,61756,667
2022-02-18,70045,70838,Blue,0,54438,54871,433
2022-01-27,70040,70042,Blue,1,34562,34597,35
2022-09-29,70047,70039,Blue,0,30796,31288,492
2022-02-20,70059,70049,Blue,0,60857,61329,472
2022-07-18,70051,70043,Blue,0,61892,62396,504
2022-10-14,70042,70050,Blue,1,46269,46722,453
2022-08-09,70054,70056,Blue,1,41668,41744,76
2022-11-23,70038,70052,Blue,1,71047,71741,694
2022-02-08,70056,70058,Blue,1,81447,81532,85
2022-11-05,70059,70051,Blue,0,42755,43081,326
2022-05-16,70057,70047,Blue,0,46586,47114,528
2022-12-24,70059,70045,Blue,0,84014,84722,708
2022-02-02,70045,70041,Blue,0,86985,87193,208
2022-08-09,70038,70054,Blue,1,76763,77511,748
2022-04-05,70051,70045,Blue,0,46970,47285,315
2022-07-10,70051,70049,Blue,0,43157,43259,102
2022-11-26,70043,70838,Blue,0,51734,51923,189
2022-09-08,70055,70838,Blue,0,41367,42439,1072
2022-07-05,70045,70039,Blue,0,33962,34284,322
2022-08-18,70048,70060,Blue,1,50934,51544,610
2022-09-16,70040,70050,Blue,1,73689,74168,479
2022-01-20,70046,70054,Blue,1,66267,66743,476
2022-01-13,70055,70053,Blue,0,19351,19443,92
2022-08-03,70040,70044,Blue,1,26532,26644,112
2022-09-28,70045,70043,Blue,0,30990,31116,126
2022-10-27,70051,70043,Blue,0,59934,60436,502
2022-11-30,70040,70052,Blue,1,47741,48388,647
2022-06-11,70055,70047,Blue,0,35375,35787,412
2022-04-01,70043,70041,Blue,0,63795,63823,28
2022-01-10,70051,70043,Blue,0,84358,84816,458
2022-03-23,70052,70054,Blue,1,26215,26275,60
2022-10-11,70042,70044,Blue,1,51934,51965,31
2022-09-27,70049,70047,Blue,0,20450,20572,122
2022-06-09,70038,70052,Blue,1,40853,41680,827
2022-02-18,70038,70040,Blue,1,57468,57485,17
2022-05-30,70046,70050,Blue,1,39777,39997,220
2022-04-12,70040,70058,Blue,1,27010,27936,926
2022-07-26,70048,70054,Blue,1,80258,80549,291
2022-03-28,70059,70057,Blue,0,20977,21022,45
2022-09-10,70053,70049,Blue,0,87630,87815,185
2022-11-23,70050,70056,Blue,1,62703,63034,331
2022-07-15,70051,70047,Blue,0,33530,33718,188
2022-12-12,70040,70050,Blue,1,87444,87931,487
2022-04-22,70044,70050,Blue,1,63943,64277,334
2022-02-22,70044,70058,Blue,1,61874,62715,841
2022-08-07,70051,70047,Blue,0,52603,52796,193
2022-10-25,70041,70838,Blue,0,42687,42819,132
2022-10-05,70038,70054,Blue,1,48259,49077,818
2022-01-28,70040,70056,Blue,1,68645,69453,808
2022-04-19,70055,70043,Blue,0,58507,59290,783
2022-06-06,70038,70052,Blue,1,57535,58487,952
2022-07-15,70051,70041,Blue,0,73762,74331,569
2022-01-21,70046,70050,Blue,1,25013,25221,208
2022-04-03,70055,70047,Blue,0,35704,36055,351
2022-06-15,70049,70041,Blue,0,65528,65974,446
2022-04-09,70057,70049,Blue,0,57931,58311,380
2022-05-27,70049,70045,Blue,0,87919,88116,197
2022-09-08,70044,70056,Blue,1,27102,27813,711
2022-11-04,70041,70838,Blue,0,37072,37199,127
2022-11-10,70051,70049,Blue,0,21934,22062,128
2022-01-14,70050,70054,Blue,1,38682,38957,275
2022-03-06,70057,70039,Blue,0,60936,61800,864
2022-02-22,70051,70838,Blue,0,30624,31436,812
2022-01-24,70057,70045,Blue,0,28540,29117,577
2022-09-24,70057,70041,Blue,0,31522,32419,897
2022-03-29,70050,70052,Blue,1,53356,53466,110
2022-09-21,70053,70838,Blue,0,70964,71750,786
2022-09-25,70052,70054,Blue,1,45824,45874,50
2022-03-11,70040,70056,Blue,1,66804,67673,869
2022-06-21,70038,70058,Blue,1,60555,61744,1189
2022-12-20,70044,70048,Blue,1,22098,22328,230
2022-03-30,70047,70045,Blue,0,19806,19924,118
2022-04-07,70053,70051,Blue,0,36683,36743,60
2022-08-08,70041,70039,Blue,0,44729,44764,35
2022-03-29,70047,70039,Blue,0,27012,27515,503
2022-08-15,70055,70053,Blue,0,52839,52884,45
2022-01-03,70048,70060,Blue,1,79055,79664,609
2022-07-13,70051,70045,Blue,0,74839,75152,313
2022-09-10,70059,70049,Blue,0,19518,19990,472
2022-01-15,70050,70054,Blue,1,61050,61272,222
2022-04-19,70048,70050,Blue,1,58877,58932,55
2022-11-07,70059,70057,Blue,0,75916,75952,36
2022-02-08,70041,70039,Blue,0,82235,82267,32
2022-08-22,70059,70045,Blue,0,34922,35683,761
2022-01-21,70059,70043,Blue,0,40411,41433,1022
2022-03-18,70057,70045,Blue,0,75582,76218,636
2022-06-12,70050,70052,Blue,1,67810,67916,106
2022-03-10,70041,70039,Blue,0,83833,83868,35
2022-02-17,70038,70048,Blue,1,77504,77947,443
2022-04-11,70053,70047,Blue,0,59084,59416,332
2022-07-21,70046,70050,Blue,1,60739,60931,192
2022-07-18,70059,70043,Blue,0,84398,85823,1425
2022-10-04,70057,70049,Blue,0,53846,54214,368
2022-08-30,70038,70058,Blue,1,36429,37482,1053
2022-06-27,70038,70060,Blue,1,72204,73561,1357
2022-01-02,70043,70838,Blue,0,55894,56151,257
2022-04-09,70054,70058,Blue,1,44501,44653,152
2022-01-08,70042,70050,Blue,1,39061,39461,400
2022-11-10,70048,70060,Blue,1,70576,71187,611
2022-11-09,70049,70045,Blue,0,44872,45095,223
2022-12-18,70049,70041,Blue,0,54925,55373,448
2022-11-13,70046,70048,Blue,1,42666,42739,73
2022-12-16,70046,70050,Blue,1,30298,30496,198
2022-11-27,70051,70041,Blue,0,66086,66659,573
2022-06-25,70059,70041,Blue,0,31393,32303,910
2022-09-19,70040,70054,Blue,1,60444,61350,906
2022-02-10,70053,70045,Blue,0,65250,65655,405
2022-03-02,70048,70054,Blue,1,30784,31101,317
2022-09-16,70059,70055,Blue,0,54650,54804,154
2022-04-29,70052,70060,Blue,1,54202,54558,356
2022-01-15,70048,70050,Blue,1,77066,77126,60
2022-06-07,70045,70041,Blue,0,46024,46237,213
2022-12-23,70041,70039,Blue,0,32235,32269,34
2022-03-21,70038,70040,Blue,1,63752,63771,19
2022-09-01,70059,70047,Blue,0,46174,46802,628
2022-11-13,70053,70838,Blue,0,48156,48954,798
2022-07-08,70055,70043,Blue,0,22773,23473,700
2022-02-06,70040,70046,Blue,1,40474,40764,290
2022-05-25,70041,70039,Blue,0,49883,49919,36
2022-06-18,70038,70056,Blue,1,29117,30119,1002
2022-01-14,70040,70060,Blue,1,54736,55884,1148
2022-03-23,70055,70041,Blue,0,56775,57579,804
2022-10-20,70047,70838,Blue,0,73972,74546,574
2022-06-22,70052,70060,Blue,1,40741,41230,489
2022-09-20,70042,70052,Blue,1,83480,84016,536
2022-01-31,70043,70041,Blue,0,67201,67230,29
2022-09-11,70053,70838,Blue,0,39761,40587,826
2022-11-25,70059,70055,Blue,0,74896,75044,148
2022-04-10,70045,70838,Blue,0,67017,67371,354
2022-03-07,70038,70050,Blue,1,65225,65866,641
2022-04-22,70049,70039,Blue,0,63437,64000,563
2022-06-18,70040,70058,Blue,1,43283,44412,1129
2022-05-19,70046,70060,Blue,1,86624,87428,804
2022-09-14,70057,70838,Blue,0,19610,20828,1218
2022-06-21,70059,70039,Blue,0,83681,84774,1093
2022-02-12,70040,70054,Blue,1,45372,46088,716
2022-01-06,70050,70058,Blue,1,72020,72428,408
2022-01-15,70053,70047,Blue,0,86824,87105,281
2022-05-07,70057,70049,Blue,0,70893,71315,422
2022-06-30,70056,70060,Blue,1,52346,52529,183
2022-10-17,70042,70052,Blue,1,46960,47505,545
2022-11-04,70049,70043,Blue,0,71245,71565,320
2022-11-03,70038,70058,Blue,1,26896,27877,981
2022-07-13,70051,70838,Blue,0,73580,74357,777
2022-12-09,70051,70043,Blue,0,51839,52295,456
2022-11-02,70059,70053,Blue,0,28012,28272,260
2022-04-28,70053,70049,Blue,0,27915,28121,206
2022-06-11,70059,70053,Blue,0,25457,25701,244
2022-07-11,70044,70050,Blue,1,55109,55468,359
2022-10-29,70059,70043,Blue,0,62179,63038,859
2022-10-24,70053,70047,Blue,0,80741,81021,280
2022-01-31,70049,70041,Blue,0,53946,54481,535
2022-08-19,70047,70039,Blue,0,52315,52779,464
2022-07-03,70044,70052,Blue,1,48007,48504,497
2022-08-18,70057,70055,Blue,0,49569,49639,70
2022-01-14,70049,70045,Blue,0,61052,61249,197
2022-01-26,70038,70048,Blue,1,61336,61803,467
2022-01-23,70053,70043,Blue,0,26666,27306,640
2022-12-17,70057,70039,Blue,0,52583,53519,936
2022-03-08,70040,70050,Blue,1,78165,78760,595
2022-09-19,70044,70046,Blue,1,67617,67718,101
2022-02-10,70038,70048,Blue,1,59236,59693,457
2022-11-14,70059,70039,Blue,0,36258,37234,976
2022-04-11,70043,70039,Blue,0,71934,72052,118
2022-03-07,70046,70060,Blue,1,32740,33570,830
2022-11-11,70050,70058,Blue,1,24336,24764,428
2022-05-18,70048,70054,Blue,1,58048,58373,325
2022-08-24,70059,70043,Blue,0,88304,89182,878
2022-01-26,70051,70045,Blue,0,52201,52533,332
2022-02-09,70051,70041,Blue,0,24656,25236,580
2022-08-18,70045,70039,Blue,0,71015,71266,251
2022-03-11,70052,70056,Blue,1,52491,52625,134
2022-04-07,70051,70838,Blue,0,42496,43257,761
2022-10-13,70057,70055,Blue,0,57173,57241,68
2022-06-23,70055,70041,Blue,0,43344,44208,864
2022-05-26,70047,70041,Blue,0,29444,29832,388
2022-04-12,70053,70051,Blue,0,58652,58714,62
2022-04-08,70052,70058,Blue,1,60601,60869,268
2022-02-03,70048,70050,Blue,1,51871,51934,63
2022-07-11,70053,70041,Blue,0,60596,61323,727
2022-06-16,70059,70047,Blue,0,82877,83445,568
2022-10-10,70038,70056,Blue,1,53957,54915,958
2022-01-13,70051,70049,Blue,0,58873,58976,103
2022-03-04,70044,70056,Blue,1,51025,51751,726
2022-11-20,70053,70047,Blue,0,69769,70064,295
2022-11-21,70059,70045,Blue,0,44058,44786,728
2022-03-17,70042,70044,Blue,1,65375,65407,32
2022-09-30,70059,70838,Blue,0,24254,25417,1163
2022-03-09,70040,70056,Blue,1,65298,66121,823
2022-09-10,70052,70054,Blue,1,59091,59151,60
2022-03-28,70059,70057,Blue,0,77177,77212,35
2022-11-15,70042,70052,Blue,1,20089,20683,594
2022-02-01,70046,70052,Blue,1,58538,58887,349
2022-03-23,70055,70039,Blue,0,34425,35359,934
2022-09-20,70052,70060,Blue,1,68704,69075,371
2022-08-19,70048,70052,Blue,1,71673,71884,211
2022-03-25,70059,70049,Blue,0,77795,78250,455
2022-07-18,70040,70058,Blue,1,35005,35958,953
2022-09-02,70046,70058,Blue,1,78682,79286,604
2022-03-22,70051,70041,Blue,0,78688,79252,564
2022-08-17,70048,70060,Blue,1,84800,85536,736
2022-10-02,70044,70046,Blue,1,26319,26433,114
2022-12-14,70050,70052,Blue,1,34149,34258,109
2022-06-27,70042,70054,Blue,1,64385,65117,732
2022-04-28,70055,70047,Blue,0,24052,24533,481
2022-09-11,70040,70048,Blue,1,61374,61834,460
2022-03-28,70038,70044,Blue,1,55329,55619,290
2022-03-18,70053,70045,Blue,0,62556,62972,416
2022-10-10,70038,70040,Blue,1,86550,86563,13
2022-04-19,70038,70040,Blue,1,61336,61351,15
2022-03-05,70044,70050,Blue,1,50394,50756,362
2022-01-10,70044,70056,Blue,1,63982,64697,715
2022-03-08,70053,70838,Blue,0,54460,55336,876
2022-01-25,70057,70049,Blue,0,28793,29197,404
2022-11-30,70050,70054,Blue,1,74847,75058,211
2022-12-17,70040,70048,Blue,1,35655,36059,404
2022-12-31,70042,70048,Blue,1,81965,82252,287
2022-03-26,70046,70050,Blue,1,39187,39380,193
2022-10-09,70043,70039,Blue,0,66055,66165,110
2022-03-17,70053,70045,Blue,0,44613,45052,439
2022-05-09,70049,70047,Blue,0,36347,36385,38
2022-06-27,70040,70048,Blue,1,25522,26040,518
2022-08-08,70059,70039,Blue,0,71233,72283,1050
2022-12-25,70055,70043,Blue,0,22452,23081,629
2022-03-16,70051,70043,Blue,0,65646,66124,478
2022-10-23,70057,70043,Blue,0,29373,30096,723
2022-12-30,70055,70043,Blue,0,72304,72956,652
2022-06-20,70059,70838,Blue,0,65612,66772,1160
2022-11-16,70048,70050,Blue,1,35485,35546,61
2022-02-28,70049,70045,Blue,0,24525,24750,225
2022-10-10,70051,70041,Blue,0,59124,59669,545
2022-09-07,70055,70051,Blue,0,22781,22921,140
2022-09-28,70038,70050,Blue,1,33239,33812,573
2022-11-29,70042,70044,Blue,1,82853,82882,29
2022-05-20,70059,70838,Blue,0,44948,46372,1424
2022-12-29,70055,70045,Blue,0,80352,80875,523
2022-02-02,70057,70053,Blue,0,44885,45057,172
2022-11-09,70040,70046,Blue,1,23185,23435,250
2022-03-21,70052,70060,Blue,1,24512,24873,361
2022-11-02,70048,70058,Blue,1,41023,41555,532
2022-03-25,70055,70051,Blue,0,72811,72950,139
2022-04-16,70047,70039,Blue,0,44439,44875,436
2022-12-30,70055,70043,Blue,0,29592,30251,659
2022-08-31,70053,70039,Blue,0,72053,72811,758
2022-03-05,70042,70048,Blue,1,60078,60402,324
2022-07-13,70040,70060,Blue,1,81512,82812,1300
2022-04-23,70059,70049,Blue,0,31933,32384,451
2022-11-08,70055,70053,Blue,0,72063,72111,48
2022-04-03,70048,70058,Blue,1,67140,67667,527
2022-02-24,70044,70056,Blue,1,56404,57068,664
2022-12-12,70057,70043,Blue,0,36913,37782,869
2022-02-18,70042,70054,Blue,1,87876,88536,660
2022-08-02,70059,70039,Blue,0,55096,56184,1088
2022-06-13,70045,70041,Blue,0,61556,61765,209
2022-10-15,70057,70043,Blue,0,61719,62471,752
2022-03-12,70053,70045,Blue,0,72166,72597,431
2022-09-28,70048,70050,Blue,1,37896,37950,54
2022-01-28,70053,70041,Blue,0,41226,42044,818
2022-04-07,70055,70045,Blue,0,44016,44611,595
2022-09-14,70057,70047,Blue,0,39570,40033,463
2022-08-27,70038,70052,Blue,1,58274,59042,768
2022-12-17,70051,70838,Blue,0,40840,41676,836
2022-08-26,70054,70060,Blue,1,56298,56575,277
2022-02-24,70053,70051,Blue,0,65286,65342,56
2022-07-16,70044,70056,Blue,1,32767,33457,690
2022-02-18,70043,70838,Blue,0,24191,24424,233
2022-12-19,70057,70053,Blue,0,51689,51848,159
2022-08-08,70048,70058,Blue,1,74180,74687,507
2022-06-06,70042,70046,Blue,1,32140,32370,230
2022-03-03,70046,70060,Blue,1,24043,25004,961
2022-11-18,70051,70041,Blue,0,67510,68148,638
2022-04-02,70052,70060,Blue,1,35795,36139,344
2022-10-28,70059,70055,Blue,0,51014,51162,148
2022-07-23,70038,70060,Blue,1,55622,56861,1239
2022-04-13,70059,70838,Blue,0,42076,43285,1209
2022-10-12,70051,70039,Blue,0,29293,30061,768
2022-05-30,70043,70041,Blue,0,77785,77813,28
2022-01-11,70042,70056,Blue,1,85059,85910,851
2022-05-25,70049,70047,Blue,0,44024,44084,60
2022-10-23,70053,70045,Blue,0,86683,87095,412
2022-10-29,70042,70054,Blue,1,47082,47705,623
2022-03-03,70053,70045,Blue,0,31782,32249,467
2022-01-28,70057,70039,Blue,0,32439,33517,1078
2022-04-01,70043,70041,Blue,0,54530,54562,32
2022-03-05,70040,70056,Blue,1,71333,72221,888
2022-03-29,70046,70058,Blue,1,38273,39044,771
2022-02-04,70046,70056,Blue,1,43430,44214,784
2022-03-13,70049,70838,Blue,0,40617,41202,585
2022-03-26,70048,70050,Blue,1,38284,38341,57
2022-10-24,70055,70051,Blue,0,22861,23002,141
2022-05-19,70052,70056,Blue,1,38541,38687,146
2022-01-03,70045,70041,Blue,0,31364,31544,180
2022-04-12,70040,70060,Blue,1,83193,84252,1059
2022-11-04,70055,70045,Blue,0,49484,50058,574
2022-07-23,70055,70049,Blue,0,65975,66271,296
2022-07-11,70057,70051,Blue,0,27501,27761,260
2022-10-11,70050,70058,Blue,1,58497,58902,405
2022-03-13,70043,70039,Blue,0,73705,73821,116
2022-02-16,70042,70054,Blue,1,30145,30894,749
2022-04-15,70049,70047,Blue,0,52239,52294,55
2022-01-05,70055,70049,Blue,0,27150,27457,307
2022-10-03,70050,70058,Blue,1,24522,24927,405
2022-10-31,70053,70049,Blue,0,34189,34382,193
2022-08-02,70059,70051,Blue,0,58461,58785,324
2022-12-02,70049,70838,Blue,0,79160,79717,557
2022-08-08,70042,70058,Blue,1,65764,66607,843
2022-06-15,70059,70043,Blue,0,21323,22228,905
2022-01-08,70050,70056,Blue,1,69138,69437,299
2022-04-20,70053,70051,Blue,0,70779,70835,56
2022-07-08,70043,70041,Blue,0,24315,24346,31
2022-08-02,70058,70060,Blue,1,22821,22888,67
2022-07-25,70055,70049,Blue,0,37359,37734,375
2022-06-10,70042,70044,Blue,1,56712,56743,31
2022-03-23,70044,70050,Blue,1,33444,33823,379
2022-01-28,70044,70058,Blue,1,21209,22012,803
2022-11-17,70049,70043,Blue,0,44144,44490,346
2022-12-27,70055,70053,Blue,0,61914,61961,47
2022-02-12,70059,70057,Blue,0,45427,45462,35
2022-03-03,70050,70054,Blue,1,52495,52689,194
2022-03-02,70053,70047,Blue,0,47409,47690,281
2022-07-11,70053,70051,Blue,0,30020,30083,63
2022-12-28,70041,70838,Blue,0,69340,69456,116
2022-12-31,70057,70041,Blue,0,35794,36639,845
2022-06-09,70055,70043,Blue,0,45143,45849,706
2022-02-12,70056,70058,Blue,1,44180,44253,73
2022-06-09,70049,70039,Blue,0,85170,85691,521
2022-09-26,70059,70039,Blue,0,86572,87825,1253
2022-04-11,70040,70052,Blue,1,48146,48774,628
2022-08-08,70040,70048,Blue,1,85026,85400,374
2022-07-07,70040,70056,Blue,1,74249,75140,891
2022-10-18,70058,70060,Blue,1,59761,59837,76
2022-12-28,70051,70045,Blue,0,57208,57570,362
2022-10-09,70059,70055,Blue,0,51135,51280,145
2022-09-15,70041,70039,Blue,0,84375,84408,33
2022-12-21,70046,70052,Blue,1,22271,22681,410
2022-05-02,70050,70052,Blue,1,20750,20858,108
2022-02-06,70049,70039,Blue,0,75955,76447,492
2022-06-17,70059,70055,Blue,0,68048,68201,153
2022-03-24,70052,70056,Blue,1,77114,77255,141
2022-03-05,70042,70056,Blue,1,37917,38702,785
2022-11-14,70046,70048,Blue,1,73029,73103,74
2022-06-10,70045,70039,Blue,0,64416,64693,277
2022-03-11,70052,70054,Blue,1,87860,87910,50
2022-11-01,70048,70050,Blue,1,77618,77672,54
2022-11-03,70045,70043,Blue,0,33432,33542,110
2022-05-20,70051,70045,Blue,0,49627,50055,428
2022-10-28,70038,70046,Blue,1,66371,66704,333
2022-09-13,70046,70056,Blue,1,47683,48228,545
2022-07-27,70053,70049,Blue,0,44954,45150,196
2022-06-26,70042,70050,Blue,1,79236,79732,496
2022-01-31,70046,70048,Blue,1,60250,60349,99
2022-02-19,70040,70042,Blue,1,52964,53001,37
2022-03-15,70038,70050,Blue,1,69428,69974,546
2022-03-03,70042,70058,Blue,1,82119,82977,858
2022-11-09,70047,70041,Blue,0,27291,27643,352
2022-08-06,70059,70049,Blue,0,75795,76304,509
2022-08-01,70059,70838,Blue,0,66315,67445,1130
2022-08-15,70038,70056,Blue,1,23575,24508,933
2022-11-07,70051,70049,Blue,0,20873,20989,116
2022-12-18,70052,70058,Blue,1,65510,65761,251
2022-08-28,70049,70047,Blue,0,58635,58689,54
2022-12-14,70044,70050,Blue,1,27091,27434,343
2022-04-11,70053,70045,Blue,0,55681,56166,485
2022-09-17,70044,70054,Blue,1,60700,61327,627
2022-08-17,70058,70060,Blue,1,76743,76801,58
2022-01-23,70057,70053,Blue,0,40227,40380,153
2022-10-21,70040,70054,Blue,1,64760,65572,812
2022-08-03,70057,70055,Blue,0,20014,20083,69
2022-05-18,70053,70049,Blue,0,28437,28657,220
2022-09-30,70046,70050,Blue,1,24870,25046,176
2022-02-23,70055,70049,Blue,0,45143,45443,300
2022-03-15,70054,70060,Blue,1,49856,50128,272
2022-07-04,70058,70060,Blue,1,62076,62245,169
2022-05-20,70043,70838,Blue,0,57603,57798,195
2022-08-01,70051,70041,Blue,0,35134,35723,589
2022-05-15,70054,70060,Blue,1,45608,45880,272
2022-03-25,70038,70046,Blue,1,76866,77159,293
2022-01-17,70050,70052,Blue,1,21681,21810,129
2022-12-02,70042,70058,Blue,1,47304,48199,895
2022-04-02,70053,70047,Blue,0,66226,66506,280
2022-10-11,70051,70043,Blue,0,30537,31082,545
2022-08-31,70040,70050,Blue,1,46210,46763,553
2022-10-31,70040,70050,Blue,1,69024,69507,483
2022-11-28,70045,70838,Blue,0,54914,55278,364
2022-01-01,70049,70041,Blue,0,84325,84723,398
2022-10-05,70040,70052,Blue,1,73692,74303,611
2022-05-19,70055,70049,Blue,0,57801,58169,368
2022-11-27,70041,70039,Blue,0,30264,30297,33
2022-10-27,70050,70056,Blue,1,25077,25378,301
2022-08-08,70055,70051,Blue,0,52740,52877,137
2022-12-31,70053,70047,Blue,0,56447,56770,323
2022-04-12,70050,70052,Blue,1,41482,41650,168
2022-11-06,70059,70047,Blue,0,46302,46860,558
2022-05-22,70039,70838,Blue,0,28696,28731,35
2022-01-12,70058,70060,Blue,1,33906,34125,219
2022-08-21,70052,70058,Blue,1,45774,46067,293
2022-07-17,70054,70058,Blue,1,27654,27802,148
2022-07-12,70052,70058,Blue,1,65851,66105,254
2022-11-09,70055,70047,Blue,0,56362,56745,383
2022-08-22,70046,70048,Blue,1,81518,81605,87
2022-03-04,70049,70838,Blue,0,45464,46057,593
2022-08-04,70051,70043,Blue,0,40573,41057,484
2022-03-27,70054,70058,Blue,1,63216,63383,167
2022-02-14,70040,70044,Blue,1,64397,64509,112
2022-10-16,70057,70041,Blue,0,36273,37137,864
2022-01-30,70043,70039,Blue,0,79063,79173,110
2022-07-20,70052,70054,Blue,1,89846,89914,68
2022-09-12,70059,70053,Blue,0,53136,53374,238
2022-04-11,70050,70054,Blue,1,65540,65746,206
2022-12-01,70049,70838,Blue,0,21371,22107,736
2022-12-31,70053,70043,Blue,0,34924,35502,578
2022-07-11,70059,70057,Blue,0,33496,33532,36
2022-03-27,70048,70058,Blue,1,53153,53645,492
2022-02-07,70045,70838,Blue,0,38281,38715,434
2022-09-14,70041,70838,Blue,0,23636,23776,140
2022-04-10,70042,70056,Blue,1,79840,80611,771
2022-01-12,70046,70054,Blue,1,63314,63741,427
2022-03-01,70044,70052,Blue,1,84447,84906,459
2022-02-27,70059,70055,Blue,0,26175,26322,147
2022-05-25,70042,70046,Blue,1,54714,54898,184
2022-07-05,70041,70039,Blue,0,39311,39343,32
2022-02-28,70038,70042,Blue,1,20438,20542,104
2022-12-25,70040,70058,Blue,1,69967,70954,987
2022-01-26,70059,70041,Blue,0,74897,75851,954
2022-06-24,70049,70045,Blue,0,22587,22816,229
2022-05-20,70042,70054,Blue,1,50927,51754,827
2022-08-25,70040,70060,Blue,1,26133,27187,1054
2022-04-12,70044,70058,Blue,1,56167,56952,785
2022-02-24,70040,70054,Blue,1,28248,29026,778
2022-11-16,70046,70060,Blue,1,65792,66496,704
2022-06-20,70040,70058,Blue,1,66892,67872,980
2022-11-11,70040,70054,Blue,1,47798,48554,756
2022-04-08,70045,70041,Blue,0,47921,48094,173
2022-05-21,70057,70047,Blue,0,26072,26546,474
2022-06-17,70049,70043,Blue,0,58317,58690,373
2022-11-28,70038,70060,Blue,1,75275,76424,1149
2022-11-09,70047,70045,Blue,0,69761,69846,85
2022-12-13,70044,70050,Blue,1,77566,77899,333
2022-01-18,70059,70838,Blue,0,64697,65904,1207
2022-10-16,70059,70039,Blue,0,70036,71061,1025
2022-12-16,70041,70838,Blue,0,48236,48349,113
2022-11-25,70059,70051,Blue,0,44740,45175,435
2022-09-22,70040,70052,Blue,1,62470,63146,676
2022-09-07,70051,70043,Blue,0,67927,68414,487
2022-12-19,70042,70060,Blue,1,30027,30973,946
2022-07-18,70047,70043,Blue,0,57307,57566,259
2022-02-17,70042,70050,Blue,1,60900,61341,441
2022-04-05,70059,70049,Blue,0,28156,28651,495
2022-01-31,70042,70050,Blue,1,28467,28931,464
2022-10-20,70056,70058,Blue,1,55529,55601,72
2022-05-26,70048,70052,Blue,1,44444,44752,308
2022-03-12,70040,70052,Blue,1,44293,44933,640
2022-06-13,70046,70050,Blue,1,87009,87206,197
2022-04-20,70051,70041,Blue,0,26458,27064,606
2022-10-10,70052,70056,Blue,1,36714,36872,158
2022-01-09,70050,70054,Blue,1,41021,41270,249
2022-01-03,70059,70043,Blue,0,54492,55343,851
2022-06-12,70040,70060,Blue,1,26257,27355,1098
2022-09-01,70049,70047,Blue,0,70190,70245,55
2022-02-26,70044,70060,Blue,1,37468,38410,942
2022-03-09,70048,70056,Blue,1,23257,23686,429
2022-02-28,70042,70048,Blue,1,25876,26189,313
2022-08-24,70046,70058,Blue,1,67014,67718,704
2022-02-04,70045,70043,Blue,0,47003,47159,156
2022-03-25,70058,70060,Blue,1,79071,79144,73
2022-10-12,70049,70045,Blue,0,73832,74030,198
2022-06-20,70059,70049,Blue,0,61007,61519,512
2022-01-19,70048,70058,Blue,1,67252,67755,503
2022-06-10,70051,70049,Blue,0,70442,70546,104
2022-06-09,70047,70838,Blue,0,85839,86324,485
2022-10-01,70059,70039,Blue,0,50841,51839,998
2022-04-02,70049,70838,Blue,0,48647,49278,631
2022-04-25,70052,70056,Blue,1,77545,77692,147
2022-04-18,70055,70049,Blue,0,31630,31920,290
2022-12-05,70050,70058,Blue,1,84732,85130,398
2022-09-09,70057,70049,Blue,0,64842,65801,959
2022-10-12,70049,70838,Blue,0,71172,71735,563
2022-10-18,70038,70054,Blue,1,27786,28600,814
2022-05-18,70055,70838,Blue,0,77358,78421,1063
2022-06-05,70049,70047,Blue,0,50927,50987,60
2022-03-29,70040,70042,Blue,1,43619,43650,31
2022-11-24,70051,70049,Blue,0,79255,79356,101
2022-07-21,70040,70042,Blue,1,34374,34410,36
2022-04-07,70046,70056,Blue,1,28825,29355,530
2022-10-30,70046,70052,Blue,1,38055,38380,325
2022-04-20,70052,70060,Blue,1,77732,78100,368
2022-09-29,70041,70838,Blue,0,42203,42329,126
2022-02-07,70041,70039,Blue,0,25812,25840,28
2022-01-28,70057,70045,Blue,0,32735,33407,672
2022-04-10,70046,70060,Blue,1,69756,70541,785
2022-03-03,70059,70047,Blue,0,24783,25363,580
2022-07-30,70052,70054,Blue,1,68223,68281,58
2022-01-09,70044,70050,Blue,1,32541,32890,349
2022-07-05,70044,70054,Blue,1,55809,56501,692
2022-08-10,70046,70060,Blue,1,40250,41115,865
2022-04-04,70044,70060,Blue,1,35307,36261,954
2022-08-10,70047,70045,Blue,0,25756,25850,94
2022-08-05,70059,70049,Blue,0,49395,49859,464
2022-12-11,70057,70053,Blue,0,61469,61632,163
2022-02-06,70038,70058,Blue,1,57493,58466,973
2022-11-07,70051,70039,Blue,0,34376,35205,829
2022-10-06,70047,70041,Blue,0,22212,22550,338
2022-11-22,70049,70045,Blue,0,82605,82794,189
2022-04-01,70046,70058,Blue,1,22249,22915,666
2022-04-25,70058,70060,Blue,1,64886,64963,77
2022-05-21,70044,70046,Blue,1,50069,50234,165
2022-03-17,70057,70041,Blue,0,48757,49656,899
2022-08-21,70038,70040,Blue,1,81004,81019,15
2022-02-19,70045,70838,Blue,0,84829,85191,362
2022-12-14,70055,70043,Blue,0,37638,38387,749
2022-02-03,70050,70054,Blue,1,87701,87917,216
2022-12-23,70040,70050,Blue,1,26750,27245,495
2022-09-16,70048,70056,Blue,1,24540,24965,425
2022-09-07,70059,70043,Blue,0,30573,31506,933
2022-08-01,70046,70052,Blue,1,49603,49940,337
2022-10-22,70051,70045,Blue,0,21198,21572,374
2022-04-11,70042,70046,Blue,1,55125,55322,197
2022-03-21,70051,70049,Blue,0,45294,45403,109
2022-02-12,70048,70060,Blue,1,32301,32889,588
2022-12-01,70046,70058,Blue,1,50643,51277,634
2022-02-09,70038,70044,Blue,1,66136,66359,223
2022-01-07,70056,70058,Blue,1,35773,35870,97
2022-07-04,70042,70054,Blue,1,43308,44095,787
2022-02-18,70040,70046,Blue,1,62907,63177,270
2022-04-20,70052,70056,Blue,1,89275,89426,151
2022-02-28,70040,70046,Blue,1,33984,34272,288
2022-08-28,70044,70056,Blue,1,69050,69694,644
2022-12-30,70051,70043,Blue,0,28939,29401,462
2022-02-14,70053,70045,Blue,0,59575,60011,436
2022-11-15,70040,70044,Blue,1,67154,67278,124
2022-07-07,70049,70043,Blue,0,68059,68435,376
2022-12-02,70051,70838,Blue,0,48216,48970,754
2022-07-17,70044,70060,Blue,1,55023,55927,904
2022-03-26,70042,70058,Blue,1,69230,70225,995
2022-12-18,70059,70041,Blue,0,64635,65620,985
2022-02-15,70057,70045,Blue,0,42760,43477,717
2022-08-10,70048,70060,Blue,1,28312,28956,644
2022-02-27,70053,70047,Blue,0,40411,40704,293
2022-03-11,70059,70049,Blue,0,42073,42573,500
2022-07-23,70053,70039,Blue,0,21239,22013,774
2022-11-09,70038,70048,Blue,1,67936,68415,479
2022-10-10,70042,70050,Blue,1,76495,76932,437
2022-10-15,70044,70048,Blue,1,61201,61446,245
2022-11-07,70038,70056,Blue,1,31435,32360,925
2022-11-21,70038,70058,Blue,1,57563,58721,1158
2022-12-09,70045,70043,Blue,0,76102,76194,92
2022-03-08,70045,70039,Blue,0,50604,50886,282
2022-04-04,70053,70047,Blue,0,20865,21139,274
2022-02-14,70051,70045,Blue,0,51241,51621,380
2022-03-27,70049,70041,Blue,0,41932,42336,404
2022-12-02,70052,70056,Blue,1,60911,61056,145
2022-02-11,70040,70052,Blue,1,55690,56295,605
2022-04-02,70047,70045,Blue,0,30919,31016,97
2022-02-11,70057,70055,Blue,0,28845,28921,76
2022-09-08,70056,70058,Blue,1,55881,55952,71
2022-10-24,70042,70052,Blue,1,28711,29280,569
2022-07-16,70055,70051,Blue,0,66674,66811,137
2022-11-04,70057,70053,Blue,0,55716,55871,155
2022-03-21,70042,70046,Blue,1,76458,76627,169
2022-03-07,70047,70838,Blue,0,54827,55361,534
2022-01-05,70049,70045,Blue,0,68963,69141,178
2022-02-28,70056,70058,Blue,1,28963,29249,286
2022-12-04,70039,70838,Blue,0,40871,40917,46
2022-07-01,70042,70056,Blue,1,65347,66197,850
2022-01-05,70045,70838,Blue,0,64503,64812,309
2022-03-30,70052,70058,Blue,1,51914,52161,247
2022-03-06,70047,70045,Blue,0,60948,61055,107
2022-08-06,70057,70055,Blue,0,42826,42894,68
2022-09-08,70042,70046,Blue,1,67791,67977,186
2022-10-27,70044,70052,Blue,1,76041,76556,515
2022-12-20,70044,70056,Blue,1,74001,74747,746
2022-10-06,70053,70049,Blue,0,45079,45275,196
2022-11-05,70040,70056,Blue,1,37820,38681,861
2022-04-01,70057,70039,Blue,0,22845,24161,1316
2022-12-15,70055,70045,Blue,0,60083,60656,573
2022-09-08,70048,70058,Blue,1,26969,27527,558
2022-04-19,70055,70838,Blue,0,40630,41820,1190
2022-02-08,70048,70054,Blue,1,89631,89914,283
2022-07-03,70038,70050,Blue,1,25333,25925,592
2022-01-07,70043,70041,Blue,0,71391,71422,31
2022-01-23,70054,70060,Blue,1,58360,58616,256
2022-02-15,70057,70055,Blue,0,63873,63944,71
2022-04-15,70058,70060,Blue,1,66662,66739,77
2022-06-27,70042,70050,Blue,1,61506,61937,431
2022-08-22,70048,70058,Blue,1,75738,76288,550
2022-03-17,70040,70050,Blue,1,27915,28447,532
2022-02-12,70049,70838,Blue,0,65921,66496,575
2022-04-05,70051,70838,Blue,0,72947,73639,692
2022-06-23,70059,70045,Blue,0,67755,68455,700
2022-01-04,70055,70051,Blue,0,46812,46945,133
2022-03-08,70038,70044,Blue,1,68974,69142,168
2022-03-21,70042,70058,Blue,1,57880,58810,930
2022-09-06,70057,70041,Blue,0,34307,35184,877
2022-11-04,70053,70039,Blue,0,32799,33585,786
2022-12-31,70059,70041,Blue,0,86606,87560,954
2022-10-23,70044,70048,Blue,1,41870,42093,223
2022-12-21,70059,70057,Blue,0,54094,54129,35
2022-08-02,70055,70045,Blue,0,75565,76075,510
2022-09-27,70040,70054,Blue,1,48457,49203,746
2022-01-12,70038,70056,Blue,1,50287,51141,854
2022-10-12,70055,70039,Blue,0,55297,56143,846
2022-03-11,70038,70056,Blue,1,42440,43389,949
2022-08-14,70040,70046,Blue,1,60255,60521,266
2022-02-22,70046,70060,Blue,1,75253,76058,805
2022-03-17,70055,70047,Blue,0,20425,20817,392
2022-07-02,70044,70048,Blue,1,30926,31178,252
2022-10-21,70046,70052,Blue,1,51259,51601,342
2022-05-01,70059,70055,Blue,0,67803,67949,146
2022-07-29,70055,70047,Blue,0,56168,56551,383
2022-06-27,70056,70058,Blue,1,72295,72387,92
2022-05-29,70045,70043,Blue,0,80554,80685,131
2022-08-08,70050,70060,Blue,1,50906,51441,535
2022-08-20,70038,70044,Blue,1,73384,73568,184
2022-06-23,70059,70041,Blue,0,27620,28604,984
2022-11-30,70043,70039,Blue,0,34692,34808,116
2022-01-23,70059,70051,Blue,0,22272,22610,338
2022-08-29,70057,70055,Blue,0,56901,56970,69
2022-02-15,70056,70060,Blue,1,62179,62499,320
2022-02-07,70042,70050,Blue,1,59782,60184,402
2022-08-26,70040,70058,Blue,1,62169,63183,1014
2022-10-03,70050,70060,Blue,1,43192,43724,532
2022-07-25,70049,70045,Blue,0,53215,53465,250
2022-02-27,70038,70056,Blue,1,79087,79975,888
2022-03-01,70041,70039,Blue,0,25178,25207,29
2022-03-16,70057,70053,Blue,0,63868,64027,159
2022-03-24,70043,70838,Blue,0,23767,23985,218
2022-01-11,70038,70044,Blue,1,21546,21704,158
2022-04-24,70040,70044,Blue,1,59830,59946,116
2022-09-28,70057,70039,Blue,0,39567,40470,903
2022-12-15,70055,70045,Blue,0,70878,71403,525
2022-07-08,70057,70047,Blue,0,75051,75519,468
2022-02-10,70053,70043,Blue,0,21973,22641,668
2022-03-08,70048,70058,Blue,1,23843,24359,516
2022-05-18,70042,70044,Blue,1,77877,77912,35
2022-03-20,70049,70043,Blue,0,58975,59321,346
2022-01-18,70038,70054,Blue,1,29773,30587,814
2022-12-29,70040,70060,Blue,1,39258,40317,1059
2022-04-15,70053,70043,Blue,0,35544,36173,629
2022-03-26,70058,70060,Blue,1,31741,31807,66
2022-05-28,70039,70838,Blue,0,24418,24451,33
2022-11-10,70057,70041,Blue,0,26799,27708,909
2022-06-04,70049,70039,Blue,0,21953,22541,588
2022-08-15,70042,70060,Blue,1,65032,65999,967
2022-08-15,70053,70045,Blue,0,85802,86266,464
2022-03-16,70046,70056,Blue,1,80154,80692,538
2022-10-27,70040,70054,Blue,1,42732,43533,801
2022-11-09,70044,70050,Blue,1,57322,57674,352
2022-08-12,70057,70051,Blue,0,71407,71664,257
2022-07-08,70059,70049,Blue,0,76082,76560,478
2022-01-14,70056,70060,Blue,1,60801,61044,243
2022-07-23,70052,70054,Blue,1,24404,24485,81
2022-07-26,70041,70838,Blue,0,76375,76495,120
2022-02-08,70058,70060,Blue,1,84885,84956,71
2022-05-26,70047,70043,Blue,0,65581,65857,276
2022-01-06,70051,70049,Blue,0,27385,27492,107
2022-04-06,70038,70040,Blue,1,55814,55831,17
2022-04-21,70059,70043,Blue,0,53923,54755,832
2022-01-23,70048,70050,Blue,1,70909,70966,57
2022-02-21,70050,70058,Blue,1,24240,24636,396
2022-03-14,70051,70041,Blue,0,44774,45318,544
2022-11-01,70058,70060,Blue,1,73135,73199,64
2022-10-29,70056,70058,Blue,1,85730,85803,73
2022-05-20,70048,70052,Blue,1,25105,25382,277
2022-10-10,70057,70041,Blue,0,78261,79068,807
2022-05-02,70054,70060,Blue,1,66316,66573,257
2022-11-07,70042,70044,Blue,1,59620,59672,52
2022-10-19,70042,70046,Blue,1,84272,84453,181
2022-06-25,70038,70050,Blue,1,42108,42750,642
2022-03-29,70048,70052,Blue,1,24856,25086,230
2022-04-14,70038,70056,Blue,1,37354,38333,979
2022-11-18,70041,70838,Blue,0,23622,23754,132
2022-10-01,70047,70045,Blue,0,44447,44541,94
2022-01-09,70038,70054,Blue,1,76399,77302,903
2022-05-21,70038,70048,Blue,1,59021,59603,582
2022-12-19,70046,70060,Blue,1,21308,22174,866
2022-10-06,70044,70060,Blue,1,87644,88543,899
2022-06-26,70040,70060,Blue,1,54092,55600,1508
2022-07-10,70052,70060,Blue,1,78256,78650,394
2022-10-25,70057,70055,Blue,0,52292,52362,70
2022-07-28,70048,70056,Blue,1,30167,30579,412
2022-09-26,70040,70048,Blue,1,24570,24966,396
2022-03-21,70038,70058,Blue,1,32655,33717,1062
2022-01-10,70059,70049,Blue,0,41647,42224,577
2022-02-09,70048,70050,Blue,1,50317,50370,53
2022-08-30,70054,70058,Blue,1,22216,22380,164
2022-11-25,70040,70060,Blue,1,61749,62809,1060
2022-08-02,70057,70045,Blue,0,55870,56539,669
2022-02-14,70050,70060,Blue,1,54289,54930,641
2022-02-02,70053,70043,Blue,0,30577,31303,726
2022-02-10,70057,70055,Blue,0,58171,58240,69
2022-07-31,70050,70056,Blue,1,40242,40567,325
2022-03-12,70042,70056,Blue,1,48170,48919,749
2022-01-23,70059,70838,Blue,0,74353,75415,1062
2022-03-15,70051,70041,Blue,0,21707,22495,788
2022-08-11,70053,70045,Blue,0,47593,48034,441
2022-01-12,70042,70050,Blue,1,23478,23944,466
2022-12-21,70051,70043,Blue,0,55773,56288,515
2022-01-31,70051,70049,Blue,0,33068,33177,109
2022-05-12,70050,70058,Blue,1,34214,34688,474
2022-12-15,70046,70054,Blue,1,58693,59148,455
2022-02-07,70046,70048,Blue,1,84080,84156,76
2022-03-08,70048,70052,Blue,1,33164,33374,210
2022-09-03,70057,70045,Blue,0,86612,87225,613
2022-08-01,70042,70044,Blue,1,77479,77513,34
2022-10-26,70038,70046,Blue,1,23562,23868,306
2022-04-22,70057,70039,Blue,0,66625,67634,1009
2022-08-06,70049,70041,Blue,0,88745,89352,607
2022-02-06,70040,70048,Blue,1,29504,29890,386
2022-12-02,70050,70058,Blue,1,65397,65794,397
2022-10-31,70055,70053,Blue,0,51142,51188,46
2022-02-05,70059,70838,Blue,0,47596,48734,1138
2022-02-15,70038,70056,Blue,1,60126,61092,966
2022-04-06,70040,70050,Blue,1,52209,52723,514
2022-01-07,70059,70039,Blue,0,73754,74792,1038
2022-10-25,70049,70043,Blue,0,55819,56156,337
2022-01-04,70046,70060,Blue,1,72961,73745,784
2022-01-24,70038,70058,Blue,1,78566,79561,995
2022-02-13,70050,70054,Blue,1,44306,44545,239
2022-09-07,70047,70838,Blue,0,20237,20846,609
2022-08-26,70038,70044,Blue,1,40895,41052,157
2022-06-13,70044,70046,Blue,1,66338,66530,192
2022-01-18,70051,70045,Blue,0,67006,67457,451
2022-01-23,70038,70048,Blue,1,68550,69029,479
2022-07-28,70055,70047,Blue,0,52244,52621,377
2022-03-30,70046,70050,Blue,1,81845,82022,177
2022-11-23,70052,70060,Blue,1,30992,31384,392
2022-10-20,70055,70039,Blue,0,31609,32542,933
2022-02-28,70049,70838,Blue,0,23342,24009,667
2022-11-16,70057,70045,Blue,0,23395,24104,709
2022-10-03,70055,70049,Blue,0,23190,23501,311
2022-02-21,70040,70058,Blue,1,67015,68027,1012
2022-03-30,70044,70054,Blue,1,34652,35355,703
2022-11-02,70038,70048,Blue,1,89113,89696,583
2022-04-24,70041,70039,Blue,0,71553,71584,31
2022-07-08,70038,70040,Blue,1,33711,33726,15
2022-07-04,70040,70042,Blue,1,56619,56652,33
2022-03-30,70047,70039,Blue,0,43813,44196,383
2022-02-08,70040,70046,Blue,1,19888,20157,269
2022-03-14,70059,70045,Blue,0,29063,29821,758
2022-02-14,70049,70041,Blue,0,26021,26502,481
2022-07-17,70052,70056,Blue,1,33814,33961,147
2022-09-25,70047,70043,Blue,0,83708,83950,242
2022-11-29,70051,70039,Blue,0,74168,74754,586
2022-07-09,70047,70043,Blue,0,54663,54939,276
2022-02-09,70044,70050,Blue,1,36098,36427,329
2022-06-10,70046,70054,Blue,1,85412,85874,462
2022-03-24,70045,70838,Blue,0,26540,26870,330
2022-12-31,70048,70056,Blue,1,90700,91126,426
2022-10-01,70057,70043,Blue,0,68189,68988,799
2022-10-11,70054,70056,Blue,1,53758,53804,46
2022-08-27,70055,70041,Blue,0,37512,38245,733
2022-03-15,70048,70056,Blue,1,61267,61665,398
2022-10-11,70054,70060,Blue,1,38704,38960,256
2022-10-25,70057,70055,Blue,0,38261,38333,72
2022-01-27,70053,70041,Blue,0,61992,62691,699
2022-11-26,70051,70045,Blue,0,18822,19192,370
2022-08-09,70055,70051,Blue,0,35574,35713,139
2022-03-05,70038,70048,Blue,1,70150,70607,457
2022-12-01,70040,70058,Blue,1,30434,31430,996
2022-06-16,70044,70052,Blue,1,73567,74109,542
2022-06-06,70045,70043,Blue,0,27852,27975,123
2022-03-27,70046,70054,Blue,1,38687,39071,384
2022-01-01,70038,70040,Blue,1,39019,39036,17
2022-04-02,70055,70049,Blue,0,48853,49147,294
2022-04-18,70038,70044,Blue,1,58626,58917,291
2022-11-01,70044,70052,Blue,1,57827,58381,554
2022-10-24,70057,70051,Blue,0,45809,46053,244
2022-01-07,70043,70041,Blue,0,40246,40275,29
2022-08-26,70053,70838,Blue,0,22010,22932,922
2022-08-18,70038,70060,Blue,1,56324,57578,1254
2022-10-20,70044,70050,Blue,1,36976,37319,343
2022-07-01,70049,70838,Blue,0,45310,45932,622
2022-09-25,70040,70058,Blue,1,88266,89168,902
2022-03-26,70046,70056,Blue,1,37051,37573,522
2022-03-28,70046,70048,Blue,1,50085,50168,83
2022-06-07,70047,70045,Blue,0,28090,28192,102
2022-06-16,70052,70058,Blue,1,32360,32700,340
2022-03-06,70047,70041,Blue,0,86126,86468,342
2022-04-10,70046,70048,Blue,1,31281,31369,88
2022-11-23,70055,70838,Blue,0,51674,52553,879
2022-06-11,70040,70044,Blue,1,36738,36854,116
2022-10-11,70051,70049,Blue,0,52639,52742,103
2022-10-06,70048,70056,Blue,1,70968,71350,382
2022-09-08,70055,70045,Blue,0,53893,54402,509
2022-08-07,70051,70047,Blue,0,39216,39409,193
2022-07-27,70051,70041,Blue,0,27989,28616,627
2022-09-18,70040,70056,Blue,1,35548,36393,845
2022-03-09,70047,70039,Blue,0,86888,87272,384
2022-11-19,70052,70058,Blue,1,41247,41501,254
2022-10-05,70059,70838,Blue,0,25515,26791,1276
2022-03-18,70049,70043,Blue,0,63419,63767,348
2022-03-23,70053,70039,Blue,0,81457,82178,721
2022-11-27,70044,70048,Blue,1,60421,60685,264
2022-10-19,70047,70043,Blue,0,29946,30235,289
2022-01-06,70038,70054,Blue,1,70927,71697,770
2022-04-14,70041,70838,Blue,0,22126,22246,120
2022-11-02,70042,70048,Blue,1,88351,88666,315
2022-06-17,70038,70042,Blue,1,23355,23438,83
2022-11-22,70057,70039,Blue,0,26343,27364,1021
2022-03-27,70044,70054,Blue,1,34144,34722,578
2022-01-26,70057,70838,Blue,0,55372,56657,1285
2022-07-29,70038,70058,Blue,1,44927,46073,1146
2022-09-03,70052,70060,Blue,1,80050,80402,352
2022-04-09,70057,70047,Blue,0,54690,55174,484
2022-03-23,70053,70041,Blue,0,61960,62590,630
2022-07-26,70046,70050,Blue,1,73580,73761,181
2022-09-29,70038,70054,Blue,1,61403,62298,895
2022-03-15,70057,70055,Blue,0,42784,42864,80
2022-08-04,70042,70058,Blue,1,59782,60699,917
2022-10-07,70046,70048,Blue,1,54479,54550,71
2022-06-17,70059,70057,Blue,0,45506,45546,40
2022-09-08,70038,70058,Blue,1,43016,44041,1025
2022-02-02,70038,70044,Blue,1,78670,78835,165
2022-05-20,70055,70049,Blue,0,75695,75992,297
2022-11-07,70048,70050,Blue,1,62089,62145,56
2022-03-26,70055,70039,Blue,0,41302,42215,913
2022-09-06,70048,70056,Blue,1,24090,24488,398
2022-10-17,70050,70058,Blue,1,37461,37950,489
2022-07-10,70055,70043,Blue,0,41001,41716,715
2022-10-12,70059,70039,Blue,0,47302,48307,1005
2022-05-18,70039,70838,Blue,0,73881,73915,34
2022-08-09,70056,70060,Blue,1,25524,25704,180
2022-09-10,70038,70056,Blue,1,24969,26201,1232
2022-12-31,70040,70054,Blue,1,45393,46149,756
2022-09-12,70054,70056,Blue,1,47934,47981,47
2022-02-04,70054,70060,Blue,1,23072,23911,839
2022-05-01,70058,70060,Blue,1,53425,53489,64
2022-04-19,70057,70039,Blue,0,78390,79457,1067
2022-03-22,70038,70060,Blue,1,65567,66776,1209
2022-03-16,70059,70047,Blue,0,64694,65243,549
2022-09-28,70048,70050,Blue,1,65772,65831,59
2022-07-01,70057,70043,Blue,0,39680,40434,754
2022-08-21,70059,70045,Blue,0,69493,70206,713
2022-03-07,70038,70056,Blue,1,84882,85770,888
2022-04-11,70053,70045,Blue,0,32052,32489,437
2022-07-02,70047,70039,Blue,0,31947,32390,443
2022-03-25,70051,70838,Blue,0,72988,73698,710
2022-01-14,70042,70056,Blue,1,65090,65883,793
2022-10-02,70044,70060,Blue,1,73484,74364,880
2022-03-16,70045,70041,Blue,0,33136,33307,171
2022-05-11,70059,70055,Blue,0,37532,37707,175
2022-02-10,70042,70054,Blue,1,54779,55467,688
2022-05-31,70040,70042,Blue,1,56069,56104,35
2022-06-10,70052,70054,Blue,1,63957,64012,55
2022-07-02,70053,70041,Blue,0,72718,73444,726
2022-06-06,70049,70041,Blue,0,22461,23016,555
2022-07-24,70038,70042,Blue,1,68296,68395,99
2022-08-19,70059,70047,Blue,0,57219,58014,795
2022-10-05,70051,70043,Blue,0,51836,52298,462
2022-12-22,70044,70060,Blue,1,24975,26018,1043
2022-09-29,70058,70060,Blue,1,33829,33910,81
2022-01-19,70038,70040,Blue,1,65537,65552,15
2022-08-15,70041,70838,Blue,0,28878,28998,120
2022-09-03,70043,70838,Blue,0,21139,21438,299
2022-05-19,70053,70039,Blue,0,20167,21224,1057
2022-12-29,70048,70060,Blue,1,82120,82749,629
2022-08-06,70059,70055,Blue,0,26535,26679,144
2022-03-14,70057,70041,Blue,0,30042,30942,900
2022-12-28,70059,70055,Blue,0,19761,19904,143
2022-12-14,70046,70052,Blue,1,76682,77030,348
2022-04-15,70059,70055,Blue,0,31758,31903,145
2022-08-14,70057,70051,Blue,0,26265,26530,265
2022-11-24,70049,70047,Blue,0,69999,70055,56
2022-12-22,70044,70046,Blue,1,82857,82964,107
2022-07-16,70051,70047,Blue,0,88619,88819,200
2022-11-27,70042,70054,Blue,1,44437,45077,640
2022-08-22,70053,70039,Blue,0,19810,20689,879
2022-03-21,70057,70045,Blue,0,62071,62729,658
2022-05-19,70053,70838,Blue,0,43509,44592,1083
2022-06-28,70047,70045,Blue,0,50533,50633,100
2022-08-26,70046,70058,Blue,1,35566,36183,617
2022-11-10,70050,70052,Blue,1,50350,50460,110
2022-10-08,70040,70058,Blue,1,39041,39984,943
2022-07-14,70053,70041,Blue,0,44135,44998,863
2022-02-08,70058,70060,Blue,1,79117,79223,106
2022-01-13,70059,70057,Blue,0,40963,40997,34
2022-02-25,70055,70053,Blue,0,70746,70802,56
2022-04-13,70038,70052,Blue,1,25464,26182,718
2022-04-06,70042,70054,Blue,1,56292,56933,641
2022-07-16,70057,70049,Blue,0,42810,43187,377
2022-11-27,70054,70058,Blue,1,24576,24727,151
2022-08-22,70040,70054,Blue,1,76616,77346,730
2022-02-25,70057,70055,Blue,0,40622,40696,74
2022-08-24,70051,70047,Blue,0,46513,46752,239
2022-01-28,70042,70044,Blue,1,68731,68758,27
2022-03-25,70055,70043,Blue,0,41124,41854,730
2022-03-16,70050,70060,Blue,1,86600,87129,529
2022-10-18,70043,70039,Blue,0,39200,39321,121
2022-02-04,70050,70058,Blue,1,30745,31515,770
2022-07-29,70057,70047,Blue,0,52047,52517,470
2022-02-16,70046,70058,Blue,1,63348,63966,618
2022-03-28,70059,70043,Blue,0,49758,50577,819
2022-08-01,70059,70838,Blue,0,63438,64616,1178
2022-08-28,70038,70050,Blue,1,62349,62930,581
2022-02-05,70038,70042,Blue,1,86408,86513,105
2022-07-22,70044,70048,Blue,1,57434,57751,317
2022-02-16,70057,70051,Blue,0,86988,87290,302
2022-11-12,70048,70058,Blue,1,81133,81682,549
2022-02-24,70046,70052,Blue,1,56362,56723,361
2022-12-12,70045,70838,Blue,0,54565,54874,309
2022-01-11,70040,70042,Blue,1,73568,73599,31
2022-07-15,70038,70052,Blue,1,59325,60012,687
2022-11-02,70042,70060,Blue,1,71267,72243,976
2022-02-10,70048,70052,Blue,1,37232,37425,193
2022-01-03,70038,70046,Blue,1,66186,66529,343
2022-06-14,70049,70041,Blue,0,22248,22748,500
2022-04-12,70044,70050,Blue,1,59565,59922,357
2022-10-07,70041,70039,Blue,0,51348,51383,35
2022-04-22,70038,70044,Blue,1,67634,67828,194
2022-12-30,70057,70043,Blue,0,70360,71051,691
2022-11-29,70044,70056,Blue,1,46320,46989,669
2022-07-12,70046,70054,Blue,1,50253,50714,461
2022-03-06,70049,70045,Blue,0,38714,38906,192
2022-08-28,70042,70052,Blue,1,65211,65896,685
2022-08-01,70057,70053,Blue,0,22809,22965,156
2022-05-20,70038,70052,Blue,1,75792,76583,791
2022-01-25,70059,70043,Blue,0,38183,39299,1116
2022-08-25,70047,70041,Blue,0,78919,79282,363
2022-05-19,70049,70041,Blue,0,83950,84504,554
2022-03-31,70049,70041,Blue,0,50737,51198,461
2022-04-06,70042,70052,Blue,1,66894,67473,579
2022-07-05,70044,70056,Blue,1,67147,67879,732
2022-10-20,70038,70058,Blue,1,65356,66483,1127
2022-01-25,70048,70054,Blue,1,33441,33761,320
2022-04-04,70040,70052,Blue,1,33312,33990,678
2022-01-14,70059,70047,Blue,0,79459,80035,576
2022-03-25,70055,70039,Blue,0,59782,60603,821
2022-01-27,70040,70050,Blue,1,42555,43069,514
2022-10-12,70053,70045,Blue,0,73073,73508,435
2022-06-06,70048,70050,Blue,1,57586,57663,77
2022-11-01,70049,70039,Blue,0,22569,23160,591
2022-12-25,70053,70039,Blue,0,63828,64531,703
2022-03-30,70052,70058,Blue,1,53752,53997,245
2022-06-30,70052,70060,Blue,1,42748,43150,402
2022-11-01,70042,70052,Blue,1,31691,32250,559
2022-12-13,70046,70054,Blue,1,52618,53108,490
2022-11-14,70049,70041,Blue,0,72270,72714,444
2022-12-28,70051,70049,Blue,0,61436,61535,99
2022-10-14,70042,70058,Blue,1,39986,40855,869
2022-01-03,70040,70058,Blue,1,66873,67841,968
2022-04-01,70053,70045,Blue,0,46388,46848,460
2022-10-09,70051,70049,Blue,0,69865,69968,103
2022-11-05,70038,70060,Blue,1,61520,62611,1091
2022-07-02,70059,70047,Blue,0,82337,82913,576
2022-06-23,70047,70838,Blue,0,54099,54759,660
2022-10-09,70049,70041,Blue,0,65082,65492,410
2022-06-09,70046,70056,Blue,1,34856,35544,688
2022-12-14,70059,70055,Blue,0,69967,70094,127
2022-01-05,70051,70838,Blue,0,34196,35054,858
2022-09-06,70055,70838,Blue,0,61019,62094,1075
2022-02-12,70056,70060,Blue,1,59350,59574,224
2022-09-30,70048,70056,Blue,1,36923,37314,391
2022-12-25,70059,70053,Blue,0,73814,74044,230
2022-09-22,70049,70045,Blue,0,47856,48087,231
2022-10-10,70038,70046,Blue,1,45200,45570,370
2022-07-22,70042,70050,Blue,1,76724,77151,427
2022-04-10,70040,70058,Blue,1,69969,70902,933
2022-10-05,70040,70048,Blue,1,27084,27474,390
2022-03-30,70045,70041,Blue,0,37788,37969,181
2022-10-11,70040,70052,Blue,1,64336,65031,695
2022-11-01,70053,70045,Blue,0,69388,69817,429
2022-05-13,70053,70049,Blue,0,41337,41541,204
2022-02-24,70038,70054,Blue,1,24562,25400,838
2022-09-05,70055,70051,Blue,0,27921,28062,141
2022-03-26,70051,70838,Blue,0,48493,49225,732
2022-01-27,70042,70048,Blue,1,32493,32935,442
2022-08-18,70059,70053,Blue,0,24974,25220,246
2022-11-02,70039,70838,Blue,0,66774,66804,30
2022-10-05,70057,70041,Blue,0,25199,26117,918
2022-04-11,70048,70056,Blue,1,67928,68336,408
2022-04-12,70051,70049,Blue,0,25303,25419,116
2022-04-20,70057,70055,Blue,0,74427,74496,69
2022-06-11,70059,70055,Blue,0,29773,29937,164
2022-10-19,70052,70060,Blue,1,50597,50939,342
2022-08-10,70049,70039,Blue,0,78102,78629,527
2022-06-10,70053,70039,Blue,0,23358,24185,827
2022-04-17,70055,70838,Blue,0,27987,28929,942
2022-03-21,70055,70043,Blue,0,70693,71427,734
2022-03-10,70044,70054,Blue,1,20339,21062,723
2022-06-01,70047,70039,Blue,0,67406,67863,457
2022-11-12,70051,70049,Blue,0,39999,40107,108
2022-10-10,70057,70039,Blue,0,27866,28774,908
2022-04-25,70057,70053,Blue,0,74480,74626,146
2022-07-22,70040,70046,Blue,1,50432,50696,264
2022-07-18,70048,70052,Blue,1,61555,61762,207
2022-07-11,70042,70054,Blue,1,47803,48567,764
2022-12-22,70042,70060,Blue,1,37709,38818,1109
2022-10-02,70042,70044,Blue,1,62098,62128,30
2022-02-13,70047,70043,Blue,0,52331,52576,245
2022-03-21,70038,70060,Blue,1,53601,54734,1133
2022-10-05,70046,70060,Blue,1,49677,50430,753
2022-11-01,70048,70050,Blue,1,52337,52397,60
2022-08-10,70047,70838,Blue,0,51603,52108,505
2022-08-08,70038,70040,Blue,1,67936,67952,16
2022-02-28,70053,70043,Blue,0,58667,59275,608
2022-04-28,70052,70054,Blue,1,69074,69129,55
2022-09-26,70045,70838,Blue,0,63165,63508,343
2022-09-29,70051,70041,Blue,0,73221,73921,700
2022-01-19,70051,70047,Blue,0,57840,58033,193
2022-10-24,70051,70045,Blue,0,70551,70880,329
2022-02-10,70057,70049,Blue,0,56660,57064,404
2022-10-07,70047,70838,Blue,0,80499,80979,480
2022-08-08,70053,70051,Blue,0,34660,34736,76
2022-05-26,70047,70039,Blue,0,75750,76188,438
2022-10-27,70052,70058,Blue,1,78394,78658,264
2022-03-29,70059,70045,Blue,0,59892,60534,642
2022-09-12,70038,70054,Blue,1,35772,36575,803
2022-03-12,70051,70045,Blue,0,30118,30438,320
2022-02-08,70047,70043,Blue,0,63537,63800,263
2022-09-13,70051,70049,Blue,0,62238,62340,102
2022-02-24,70044,70052,Blue,1,44373,44942,569
2022-08-08,70046,70052,Blue,1,63311,63631,320
2022-09-24,70038,70054,Blue,1,60430,61265,835
2022-12-27,70038,70046,Blue,1,61485,61838,353
2022-10-25,70059,70045,Blue,0,54138,54852,714
2022-12-21,70057,70043,Blue,0,66756,67488,732
2022-07-10,70042,70056,Blue,1,88362,89153,791
2022-11-21,70040,70054,Blue,1,47723,48457,734
2022-01-10,70047,70039,Blue,0,65335,65719,384
2022-04-11,70057,70838,Blue,0,60908,61871,963
2022-09-11,70038,70040,Blue,1,25621,25639,18
2022-12-08,70055,70043,Blue,0,32323,33036,713
2022-10-16,70044,70054,Blue,1,79442,80064,622
2022-06-23,70057,70049,Blue,0,47674,48051,377
2022-09-28,70042,70052,Blue,1,72205,72738,533
2022-11-05,70038,70044,Blue,1,88207,88405,198
2022-08-31,70057,70041,Blue,0,43347,44265,918
2022-07-09,70058,70060,Blue,1,32850,32913,63
2022-06-03,70042,70048,Blue,1,63832,64232,400
2022-11-21,70056,70058,Blue,1,73731,73802,71
2022-12-13,70048,70060,Blue,1,47656,48237,581
2022-11-05,70050,70056,Blue,1,65853,66166,313
2022-06-22,70057,70049,Blue,0,24583,24969,386
2022-04-18,70044,70056,Blue,1,67572,68265,693
2022-01-15,70055,70053,Blue,0,81737,81790,53
2022-10-01,70051,70039,Blue,0,53905,54557,652
2022-06-26,70051,70039,Blue,0,50474,51198,724
2022-11-02,70043,70041,Blue,0,23324,23354,30
2022-09-24,70052,70056,Blue,1,62320,62463,143
2022-12-09,70043,70039,Blue,0,77324,77425,101
2022-06-13,70042,70054,Blue,1,85539,86212,673
2022-12-29,70055,70047,Blue,0,63959,64329,370
2022-11-11,70046,70052,Blue,1,62391,62769,378
2022-02-17,70042,70056,Blue,1,62685,63446,761
2022-01-02,70059,70051,Blue,0,24641,24983,342
2022-11-13,70055,70049,Blue,0,52406,52695,289
2022-03-21,70048,70056,Blue,1,64942,65389,447
2022-11-29,70053,70043,Blue,0,52778,53334,556
2022-02-20,70046,70050,Blue,1,51890,52049,159
2022-02-24,70044,70060,Blue,1,88621,89790,1169
2022-09-17,70059,70055,Blue,0,43859,43999,140
2022-03-16,70048,70058,Blue,1,54809,55296,487
2022-07-06,70051,70049,Blue,0,79185,79290,105
2022-07-26,70045,70039,Blue,0,34772,35090,318
2022-08-22,70048,70058,Blue,1,87856,88412,556
2022-03-14,70059,70045,Blue,0,55132,55829,697
2022-11-12,70044,70046,Blue,1,80837,80946,109
2022-10-19,70049,70041,Blue,0,69174,69571,397
2022-09-29,70051,70043,Blue,0,83871,84363,492
2022-11-04,70045,70041,Blue,0,80656,80825,169
2022-03-09,70053,70043,Blue,0,61152,61821,669
2022-08-09,70042,70050,Blue,1,64368,64914,546
2022-01-27,70043,70041,Blue,0,53477,53505,28
2022-08-09,70045,70043,Blue,0,66128,66217,89
2022-11-17,70059,70055,Blue,0,64778,64924,146
2022-07-08,70043,70838,Blue,0,48280,48489,209
2022-05-24,70045,70039,Blue,0,42193,42505,312
2022-12-24,70049,70838,Blue,0,56742,57324,582
2022-08-09,70059,70043,Blue,0,23838,24717,879
2022-12-19,70044,70056,Blue,1,63843,64577,734
2022-11-27,70051,70039,Blue,0,35879,36566,687
2022-11-25,70046,70056,Blue,1,35316,35846,530
2022-06-21,70047,70838,Blue,0,25428,25979,551
2022-03-22,70042,70048,Blue,1,32508,33223,715
2022-12-27,70042,70054,Blue,1,27801,28430,629
2022-09-29,70052,70056,Blue,1,37499,37638,139
2022-05-26,70038,70050,Blue,1,26234,26812,578
2022-12-10,70046,70048,Blue,1,77002,77087,85
2022-12-10,70054,70060,Blue,1,73250,73520,270
2022-03-03,70057,70045,Blue,0,28528,29275,747
2022-09-23,70057,70047,Blue,0,58291,58837,546
2022-05-19,70050,70058,Blue,1,53484,53900,416
2022-03-25,70047,70041,Blue,0,45596,45911,315
2022-11-28,70040,70050,Blue,1,61440,62039,599
2022-01-13,70044,70056,Blue,1,36391,37399,1008
2022-01-25,70055,70051,Blue,0,58295,58454,159
2022-01-14,70046,70048,Blue,1,83033,83107,74
2022-02-01,70059,70049,Blue,0,66471,66989,518
2022-12-08,70051,70838,Blue,0,42996,43746,750
2022-08-23,70038,70040,Blue,1,34610,34625,15
2022-09-19,70040,70056,Blue,1,40968,41751,783
2022-02-05,70059,70055,Blue,0,40575,40717,142
2022-09-15,70046,70048,Blue,1,80413,80485,72
2022-05-18,70046,70050,Blue,1,46965,47155,190
2022-09-24,70047,70039,Blue,0,67121,67542,421
2022-10-21,70049,70039,Blue,0,53051,53608,557
2022-08-21,70053,70047,Blue,0,54120,54404,284
2022-08-12,70045,70838,Blue,0,69906,70282,376
2022-10-24,70048,70050,Blue,1,23900,23965,65
2022-03-22,70058,70060,Blue,1,27031,27297,266
2022-11-25,70054,70056,Blue,1,32459,32508,49
2022-02-13,70056,70058,Blue,1,44692,44783,91
2022-04-08,70051,70039,Blue,0,49052,49704,652
2022-07-12,70059,70049,Blue,0,61704,62158,454
2022-12-22,70047,70041,Blue,0,57451,57735,284
2022-09-23,70045,70043,Blue,0,19288,19391,103
2022-10-19,70049,70045,Blue,0,58645,58830,185
2022-09-24,70049,70838,Blue,0,64859,65723,864
2022-02-10,70048,70054,Blue,1,85818,86103,285
2022-01-03,70059,70047,Blue,0,58512,59102,590
2022-02-05,70059,70049,Blue,0,37333,37781,448
2022-01-21,70053,70047,Blue,0,62001,62440,439
2022-03-08,70040,70042,Blue,1,58694,58725,31
2022-11-10,70044,70050,Blue,1,61398,61787,389
2022-03-08,70044,70054,Blue,1,30786,31399,613
2022-10-07,70057,70041,Blue,0,50483,51305,822
2022-07-29,70039,70838,Blue,0,25316,25351,35
2022-01-18,70057,70053,Blue,0,86363,86514,151
2022-08-04,70048,70054,Blue,1,50509,50823,314
2022-01-12,70059,70047,Blue,0,59899,60500,601
2022-08-23,70043,70039,Blue,0,57978,58089,111
2022-10-28,70053,70039,Blue,0,52478,53215,737
2022-01-02,70051,70045,Blue,0,74745,75062,317
2022-11-08,70046,70050,Blue,1,31478,31663,185
2022-03-02,70050,70052,Blue,1,58934,59081,147
2022-06-12,70051,70047,Blue,0,63365,63565,200
2022-11-03,70055,70838,Blue,0,74006,74857,851
2022-04-08,70044,70058,Blue,1,21811,22644,833
2022-04-22,70053,70041,Blue,0,86565,87212,647
2022-07-21,70048,70054,Blue,1,69011,69342,331
2022-02-21,70039,70838,Blue,0,28818,28853,35
2022-07-09,70059,70043,Blue,0,19514,20400,886
2022-04-20,70059,70053,Blue,0,57526,57764,238
2022-03-04,70038,70054,Blue,1,23967,24926,959
2022-02-14,70046,70054,Blue,1,52005,52416,411
2022-03-20,70052,70060,Blue,1,29245,29604,359
2022-01-25,70059,70051,Blue,0,78317,78682,365
2022-12-01,70044,70058,Blue,1,26671,27570,899
2022-04-02,70044,70060,Blue,1,85738,86627,889
2022-09-01,70059,70039,Blue,0,83007,84019,1012
2022-01-25,70038,70054,Blue,1,60437,61243,806
2022-11-16,70053,70045,Blue,0,69945,70386,441
2022-03-28,70045,70838,Blue,0,32657,33030,373
2022-02-09,70038,70052,Blue,1,24343,25132,789
2022-07-03,70053,70039,Blue,0,83255,84022,767
2022-01-10,70057,70047,Blue,0,72151,72614,463
2022-07-14,70044,70054,Blue,1,42780,43756,976
2022-10-21,70051,70047,Blue,0,41706,41914,208
2022-04-05,70054,70058,Blue,1,75490,75645,155
2022-07-27,70044,70056,Blue,1,34015,34777,762
2022-08-08,70056,70060,Blue,1,43605,43785,180
2022-01-26,70045,70039,Blue,0,61620,61896,276
2022-07-05,70048,70050,Blue,1,64911,64969,58
2022-09-12,70056,70058,Blue,1,89182,89252,70
2022-04-03,70059,70057,Blue,0,23831,23872,41
2022-06-10,70057,70047,Blue,0,65151,65631,480
2022-09-26,70048,70054,Blue,1,67497,67814,317
2022-06-21,70055,70049,Blue,0,52170,52435,265
2022-03-22,70055,70041,Blue,0,25934,26707,773
2022-03-25,70050,70052,Blue,1,26052,26178,126
2022-03-30,70038,70060,Blue,1,76870,78161,1291
2022-03-16,70056,70058,Blue,1,65595,65666,71
2022-04-07,70048,70060,Blue,1,48643,49316,673
2022-08-24,70048,70050,Blue,1,64538,64595,57
2022-10-13,70040,70054,Blue,1,59377,60276,899
2022-07-11,70057,70049,Blue,0,67135,67524,389
2022-07-27,70044,70046,Blue,1,35728,35834,106
2022-03-21,70044,70050,Blue,1,50509,50840,331
2022-10-21,70059,70057,Blue,0,56195,56231,36
2022-09-22,70038,70050,Blue,1,46154,46746,592
2022-03-28,70052,70060,Blue,1,60326,60716,390
2022-03-18,70054,70056,Blue,1,84006,84054,48
2022-07-20,70047,70039,Blue,0,25693,26125,432
2022-05-12,70052,70058,Blue,1,85428,85677,249
2022-04-11,70049,70039,Blue,0,54760,55351,591
2022-03-20,70055,70053,Blue,0,27163,27215,52
2022-12-06,70059,70043,Blue,0,64039,64881,842
2022-07-06,70050,70056,Blue,1,38087,38450,363
2022-03-24,70045,70043,Blue,0,38887,38980,93
2022-01-07,70054,70060,Blue,1,53002,53684,682
2022-12-17,70040,70060,Blue,1,70212,71295,1083
2022-08-25,70046,70050,Blue,1,31998,32188,190
2022-01-24,70047,70041,Blue,0,32543,32889,346
2022-07-14,70055,70043,Blue,0,21027,21737,710
2022-01-09,70059,70043,Blue,0,53839,54743,904
2022-04-22,70053,70041,Blue,0,19442,20154,712
2022-11-04,70052,70056,Blue,1,79881,80015,134
2022-09-19,70053,70047,Blue,0,71458,71739,281
2022-08-26,70038,70040,Blue,1,32881,32897,16
2022-01-11,70059,70047,Blue,0,23358,23988,630
2022-01-18,70051,70045,Blue,0,82138,82479,341
2022-12-27,70046,70054,Blue,1,60622,61064,442
2022-03-03,70051,70039,Blue,0,29766,30469,703
2022-06-04,70043,70838,Blue,0,22429,22637,208
2022-07-30,70042,70052,Blue,1,58610,59209,599
2022-10-11,70053,70051,Blue,0,68983,69046,63
2022-11-12,70059,70039,Blue,0,44357,45349,992
2022-10-24,70055,70043,Blue,0,55293,55956,663
2022-09-15,70045,70838,Blue,0,60836,61137,301
2022-02-07,70053,70043,Blue,0,50100,50742,642
2022-06-21,70044,70054,Blue,1,52938,53652,714
2022-01-14,70052,70056,Blue,1,57896,58033,137
2022-09-01,70051,70838,Blue,0,57308,58062,754
2022-01-18,70040,70056,Blue,1,69498,70410,912
2022-10-09,70044,70056,Blue,1,73915,74620,705
2022-09-15,70057,70838,Blue,0,82708,83639,931
2022-10-25,70051,70045,Blue,0,31377,31742,365
2022-02-21,70059,70055,Blue,0,75793,75939,146
2022-07-08,70044,70050,Blue,1,84034,84377,343
2022-03-29,70051,70838,Blue,0,51100,51886,786
2022-09-09,70052,70060,Blue,1,24867,25313,446
2022-08-30,70059,70838,Blue,0,23416,24605,1189
2022-11-10,70038,70058,Blue,1,27528,28604,1076
2022-10-14,70050,70054,Blue,1,67635,67854,219
2022-09-27,70057,70047,Blue,0,64829,65349,520
2022-08-26,70042,70060,Blue,1,23326,24387,1061
2022-06-10,70044,70052,Blue,1,54757,55268,511
2022-04-13,70056,70058,Blue,1,60546,60620,74
2022-10-31,70046,70052,Blue,1,42992,43353,361
2022-08-24,70048,70052,Blue,1,61863,62097,234
2022-07-08,70055,70043,Blue,0,67278,67954,676
2022-09-25,70044,70048,Blue,1,43875,44152,277
2022-06-13,70046,70060,Blue,1,25577,26353,776
2022-12-27,70040,70052,Blue,1,27125,27746,621
2022-09-22,70042,70058,Blue,1,30142,31037,895
2022-07-19,70053,70047,Blue,0,46020,46321,301
2022-10-21,70059,70039,Blue,0,82884,83918,1034
2022-06-24,70057,70045,Blue,0,30669,31644,975
2022-10-05,70047,70838,Blue,0,31215,31726,511
2022-08-15,70048,70052,Blue,1,26996,27243,247
2022-05-21,70053,70043,Blue,0,53798,54431,633
2022-08-02,70051,70047,Blue,0,30961,31209,248
2022-01-06,70048,70054,Blue,1,76283,76589,306
2022-03-10,70048,70056,Blue,1,85838,86206,368
2022-04-04,70055,70043,Blue,0,67692,68342,650
2022-06-16,70051,70043,Blue,0,33033,33576,543
2022-10-05,70055,70049,Blue,0,28674,28960,286
2022-01-25,70057,70055,Blue,0,22840,22911,71
2022-01-10,70048,70050,Blue,1,78076,78137,61
2022-08-03,70056,70058,Blue,1,67278,67345,67
2022-12-11,70055,70045,Blue,0,76164,76705,541
2022-04-11,70052,70058,Blue,1,28354,28615,261
2022-07-19,70043,70041,Blue,0,79816,79844,28
2022-04-20,70059,70043,Blue,0,86315,87267,952
2022-06-08,70047,70039,Blue,0,24264,24765,501
2022-08-19,70038,70050,Blue,1,62284,62957,673
2022-01-27,70057,70838,Blue,0,30948,32052,1104
2022-09-08,70050,70056,Blue,1,71366,71666,300
2022-06-27,70055,70838,Blue,0,66677,67641,964
2022-03-23,70055,70051,Blue,0,62768,62901,133
2022-01-28,70051,70047,Blue,0,40824,41030,206
2022-09-14,70044,70052,Blue,1,28427,28944,517
2022-03-25,70057,70047,Blue,0,37075,37585,510
2022-12-18,70043,70041,Blue,0,58588,58617,29
2022-01-20,70055,70051,Blue,0,27147,27343,196
2022-12-21,70038,70048,Blue,1,62426,62888,462
2022-01-14,70042,70056,Blue,1,36868,37685,817
2022-03-01,70053,70043,Blue,0,69359,69943,584
2022-01-21,70042,70054,Blue,1,33979,34703,724
2022-09-29,70042,70044,Blue,1,78618,78649,31
2022-09-20,70053,70041,Blue,0,66825,67478,653
2022-02-01,70038,70056,Blue,1,53537,54429,892
2022-06-21,70056,70058,Blue,1,38248,38322,74
2022-06-13,70050,70060,Blue,1,54031,54587,556
2022-07-02,70042,70056,Blue,1,71389,72229,840
2022-09-30,70048,70054,Blue,1,76647,76974,327
2022-12-11,70039,70838,Blue,0,84880,84912,32
2022-07-29,70048,70054,Blue,1,75107,75414,307
2022-12-03,70057,70049,Blue,0,67198,67587,389
2022-01-28,70049,70045,Blue,0,58964,59169,205
2022-03-07,70038,70040,Blue,1,26058,26078,20
2022-01-11,70038,70060,Blue,1,28152,29638,1486
2022-03-03,70049,70838,Blue,0,51719,52372,653
2022-03-24,70045,70041,Blue,0,57059,57246,187
2022-12-23,70059,70838,Blue,0,65477,66649,1172
2022-02-04,70046,70052,Blue,1,33014,33380,366
2022-05-08,70054,70060,Blue,1,47523,47814,291
2022-01-21,70048,70058,Blue,1,60006,60540,534
2022-10-21,70047,70039,Blue,0,69271,69676,405
2022-12-26,70059,70049,Blue,0,48976,49419,443
2022-11-25,70059,70041,Blue,0,26775,27731,956
2022-02-21,70054,70060,Blue,1,60426,60695,269
2022-12-21,70038,70056,Blue,1,27053,27923,870
2022-12-03,70043,70838,Blue,0,70613,70799,186
2022-02-02,70042,70044,Blue,1,58909,58937,28
2022-10-02,70040,70044,Blue,1,78408,78516,108
2022-02-09,70042,70058,Blue,1,62680,63616,936
2022-05-19,70051,70041,Blue,0,47195,48017,822
2022-07-23,70040,70044,Blue,1,63737,63861,124
2022-10-27,70046,70060,Blue,1,67562,68320,758
2022-11-10,70048,70050,Blue,1,83278,83337,59
2022-03-28,70052,70054,Blue,1,67566,67616,50
2022-03-20,70059,70838,Blue,0,59809,60885,1076
2022-03-20,70042,70046,Blue,1,74899,75076,177
2022-11-23,70048,70058,Blue,1,22736,23236,500
2022-01-01,70059,70053,Blue,0,54374,54598,224
2022-02-20,70051,70838,Blue,0,81268,82149,881
2022-08-11,70045,70041,Blue,0,36679,36860,181
2022-01-04,70040,70048,Blue,1,69496,69932,436
2022-08-29,70045,70041,Blue,0,31446,31623,177
2022-12-18,70053,70049,Blue,0,34251,34487,236
2022-06-16,70038,70056,Blue,1,23055,24239,1184
2022-07-27,70059,70053,Blue,0,60313,60552,239
2022-12-23,70050,70052,Blue,1,37750,37891,141
2022-02-16,70059,70049,Blue,0,30553,31034,481
2022-02-22,70049,70838,Blue,0,35245,35861,616
2022-04-19,70050,70060,Blue,1,34192,34720,528
2022-10-01,70059,70045,Blue,0,39496,40246,750
2022-02-18,70045,70041,Blue,0,82531,82735,204
2022-06-14,70050,70060,Blue,1,61702,62280,578
2022-04-27,70059,70055,Blue,0,33085,33225,140
2022-12-07,70048,70058,Blue,1,27357,27849,492
2022-01-28,70048,70054,Blue,1,33156,33524,368
2022-04-03,70042,70048,Blue,1,35613,35939,326
2022-08-05,70040,70060,Blue,1,31595,32615,1020
2022-11-14,70057,70838,Blue,0,50024,51042,1018
2022-12-23,70059,70049,Blue,0,62204,62727,523
2022-04-28,70059,70055,Blue,0,20791,20943,152
2022-12-13,70040,70054,Blue,1,41012,41829,817
2022-04-12,70055,70051,Blue,0,35497,35646,149
2022-02-09,70042,70052,Blue,1,22915,23519,604
2022-03-07,70048,70058,Blue,1,86473,86955,482
2022-09-16,70048,70054,Blue,1,32497,32851,354
2022-10-26,70054,70056,Blue,1,30708,30756,48
2022-10-09,70059,70047,Blue,0,57071,57611,540
2022-02-01,70040,70042,Blue,1,72024,72055,31
2022-01-18,70040,70052,Blue,1,71475,72186,711
2022-11-07,70054,70060,Blue,1,67942,68203,261
2022-08-22,70038,70060,Blue,1,31258,32423,1165
2022-07-06,70053,70041,Blue,0,56666,57363,697
2022-02-22,70052,70054,Blue,1,54573,54627,54
2022-03-21,70059,70045,Blue,0,60190,60895,705
2022-10-01,70042,70054,Blue,1,75711,76345,634
2022-01-07,70044,70060,Blue,1,82221,83212,991
2022-09-12,70038,70044,Blue,1,72075,72262,187
2022-09-06,70057,70045,Blue,0,73161,73842,681
2022-12-10,70038,70046,Blue,1,60435,60783,348
2022-10-11,70057,70838,Blue,0,56726,57726,1000
2022-08-16,70038,70058,Blue,1,22300,23390,1090
2022-06-16,70040,70060,Blue,1,66681,67921,1240
2022-12-20,70042,70048,Blue,1,36214,36507,293
2022-03-11,70043,70039,Blue,0,81069,81176,107
2022-11-24,70059,70043,Blue,0,83001,83862,861
2022-10-23,70049,70043,Blue,0,45671,46037,366
2022-11-24,70048,70056,Blue,1,86010,86392,382
2022-11-21,70042,70060,Blue,1,56664,57645,981
2022-11-14,70055,70053,Blue,0,24328,24373,45
2022-09-06,70053,70049,Blue,0,23296,23513,217
2022-02-19,70053,70047,Blue,0,33853,34159,306
2022-01-29,70052,70060,Blue,1,60394,61057,663
2022-01-25,70038,70056,Blue,1,79814,80728,914
2022-03-03,70040,70044,Blue,1,74203,74312,109
2022-11-27,70040,70042,Blue,1,49442,49472,30
2022-06-16,70050,70060,Blue,1,68964,69581,617
2022-06-13,70046,70052,Blue,1,34831,35280,449
2022-04-17,70049,70039,Blue,0,63537,64057,520
2022-01-27,70048,70056,Blue,1,31068,31461,393
2022-08-08,70053,70838,Blue,0,67342,68118,776
2022-07-06,70047,70039,Blue,0,70786,71213,427
2022-07-27,70046,70048,Blue,1,52275,52365,90
2022-02-27,70038,70048,Blue,1,82988,83455,467
2022-04-11,70040,70048,Blue,1,72072,72541,469
2022-08-21,70045,70039,Blue,0,51879,52148,269
2022-01-02,70043,70039,Blue,0,31712,31818,106
2022-01-11,70043,70039,Blue,0,36759,36881,122
2022-10-14,70045,70838,Blue,0,28887,29251,364
2022-03-13,70042,70044,Blue,1,39164,39194,30
2022-07-11,70040,70054,Blue,1,61884,62866,982
2022-08-25,70057,70053,Blue,0,58870,59028,158
2022-02-28,70046,70048,Blue,1,53781,53894,113
2022-07-20,70050,70060,Blue,1,83470,83988,518
2022-11-01,70049,70041,Blue,0,66063,66487,424
2022-10-11,70042,70044,Blue,1,39039,39068,29
2022-10-04,70044,70054,Blue,1,43827,44501,674
2022-09-19,70044,70046,Blue,1,75427,75536,109
2022-06-21,70050,70052,Blue,1,58051,58191,140
2022-06-24,70047,70045,Blue,0,21478,21582,104
2022-01-01,70057,70045,Blue,0,81637,82408,771
2022-08-19,70047,70043,Blue,0,22194,22449,255
2022-05-13,70059,70055,Blue,0,25521,25670,149
2022-02-07,70042,70052,Blue,1,50475,51055,580
2022-10-20,70049,70043,Blue,0,25642,26020,378
2022-07-12,70049,70838,Blue,0,79906,80518,612
2022-04-07,70056,70060,Blue,1,81206,81378,172
2022-08-08,70038,70052,Blue,1,77853,78551,698
2022-11-13,70040,70052,Blue,1,24023,24699,676
2022-08-18,70048,70054,Blue,1,44667,44982,315
2022-01-02,70044,70058,Blue,1,72263,72986,723
2022-01-11,70046,70054,Blue,1,52312,52751,439
2022-12-22,70057,70051,Blue,0,81161,81422,261
2022-11-30,70046,70050,Blue,1,74636,74810,174
2022-04-16,70054,70058,Blue,1,40888,41066,178
2022-05-05,70059,70055,Blue,0,60217,60362,145
2022-06-05,70038,70044,Blue,1,23713,23873,160
2022-08-26,70045,70043,Blue,0,20682,20780,98
2022-01-07,70040,70042,Blue,1,21119,21157,38
2022-12-01,70055,70051,Blue,0,21020,21159,139
2022-07-24,70048,70060,Blue,1,87828,88464,636
2022-01-03,70046,70048,Blue,1,77280,77362,82
2022-11-02,70038,70060,Blue,1,54031,55282,1251
2022-04-03,70057,70043,Blue,0,44730,45559,829
2022-05-24,70043,70041,Blue,0,62602,62641,39
2022-11-19,70053,70041,Blue,0,70008,70636,628
2022-10-05,70057,70053,Blue,0,58294,58448,154
2022-12-13,70040,70048,Blue,1,65453,65891,438
2022-04-06,70047,70043,Blue,0,47235,47462,227
2022-06-20,70038,70044,Blue,1,66396,66588,192
2022-08-30,70040,70052,Blue,1,35867,36552,685
2022-10-18,70042,70044,Blue,1,57155,57187,32
2022-03-23,70038,70042,Blue,1,30555,30656,101
2022-09-08,70053,70041,Blue,0,28371,29058,687
2022-10-15,70042,70048,Blue,1,35168,35471,303
2022-01-11,70040,70052,Blue,1,58987,59645,658
2022-06-25,70038,70054,Blue,1,65643,66817,1174
2022-02-21,70057,70051,Blue,0,70893,71158,265
2022-07-24,70038,70052,Blue,1,83718,84456,738
2022-08-13,70038,70048,Blue,1,33972,34433,461
2022-09-27,70048,70054,Blue,1,54574,54865,291
2022-02-24,70049,70041,Blue,0,61445,61931,486
2022-05-30,70038,70050,Blue,1,51911,52658,747
2022-01-11,70041,70838,Blue,0,25312,25475,163
2022-09-02,70040,70042,Blue,1,78960,78995,35
2022-03-28,70059,70838,Blue,0,82878,84147,1269
2022-01-25,70049,70039,Blue,0,48286,48898,612
2022-08-30,70047,70039,Blue,0,26153,26580,427
2022-11-24,70047,70838,Blue,0,39422,39911,489
2022-11-19,70047,70045,Blue,0,57951,58048,97
2022-03-17,70040,70056,Blue,1,24605,25391,786
2022-10-10,70038,70054,Blue,1,77830,78591,761
2022-04-11,70049,70045,Blue,0,22990,23217,227
2022-01-13,70052,70058,Blue,1,54832,55077,245
2022-07-08,70038,70048,Blue,1,53031,53533,502
2022-07-19,70053,70041,Blue,0,53358,54090,732
2022-06-29,70040,70060,Blue,1,54879,55997,1118
2022-08-23,70048,70058,Blue,1,60432,61019,587
2022-10-01,70059,70049,Blue,0,47140,47659,519
2022-08-11,70038,70058,Blue,1,48206,49238,1032
2022-03-22,70038,70042,Blue,1,58334,58450,116
2022-03-18,70049,70838,Blue,0,39797,40488,691
2022-09-21,70047,70043,Blue,0,26226,26548,322
2022-02-07,70051,70045,Blue,0,36265,36696,431
2022-03-18,70040,70042,Blue,1,30310,30341,31
2022-02-17,70053,70045,Blue,0,56583,57030,447
2022-11-15,70038,70060,Blue,1,53892,54994,1102
2022-12-07,70051,70047,Blue,0,35660,35854,194
2022-01-24,70038,70052,Blue,1,57430,58158,728
2022-08-15,70049,70039,Blue,0,26920,27540,620
2022-03-28,70057,70043,Blue,0,24651,25462,811
2022-12-08,70042,70054,Blue,1,29122,29747,625
2022-03-31,70057,70838,Blue,0,81274,82308,1034
2022-11-22,70046,70048,Blue,1,36632,36717,85
2022-06-29,70051,70045,Blue,0,76803,77166,363
2022-09-19,70051,70039,Blue,0,24617,25321,704
2022-04-04,70053,70047,Blue,0,86005,86274,269
2022-09-16,70057,70055,Blue,0,33581,33650,69
2022-08-09,70045,70041,Blue,0,21213,21413,200
2022-02-10,70044,70052,Blue,1,61280,61767,487
2022-08-16,70038,70056,Blue,1,29513,30466,953
2022-11-02,70057,70047,Blue,0,31639,32208,569
2022-09-13,70052,70054,Blue,1,69739,69786,47
2022-12-18,70052,70060,Blue,1,44348,44694,346
2022-07-23,70043,70039,Blue,0,55076,55196,120
2022-01-24,70055,70045,Blue,0,41119,41674,555
2022-06-23,70048,70054,Blue,1,30825,31181,356
2022-05-24,70042,70044,Blue,1,63853,63891,38
2022-01-10,70059,70043,Blue,0,64698,65569,871
2022-07-18,70051,70047,Blue,0,48735,48932,197
2022-07-12,70041,70039,Blue,0,82675,82706,31
2022-06-29,70041,70039,Blue,0,86807,86839,32
2022-09-20,70038,70052,Blue,1,57051,57734,683
2022-08-22,70050,70056,Blue,1,82668,83008,340
2022-06-14,70055,70045,Blue,0,19757,20361,604
2022-02-17,70057,70045,Blue,0,69164,69893,729
2022-01-08,70043,70838,Blue,0,42564,42783,219
2022-01-15,70051,70041,Blue,0,55010,55611,601
2022-01-25,70048,70054,Blue,1,35242,35567,325
2022-01-31,70050,70054,Blue,1,61912,62345,433
2022-02-19,70046,70058,Blue,1,39764,40361,597
2022-10-08,70049,70047,Blue,0,53575,53632,57
2022-07-25,70048,70058,Blue,1,32836,33337,501
2022-12-20,70050,70052,Blue,1,41921,42043,122
2022-04-08,70042,70048,Blue,1,21094,21397,303
2022-02-21,70054,70060,Blue,1,45651,45923,272
2022-01-23,70046,70056,Blue,1,32730,33278,548
2022-02-18,70055,70838,Blue,0,61882,62866,984
2022-08-01,70043,70838,Blue,0,35826,36033,207
2022-01-12,70044,70050,Blue,1,64867,65225,358
2022-06-10,70059,70053,Blue,0,51194,51442,248
2022-08-24,70057,70051,Blue,0,63052,63294,242
2022-02-23,70052,70060,Blue,1,80020,80412,392
2022-07-08,70038,70056,Blue,1,45109,46040,931
2022-07-15,70040,70052,Blue,1,43043,43721,678
2022-04-08,70038,70052,Blue,1,63139,63884,745
2022-04-13,70040,70058,Blue,1,57197,58138,941
2022-02-20,70044,70048,Blue,1,43195,43417,222
2022-10-17,70055,70043,Blue,0,56172,56820,648
2022-08-30,70052,70056,Blue,1,54639,54774,135
2022-02-28,70057,70838,Blue,0,78385,79460,1075
2022-10-12,70055,70053,Blue,0,21917,21967,50
2022-11-13,70053,70047,Blue,0,83247,83532,285
2022-08-13,70052,70058,Blue,1,88434,88720,286
2022-03-19,70055,70045,Blue,0,20365,20910,545
2022-11-06,70055,70051,Blue,0,67521,67656,135
2022-01-26,70048,70060,Blue,1,74620,75286,666
2022-12-22,70055,70838,Blue,0,54371,55298,927
2022-04-19,70047,70041,Blue,0,51079,51392,313
2022-07-26,70059,70838,Blue,0,55098,56355,1257
2022-12-30,70051,70039,Blue,0,55209,55875,666
2022-07-05,70046,70056,Blue,1,47321,47990,669
2022-03-10,70038,70046,Blue,1,28228,28554,326
2022-02-16,70052,70054,Blue,1,72859,72908,49
2022-09-28,70042,70048,Blue,1,47271,47556,285
2022-05-02,70058,70060,Blue,1,67439,67518,79
2022-09-27,70042,70052,Blue,1,76500,77078,578
2022-04-07,70055,70053,Blue,0,32538,32586,48
2022-06-12,70038,70054,Blue,1,28514,29387,873
2022-04-20,70050,70054,Blue,1,77574,77784,210
2022-12-14,70042,70060,Blue,1,84546,85516,970
2022-12-14,70045,70043,Blue,0,87291,87377,86
2022-02-26,70052,70060,Blue,1,38026,38410,384
2022-03-05,70059,70039,Blue,0,36793,37911,1118
2022-07-04,70057,70045,Blue,0,74273,74901,628
2022-07-13,70046,70054,Blue,1,62925,63383,458
2022-01-08,70040,70060,Blue,1,45902,46885,983
2022-04-14,70042,70058,Blue,1,29813,30693,880
2022-12-13,70044,70048,Blue,1,80862,81102,240
2022-03-07,70057,70051,Blue,0,47720,47984,264
2022-06-14,70050,70056,Blue,1,43810,44158,348
2022-12-04,70046,70056,Blue,1,35050,35666,616
2022-10-22,70055,70045,Blue,0,45086,45645,559
2022-08-20,70057,70049,Blue,0,34172,34571,399
2022-08-24,70059,70838,Blue,0,52553,53709,1156
2022-01-27,70053,70039,Blue,0,31184,31966,782
2022-11-21,70040,70046,Blue,1,76445,76701,256
2022-04-18,70051,70047,Blue,0,22200,22462,262
2022-08-18,70049,70039,Blue,0,27357,27925,568
2022-04-09,70055,70838,Blue,0,52642,53583,941
2022-09-19,70048,70060,Blue,1,51676,52284,608
2022-08-31,70057,70838,Blue,0,53610,54610,1000
2022-03-06,70043,70838,Blue,0,34872,35075,203
2022-06-11,70042,70054,Blue,1,62232,62940,708
2022-01-25,70048,70050,Blue,1,79042,79095,53
2022-04-21,70046,70048,Blue,1,21321,21402,81
2022-11-23,70040,70058,Blue,1,85764,86743,979
2022-04-08,70045,70039,Blue,0,63929,64180,251
2022-10-04,70053,70045,Blue,0,44181,44608,427
2022-02-24,70044,70058,Blue,1,57520,58368,848
2022-06-10,70052,70056,Blue,1,27456,27603,147
2022-04-05,70059,70039,Blue,0,64695,65698,1003
2022-11-16,70055,70045,Blue,0,71751,72260,509
2022-09-09,70046,70056,Blue,1,66186,66885,699
2022-06-23,70045,70043,Blue,0,54276,54411,135
2022-06-22,70042,70058,Blue,1,64800,65716,916
2022-02-22,70057,70043,Blue,0,56068,56814,746
2022-09-14,70052,70056,Blue,1,32106,32273,167
2022-03-22,70059,70053,Blue,0,29067,29303,236
2022-01-20,70054,70060,Blue,1,26639,26899,260
2022-02-25,70056,70060,Blue,1,87522,87701,179
2022-10-11,70059,70039,Blue,0,85756,86783,1027
2022-08-11,70052,70058,Blue,1,28964,29235,271
2022-10-07,70044,70046,Blue,1,89422,89528,106
2022-03-10,70059,70053,Blue,0,77773,77985,212
2022-09-12,70042,70056,Blue,1,72231,72993,762
2022-04-08,70057,70041,Blue,0,61475,62281,806
2022-11-07,70051,70049,Blue,0,66676,66780,104
2022-08-29,70038,70050,Blue,1,34070,34632,562
2022-10-15,70044,70056,Blue,1,30406,31803,1397
2022-07-11,70057,70049,Blue,0,68683,69101,418
2022-11-20,70059,70051,Blue,0,42022,42346,324
2022-09-08,70044,70058,Blue,1,35902,36701,799
2022-03-10,70056,70060,Blue,1,90018,90184,166
2022-02-21,70057,70043,Blue,0,74667,75475,808
2022-04-15,70046,70060,Blue,1,34226,35007,781
2022-09-11,70051,70041,Blue,0,47189,47775,586
2022-09-28,70052,70058,Blue,1,74928,75243,315
2022-10-29,70044,70052,Blue,1,65563,66067,504
2022-04-12,70055,70051,Blue,0,26258,26423,165
2022-01-20,70046,70056,Blue,1,35622,36255,633
2022-02-28,70047,70039,Blue,0,65608,65996,388
2022-02-28,70057,70043,Blue,0,52170,52935,765
2022-07-13,70050,70056,Blue,1,38585,38896,311
2022-09-03,70044,70046,Blue,1,52578,52686,108
2022-06-22,70040,70044,Blue,1,67307,67443,136
2022-10-10,70048,70050,Blue,1,68463,68524,61
2022-08-24,70059,70047,Blue,0,46464,47086,622
2022-01-05,70052,70058,Blue,1,48560,48833,273
2022-01-29,70050,70060,Blue,1,31879,32651,772
2022-11-05,70050,70052,Blue,1,33864,33980,116
2022-09-19,70042,70054,Blue,1,64268,64948,680
2022-12-02,70049,70041,Blue,0,45789,46210,421
2022-07-01,70050,70054,Blue,1,54408,54652,244
2022-02-12,70040,70052,Blue,1,65375,66070,695
2022-04-19,70053,70041,Blue,0,32091,32803,712
2022-06-13,70050,70058,Blue,1,70572,71004,432
2022-10-02,70042,70048,Blue,1,80749,81099,350
2022-10-10,70038,70060,Blue,1,66928,68126,1198
2022-03-09,70048,70054,Blue,1,76386,76700,314
2022-10-01,70046,70048,Blue,1,35963,36048,85
2022-08-07,70038,70040,Blue,1,68287,68301,14
2022-12-25,70059,70041,Blue,0,60315,61217,902
2022-04-08,70048,70054,Blue,1,49200,49501,301
2022-01-02,70039,70838,Blue,0,56525,56568,43
2022-06-24,70059,70055,Blue,0,22997,23160,163
2022-10-12,70055,70049,Blue,0,28257,28557,300
2022-08-05,70041,70039,Blue,0,57188,57274,86
2022-02-06,70040,70042,Blue,1,24655,24689,34
2022-07-29,70051,70043,Blue,0,37535,38215,680
2022-04-19,70044,70048,Blue,1,35677,35957,280
2022-05-22,70038,70042,Blue,1,36320,36422,102
2022-10-28,70053,70039,Blue,0,27474,28235,761
2022-07-18,70044,70056,Blue,1,57929,58635,706
2022-09-14,70044,70056,Blue,1,46967,47635,668
2022-04-24,70040,70048,Blue,1,59830,60240,410
2022-07-05,70047,70838,Blue,0,54053,54591,538
2022-02-16,70047,70041,Blue,0,24409,24818,409
2022-01-14,70038,70056,Blue,1,50774,51743,969
2022-01-18,70059,70041,Blue,0,26354,27423,1069
2022-03-03,70046,70048,Blue,1,63546,63638,92
2022-09-19,70052,70060,Blue,1,61297,61688,391
2022-04-06,70057,70039,Blue,0,20679,21714,1035
2022-07-17,70059,70838,Blue,0,38179,39312,1133
2022-02-12,70051,70049,Blue,0,65785,65888,103
2022-07-06,70046,70056,Blue,1,26915,27455,540
2022-10-18,70044,70058,Blue,1,34655,35424,769
2022-05-04,70059,70057,Blue,0,44726,44761,35
2022-03-11,70047,70838,Blue,0,41586,42133,547
2022-06-14,70040,70050,Blue,1,89390,89875,485
2022-07-24,70054,70058,Blue,1,86392,86548,156
2022-08-02,70050,70060,Blue,1,83284,83804,520
2022-08-15,70051,70049,Blue,0,71671,71775,104
2022-03-28,70044,70046,Blue,1,65764,65869,105
2022-06-24,70051,70838,Blue,0,20307,21124,817
2022-11-16,70042,70048,Blue,1,61373,61701,328
2022-04-18,70046,70048,Blue,1,79025,79146,121
2022-03-04,70049,70041,Blue,0,55002,55444,442
2022-06-25,70057,70051,Blue,0,34714,34955,241
2022-01-12,70050,70060,Blue,1,22616,23355,739
2022-04-19,70046,70048,Blue,1,87450,87516,66
2022-09-13,70040,70048,Blue,1,68008,68410,402
2022-09-04,70057,70045,Blue,0,44195,44830,635
2022-10-25,70059,70051,Blue,0,30140,30474,334
2022-07-18,70053,70838,Blue,0,38328,39251,923
2022-01-15,70038,70060,Blue,1,71658,72888,1230
2022-02-11,70059,70043,Blue,0,24256,25087,831
2022-08-09,70053,70039,Blue,0,65222,65989,767
2022-07-30,70044,70056,Blue,1,21869,22511,642
2022-01-04,70042,70058,Blue,1,73125,73977,852
2022-08-03,70053,70045,Blue,0,72513,72929,416
2022-06-22,70041,70039,Blue,0,59639,59671,32
2022-01-02,70045,70041,Blue,0,24539,24694,155
2022-11-12,70058,70060,Blue,1,73334,73398,64
2022-07-09,70059,70051,Blue,0,34095,34434,339
2022-01-14,70040,70054,Blue,1,51970,52714,744
2022-02-08,70045,70838,Blue,0,49464,49857,393
2022-01-28,70053,70047,Blue,0,66789,67085,296
2022-10-29,70040,70060,Blue,1,80687,81759,1072
2022-01-26,70050,70060,Blue,1,65855,66512,657
2022-01-20,70047,70041,Blue,0,54825,55151,326
2022-06-16,70046,70050,Blue,1,49710,49900,190
2022-08-21,70050,70058,Blue,1,57072,57492,420
2022-08-10,70038,70048,Blue,1,77310,77783,473
2022-02-04,70048,70060,Blue,1,45317,45927,610
2022-08-28,70049,70045,Blue,0,75935,76158,223
2022-12-22,70042,70048,Blue,1,24668,25030,362
2022-11-20,70059,70043,Blue,0,57076,57939,863
2022-09-15,70053,70838,Blue,0,21096,21957,861
2022-03-20,70059,70045,Blue,0,22274,22987,713
2022-03-30,70041,70039,Blue,0,76383,76413,30
2022-08-22,70044,70056,Blue,1,72711,73432,721
2022-07-17,70057,70045,Blue,0,75019,75641,622
2022-01-20,70042,70056,Blue,1,26302,27225,923
2022-10-04,70040,70042,Blue,1,51515,51545,30
2022-03-17,70042,70046,Blue,1,40846,41047,201
2022-07-21,70055,70053,Blue,0,64174,64221,47
2022-03-12,70040,70048,Blue,1,42671,43045,374
2022-06-17,70046,70048,Blue,1,27626,27736,110
2022-04-08,70059,70047,Blue,0,54496,55043,547
2022-06-26,70048,70056,Blue,1,49939,50361,422
2022-03-31,70046,70052,Blue,1,75161,75468,307
2022-01-04,70051,70045,Blue,0,29464,29787,323
2022-11-09,70051,70043,Blue,0,46515,47000,485
2022-07-14,70038,70042,Blue,1,49356,49453,97
2022-12-02,70057,70051,Blue,0,74532,74773,241
2022-02-05,70040,70048,Blue,1,30246,30631,385
2022-01-31,70053,70047,Blue,0,74713,75059,346
2022-09-26,70059,70838,Blue,0,81236,82745,1509
2022-11-29,70040,70056,Blue,1,82770,83590,820
2022-08-26,70039,70838,Blue,0,72839,72873,34
2022-08-30,70052,70060,Blue,1,21930,22285,355
2022-04-14,70059,70045,Blue,0,53602,54360,758
2022-07-31,70051,70047,Blue,0,36569,36775,206
2022-07-14,70042,70056,Blue,1,58875,59694,819
2022-07-26,70055,70053,Blue,0,21016,21061,45
2022-08-18,70055,70051,Blue,0,46519,46661,142
2022-04-03,70050,70054,Blue,1,71011,71227,216
2022-11-19,70051,70838,Blue,0,38230,38918,688
2022-04-08,70040,70056,Blue,1,31212,32041,829
2022-01-25,70046,70058,Blue,1,64111,64737,626
2022-06-10,70059,70838,Blue,0,23375,24662,1287
2022-02-03,70040,70052,Blue,1,36791,37423,632
2022-06-10,70054,70058,Blue,1,35066,35316,250
2022-08-22,70044,70054,Blue,1,57046,57631,585
2022-03-07,70053,70838,Blue,0,37401,38355,954
2022-11-06,70053,70043,Blue,0,82631,83213,582
2022-01-27,70049,70039,Blue,0,28831,29346,515
2022-01-25,70038,70040,Blue,1,59261,59278,17
2022-06-04,70050,70052,Blue,1,78924,79108,184
2022-02-10,70038,70042,Blue,1,20727,20832,105
2022-09-02,70055,70043,Blue,0,42785,43530,745
2022-09-15,70057,70041,Blue,0,56732,57668,936
2022-09-23,70045,70043,Blue,0,64352,64448,96
2022-01-26,70042,70058,Blue,1,41597,42462,865
2022-01-02,70049,70041,Blue,0,48553,49075,522
2022-04-22,70045,70041,Blue,0,50518,50694,176
2022-10-24,70059,70039,Blue,0,74894,75915,1021
2022-06-20,70046,70048,Blue,1,35741,35828,87
2022-08-21,70040,70052,Blue,1,66749,67419,670
2022-03-02,70049,70041,Blue,0,55607,56029,422
2022-04-18,70039,70838,Blue,0,85011,85045,34
2022-02-05,70042,70056,Blue,1,42213,42944,731
2022-10-06,70059,70045,Blue,0,86055,86706,651
2022-01-11,70045,70043,Blue,0,64557,64660,103
2022-09-13,70053,70047,Blue,0,31742,32120,378
2022-04-16,70049,70047,Blue,0,37397,37453,56
2022-03-01,70049,70045,Blue,0,63939,64155,216
2022-06-07,70050,70052,Blue,1,41065,41252,187
2022-08-26,70059,70039,Blue,0,28453,29547,1094
2022-03-30,70042,70060,Blue,1,72603,73622,1019
2022-01-07,70058,70060,Blue,1,59035,59236,201
2022-07-05,70040,70054,Blue,1,60201,60981,780
2022-03-23,70049,70041,Blue,0,43247,43807,560
2022-08-23,70051,70047,Blue,0,35269,35474,205
2022-07-13,70044,70054,Blue,1,79177,80216,1039
2022-01-12,70043,70041,Blue,0,77635,77669,34
2022-11-15,70042,70050,Blue,1,45244,45664,420
2022-03-15,70042,70050,Blue,1,74789,75183,394
2022-10-12,70042,70044,Blue,1,30910,30938,28
2022-05-25,70049,70047,Blue,0,73238,73295,57
2022-11-25,70045,70838,Blue,0,37121,37469,348
2022-10-12,70038,70056,Blue,1,25642,26461,819
2022-03-07,70053,70039,Blue,0,29970,30768,798
2022-08-01,70042,70052,Blue,1,31694,32278,584
2022-02-14,70055,70838,Blue,0,56774,57709,935
2022-01-18,70049,70838,Blue,0,31411,32100,689
2022-11-24,70057,70039,Blue,0,38906,39820,914
2022-08-07,70057,70045,Blue,0,69580,70192,612
2022-01-26,70038,70044,Blue,1,69306,69473,167
2022-03-24,70046,70052,Blue,1,54379,54709,330
2022-03-15,70059,70039,Blue,0,78907,79939,1032
2022-01-06,70054,70058,Blue,1,52129,52295,166
2022-04-14,70053,70043,Blue,0,60755,61384,629
2022-06-23,70059,70051,Blue,0,64996,65326,330
2022-02-24,70048,70052,Blue,1,40665,40919,254
2022-07-06,70048,70058,Blue,1,48155,48781,626
2022-02-27,70038,70056,Blue,1,69374,70311,937
2022-01-22,70048,70052,Blue,1,76614,76835,221
2022-10-16,70043,70838,Blue,0,43065,43289,224
2022-09-03,70042,70044,Blue,1,48162,48194,32
2022-02-21,70057,70838,Blue,0,20921,22094,1173
2022-08-01,70038,70050,Blue,1,60334,60914,580
2022-03-03,70040,70060,Blue,1,51722,52846,1124
2022-03-20,70052,70060,Blue,1,79896,80232,336
2022-10-15,70052,70058,Blue,1,28232,28483,251
2022-01-10,70046,70060,Blue,1,75614,76326,712
2022-10-28,70059,70043,Blue,0,30979,31813,834
2022-02-08,70045,70043,Blue,0,57372,57477,105
2022-07-06,70057,70838,Blue,0,57033,58129,1096
2022-03-29,70040,70052,Blue,1,27731,28424,693
2022-11-20,70049,70838,Blue,0,88715,89612,897
2022-07-08,70057,70039,Blue,0,48931,49827,896
2022-12-10,70047,70039,Blue,0,71976,72349,373
2022-07-11,70056,70058,Blue,1,58041,58113,72
2022-08-02,70044,70060,Blue,1,47392,48290,898
2022-01-28,70053,70049,Blue,0,58966,59169,203
2022-02-16,70040,70046,Blue,1,82026,82270,244
2022-03-23,70055,70047,Blue,0,63673,64054,381
2022-09-27,70047,70043,Blue,0,21671,21932,261
2022-12-25,70052,70054,Blue,1,64231,64286,55
2022-01-21,70038,70058,Blue,1,66430,67426,996
2022-09-18,70059,70041,Blue,0,77595,78525,930
2022-12-24,70042,70060,Blue,1,59536,60565,1029
2022-05-22,70048,70050,Blue,1,34011,34082,71
2022-04-24,70050,70058,Blue,1,88758,89137,379
2022-01-28,70040,70050,Blue,1,80948,81485,537
2022-02-02,70053,70045,Blue,0,25752,26199,447
2022-06-09,70044,70054,Blue,1,43213,43855,642
2022-12-03,70051,70043,Blue,0,75496,76000,504
2022-11-17,70040,70046,Blue,1,49817,50072,255
2022-05-19,70046,70048,Blue,1,51644,51767,123
2022-11-01,70046,70058,Blue,1,54926,55571,645
2022-08-29,70038,70042,Blue,1,49216,49333,117
2022-02-13,70044,70056,Blue,1,27074,27729,655
2022-05-18,70049,70043,Blue,0,20798,21504,706
2022-10-31,70038,70048,Blue,1,75888,76364,476
2022-04-15,70040,70050,Blue,1,86053,86542,489
2022-05-05,70059,70047,Blue,0,76216,76819,603
2022-11-11,70040,70052,Blue,1,65406,66042,636
2022-01-21,70051,70041,Blue,0,23834,24524,690
2022-06-24,70050,70058,Blue,1,62291,62733,442
2022-10-26,70059,70041,Blue,0,51974,52910,936
2022-12-24,70057,70053,Blue,0,59005,59172,167
2022-02-18,70048,70050,Blue,1,81405,81466,61
2022-03-25,70040,70048,Blue,1,50856,51277,421
2022-01-27,70059,70057,Blue,0,58394,58429,35
2022-08-09,70049,70047,Blue,0,36996,37054,58
2022-09-07,70048,70052,Blue,1,60484,60710,226
2022-07-01,70050,70052,Blue,1,79946,80051,105
2022-03-19,70049,70039,Blue,0,69719,70208,489
2022-05-28,70042,70048,Blue,1,25018,25385,367
2022-01-27,70051,70049,Blue,0,81659,81763,104
2022-09-20,70047,70838,Blue,0,57838,58349,511
2022-04-24,70049,70039,Blue,0,52739,53282,543
2022-04-22,70059,70039,Blue,0,23360,24480,1120
2022-11-11,70045,70043,Blue,0,34665,34749,84
2022-01-27,70040,70060,Blue,1,31811,32994,1183
2022-07-28,70057,70039,Blue,0,71314,72259,945
2022-07-27,70041,70838,Blue,0,75857,75960,103
2022-07-29,70049,70041,Blue,0,69545,69963,418
2022-12-09,70039,70838,Blue,0,45835,45871,36
2022-02-15,70048,70056,Blue,1,34421,34826,405
2022-04-18,70042,70050,Blue,1,68736,69143,407
2022-11-09,70059,70055,Blue,0,64995,65138,143
2022-12-09,70043,70039,Blue,0,62293,62399,106
2022-04-06,70053,70045,Blue,0,50009,50432,423
2022-03-06,70048,70050,Blue,1,82806,82864,58
2022-10-29,70052,70054,Blue,1,28777,28832,55
2022-08-25,70048,70052,Blue,1,79577,79786,209
2022-11-26,70056,70060,Blue,1,76449,76626,177
2022-12-11,70054,70056,Blue,1,64976,65025,49
2022-09-11,70044,70048,Blue,1,59857,60082,225
2022-02-26,70053,70045,Blue,0,51718,52155,437
2022-08-20,70051,70838,Blue,0,67974,68813,839
2022-02-16,70052,70058,Blue,1,28684,28942,258
2022-05-22,70043,70041,Blue,0,61525,61557,32
2022-07-18,70046,70048,Blue,1,28953,29024,71
2022-07-28,70053,70039,Blue,0,48139,48900,761
2022-09-07,70057,70055,Blue,0,21814,21884,70
2022-07-02,70045,70838,Blue,0,78554,78908,354
2022-08-27,70040,70056,Blue,1,45926,46760,834
2022-06-26,70059,70045,Blue,0,37516,38237,721
2022-05-09,70055,70047,Blue,0,31183,31583,400
2022-03-19,70053,70047,Blue,0,39764,40053,289
2022-02-09,70048,70056,Blue,1,71477,71860,383
2022-02-17,70055,70049,Blue,0,74533,74828,295
2022-02-20,70055,70047,Blue,0,54031,54422,391
2022-10-31,70049,70047,Blue,0,21427,21496,69
2022-04-23,70049,70045,Blue,0,68064,68265,201
2022-12-07,70041,70039,Blue,0,77414,77444,30
2022-11-05,70043,70039,Blue,0,34631,34745,114
2022-02-22,70041,70838,Blue,0,25576,25704,128
2022-08-05,70059,70039,Blue,0,57624,58720,1096
2022-11-14,70050,70054,Blue,1,40526,40783,257
2022-11-12,70052,70056,Blue,1,69850,69988,138
2022-05-19,70042,70046,Blue,1,56738,56961,223
2022-11-04,70055,70051,Blue,0,60670,60805,135
2022-01-10,70049,70043,Blue,0,77153,77502,349
2022-10-03,70057,70049,Blue,0,52047,52428,381
2022-04-20,70038,70054,Blue,1,23650,24485,835
2022-09-09,70038,70052,Blue,1,66888,67618,730
2022-10-24,70042,70048,Blue,1,55110,55434,324
2022-04-11,70055,70043,Blue,0,19368,20111,743
2022-04-07,70052,70058,Blue,1,35485,35734,249
2022-09-05,70055,70045,Blue,0,76172,76921,749
2022-01-05,70059,70041,Blue,0,32867,33850,983
2022-08-14,70038,70040,Blue,1,67207,67223,16
2022-03-16,70044,70056,Blue,1,38844,39609,765
2022-08-18,70049,70039,Blue,0,83879,84378,499
2022-04-16,70042,70046,Blue,1,29822,30032,210
2022-07-29,70053,70049,Blue,0,70866,71059,193
2022-09-21,70044,70054,Blue,1,54765,55369,604
2022-01-04,70047,70838,Blue,0,45552,45991,439
2022-09-22,70038,70058,Blue,1,48678,49633,955
2022-11-08,70051,70045,Blue,0,24163,24493,330
2022-02-22,70040,70056,Blue,1,72154,73011,857
2022-09-28,70049,70838,Blue,0,27852,28475,623
2022-09-25,70057,70051,Blue,0,42210,42442,232
2022-08-26,70057,70039,Blue,0,54874,55785,911
2022-03-05,70038,70058,Blue,1,87305,88291,986
2022-03-10,70038,70054,Blue,1,29647,30412,765
2022-09-27,70053,70047,Blue,0,65270,65567,297
2022-10-16,70042,70050,Blue,1,52756,53177,421
2022-02-06,70046,70054,Blue,1,74579,74966,387
2022-10-05,70038,70050,Blue,1,43511,44123,612
2022-09-10,70044,70048,Blue,1,36868,37087,219
2022-09-28,70049,70043,Blue,0,22020,22392,372
2022-04-10,70038,70040,Blue,1,70992,71007,15
2022-03-15,70049,70039,Blue,0,73732,74187,455
2022-04-04,70050,70052,Blue,1,37990,38100,110
2022-10-24,70045,70041,Blue,0,40881,41062,181
2022-06-02,70044,70046,Blue,1,51924,52043,119
2022-08-16,70042,70060,Blue,1,58251,59232,981
2022-04-21,70053,70045,Blue,0,39583,40232,649
2022-09-11,70051,70041,Blue,0,60172,60723,551
2022-08-10,70059,70838,Blue,0,43310,44501,1191
2022-10-01,70045,70041,Blue,0,75907,76086,179
2022-07-03,70038,70040,Blue,1,26961,26975,14
2022-09-25,70038,70044,Blue,1,70455,70610,155
2022-09-05,70038,70044,Blue,1,42325,42498,173
2022-03-30,70039,70838,Blue,0,74270,74303,33
2022-08-17,70054,70056,Blue,1,74030,74077,47
2022-02-02,70038,70060,Blue,1,35535,36804,1269
2022-06-24,70045,70041,Blue,0,78306,78476,170
2022-11-20,70054,70058,Blue,1,38524,38679,155
2022-09-02,70046,70054,Blue,1,27283,27727,444
2022-08-16,70046,70052,Blue,1,53034,53390,356
2022-07-25,70048,70052,Blue,1,48472,48685,213
2022-05-06,70059,70051,Blue,0,66074,66399,325
2022-06-10,70059,70838,Blue,0,60656,61993,1337
2022-08-13,70041,70039,Blue,0,75585,75623,38
2022-09-26,70057,70049,Blue,0,34294,34762,468
2022-10-03,70044,70056,Blue,1,81587,83033,1446
2022-08-03,70040,70058,Blue,1,58107,59094,987
2022-07-07,70042,70046,Blue,1,42231,42442,211
2022-07-05,70050,70058,Blue,1,61560,61970,410
2022-04-05,70052,70054,Blue,1,89830,89886,56
2022-04-05,70042,70060,Blue,1,53891,54942,1051
2022-11-14,70055,70045,Blue,0,57906,58386,480
2022-03-28,70045,70041,Blue,0,83047,83216,169
2022-11-12,70059,70049,Blue,0,37337,37780,443
2022-03-11,70055,70041,Blue,0,42890,43743,853
2022-07-05,70045,70041,Blue,0,59274,59465,191
2022-07-12,70045,70041,Blue,0,23332,23506,174
2022-01-20,70042,70058,Blue,1,55550,56413,863
2022-02-11,70046,70054,Blue,1,60627,61059,432
2022-09-26,70046,70048,Blue,1,25890,25969,79
2022-09-30,70053,70041,Blue,0,34178,34844,666
2022-10-05,70047,70045,Blue,0,26212,26320,108
2022-09-30,70053,70049,Blue,0,52541,52742,201
2022-02-15,70055,70047,Blue,0,49938,50360,422
2022-05-25,70042,70044,Blue,1,49430,49457,27
2022-11-12,70044,70056,Blue,1,67791,68574,783
2022-03-28,70057,70045,Blue,0,23752,24396,644
2022-04-06,70044,70052,Blue,1,25686,26225,539
2022-08-18,70053,70043,Blue,0,24296,24966,670
2022-06-10,70038,70056,Blue,1,68419,69483,1064
2022-02-08,70040,70050,Blue,1,32793,33408,615
2022-02-28,70047,70045,Blue,0,19863,19992,129
2022-04-06,70046,70060,Blue,1,45760,46531,771
2022-07-15,70047,70041,Blue,0,28697,29050,353
2022-02-24,70044,70060,Blue,1,63965,64975,1010
2022-07-27,70044,70054,Blue,1,46675,47294,619
2022-07-21,70038,70040,Blue,1,78324,78339,15
2022-03-20,70045,70039,Blue,0,50794,51068,274
2022-11-03,70059,70057,Blue,0,80256,80291,35
2022-02-22,70053,70041,Blue,0,23248,23996,748
2022-12-03,70049,70045,Blue,0,62187,62388,201
2022-08-24,70051,70043,Blue,0,36761,37366,605
2022-02-23,70042,70054,Blue,1,75431,76124,693
2022-03-06,70046,70052,Blue,1,37369,37694,325
2022-10-21,70040,70058,Blue,1,54172,55140,968
2022-07-06,70055,70039,Blue,0,62827,63690,863
2022-01-26,70044,70056,Blue,1,53307,54001,694
2022-07-22,70046,70050,Blue,1,69742,69938,196
2022-10-25,70051,70039,Blue,0,47661,48300,639
2022-02-26,70042,70046,Blue,1,44941,45134,193
2022-08-06,70045,70041,Blue,0,50503,50701,198
2022-02-08,70057,70838,Blue,0,82422,83467,1045
2022-02-20,70056,70058,Blue,1,63921,63994,73
2022-02-22,70057,70051,Blue,0,55467,55736,269
2022-04-12,70042,70060,Blue,1,34300,35344,1044
2022-01-08,70055,70053,Blue,0,63460,63515,55
2022-10-25,70039,70838,Blue,0,83978,84011,33
2022-06-25,70038,70044,Blue,1,88221,88391,170
2022-06-10,70045,70838,Blue,0,23255,23642,387
2022-10-03,70054,70060,Blue,1,31263,31556,293
2022-12-22,70042,70052,Blue,1,54779,55333,554
2022-10-04,70043,70039,Blue,0,28623,28743,120
2022-12-23,70040,70042,Blue,1,68872,68909,37
2022-10-18,70042,70046,Blue,1,60846,61039,193
2022-11-30,70055,70051,Blue,0,76095,76232,137
2022-11-05,70053,70047,Blue,0,45714,46001,287
2022-06-18,70044,70052,Blue,1,80181,80700,519
2022-12-23,70059,70039,Blue,0,63768,64940,1172
2022-02-14,70055,70051,Blue,0,58271,58401,130
2022-11-23,70051,70045,Blue,0,49783,50140,357
2022-09-01,70053,70041,Blue,0,69951,70626,675
2022-05-19,70044,70058,Blue,1,42380,43360,980
2022-06-16,70047,70039,Blue,0,70458,70880,422
2022-12-20,70038,70046,Blue,1,51254,51612,358
2022-02-23,70042,70056,Blue,1,63650,64420,770
2022-01-12,70040,70048,Blue,1,31803,32224,421
2022-10-13,70053,70838,Blue,0,39787,40574,787
2022-09-15,70046,70056,Blue,1,26005,26566,561
2022-06-05,70042,70046,Blue,1,53871,54087,216
2022-01-24,70053,70051,Blue,0,68757,68813,56
2022-07-26,70047,70045,Blue,0,53969,54101,132
2022-10-15,70059,70051,Blue,0,30325,30657,332
2022-11-04,70051,70047,Blue,0,53117,53324,207
2022-04-07,70049,70039,Blue,0,84050,84541,491
2022-01-19,70038,70042,Blue,1,42490,42596,106
2022-11-25,70051,70045,Blue,0,70589,70942,353
2022-09-08,70049,70045,Blue,0,83908,84101,193
2022-03-21,70048,70052,Blue,1,63048,63296,248
2022-01-20,70053,70039,Blue,0,79783,80592,809
2022-08-20,70053,70051,Blue,0,71635,71690,55
2022-06-10,70049,70045,Blue,0,26274,26499,225
2022-10-25,70046,70058,Blue,1,87725,88313,588
2022-04-08,70049,70043,Blue,0,75404,75786,382
2022-06-27,70038,70052,Blue,1,58291,59094,803
2022-09-21,70045,70838,Blue,0,69872,70201,329
2022-02-24,70057,70053,Blue,0,55225,55392,167
2022-07-23,70038,70058,Blue,1,77822,78883,1061
2022-10-17,70057,70049,Blue,0,52627,53032,405
2022-06-25,70040,70058,Blue,1,64818,66067,1249
2022-03-26,70041,70838,Blue,0,73472,73593,121
2022-07-26,70051,70838,Blue,0,82695,83416,721
2022-06-19,70048,70058,Blue,1,57535,58052,517
2022-10-02,70058,70060,Blue,1,52626,52686,60
2022-05-20,70044,70058,Blue,1,48959,49861,902
2022-06-19,70048,70050,Blue,1,57535,57601,66
2022-12-28,70055,70047,Blue,0,33823,34174,351
2022-01-20,70059,70043,Blue,0,31456,32476,1020
2022-12-23,70048,70052,Blue,1,68704,68947,243
2022-11-28,70044,70048,Blue,1,25438,25668,230
2022-12-15,70057,70838,Blue,0,20030,21163,1133
2022-01-18,70040,70054,Blue,1,33968,34859,891
2022-12-25,70056,70058,Blue,1,30142,30212,70
2022-01-15,70051,70049,Blue,0,49572,49674,102
2022-10-24,70038,70054,Blue,1,43513,44376,863
2022-12-13,70055,70838,Blue,0,57577,58423,846
2022-08-25,70042,70060,Blue,1,51515,52519,1004
2022-04-21,70044,70056,Blue,1,50981,51647,666
2022-04-04,70053,70049,Blue,0,52773,53007,234
2022-08-14,70050,70058,Blue,1,65670,66099,429
2022-08-26,70048,70050,Blue,1,25253,25313,60
2022-10-09,70059,70043,Blue,0,51728,52539,811
2022-05-18,70041,70039,Blue,0,28525,28560,35
2022-11-20,70055,70041,Blue,0,56721,57465,744
2022-07-09,70038,70044,Blue,1,36137,36313,176
2022-04-28,70059,70053,Blue,0,32658,32892,234
2022-01-04,70038,70040,Blue,1,57727,57745,18
2022-04-07,70042,70060,Blue,1,66553,67554,1001
2022-06-26,70042,70044,Blue,1,84763,84793,30
2022-06-24,70059,70055,Blue,0,31218,31447,229
2022-10-12,70057,70055,Blue,0,82042,82109,67
2022-12-02,70046,70058,Blue,1,31713,32327,614
2022-11-13,70048,70050,Blue,1,38796,38852,56
2022-11-30,70053,70047,Blue,0,46543,46835,292
2022-03-29,70050,70056,Blue,1,62813,63082,269
2022-10-22,70048,70058,Blue,1,80446,80939,493
2022-03-17,70042,70044,Blue,1,45916,45944,28
2022-03-11,70055,70049,Blue,0,71238,71602,364
2022-01-20,70052,70054,Blue,1,37223,37276,53
2022-12-14,70042,70048,Blue,1,62191,62545,354
2022-06-02,70041,70838,Blue,0,57302,57431,129
2022-04-12,70049,70043,Blue,0,27182,27553,371
2022-10-31,70040,70048,Blue,1,25345,25885,540
2022-08-26,70046,70056,Blue,1,32820,33378,558
2022-08-26,70057,70047,Blue,0,63526,64021,495
2022-10-28,70047,70043,Blue,0,24480,24753,273
2022-02-22,70055,70053,Blue,0,31038,31085,47
2022-12-27,70056,70058,Blue,1,67180,67255,75
2022-04-14,70059,70057,Blue,0,25754,25789,35
2022-05-15,70052,70058,Blue,1,58812,59077,265
2022-11-30,70044,70054,Blue,1,70255,70825,570
2022-01-18,70048,70060,Blue,1,61951,62587,636
2022-06-13,70054,70058,Blue,1,88527,88675,148
2022-02-11,70040,70044,Blue,1,43569,43690,121
2022-04-12,70059,70041,Blue,0,64093,65069,976
2022-08-11,70040,70060,Blue,1,58414,59488,1074
2022-01-02,70038,70048,Blue,1,78028,78476,448
2022-07-15,70059,70053,Blue,0,45260,45494,234
2022-01-03,70046,70058,Blue,1,86364,86982,618
2022-10-05,70038,70060,Blue,1,28577,29644,1067
2022-03-25,70043,70838,Blue,0,32659,32846,187
2022-12-27,70057,70041,Blue,0,59786,60607,821
2022-09-22,70043,70041,Blue,0,72109,72136,27
2022-01-16,70051,70043,Blue,0,26752,27262,510
2022-03-24,70059,70045,Blue,0,54496,55203,707
2022-01-22,70050,70052,Blue,1,79905,80021,116
2022-09-28,70057,70043,Blue,0,60622,61420,798
2022-10-14,70038,70044,Blue,1,35296,35459,163
2022-10-26,70042,70052,Blue,1,49884,50427,543
2022-02-14,70047,70039,Blue,0,32656,33100,444
2022-11-16,70051,70045,Blue,0,65924,66285,361
2022-02-09,70052,70054,Blue,1,55026,55080,54
2022-11-21,70050,70060,Blue,1,35010,35615,605
2022-09-24,70043,70041,Blue,0,29764,29797,33
2022-10-10,70038,70052,Blue,1,31508,32246,738
2022-06-16,70053,70039,Blue,0,57206,58010,804
2022-12-14,70049,70047,Blue,0,63693,63753,60
2022-08-08,70046,70050,Blue,1,68889,69058,169
2022-08-25,70055,70838,Blue,0,26552,27552,1000
2022-06-17,70038,70048,Blue,1,42691,43179,488
2022-02-02,70055,70045,Blue,0,65161,65760,599
2022-08-08,70050,70060,Blue,1,45124,45656,532
2022-05-09,70050,70052,Blue,1,72467,72582,115
2022-04-22,70052,70060,Blue,1,69094,69458,364
2022-08-19,70039,70838,Blue,0,74895,74930,35
2022-07-25,70056,70058,Blue,1,68601,68678,77
2022-03-27,70059,70055,Blue,0,31653,31801,148
2022-06-23,70050,70052,Blue,1,27936,28053,117
2022-08-09,70045,70043,Blue,0,84972,85072,100
2022-11-17,70045,70041,Blue,0,65737,65904,167
2022-06-10,70053,70039,Blue,0,64478,65242,764
2022-01-10,70040,70042,Blue,1,45844,45874,30
2022-08-08,70059,70838,Blue,0,34877,36104,1227
2022-09-09,70048,70054,Blue,1,25782,26071,289
2022-04-24,70051,70039,Blue,0,23408,24029,621
2022-10-23,70038,70052,Blue,1,59107,59853,746
2022-12-02,70050,70058,Blue,1,39454,40086,632
2022-04-12,70043,70041,Blue,0,25898,25927,29
2022-06-17,70038,70040,Blue,1,63733,63748,15
2022-04-01,70044,70058,Blue,1,42160,43040,880
2022-08-30,70057,70055,Blue,0,30213,30281,68
2022-06-16,70039,70838,Blue,0,57064,57098,34
2022-09-25,70053,70838,Blue,0,68698,69546,848
2022-09-21,70040,70052,Blue,1,48356,49045,689
2022-10-07,70044,70054,Blue,1,59921,60546,625
2022-06-14,70055,70053,Blue,0,32276,32345,69
2022-10-10,70059,70039,Blue,0,46383,47412,1029
2022-01-07,70059,70057,Blue,0,69080,69118,38
2022-01-05,70050,70060,Blue,1,52792,53356,564
2022-10-28,70048,70050,Blue,1,76882,76940,58
2022-02-20,70059,70039,Blue,0,49518,50533,1015
2022-04-22,70044,70052,Blue,1,56750,57204,454
2022-08-06,70051,70045,Blue,0,43101,43427,326
2022-11-07,70057,70039,Blue,0,39116,40466,1350
2022-04-21,70040,70058,Blue,1,25260,26282,1022
2022-09-13,70047,70043,Blue,0,22253,22506,253
2022-04-07,70047,70045,Blue,0,56256,56344,88
2022-06-09,70048,70058,Blue,1,73589,74197,608
2022-02-13,70051,70045,Blue,0,76944,77286,342
2022-03-18,70055,70041,Blue,0,64583,65264,681
2022-04-15,70056,70058,Blue,1,43843,43914,71
2022-06-28,70047,70041,Blue,0,35617,36000,383
2022-04-26,70059,70051,Blue,0,41120,41468,348
2022-04-20,70038,70050,Blue,1,26050,26611,561
2022-03-31,70040,70042,Blue,1,28520,28553,33
2022-04-03,70057,70055,Blue,0,59311,59379,68
2022-12-18,70047,70041,Blue,0,47966,48285,319
2022-05-17,70058,70060,Blue,1,43947,44009,62
2022-09-02,70046,70052,Blue,1,21655,22094,439
2022-03-10,70053,70838,Blue,0,30860,31772,912
2022-10-19,70055,70049,Blue,0,33317,33624,307
2022-03-04,70048,70058,Blue,1,37899,38452,553
2022-06-10,70057,70051,Blue,0,46183,46444,261
2022-01-14,70057,70047,Blue,0,65065,65552,487
2022-02-14,70051,70838,Blue,0,88515,89488,973
2022-10-02,70050,70056,Blue,1,82894,83181,287
2022-06-20,70046,70060,Blue,1,80341,81086,745
2022-03-26,70059,70047,Blue,0,61103,61708,605
2022-03-30,70059,70045,Blue,0,43821,44729,908
2022-11-20,70053,70045,Blue,0,77304,77699,395
2022-07-24,70038,70042,Blue,1,89116,89206,90
2022-03-29,70038,70056,Blue,1,36774,37792,1018
2022-04-20,70051,70039,Blue,0,54295,54971,676
2022-09-07,70050,70052,Blue,1,77882,77993,111
2022-07-17,70043,70838,Blue,0,22439,22649,210
2022-12-22,70050,70052,Blue,1,76959,77081,122
2022-08-21,70046,70056,Blue,1,87690,88226,536
2022-02-24,70038,70040,Blue,1,65832,65855,23
2022-07-19,70046,70048,Blue,1,64736,64813,77
2022-01-07,70055,70051,Blue,0,85349,85520,171
2022-03-26,70055,70049,Blue,0,48332,48619,287
2022-06-30,70057,70043,Blue,0,67033,67842,809
2022-06-06,70043,70039,Blue,0,25701,25827,126
2022-07-10,70044,70048,Blue,1,41880,42123,243
2022-04-07,70045,70043,Blue,0,66731,66825,94
2022-09-26,70057,70838,Blue,0,27955,29150,1195
2022-10-08,70052,70056,Blue,1,62325,62527,202
2022-12-15,70042,70044,Blue,1,56662,56693,31
2022-11-19,70047,70043,Blue,0,46021,46258,237
2022-10-23,70046,70052,Blue,1,59525,59853,328
2022-08-10,70054,70060,Blue,1,51709,51987,278
2022-03-12,70055,70045,Blue,0,42915,43409,494
2022-11-09,70040,70046,Blue,1,76804,77052,248
2022-03-14,70053,70047,Blue,0,36646,36976,330
2022-10-25,70040,70060,Blue,1,25770,26813,1043
2022-12-05,70046,70048,Blue,1,72445,72515,70
2022-10-01,70058,70060,Blue,1,59309,59370,61
2022-06-07,70044,70050,Blue,1,69181,69588,407
2022-11-18,70041,70838,Blue,0,36506,36631,125
2022-10-05,70040,70054,Blue,1,52147,52910,763
2022-09-30,70055,70838,Blue,0,37707,38683,976
2022-11-09,70042,70046,Blue,1,39994,40169,175
2022-04-11,70045,70041,Blue,0,84727,84886,159
2022-09-26,70048,70050,Blue,1,57323,57379,56
2022-03-18,70049,70047,Blue,0,28954,29010,56
2022-11-29,70042,70050,Blue,1,55136,55552,416
2022-03-04,70042,70056,Blue,1,53713,54484,771
2022-04-15,70055,70043,Blue,0,22634,23437,803
2022-11-02,70042,70054,Blue,1,53559,54306,747
2022-06-27,70054,70058,Blue,1,77253,77405,152
2022-03-03,70040,70050,Blue,1,49184,49739,555
2022-08-31,70059,70053,Blue,0,48378,48603,225
2022-07-15,70049,70043,Blue,0,28129,28527,398
2022-05-20,70040,70046,Blue,1,65355,65625,270
2022-02-09,70051,70043,Blue,0,32118,32603,485
2022-10-26,70044,70056,Blue,1,24167,24851,684
2022-11-18,70041,70838,Blue,0,49393,49510,117
2022-03-27,70059,70049,Blue,0,81555,82112,557
2022-08-17,70049,70045,Blue,0,61830,62017,187
2022-03-01,70055,70043,Blue,0,77370,78225,855
2022-02-05,70059,70039,Blue,0,34100,35116,1016
2022-02-17,70042,70044,Blue,1,68740,68767,27
2022-11-08,70038,70060,Blue,1,61645,62827,1182
2022-03-17,70046,70058,Blue,1,55255,55916,661
2022-11-22,70057,70053,Blue,0,25078,25236,158
2022-04-01,70055,70039,Blue,0,68318,69104,786
2022-06-28,70059,70051,Blue,0,35490,35872,382
2022-06-04,70047,70039,Blue,0,45930,46335,405
2022-01-15,70043,70039,Blue,0,27996,28100,104
2022-08-27,70049,70039,Blue,0,70879,71423,544
2022-09-24,70042,70046,Blue,1,28172,28342,170
2022-03-17,70055,70041,Blue,0,65502,66231,729
2022-03-22,70038,70054,Blue,1,23313,24291,978
2022-01-25,70059,70057,Blue,0,24258,24294,36
2022-02-24,70057,70047,Blue,0,81280,81812,532
2022-03-08,70044,70048,Blue,1,54517,54738,221
2022-01-29,70042,70046,Blue,1,50834,51047,213
2022-03-13,70059,70838,Blue,0,29293,30413,1120
2022-06-29,70040,70058,Blue,1,35110,36141,1031
2022-02-09,70051,70047,Blue,0,66604,66828,224
2022-04-23,70050,70052,Blue,1,71825,71941,116
2022-10-13,70053,70039,Blue,0,52526,53209,683
2022-08-26,70059,70055,Blue,0,62132,62337,205
2022-12-29,70059,70057,Blue,0,28458,28493,35
2022-09-12,70059,70051,Blue,0,67095,67416,321
2022-02-15,70051,70041,Blue,0,40268,40829,561
2022-11-16,70038,70048,Blue,1,60669,61147,478
2022-10-14,70055,70043,Blue,0,27798,28471,673
2022-08-01,70038,70048,Blue,1,76753,77205,452
2022-06-30,70052,70054,Blue,1,66230,66298,68
2022-11-06,70042,70050,Blue,1,61946,62335,389
2022-08-29,70038,70044,Blue,1,84906,85096,190
2022-12-28,70040,70042,Blue,1,30301,30331,30
2022-10-20,70043,70041,Blue,0,58236,58262,26
2022-04-19,70043,70039,Blue,0,38120,38235,115
2022-02-25,70053,70049,Blue,0,66489,66699,210
2022-03-18,70045,70041,Blue,0,53570,53749,179
2022-03-16,70054,70060,Blue,1,81186,81474,288
2022-11-18,70044,70050,Blue,1,48348,48673,325
2022-08-18,70053,70051,Blue,0,63184,63240,56
2022-09-28,70047,70041,Blue,0,21505,21860,355
2022-08-19,70042,70050,Blue,1,50940,51509,569
2022-04-06,70057,70039,Blue,0,58343,59330,987
2022-02-05,70044,70046,Blue,1,68219,68324,105
2022-11-23,70042,70044,Blue,1,44849,44878,29
2022-11-14,70053,70051,Blue,0,57740,57794,54
2022-03-17,70051,70043,Blue,0,27362,27892,530
2022-04-20,70044,70050,Blue,1,52522,52871,349
2022-07-23,70056,70060,Blue,1,73430,73683,253
2022-01-25,70048,70056,Blue,1,48204,48594,390
2022-01-04,70041,70039,Blue,0,39741,39779,38
2022-02-10,70059,70053,Blue,0,35826,36071,245
2022-11-09,70040,70060,Blue,1,28214,29240,1026
2022-04-13,70045,70838,Blue,0,56461,56873,412
2022-06-24,70057,70838,Blue,0,84933,86000,1067
2022-01-23,70043,70039,Blue,0,45020,45135,115
2022-01-14,70052,70056,Blue,1,28688,28826,138
2022-03-23,70056,70058,Blue,1,32098,32170,72
2022-02-04,70055,70053,Blue,0,88310,88371,61
2022-11-20,70042,70050,Blue,1,66813,67228,415
2022-08-27,70055,70045,Blue,0,26752,27266,514
2022-06-13,70055,70041,Blue,0,22239,23046,807
2022-01-20,70050,70052,Blue,1,61638,61756,118
2022-01-12,70049,70043,Blue,0,31425,31872,447
2022-11-07,70055,70049,Blue,0,46389,46738,349
2022-03-11,70044,70052,Blue,1,33583,34147,564
2022-08-06,70040,70058,Blue,1,79347,80330,983
2022-02-09,70048,70050,Blue,1,31054,31111,57
2022-01-27,70038,70060,Blue,1,27928,29200,1272
2022-03-30,70049,70045,Blue,0,33184,33384,200
2022-08-13,70052,70060,Blue,1,70435,70825,390
2022-10-05,70046,70048,Blue,1,23386,23474,88
2022-06-12,70038,70060,Blue,1,62348,63558,1210
2022-04-04,70041,70039,Blue,0,58082,58119,37
2022-02-14,70038,70060,Blue,1,25453,26725,1272
2022-11-10,70040,70048,Blue,1,57427,57888,461
2022-06-23,70049,70039,Blue,0,78928,79467,539
2022-09-02,70040,70052,Blue,1,51892,52540,648
2022-09-13,70057,70047,Blue,0,83669,84145,476
2022-10-29,70049,70047,Blue,0,38951,39006,55
2022-12-07,70048,70056,Blue,1,38848,39256,408
2022-04-24,70042,70052,Blue,1,80523,81092,569
2022-09-25,70051,70041,Blue,0,44492,45195,703
2022-07-21,70043,70838,Blue,0,24018,24234,216
2022-07-01,70056,70060,Blue,1,47224,47404,180
2022-07-20,70044,70060,Blue,1,63581,64594,1013
2022-06-24,70059,70055,Blue,0,28581,28744,163
2022-03-15,70050,70052,Blue,1,32070,32186,116
2022-02-22,70043,70039,Blue,0,79910,80015,105
2022-12-28,70050,70060,Blue,1,42523,43056,533
2022-08-13,70055,70039,Blue,0,34290,35101,811
2022-04-14,70059,70047,Blue,0,56299,56846,547
2022-04-01,70055,70041,Blue,0,23571,24434,863
2022-03-31,70059,70047,Blue,0,64396,64924,528
2022-11-09,70045,70043,Blue,0,46400,46494,94
2022-04-04,70057,70838,Blue,0,53976,55086,1110
2022-07-13,70042,70046,Blue,1,53086,53304,218
2022-06-28,70038,70048,Blue,1,22237,22734,497
2022-01-14,70042,70054,Blue,1,68374,69224,850
2022-09-08,70051,70047,Blue,0,43607,43819,212
2022-09-07,70040,70058,Blue,1,30423,31287,864
2022-05-19,70044,70058,Blue,1,45127,46150,1023
2022-09-16,70057,70049,Blue,0,36476,36970,494
2022-12-20,70050,70056,Blue,1,64395,64685,290
2022-08-13,70053,70043,Blue,0,26266,26826,560
2022-06-27,70050,70058,Blue,1,65070,65610,540
2022-03-23,70038,70052,Blue,1,66137,66895,758
2022-02-24,70043,70838,Blue,0,78662,78848,186
2022-11-20,70046,70058,Blue,1,56820,57411,591
2022-08-14,70042,70054,Blue,1,25490,26171,681
2022-08-25,70056,70058,Blue,1,32144,32234,90
2022-12-05,70044,70054,Blue,1,50437,51113,676
2022-04-16,70038,70052,Blue,1,43689,44453,764
2022-09-24,70052,70058,Blue,1,61828,62067,239
2022-03-01,70055,70045,Blue,0,29860,30479,619
2022-09-02,70040,70048,Blue,1,55351,55761,410
2022-04-06,70047,70838,Blue,0,27610,28152,542
2022-12-13,70054,70056,Blue,1,60314,60353,39
2022-01-31,70045,70041,Blue,0,63188,63384,196
2022-01-24,70051,70041,Blue,0,75274,75857,583
2022-10-31,70040,70056,Blue,1,24811,25800,989
2022-04-01,70057,70838,Blue,0,18908,20052,1144
2022-02-07,70049,70041,Blue,0,80562,80989,427
2022-06-30,70053,70043,Blue,0,74911,75517,606
2022-09-25,70057,70053,Blue,0,44731,44887,156
2022-04-09,70044,70058,Blue,1,68209,68953,744
2022-09-17,70055,70053,Blue,0,82507,82555,48
2022-02-05,70059,70043,Blue,0,45445,46451,1006
2022-01-02,70048,70054,Blue,1,63147,63482,335
2022-03-02,70054,70060,Blue,1,51706,51977,271
2022-08-17,70057,70053,Blue,0,60391,60541,150
2022-06-13,70049,70838,Blue,0,21864,22585,721
2022-03-31,70049,70045,Blue,0,24177,24407,230
2022-10-22,70057,70838,Blue,0,88320,89835,1515
2022-11-05,70059,70049,Blue,0,42201,42654,453
2022-02-13,70047,70041,Blue,0,65778,66140,362
2022-03-16,70055,70043,Blue,0,63369,64049,680
2022-02-09,70047,70045,Blue,0,76146,76263,117
2022-08-05,70055,70047,Blue,0,49576,49956,380
2022-12-22,70055,70039,Blue,0,28181,29004,823
2022-05-06,70059,70055,Blue,0,77419,77566,147
2022-12-13,70059,70041,Blue,0,68667,69646,979
2022-11-09,70042,70056,Blue,1,89256,90008,752
2022-05-06,70057,70055,Blue,0,86372,86441,69
2022-06-13,70055,70053,Blue,0,79640,79685,45
2022-02-05,70040,70056,Blue,1,65883,66691,808
2022-06-14,70042,70044,Blue,1,75956,75990,34
2022-04-23,70055,70043,Blue,0,78638,79338,700
2022-04-21,70040,70044,Blue,1,33570,33702,132
2022-01-17,70047,70838,Blue,0,40671,41195,524
2022-12-03,70038,70046,Blue,1,72315,72648,333
2022-05-03,70056,70058,Blue,1,63551,63622,71
2022-09-04,70059,70057,Blue,0,24161,24257,96
2022-04-06,70039,70838,Blue,0,73038,73067,29
2022-12-02,70040,70046,Blue,1,56815,57069,254
2022-12-27,70052,70054,Blue,1,25391,25453,62
2022-02-28,70057,70047,Blue,0,57278,57729,451
2022-10-19,70046,70060,Blue,1,57427,58216,789
2022-12-02,70053,70043,Blue,0,75177,75738,561
2022-07-24,70055,70047,Blue,0,58880,59254,374
2022-03-04,70042,70056,Blue,1,53534,54369,835
2022-08-21,70043,70041,Blue,0,74795,74825,30
2022-01-27,70052,70054,Blue,1,59090,59136,46
2022-10-17,70045,70838,Blue,0,49589,49924,335
2022-11-08,70052,70054,Blue,1,35633,35685,52
2022-05-20,70059,70057,Blue,0,19876,19914,38
2022-03-22,70057,70053,Blue,0,57143,57298,155
2022-01-13,70050,70056,Blue,1,44092,44407,315
2022-07-22,70055,70838,Blue,0,49585,50547,962
2022-02-16,70059,70053,Blue,0,31452,31675,223
2022-06-08,70040,70046,Blue,1,23888,24152,264
2022-08-10,70055,70047,Blue,0,28653,29048,395
2022-08-18,70038,70058,Blue,1,54019,55071,1052
2022-07-06,70049,70041,Blue,0,27800,28299,499
2022-08-05,70038,70046,Blue,1,60804,61166,362
2022-11-03,70055,70051,Blue,0,50595,50735,140
2022-06-11,70040,70050,Blue,1,28632,29171,539
2022-03-22,70059,70057,Blue,0,58273,58307,34
2022-12-25,70049,70043,Blue,0,50557,50896,339
2022-07-22,70044,70050,Blue,1,68822,69178,356
2022-12-28,70053,70838,Blue,0,49010,49849,839
2022-07-28,70051,70838,Blue,0,24211,25001,790
2022-10-22,70038,70060,Blue,1,31814,32930,1116
2022-11-05,70057,70047,Blue,0,35781,36225,444
2022-03-18,70038,70050,Blue,1,51912,52469,557
2022-07-09,70054,70056,Blue,1,33822,33869,47
2022-06-14,70059,70049,Blue,0,79862,80361,499
2022-10-14,70038,70046,Blue,1,40908,41262,354
2022-11-27,70051,70049,Blue,0,54813,54918,105
2022-06-26,70050,70052,Blue,1,39064,39174,110
2022-01-22,70055,70043,Blue,0,42925,43615,690
2022-05-29,70039,70838,Blue,0,52030,52070,40
2022-10-04,70038,70044,Blue,1,54928,55107,179
2022-06-08,70040,70042,Blue,1,52232,52263,31
2022-10-27,70042,70050,Blue,1,40684,41155,471
2022-04-22,70040,70052,Blue,1,31511,32147,636
2022-02-16,70052,70060,Blue,1,63188,63581,393
2022-11-26,70057,70053,Blue,0,21585,21740,155
2022-09-04,70040,70054,Blue,1,80437,81217,780
2022-11-27,70042,70050,Blue,1,25456,25839,383
2022-09-21,70051,70043,Blue,0,76271,76832,561
2022-02-11,70059,70047,Blue,0,20236,20845,609
2022-04-13,70050,70052,Blue,1,74062,74168,106
2022-07-27,70059,70055,Blue,0,25939,26095,156
2022-10-07,70054,70060,Blue,1,68178,68516,338
2022-11-12,70046,70050,Blue,1,32167,32334,167
2022-01-19,70056,70058,Blue,1,39588,39685,97
2022-02-18,70055,70838,Blue,0,55274,56189,915
2022-06-09,70053,70041,Blue,0,21958,22666,708
2022-01-24,70057,70047,Blue,0,42951,43387,436
2022-04-02,70040,70044,Blue,1,43755,43868,113
2022-09-25,70053,70051,Blue,0,72472,72523,51
2022-10-14,70038,70060,Blue,1,70516,71715,1199
2022-05-20,70043,70838,Blue,0,77799,77990,191
2022-10-22,70056,70060,Blue,1,35421,35599,178
2022-06-13,70044,70060,Blue,1,52227,53214,987
2022-11-30,70059,70047,Blue,0,47295,47836,541
2022-08-26,70040,70050,Blue,1,78844,79344,500
2022-12-05,70059,70055,Blue,0,81282,81424,142
2022-07-09,70039,70838,Blue,0,47061,47092,31
2022-09-12,70046,70050,Blue,1,25992,26163,171
2022-07-02,70046,70048,Blue,1,42084,42173,89
2022-03-27,70057,70039,Blue,0,42270,43340,1070
2022-06-20,70047,70043,Blue,0,31231,31507,276
2022-04-27,70059,70047,Blue,0,28455,29046,591
2022-11-13,70047,70838,Blue,0,47379,47827,448
2022-07-25,70046,70048,Blue,1,48335,48419,84
2022-02-19,70048,70054,Blue,1,32896,33215,319
2022-09-17,70042,70054,Blue,1,45501,46132,631
2022-01-03,70053,70041,Blue,0,52796,53458,662
2022-03-13,70038,70040,Blue,1,46798,46812,14
2022-12-26,70052,70054,Blue,1,65790,65873,83
2022-09-16,70049,70043,Blue,0,75904,76282,378
2022-02-23,70048,70052,Blue,1,52407,52608,201
2022-08-09,70044,70050,Blue,1,62685,63014,329
2022-08-25,70044,70058,Blue,1,59533,60347,814
2022-11-21,70040,70058,Blue,1,85752,86711,959
2022-04-01,70059,70055,Blue,0,26359,26514,155
2022-10-30,70059,70045,Blue,0,63724,64409,685
2022-09-15,70038,70042,Blue,1,55212,55360,148
2022-08-05,70040,70056,Blue,1,27478,28296,818
2022-03-15,70050,70056,Blue,1,57716,58031,315
2022-04-08,70052,70054,Blue,1,22828,22883,55
2022-08-14,70047,70043,Blue,0,50102,50346,244
2022-02-22,70053,70047,Blue,0,65894,66202,308
2022-06-15,70053,70039,Blue,0,74638,75384,746
2022-02-06,70049,70047,Blue,0,66266,66327,61
2022-09-26,70051,70039,Blue,0,54530,55197,667
2022-08-15,70050,70052,Blue,1,27122,27243,121
2022-04-10,70053,70047,Blue,0,82486,82771,285
2022-10-21,70051,70041,Blue,0,30101,30734,633
2022-06-09,70044,70048,Blue,1,29275,29548,273
2022-06-09,70038,70042,Blue,1,66831,66928,97
2022-10-10,70052,70060,Blue,1,61499,61864,365
2022-02-04,70053,70043,Blue,0,76975,77731,756
2022-03-03,70057,70838,Blue,0,50787,51846,1059
2022-10-24,70053,70838,Blue,0,68926,69807,881
2022-02-24,70040,70042,Blue,1,54356,54390,34
2022-04-19,70046,70056,Blue,1,58154,58704,550
2022-03-28,70048,70060,Blue,1,20471,21149,678
2022-11-07,70044,70056,Blue,1,81905,82580,675
2022-11-23,70049,70047,Blue,0,66648,66702,54
2022-11-17,70038,70056,Blue,1,26391,27528,1137
2022-05-27,70050,70052,Blue,1,23525,23716,191
2022-07-16,70048,70052,Blue,1,53519,53737,218
2022-09-04,70040,70050,Blue,1,57588,58100,512
2022-09-03,70047,70838,Blue,0,57389,57937,548
2022-03-26,70052,70056,Blue,1,64115,64244,129
2022-09-28,70059,70039,Blue,0,29771,30942,1171
2022-02-10,70051,70049,Blue,0,88487,88602,115
2022-06-23,70040,70046,Blue,1,32236,32539,303
2022-08-14,70053,70041,Blue,0,55730,56437,707
2022-02-23,70042,70052,Blue,1,78783,79352,569
2022-06-09,70038,70060,Blue,1,60802,62818,2016
2022-09-15,70050,70060,Blue,1,61772,62334,562
2022-04-13,70050,70056,Blue,1,56094,56407,313
2022-03-19,70042,70060,Blue,1,54647,55561,914
2022-05-22,70046,70052,Blue,1,53009,53515,506
2022-09-22,70053,70039,Blue,0,78718,79491,773
2022-03-21,70040,70050,Blue,1,63823,64406,583
2022-09-01,70051,70039,Blue,0,69033,69730,697
2022-04-11,70055,70838,Blue,0,55010,55939,929
2022-12-03,70046,70050,Blue,1,60728,60902,174
2022-01-26,70038,70056,Blue,1,58038,58957,919
2022-06-08,70038,70052,Blue,1,20954,21887,933
2022-03-19,70059,70053,Blue,0,21495,21724,229
2022-07-19,70057,70055,Blue,0,24329,24397,68
2022-11-13,70059,70051,Blue,0,39497,39846,349
2022-03-03,70038,70046,Blue,1,49097,49458,361
2022-02-16,70059,70053,Blue,0,53593,53823,230
2022-09-23,70046,70052,Blue,1,49562,49900,338
2022-04-22,70042,70060,Blue,1,80026,81101,1075
2022-06-11,70056,70058,Blue,1,25288,25359,71
2022-04-04,70053,70043,Blue,0,58334,58928,594
2022-06-16,70043,70838,Blue,0,68591,68810,219
2022-08-21,70042,70050,Blue,1,27801,28211,410
2022-06-13,70053,70043,Blue,0,19468,20170,702
2022-07-27,70040,70054,Blue,1,86594,87314,720
2022-02-15,70049,70047,Blue,0,21084,21138,54
2022-06-28,70045,70043,Blue,0,40465,40576,111
2022-06-20,70044,70054,Blue,1,56580,57221,641
2022-01-07,70050,70060,Blue,1,60501,61164,663
2022-12-31,70047,70045,Blue,0,42861,42955,94
2022-10-28,70038,70060,Blue,1,30258,31347,1089
2022-06-14,70050,70052,Blue,1,72554,72669,115
2022-02-18,70051,70049,Blue,0,77003,77104,101
2022-04-20,70055,70039,Blue,0,23601,24513,912
2022-12-07,70054,70058,Blue,1,28251,28418,167
2022-12-10,70057,70055,Blue,0,23566,23636,70
2022-03-05,70038,70054,Blue,1,78614,79443,829
2022-08-31,70038,70050,Blue,1,23389,23959,570
2022-01-06,70055,70838,Blue,0,76849,77859,1010
2022-08-29,70038,70056,Blue,1,40467,41389,922
2022-02-10,70044,70050,Blue,1,25944,26291,347
2022-07-19,70044,70052,Blue,1,55144,55632,488
2022-10-19,70059,70057,Blue,0,73816,73853,37
2022-03-28,70048,70052,Blue,1,59261,59457,196
2022-10-22,70053,70041,Blue,0,39223,39883,660
2022-06-09,70040,70058,Blue,1,74119,75072,953
2022-09-28,70047,70043,Blue,0,35602,35878,276
2022-04-20,70046,70052,Blue,1,76719,77099,380
2022-12-14,70052,70054,Blue,1,42222,42277,55
2022-03-01,70055,70047,Blue,0,22240,22699,459
2022-10-11,70050,70054,Blue,1,67001,67203,202
2022-09-03,70053,70838,Blue,0,65134,66057,923
2022-02-09,70040,70054,Blue,1,31724,32542,818
2022-09-19,70048,70056,Blue,1,36274,36645,371
2022-02-04,70038,70046,Blue,1,19866,20192,326
2022-01-05,70038,70060,Blue,1,43507,44604,1097
2022-08-28,70040,70060,Blue,1,31632,32686,1054
2022-10-18,70047,70041,Blue,0,39065,39375,310
2022-11-18,70053,70049,Blue,0,66608,66902,294
2022-03-13,70054,70056,Blue,1,55677,55723,46
2022-06-28,70047,70838,Blue,0,46147,46624,477
2022-07-11,70046,70048,Blue,1,31111,31203,92
2022-06-29,70051,70047,Blue,0,25145,25341,196
2022-01-20,70050,70052,Blue,1,72020,72133,113
2022-07-25,70055,70039,Blue,0,33672,34550,878
2022-12-07,70042,70044,Blue,1,34222,34254,32
2022-02-07,70042,70044,Blue,1,23850,23877,27
2022-11-12,70048,70060,Blue,1,58781,59386,605
2022-12-28,70059,70047,Blue,0,67334,67891,557
2022-12-27,70046,70052,Blue,1,69891,70237,346
2022-12-27,70038,70050,Blue,1,67420,68014,594
2022-12-13,70051,70043,Blue,0,30889,31393,504
2022-12-27,70057,70838,Blue,0,53376,54363,987
2022-03-29,70046,70058,Blue,1,58452,59125,673
2022-05-18,70041,70039,Blue,0,59516,59553,37
2022-02-28,70046,70060,Blue,1,28936,30033,1097
2022-01-10,70059,70057,Blue,0,82334,82370,36
2022-02-15,70053,70045,Blue,0,39585,40122,537
2022-11-12,70053,70043,Blue,0,84322,84928,606
2022-01-20,70044,70060,Blue,1,89352,90157,805
2022-09-14,70049,70047,Blue,0,64488,64542,54
2022-12-04,70057,70055,Blue,0,63701,63770,69
2022-08-12,70055,70047,Blue,0,80956,81338,382
2022-06-15,70053,70047,Blue,0,20879,21158,279
2022-04-21,70055,70051,Blue,0,63678,63818,140
2022-07-28,70057,70055,Blue,0,40652,40724,72
2022-12-01,70059,70043,Blue,0,54080,55064,984
2022-09-14,70042,70056,Blue,1,33066,33906,840
2022-12-09,70046,70056,Blue,1,68290,68797,507
2022-04-11,70057,70041,Blue,0,84086,84886,800
2022-08-02,70048,70052,Blue,1,44651,44866,215
2022-06-12,70057,70838,Blue,0,40226,41244,1018
2022-03-13,70042,70058,Blue,1,26416,27258,842
2022-06-23,70045,70041,Blue,0,45530,45765,235
2022-06-17,70057,70053,Blue,0,66579,66734,155
2022-08-20,70055,70053,Blue,0,47787,47834,47
2022-10-05,70042,70056,Blue,1,60373,61147,774
2022-11-01,70042,70060,Blue,1,40053,41073,1020
2022-03-25,70059,70055,Blue,0,58999,59147,148
2022-01-14,70049,70838,Blue,0,37504,38087,583
2022-11-15,70052,70056,Blue,1,67670,67828,158
2022-08-18,70038,70058,Blue,1,66273,67330,1057
2022-02-06,70045,70039,Blue,0,63274,63540,266
2022-09-30,70059,70049,Blue,0,35892,36371,479
2022-10-31,70059,70051,Blue,0,55758,56099,341
2022-07-30,70059,70053,Blue,0,50836,51076,240
2022-08-14,70059,70055,Blue,0,75467,75613,146
2022-08-22,70052,70060,Blue,1,52155,52586,431
2022-04-18,70059,70051,Blue,0,83476,83794,318
2022-06-30,70048,70056,Blue,1,31650,32074,424
2022-10-23,70046,70060,Blue,1,41436,42160,724
2022-08-04,70059,70055,Blue,0,87316,87456,140
2022-02-10,70059,70043,Blue,0,86294,87182,888
2022-12-30,70040,70058,Blue,1,61979,62966,987
2022-10-07,70046,70048,Blue,1,29616,29702,86
2022-09-13,70059,70838,Blue,0,64258,65327,1069
2022-12-30,70045,70041,Blue,0,23292,23453,161
2022-11-05,70045,70039,Blue,0,69402,69736,334
2022-01-13,70047,70041,Blue,0,31544,31898,354
2022-03-18,70051,70045,Blue,0,78687,79026,339
2022-02-17,70050,70052,Blue,1,28930,29035,105
2022-04-20,70050,70056,Blue,1,62403,62713,310
2022-07-17,70048,70050,Blue,1,82848,82909,61
2022-06-22,70057,70045,Blue,0,74594,75269,675
2022-09-03,70059,70045,Blue,0,77114,77801,687
2022-08-25,70057,70041,Blue,0,54163,55044,881
2022-04-04,70040,70046,Blue,1,47005,47294,289
2022-02-01,70053,70045,Blue,0,62582,63010,428
2022-06-16,70051,70838,Blue,0,62187,62961,774
2022-10-15,70056,70060,Blue,1,53278,53441,163
2022-02-11,70057,70039,Blue,0,62093,63124,1031
2022-07-09,70059,70057,Blue,0,71888,71925,37
2022-12-31,70059,70049,Blue,0,74954,75444,490
2022-03-29,70038,70042,Blue,1,34448,34535,87
2022-02-04,70040,70054,Blue,1,57664,58589,925
2022-04-12,70051,70838,Blue,0,35682,36509,827
2022-02-08,70044,70060,Blue,1,64830,65898,1068
2022-01-06,70059,70043,Blue,0,26355,27238,883
2022-09-15,70059,70055,Blue,0,24258,24408,150
2022-02-19,70054,70056,Blue,1,85518,85565,47
2022-04-03,70059,70039,Blue,0,78256,79236,980
2022-09-06,70057,70051,Blue,0,42799,43046,247
2022-02-18,70047,70039,Blue,0,51766,52191,425
2022-09-08,70050,70058,Blue,1,50341,50741,400
2022-10-02,70040,70058,Blue,1,27738,28678,940
2022-07-09,70059,70047,Blue,0,29240,29769,529
2022-09-26,70044,70048,Blue,1,80298,80525,227
2022-06-11,70041,70039,Blue,0,53506,53537,31
2022-08-30,70053,70051,Blue,0,23686,23748,62
2022-06-08,70040,70042,Blue,1,54166,54204,38
2022-12-02,70057,70047,Blue,0,25901,26395,494
2022-10-15,70041,70838,Blue,0,29242,29377,135
2022-06-13,70042,70054,Blue,1,78701,79383,682
2022-12-10,70042,70044,Blue,1,76772,76803,31
2022-10-24,70038,70058,Blue,1,64808,65815,1007
2022-07-11,70053,70043,Blue,0,41389,42029,640
2022-06-01,70046,70052,Blue,1,84331,84861,530
2022-05-11,70053,70049,Blue,0,63388,63589,201
2022-12-02,70042,70058,Blue,1,52194,53012,818
2022-09-26,70042,70048,Blue,1,35169,35465,296
2022-02-16,70057,70045,Blue,0,72056,72649,593
2022-01-26,70053,70049,Blue,0,87189,87410,221
2022-04-08,70053,70047,Blue,0,22687,23011,324
2022-02-17,70047,70041,Blue,0,38848,39167,319
2022-08-13,70038,70046,Blue,1,52354,52738,384
2022-02-24,70047,70045,Blue,0,31849,31996,147
2022-01-25,70040,70058,Blue,1,64102,65042,940
2022-09-18,70047,70043,Blue,0,42807,43078,271
2022-12-29,70038,70042,Blue,1,35781,35882,101
2022-07-01,70048,70054,Blue,1,30910,31230,320
2022-11-16,70043,70838,Blue,0,56007,56212,205
2022-11-20,70054,70058,Blue,1,32323,32473,150
2022-12-04,70053,70043,Blue,0,60253,61029,776
2022-10-26,70038,70044,Blue,1,21080,21277,197
2022-07-02,70050,70052,Blue,1,29154,29260,106
2022-11-16,70042,70058,Blue,1,73141,74043,902
2022-12-29,70044,70058,Blue,1,33052,33859,807
2022-03-03,70038,70046,Blue,1,22412,22694,282
2022-02-17,70055,70039,Blue,0,23472,24406,934
2022-09-13,70038,70048,Blue,1,75239,75700,461
2022-12-01,70046,70056,Blue,1,50106,50603,497
2022-08-22,70045,70838,Blue,0,28851,29224,373
2022-02-23,70057,70838,Blue,0,34776,35868,1092
2022-10-08,70051,70045,Blue,0,75489,75842,353
2022-06-16,70057,70055,Blue,0,22502,22670,168
2022-05-08,70057,70055,Blue,0,75686,75755,69
2022-08-04,70046,70052,Blue,1,71437,71767,330
2022-03-20,70055,70041,Blue,0,65357,66095,738
2022-02-07,70050,70056,Blue,1,58006,58374,368
2022-02-08,70038,70040,Blue,1,45798,45817,19
2022-10-17,70041,70838,Blue,0,39454,39572,118
2022-06-10,70057,70053,Blue,0,49844,49994,150
2022-10-05,70044,70046,Blue,1,49474,49619,145
2022-08-10,70038,70048,Blue,1,21804,22276,472
2022-03-23,70053,70051,Blue,0,31436,31494,58
2022-10-19,70043,70838,Blue,0,25146,25344,198
2022-03-24,70055,70045,Blue,0,54677,55203,526
2022-01-11,70051,70043,Blue,0,31301,31777,476
2022-07-02,70044,70046,Blue,1,55274,55389,115
2022-09-22,70052,70060,Blue,1,45418,45779,361
2022-07-08,70059,70838,Blue,0,59591,60704,1113
2022-03-07,70042,70056,Blue,1,29811,30614,803
2022-01-15,70052,70056,Blue,1,43393,43539,146
2022-04-18,70059,70055,Blue,0,68477,68620,143
2022-08-05,70051,70043,Blue,0,62945,63445,500
2022-03-24,70038,70042,Blue,1,55940,56033,93
2022-04-17,70038,70054,Blue,1,27666,28386,720
2022-12-08,70040,70044,Blue,1,21852,21961,109
2022-12-29,70038,70060,Blue,1,34383,35529,1146
2022-04-22,70047,70045,Blue,0,61664,61790,126
2022-01-03,70055,70047,Blue,0,43402,43769,367
2022-12-04,70040,70044,Blue,1,76511,76630,119
2022-11-17,70057,70041,Blue,0,66098,66962,864
2022-08-29,70040,70050,Blue,1,81289,81760,471
2022-11-13,70045,70039,Blue,0,45403,45641,238
2022-03-14,70057,70041,Blue,0,61467,62288,821
2022-11-18,70055,70045,Blue,0,39984,40765,781
2022-09-23,70048,70054,Blue,1,22820,23164,344
2022-05-20,70048,70054,Blue,1,78891,79192,301
2022-07-23,70044,70058,Blue,1,32025,32806,781
2022-09-02,70050,70056,Blue,1,55143,55437,294
2022-06-19,70038,70046,Blue,1,55335,55684,349
2022-10-11,70059,70057,Blue,0,75372,75408,36
2022-05-18,70049,70045,Blue,0,52423,52717,294
2022-01-13,70050,70052,Blue,1,61697,61811,114
2022-12-31,70038,70046,Blue,1,45317,45669,352
2022-11-17,70052,70058,Blue,1,23074,23326,252
2022-02-25,70038,70048,Blue,1,83726,84164,438
2022-08-03,70053,70051,Blue,0,71089,71147,58
2022-12-06,70059,70838,Blue,0,71365,72432,1067
2022-09-12,70046,70054,Blue,1,62232,62686,454
2022-05-20,70046,70056,Blue,1,31934,32555,621
2022-09-25,70053,70043,Blue,0,36460,37130,670
2022-07-23,70048,70060,Blue,1,71170,71891,721
2022-10-16,70059,70053,Blue,0,60320,60545,225
2022-10-17,70059,70039,Blue,0,21462,22604,1142
2022-08-31,70046,70048,Blue,1,22679,22758,79
2022-06-22,70041,70039,Blue,0,56171,56210,39
2022-02-17,70046,70056,Blue,1,88690,89201,511
2022-02-03,70047,70838,Blue,0,42212,42762,550
2022-10-31,70038,70050,Blue,1,25289,25984,695
2022-02-15,70047,70039,Blue,0,55677,56139,462
2022-03-21,70059,70053,Blue,0,38117,38374,257
2022-01-24,70053,70047,Blue,0,62868,63148,280
2022-09-20,70042,70048,Blue,1,65563,65878,315
2022-08-10,70052,70058,Blue,1,31938,32212,274
2022-04-16,70039,70838,Blue,0,70831,70870,39
2022-08-18,70038,70060,Blue,1,77407,78539,1132
2022-09-03,70059,70051,Blue,0,60017,60354,337
2022-11-19,70047,70039,Blue,0,88864,89514,650
2022-03-12,70039,70838,Blue,0,43775,43808,33
2022-07-13,70047,70041,Blue,0,27433,27848,415
2022-02-05,70040,70048,Blue,1,69737,70138,401
2022-07-05,70041,70838,Blue,0,61893,62009,116
2022-11-15,70040,70046,Blue,1,42085,42340,255
2022-06-11,70055,70053,Blue,0,56443,56489,46
2022-10-23,70038,70046,Blue,1,82487,82845,358
2022-03-17,70050,70052,Blue,1,35320,35436,116
2022-02-08,70049,70041,Blue,0,63132,63565,433
2022-09-20,70038,70050,Blue,1,31314,31901,587
2022-12-29,70052,70056,Blue,1,77739,77870,131
2022-12-21,70059,70039,Blue,0,27904,28910,1006
2022-01-03,70042,70056,Blue,1,52335,53091,756
2022-09-07,70045,70041,Blue,0,78208,78364,156
2022-09-10,70052,70060,Blue,1,69315,69680,365
2022-09-07,70051,70041,Blue,0,26373,27024,651
2022-07-02,70044,70046,Blue,1,43568,43698,130
2022-12-06,70054,70058,Blue,1,34893,35060,167
2022-01-20,70046,70060,Blue,1,27304,28111,807
2022-03-30,70059,70041,Blue,0,44952,45877,925
2022-07-27,70057,70041,Blue,0,35581,36502,921
2022-03-08,70048,70052,Blue,1,34421,34622,201
2022-04-30,70053,70047,Blue,0,63273,63546,273
2022-07-19,70038,70042,Blue,1,27839,27943,104
2022-08-15,70045,70838,Blue,0,63182,63530,348
2022-12-12,70059,70043,Blue,0,79021,79862,841
2022-05-21,70045,70039,Blue,0,33269,33554,285
2022-08-09,70057,70053,Blue,0,84357,84504,147
2022-01-11,70056,70060,Blue,1,59849,60293,444
2022-12-10,70038,70046,Blue,1,53419,53715,296
2022-11-24,70047,70045,Blue,0,30173,30278,105
2022-01-19,70053,70039,Blue,0,42987,43806,819
2022-07-28,70048,70052,Blue,1,52351,52579,228
2022-04-11,70048,70052,Blue,1,78096,78326,230
2022-03-06,70048,70056,Blue,1,66691,67091,400
2022-12-08,70055,70047,Blue,0,48552,48917,365
2022-01-19,70038,70048,Blue,1,86085,86596,511
2022-09-03,70048,70058,Blue,1,52407,52929,522
2022-07-21,70047,70043,Blue,0,52577,52850,273
2022-11-15,70055,70047,Blue,0,69869,70246,377
2022-03-29,70043,70838,Blue,0,62587,62824,237
2022-09-19,70044,70054,Blue,1,35140,35753,613
2022-08-14,70038,70040,Blue,1,89957,89971,14
2022-07-05,70049,70043,Blue,0,36268,36647,379
2022-12-22,70059,70039,Blue,0,30906,31910,1004
2022-08-13,70048,70056,Blue,1,69042,69453,411
2022-11-16,70040,70060,Blue,1,52399,53470,1071
2022-11-27,70044,70050,Blue,1,83395,83714,319
2022-10-19,70049,70838,Blue,0,73309,73935,626
2022-03-08,70059,70838,Blue,0,25755,26968,1213
2022-03-22,70052,70060,Blue,1,77023,77346,323
2022-05-18,70050,70052,Blue,1,25151,25277,126
2022-09-13,70056,70060,Blue,1,58761,58986,225
2022-08-15,70044,70056,Blue,1,81052,81729,677
2022-06-17,70039,70838,Blue,0,61070,61105,35
2022-02-07,70043,70838,Blue,0,22665,22972,307
2022-12-13,70051,70047,Blue,0,80381,80579,198
2022-03-11,70055,70047,Blue,0,44045,44470,425
2022-08-07,70053,70039,Blue,0,53038,53826,788
2022-04-02,70042,70052,Blue,1,32492,33085,593
2022-07-14,70050,70054,Blue,1,46034,46266,232
2022-02-26,70050,70052,Blue,1,62227,62339,112
2022-03-21,70055,70838,Blue,0,47307,48307,1000
2022-11-08,70050,70058,Blue,1,21766,22171,405
2022-03-21,70046,70048,Blue,1,65616,65688,72
2022-06-16,70042,70058,Blue,1,22014,23053,1039
2022-06-21,70059,70041,Blue,0,77228,78222,994
2022-09-14,70044,70050,Blue,1,46289,46603,314
2022-05-11,70052,70054,Blue,1,55909,55962,53
2022-09-19,70054,70060,Blue,1,51201,51454,253
2022-10-14,70051,70838,Blue,0,58788,59503,715
2022-09-22,70046,70060,Blue,1,79481,80253,772
2022-04-20,70050,70054,Blue,1,64095,64420,325
2022-06-15,70048,70052,Blue,1,32142,32368,226
2022-03-14,70048,70052,Blue,1,56748,56951,203
2022-04-10,70051,70041,Blue,0,65016,65604,588
2022-10-28,70051,70045,Blue,0,60894,61244,350
2022-11-09,70059,70039,Blue,0,71774,72744,970
2022-07-03,70038,70060,Blue,1,78553,79734,1181
2022-10-30,70059,70055,Blue,0,76513,76652,139
2022-02-23,70057,70047,Blue,0,47762,48271,509
2022-03-03,70056,70058,Blue,1,69982,70054,72
2022-09-25,70059,70049,Blue,0,75433,75914,481
2022-12-19,70057,70047,Blue,0,59977,60575,598
2022-08-24,70053,70039,Blue,0,37574,38529,955
2022-04-15,70058,70060,Blue,1,69725,69861,136
2022-11-24,70054,70058,Blue,1,55070,55225,155
2022-02-25,70038,70056,Blue,1,26670,27577,907
2022-11-11,70057,70053,Blue,0,47366,47517,151
2022-06-19,70038,70050,Blue,1,85517,86161,644
2022-04-14,70054,70056,Blue,1,52956,53002,46
2022-04-10,70046,70056,Blue,1,55724,56270,546
2022-11-20,70055,70051,Blue,0,81737,81868,131
2022-10-12,70056,70058,Blue,1,68481,68551,70
2022-12-27,70040,70042,Blue,1,31926,31957,31
2022-10-03,70040,70054,Blue,1,55537,56317,780
2022-08-12,70042,70046,Blue,1,55825,56061,236
2022-02-18,70049,70043,Blue,0,45454,45811,357
2022-02-25,70059,70051,Blue,0,21705,22142,437
2022-07-21,70059,70045,Blue,0,71674,72597,923
2022-01-11,70053,70039,Blue,0,20851,21565,714
2022-07-22,70041,70838,Blue,0,27766,27889,123
2022-08-05,70046,70054,Blue,1,89813,90228,415
2022-02-09,70053,70049,Blue,0,26988,27201,213
2022-08-26,70053,70049,Blue,0,32926,33131,205
2022-11-19,70047,70043,Blue,0,20320,20581,261
2022-10-17,70051,70041,Blue,0,63262,63820,558
2022-11-11,70046,70056,Blue,1,87105,87642,537
2022-12-23,70046,70048,Blue,1,53150,53231,81
2022-04-06,70057,70049,Blue,0,34240,34652,412
2022-03-17,70051,70045,Blue,0,19257,19642,385
2022-06-16,70053,70045,Blue,0,58460,58924,464
2022-11-12,70038,70060,Blue,1,68404,69537,1133
2022-10-13,70042,70048,Blue,1,53057,53348,291
2022-11-13,70044,70058,Blue,1,24739,25514,775
2022-06-21,70048,70056,Blue,1,42247,42779,532
2022-06-29,70059,70053,Blue,0,27247,27491,244
2022-01-10,70043,70039,Blue,0,72943,73054,111
2022-07-13,70038,70050,Blue,1,81404,82085,681
2022-07-26,70040,70060,Blue,1,31151,32264,1113
2022-07-15,70052,70056,Blue,1,74694,74854,160
2022-12-04,70046,70052,Blue,1,59886,60245,359
2022-01-24,70044,70060,Blue,1,84507,85448,941
2022-06-17,70057,70041,Blue,0,32742,33633,891
2022-11-30,70057,70838,Blue,0,57040,58123,1083
2022-11-21,70048,70058,Blue,1,50701,51289,588
2022-10-18,70043,70041,Blue,0,23243,23274,31
2022-10-23,70050,70052,Blue,1,84361,84502,141
2022-10-04,70055,70053,Blue,0,48071,48125,54
2022-06-09,70057,70838,Blue,0,50800,51881,1081
2022-04-11,70038,70048,Blue,1,62527,63155,628
2022-10-16,70047,70838,Blue,0,48493,49028,535
2022-04-20,70047,70838,Blue,0,51656,52272,616
2022-04-24,70046,70052,Blue,1,88541,88865,324
2022-02-14,70057,70051,Blue,0,56373,56654,281
2022-01-27,70059,70057,Blue,0,32657,32692,35
2022-07-09,70040,70052,Blue,1,51866,52554,688
2022-07-08,70038,70044,Blue,1,72194,72359,165
2022-07-15,70057,70049,Blue,0,26040,26478,438
2022-08-07,70044,70058,Blue,1,77803,78592,789
2022-05-19,70048,70058,Blue,1,28386,28940,554
2022-06-05,70043,70041,Blue,0,44190,44227,37
2022-04-17,70046,70056,Blue,1,40466,41472,1006
2022-11-18,70059,70838,Blue,0,61451,62731,1280
2022-01-10,70059,70049,Blue,0,47658,48184,526
2022-07-14,70057,70045,Blue,0,28036,28686,650
2022-03-10,70038,70060,Blue,1,46977,48241,1264
2022-08-08,70045,70039,Blue,0,64763,65024,261
2022-08-31,70046,70058,Blue,1,53741,54381,640
2022-01-19,70059,70051,Blue,0,58109,58430,321
2022-02-18,70040,70044,Blue,1,87800,87909,109
2022-04-21,70053,70041,Blue,0,80859,81496,637
2022-07-19,70057,70047,Blue,0,35456,35963,507
2022-04-09,70047,70838,Blue,0,48756,49275,519
2022-05-10,70056,70060,Blue,1,41265,41451,186
2022-10-11,70044,70046,Blue,1,71806,71912,106
2022-12-09,70053,70051,Blue,0,29608,29674,66
2022-09-24,70045,70041,Blue,0,54794,54974,180
2022-04-07,70054,70056,Blue,1,84044,84094,50
2022-04-09,70043,70041,Blue,0,45310,45339,29
2022-04-09,70057,70838,Blue,0,36330,37386,1056
2022-12-01,70057,70041,Blue,0,26741,27649,908
2022-12-12,70044,70052,Blue,1,47320,47802,482
2022-12-07,70049,70047,Blue,0,55594,55649,55
2022-04-06,70042,70058,Blue,1,87277,88145,868
2022-12-25,70051,70047,Blue,0,69303,69502,199
2022-07-03,70044,70058,Blue,1,58289,59188,899
2022-12-20,70059,70057,Blue,0,40342,40377,35
2022-08-18,70044,70054,Blue,1,70502,71188,686
2022-03-21,70038,70060,Blue,1,71966,73143,1177
2022-10-26,70041,70039,Blue,0,27849,27880,31
2022-11-19,70047,70041,Blue,0,49264,49588,324
2022-09-20,70042,70054,Blue,1,63986,64727,741
2022-04-09,70055,70047,Blue,0,42934,43306,372
2022-12-22,70046,70056,Blue,1,23535,24069,534
2022-03-30,70038,70054,Blue,1,56239,57081,842
2022-11-09,70042,70056,Blue,1,29561,30345,784
2022-02-11,70040,70044,Blue,1,42500,42609,109
2022-07-01,70053,70045,Blue,0,80228,80830,602
2022-01-23,70051,70047,Blue,0,36618,36814,196
2022-03-08,70038,70060,Blue,1,25157,26476,1319
2022-01-19,70048,70054,Blue,1,61288,61588,300
2022-11-17,70057,70049,Blue,0,20017,20419,402
2022-03-19,70042,70046,Blue,1,68701,68877,176
2022-02-06,70057,70055,Blue,0,33273,33342,69
2022-04-16,70059,70049,Blue,0,49222,49714,492
2022-08-19,70047,70045,Blue,0,77036,77134,98
2022-11-07,70041,70039,Blue,0,63808,63841,33
2022-01-27,70042,70044,Blue,1,49890,49917,27
2022-01-14,70059,70039,Blue,0,44968,45922,954
2022-12-10,70042,70060,Blue,1,21161,22184,1023
2022-06-28,70054,70058,Blue,1,31080,31249,169
2022-02-04,70045,70043,Blue,0,59187,59286,99
2022-06-22,70048,70058,Blue,1,56725,57229,504
2022-03-09,70040,70058,Blue,1,26419,27357,938
2022-05-03,70056,70060,Blue,1,41803,41975,172
2022-09-04,70045,70838,Blue,0,47559,47926,367
2022-12-30,70040,70048,Blue,1,63705,64181,476
2022-08-29,70042,70054,Blue,1,26380,27030,650
2022-01-01,70040,70050,Blue,1,47831,48315,484
2022-11-02,70051,70043,Blue,0,58071,58523,452
2022-03-24,70040,70042,Blue,1,26710,26742,32
2022-12-02,70052,70054,Blue,1,59930,59983,53
2022-12-04,70038,70048,Blue,1,34704,35122,418
2022-02-25,70052,70060,Blue,1,76564,76943,379
2022-02-06,70048,70058,Blue,1,45453,45923,470
2022-09-04,70038,70056,Blue,1,55326,56275,949
2022-05-03,70050,70058,Blue,1,72940,73344,404
2022-10-14,70059,70039,Blue,0,40120,41230,1110
2022-07-14,70057,70045,Blue,0,58298,58911,613
2022-10-19,70050,70058,Blue,1,33169,33545,376
2022-02-21,70041,70838,Blue,0,48679,48807,128
2022-12-19,70046,70058,Blue,1,45563,46271,708
2022-12-08,70050,70060,Blue,1,69677,70315,638
2022-08-20,70040,70054,Blue,1,36202,36955,753
2022-09-29,70057,70051,Blue,0,82733,82966,233
2022-07-12,70044,70052,Blue,1,49479,49995,516
2022-08-30,70042,70046,Blue,1,31313,31492,179
2022-01-17,70059,70041,Blue,0,55701,56708,1007
2022-06-08,70040,70046,Blue,1,81684,81975,291
2022-12-30,70050,70060,Blue,1,65478,66017,539
2022-02-15,70038,70056,Blue,1,42569,43598,1029
2022-03-17,70042,70054,Blue,1,40298,40950,652
2022-08-01,70055,70049,Blue,0,53960,54253,293
2022-06-20,70040,70054,Blue,1,45223,46029,806
2022-04-08,70057,70053,Blue,0,32736,32894,158
2022-04-04,70049,70045,Blue,0,31355,31536,181
2022-09-01,70043,70041,Blue,0,77330,77358,28
2022-08-28,70057,70053,Blue,0,82286,82434,148
2022-11-29,70057,70045,Blue,0,46895,47708,813
2022-06-10,70047,70039,Blue,0,26116,26564,448
2022-07-05,70053,70838,Blue,0,81633,82493,860
2022-07-16,70054,70058,Blue,1,80820,80986,166
2022-07-19,70055,70041,Blue,0,58512,59374,862
2022-10-23,70046,70052,Blue,1,60040,60385,345
2022-01-10,70048,70056,Blue,1,62555,62949,394
2022-07-02,70048,70058,Blue,1,48571,49087,516
2022-04-06,70055,70041,Blue,0,46274,47052,778
2022-08-19,70055,70041,Blue,0,60596,61399,803
2022-01-14,70046,70058,Blue,1,79029,79670,641
2022-08-01,70042,70046,Blue,1,39451,39626,175
2022-06-17,70046,70056,Blue,1,32134,32922,788
2022-08-19,70059,70039,Blue,0,54899,55940,1041
2022-12-23,70057,70039,Blue,0,55806,56878,1072
2022-01-20,70044,70054,Blue,1,32534,33121,587
2022-08-14,70059,70838,Blue,0,25406,26499,1093
2022-02-14,70057,70043,Blue,0,30938,31739,801
2022-03-25,70042,70056,Blue,1,24788,25525,737
2022-01-25,70046,70048,Blue,1,29448,29554,106
2022-11-02,70045,70043,Blue,0,78413,78507,94
2022-10-06,70057,70045,Blue,0,56265,56888,623
2022-07-18,70044,70060,Blue,1,55750,56708,958
2022-12-09,70044,70052,Blue,1,75420,75921,501
2022-03-01,70058,70060,Blue,1,66171,66239,68
2022-09-25,70057,70047,Blue,0,55000,55563,563
2022-03-11,70059,70838,Blue,0,41536,42628,1092
2022-09-21,70044,70060,Blue,1,23624,24514,890
2022-07-31,70059,70049,Blue,0,73806,74253,447
2022-05-02,70050,70056,Blue,1,70048,70337,289
2022-11-21,70038,70052,Blue,1,53954,54692,738
2022-04-03,70055,70039,Blue,0,27189,28070,881
2022-02-01,70057,70055,Blue,0,56727,56802,75
2022-02-18,70056,70060,Blue,1,52810,53003,193
2022-08-12,70059,70049,Blue,0,82540,83020,480
2022-05-22,70044,70048,Blue,1,82878,83163,285
2022-01-31,70050,70056,Blue,1,62500,62994,494
2022-09-26,70051,70043,Blue,0,86426,86894,468
2022-03-21,70038,70044,Blue,1,38027,38211,184
2022-12-27,70059,70043,Blue,0,42919,43811,892
2022-04-12,70051,70043,Blue,0,21369,21907,538
2022-12-16,70054,70060,Blue,1,62760,63011,251
2022-09-09,70059,70047,Blue,0,67361,68288,927
2022-10-27,70049,70045,Blue,0,58265,58483,218
2022-12-01,70059,70047,Blue,0,60009,60629,620
2022-01-16,70045,70838,Blue,0,67037,67366,329
2022-01-19,70057,70047,Blue,0,33233,33768,535
2022-06-21,70057,70051,Blue,0,23532,23795,263
2022-12-14,70040,70046,Blue,1,30821,31095,274
2022-05-24,70038,70040,Blue,1,34983,34998,15
2022-04-10,70049,70039,Blue,0,72696,73190,494
2022-12-26,70047,70043,Blue,0,22919,23167,248
2022-01-24,70055,70838,Blue,0,56761,57704,943
2022-12-29,70050,70060,Blue,1,83246,83772,526
2022-10-08,70038,70048,Blue,1,66372,66840,468
2022-10-01,70040,70054,Blue,1,60639,61423,784
2022-04-11,70048,70058,Blue,1,45974,46484,510
2022-02-11,70059,70838,Blue,0,26072,27264,1192
2022-02-18,70046,70054,Blue,1,60853,61296,443
2022-06-13,70040,70058,Blue,1,20514,21522,1008
2022-09-18,70053,70039,Blue,0,75162,75910,748
2022-06-02,70049,70045,Blue,0,67363,67564,201
2022-06-24,70044,70050,Blue,1,45571,45987,416
2022-09-01,70051,70039,Blue,0,49222,49878,656
2022-04-15,70059,70047,Blue,0,32067,32756,689
2022-08-16,70044,70048,Blue,1,63795,64056,261
2022-08-27,70051,70039,Blue,0,40414,41067,653
2022-05-24,70047,70043,Blue,0,68895,69191,296
2022-11-12,70053,70039,Blue,0,57643,58373,730
2022-10-13,70041,70838,Blue,0,32435,32576,141
2022-02-28,70046,70054,Blue,1,68971,69383,412
2022-01-20,70053,70041,Blue,0,68168,68934,766
2022-09-30,70043,70039,Blue,0,50881,50993,112
2022-08-26,70045,70043,Blue,0,48610,48699,89
2022-05-11,70051,70047,Blue,0,31360,31554,194
2022-03-29,70059,70049,Blue,0,67519,67944,425
2022-03-02,70042,70048,Blue,1,25638,25968,330
2022-07-13,70042,70046,Blue,1,34409,34622,213
2022-08-29,70055,70049,Blue,0,30737,31122,385
2022-07-15,70049,70039,Blue,0,24383,24928,545
2022-07-29,70040,70060,Blue,1,51224,52472,1248
2022-06-28,70039,70838,Blue,0,46593,46624,31
2022-10-29,70038,70048,Blue,1,60435,60965,530
2022-04-10,70042,70046,Blue,1,65762,65943,181
2022-11-08,70053,70045,Blue,0,39226,39718,492
2022-07-11,70044,70056,Blue,1,65222,65949,727
2022-11-30,70051,70043,Blue,0,31686,32201,515
2022-03-09,70055,70047,Blue,0,42866,43298,432
2022-10-31,70047,70039,Blue,0,24893,25431,538
2022-06-24,70059,70053,Blue,0,31399,32701,1302
2022-03-21,70054,70058,Blue,1,43758,43910,152
2022-04-04,70043,70041,Blue,0,59696,59729,33
2022-03-21,70041,70838,Blue,0,53751,53942,191
2022-08-15,70049,70838,Blue,0,86040,86659,619
2022-11-17,70044,70054,Blue,1,72970,73545,575
2022-12-07,70044,70050,Blue,1,63225,63571,346
2022-06-22,70053,70043,Blue,0,32109,32733,624
2022-09-19,70053,70039,Blue,0,30076,30970,894
2022-11-10,70059,70047,Blue,0,79417,79983,566
2022-02-22,70055,70049,Blue,0,30150,30480,330
2022-12-18,70056,70058,Blue,1,62293,62363,70
2022-12-20,70040,70048,Blue,1,41365,41780,415
2022-12-19,70053,70041,Blue,0,63648,64337,689
2022-09-16,70051,70039,Blue,0,49754,50424,670
2022-02-04,70040,70042,Blue,1,53421,53455,34
2022-07-07,70040,70046,Blue,1,50630,50907,277
2022-06-09,70057,70043,Blue,0,30344,31172,828
2022-08-03,70038,70044,Blue,1,53903,54081,178
2022-08-03,70057,70039,Blue,0,32325,33375,1050
2022-07-06,70053,70049,Blue,0,28361,28578,217
2022-04-19,70051,70043,Blue,0,55438,55932,494
2022-12-31,70057,70051,Blue,0,25539,25810,271
2022-11-21,70055,70039,Blue,0,88314,89488,1174
2022-07-22,70044,70050,Blue,1,79276,79657,381
2022-01-27,70046,70056,Blue,1,47298,47891,593
2022-08-30,70054,70060,Blue,1,52661,52913,252
2022-01-15,70053,70043,Blue,0,66657,68015,1358
2022-11-06,70048,70054,Blue,1,54189,54480,291
2022-02-23,70048,70060,Blue,1,82628,83298,670
2022-09-16,70059,70051,Blue,0,25937,26270,333
2022-11-18,70059,70047,Blue,0,35777,36374,597
2022-02-07,70040,70060,Blue,1,52269,53992,1723
2022-10-14,70046,70050,Blue,1,85316,85516,200
2022-04-10,70041,70838,Blue,0,62422,62561,139
2022-12-16,70057,70039,Blue,0,41677,42677,1000
2022-01-26,70041,70838,Blue,0,69432,69547,115
2022-01-24,70058,70060,Blue,1,31025,31121,96
2022-03-02,70053,70047,Blue,0,72896,73197,301
2022-12-29,70042,70046,Blue,1,83316,83496,180
2022-02-11,70055,70051,Blue,0,46805,46944,139
2022-11-30,70041,70039,Blue,0,22660,22696,36
2022-08-16,70057,70043,Blue,0,26011,26833,822
2022-03-07,70043,70041,Blue,0,57820,57848,28
2022-11-01,70038,70044,Blue,1,56000,56157,157
2022-01-19,70055,70043,Blue,0,87655,88284,629
2022-03-20,70051,70041,Blue,0,25722,26267,545
2022-08-31,70051,70043,Blue,0,22011,22537,526
2022-01-07,70048,70058,Blue,1,33707,34230,523
2022-12-14,70055,70045,Blue,0,26979,27551,572
2022-10-05,70046,70054,Blue,1,25989,26431,442
2022-01-06,70042,70060,Blue,1,26489,27460,971
2022-06-09,70053,70039,Blue,0,69759,70530,771
2022-01-05,70051,70047,Blue,0,62132,62340,208
2022-09-21,70050,70052,Blue,1,52356,52473,117
2022-04-16,70045,70043,Blue,0,56502,56596,94
2022-10-31,70038,70044,Blue,1,56035,56263,228
2022-06-20,70055,70039,Blue,0,71485,72292,807
2022-01-02,70052,70058,Blue,1,38463,38718,255
2022-04-12,70058,70060,Blue,1,34974,35046,72
2022-07-03,70038,70044,Blue,1,82988,83175,187
2022-06-14,70038,70052,Blue,1,65835,66583,748
2022-11-06,70053,70051,Blue,0,73731,73781,50
2022-09-16,70044,70046,Blue,1,37533,37640,107
2022-03-25,70055,70049,Blue,0,24741,25057,316
2022-02-06,70051,70047,Blue,0,63386,63580,194
2022-07-26,70045,70838,Blue,0,69949,70268,319
2022-09-14,70038,70040,Blue,1,47193,47207,14
2022-04-10,70040,70054,Blue,1,73750,74511,761
2022-02-11,70040,70046,Blue,1,19892,20151,259
2022-03-04,70046,70050,Blue,1,27957,28150,193
2022-02-15,70057,70039,Blue,0,51269,52422,1153
2022-03-30,70057,70039,Blue,0,28541,29523,982
2022-03-24,70057,70043,Blue,0,83549,84260,711
2022-03-12,70045,70039,Blue,0,49417,49669,252
2022-04-08,70049,70838,Blue,0,28704,29315,611
2022-04-12,70044,70048,Blue,1,89357,89576,219
2022-10-18,70044,70046,Blue,1,21613,21723,110
2022-06-24,70043,70041,Blue,0,41457,41489,32
2022-11-25,70053,70039,Blue,0,86974,87679,705
2022-12-19,70057,70045,Blue,0,54613,55314,701
2022-12-06,70047,70838,Blue,0,75954,76389,435
2022-10-15,70055,70838,Blue,0,60191,61139,948
2022-03-10,70038,70044,Blue,1,46977,47189,212
2022-04-03,70055,70053,Blue,0,47537,47586,49
2022-02-16,70053,70045,Blue,0,72246,72649,403
2022-03-31,70057,70053,Blue,0,82406,82558,152
2022-02-09,70048,70054,Blue,1,76012,76334,322
2022-02-15,70057,70055,Blue,0,82946,83016,70
2022-02-10,70055,70838,Blue,0,83661,84677,1016
2022-12-23,70046,70052,Blue,1,37261,37657,396
2022-11-17,70048,70052,Blue,1,21693,21911,218
2022-02-11,70038,70052,Blue,1,19815,20585,770
2022-09-12,70046,70060,Blue,1,24859,25641,782
2022-02-11,70051,70039,Blue,0,48042,48775,733
2022-10-25,70038,70052,Blue,1,72074,72751,677
2022-10-15,70040,70052,Blue,1,48612,49257,645
2022-09-26,70038,70058,Blue,1,45175,46192,1017
2022-08-01,70045,70041,Blue,0,60046,60221,175
2022-11-29,70040,70046,Blue,1,30308,30557,249
2022-10-18,70038,70040,Blue,1,86525,86538,13
2022-03-23,70040,70058,Blue,1,52416,53383,967
2022-04-16,70049,70039,Blue,0,42271,42851,580
2022-06-25,70038,70052,Blue,1,46942,47838,896
2022-03-29,70046,70058,Blue,1,69301,69932,631
2022-09-21,70046,70048,Blue,1,87711,87779,68
2022-03-11,70043,70041,Blue,0,24298,24327,29
2022-04-07,70059,70045,Blue,0,35842,36553,711
2022-12-05,70038,70052,Blue,1,72619,73329,710
2022-02-22,70048,70052,Blue,1,34998,35344,346
2022-03-14,70042,70048,Blue,1,48206,48488,282
2022-03-07,70045,70838,Blue,0,24508,24871,363
2022-01-18,70045,70041,Blue,0,35185,35391,206
2022-03-21,70048,70050,Blue,1,62855,62914,59
2022-02-11,70057,70049,Blue,0,69161,69560,399
2022-09-25,70042,70048,Blue,1,65253,65567,314
2022-08-20,70057,70043,Blue,0,85061,86321,1260
2022-07-03,70049,70047,Blue,0,63514,63572,58
2022-12-23,70059,70047,Blue,0,56493,57186,693
2022-07-02,70046,70060,Blue,1,35965,36643,678
2022-12-17,70040,70060,Blue,1,57851,58953,1102
2022-08-23,70054,70060,Blue,1,34572,34899,327
2022-12-12,70042,70046,Blue,1,81729,81907,178
2022-02-17,70039,70838,Blue,0,87950,87984,34
2022-08-14,70049,70047,Blue,0,54369,54424,55
2022-04-11,70059,70047,Blue,0,64699,65265,566
2022-11-21,70049,70045,Blue,0,40010,40216,206
2022-07-04,70057,70047,Blue,0,82954,83400,446
2022-10-10,70053,70041,Blue,0,60275,60935,660
2022-02-16,70043,70039,Blue,0,31752,31861,109
2022-09-21,70057,70053,Blue,0,57289,57443,154
2022-02-28,70059,70047,Blue,0,36380,37073,693
2022-01-22,70040,70052,Blue,1,69062,69705,643
2022-01-11,70057,70838,Blue,0,52166,53419,1253
2022-02-22,70051,70045,Blue,0,87835,88150,315
2022-09-05,70038,70040,Blue,1,80563,80577,14
2022-09-25,70040,70054,Blue,1,70513,71193,680
2022-04-24,70055,70045,Blue,0,77228,77737,509
2022-01-23,70038,70056,Blue,1,27767,28634,867
2022-01-24,70057,70053,Blue,0,23434,23635,201
2022-12-22,70046,70054,Blue,1,75333,75782,449
2022-02-28,70043,70039,Blue,0,23388,23501,113
2022-10-27,70044,70052,Blue,1,63050,63539,489
2022-05-23,70048,70052,Blue,1,27300,27593,293
2022-03-11,70050,70056,Blue,1,70542,70833,291
2022-11-06,70051,70045,Blue,0,28897,29226,329
2022-09-14,70057,70051,Blue,0,85080,85319,239
2022-03-30,70046,70048,Blue,1,65114,65211,97
2022-11-14,70053,70838,Blue,0,41884,42819,935
2022-06-27,70042,70050,Blue,1,79876,80377,501
2022-08-18,70049,70039,Blue,0,74472,74956,484
2022-12-15,70038,70040,Blue,1,76017,76038,21
2022-06-29,70046,70052,Blue,1,36803,37173,370
2022-12-10,70053,70041,Blue,0,40861,41512,651
2022-10-03,70044,70052,Blue,1,41073,41532,459
2022-02-07,70059,70041,Blue,0,55508,56578,1070
2022-05-16,70049,70047,Blue,0,76929,76975,46
2022-02-12,70038,70054,Blue,1,51884,52739,855
2022-01-10,70052,70056,Blue,1,84514,84650,136
2022-12-28,70053,70045,Blue,0,23963,24383,420
2022-11-07,70053,70049,Blue,0,58385,58601,216
2022-05-04,70054,70060,Blue,1,63779,64046,267
2022-03-24,70051,70043,Blue,0,51527,52018,491
2022-03-19,70042,70054,Blue,1,55739,56428,689
2022-09-08,70042,70050,Blue,1,38578,39002,424
2022-01-13,70040,70056,Blue,1,25250,26155,905
2022-08-14,70059,70041,Blue,0,30851,31798,947
2022-12-16,70049,70041,Blue,0,75415,75831,416
2022-03-01,70048,70054,Blue,1,29556,29866,310
2022-10-08,70045,70041,Blue,0,84791,84970,179
2022-03-17,70059,70039,Blue,0,31163,32186,1023
2022-06-16,70047,70041,Blue,0,56596,56931,335
2022-03-31,70059,70053,Blue,0,75497,75725,228
2022-06-27,70040,70052,Blue,1,56275,56970,695
2022-01-17,70047,70045,Blue,0,27732,27832,100
2022-08-09,70052,70056,Blue,1,55355,55523,168
2022-11-24,70050,70054,Blue,1,39909,40107,198
2022-09-19,70051,70838,Blue,0,59633,60347,714
2022-01-04,70055,70041,Blue,0,40800,41577,777
2022-09-12,70038,70058,Blue,1,39854,40875,1021
2022-10-19,70049,70039,Blue,0,73309,73850,541
2022-09-13,70038,70052,Blue,1,48246,48979,733
2022-09-05,70055,70838,Blue,0,68582,69507,925
2022-11-20,70055,70039,Blue,0,44238,45123,885
2022-10-01,70038,70056,Blue,1,23655,24513,858
2022-03-26,70054,70058,Blue,1,66842,66999,157
2022-06-09,70038,70044,Blue,1,23652,23811,159
2022-07-11,70050,70054,Blue,1,33833,34096,263
2022-07-28,70040,70060,Blue,1,70264,71302,1038
2022-08-19,70057,70045,Blue,0,39855,40513,658
2022-12-30,70056,70060,Blue,1,31643,31816,173
2022-12-04,70055,70047,Blue,0,70223,70595,372
2022-09-21,70048,70058,Blue,1,49884,50399,515
2022-02-07,70059,70049,Blue,0,32968,33519,551
2022-08-19,70057,70041,Blue,0,29801,30724,923
2022-11-26,70050,70052,Blue,1,36171,36285,114
2022-09-06,70049,70838,Blue,0,55189,55784,595
2022-07-29,70043,70039,Blue,0,67907,68013,106
2022-06-17,70047,70043,Blue,0,55440,55727,287
2022-11-22,70057,70041,Blue,0,35318,36236,918
2022-04-08,70040,70046,Blue,1,24640,24889,249
2022-02-01,70044,70048,Blue,1,39934,40181,247
2022-03-24,70055,70045,Blue,0,75075,75603,528
2022-12-13,70052,70056,Blue,1,49172,49343,171
2022-11-30,70059,70047,Blue,0,49394,49949,555
2022-04-08,70053,70047,Blue,0,64948,65248,300
2022-04-12,70057,70055,Blue,0,77840,77908,68
2022-04-11,70038,70056,Blue,1,23952,24875,923
2022-02-14,70057,70049,Blue,0,58774,59160,386
2022-05-20,70057,70838,Blue,0,34247,35458,1211
2022-07-27,70059,70057,Blue,0,53539,53574,35
2022-09-15,70055,70047,Blue,0,73726,74281,555
2022-10-19,70040,70058,Blue,1,87429,88287,858
2022-08-01,70053,70039,Blue,0,54047,54801,754
2022-06-21,70057,70049,Blue,0,87428,87795,367
2022-02-27,70059,70051,Blue,0,63015,63349,334
2022-07-02,70045,70039,Blue,0,68922,69194,272
2022-12-29,70049,70838,Blue,0,32053,32656,603
2022-11-20,70052,70054,Blue,1,29950,30000,50
2022-12-26,70056,70058,Blue,1,71952,72026,74
2022-02-17,70059,70039,Blue,0,60193,61248,1055
2022-12-13,70055,70838,Blue,0,24040,24975,935
2022-04-19,70049,70047,Blue,0,60115,60170,55
2022-11-19,70043,70041,Blue,0,67381,67409,28
2022-04-14,70048,70052,Blue,1,28162,28372,210
2022-08-11,70042,70056,Blue,1,81393,82151,758
2022-09-17,70047,70838,Blue,0,62890,63398,508
2022-06-13,70050,70056,Blue,1,33427,33757,330
2022-08-10,70047,70838,Blue,0,77500,77951,451
2022-05-18,70043,70039,Blue,0,60603,60710,107
2022-09-29,70047,70039,Blue,0,70384,70845,461
2022-03-12,70054,70058,Blue,1,26617,26784,167
2022-07-08,70038,70056,Blue,1,20021,20946,925
2022-12-09,70042,70058,Blue,1,49414,50310,896
2022-01-19,70045,70043,Blue,0,85918,86027,109
2022-04-14,70055,70051,Blue,0,41162,41301,139
2022-06-10,70040,70052,Blue,1,86644,87399,755
2022-02-11,70057,70049,Blue,0,78976,79384,408
2022-10-27,70059,70057,Blue,0,72324,72358,34
2022-03-02,70041,70039,Blue,0,58836,58871,35
2022-10-06,70053,70049,Blue,0,41554,41773,219
2022-01-31,70038,70046,Blue,1,51722,52057,335
2022-06-24,70049,70838,Blue,0,27782,28526,744
2022-02-26,70038,70044,Blue,1,76119,76306,187
2022-07-28,70044,70058,Blue,1,21099,21872,773
2022-03-01,70047,70043,Blue,0,19854,20141,287
2022-03-16,70047,70041,Blue,0,70053,70365,312
2022-11-17,70046,70052,Blue,1,48031,48366,335
2022-03-30,70047,70838,Blue,0,29954,30460,506
2022-09-13,70040,70042,Blue,1,31785,31818,33
2022-07-12,70055,70039,Blue,0,58462,59332,870
2022-02-08,70051,70049,Blue,0,29776,29883,107
2022-03-04,70045,70039,Blue,0,68266,68500,234
2022-11-05,70038,70050,Blue,1,81379,82008,629
2022-10-08,70047,70838,Blue,0,29269,29740,471
2022-01-26,70051,70039,Blue,0,59510,60247,737
2022-04-06,70042,70052,Blue,1,54250,54845,595
2022-03-24,70043,70838,Blue,0,56829,57051,222
2022-11-30,70051,70047,Blue,0,57315,57518,203
2022-12-06,70052,70060,Blue,1,73954,74313,359
2022-10-18,70042,70044,Blue,1,42408,42437,29
2022-03-13,70054,70056,Blue,1,33270,33319,49
2022-03-17,70053,70051,Blue,0,82013,82077,64
2022-09-25,70040,70044,Blue,1,55970,56092,122
2022-12-30,70047,70043,Blue,0,31488,31721,233
2022-04-09,70049,70041,Blue,0,34584,34996,412
2022-08-15,70051,70039,Blue,0,37336,38067,731
2022-03-17,70042,70050,Blue,1,35807,36277,470
2022-12-13,70048,70056,Blue,1,42306,42746,440
2022-04-09,70051,70045,Blue,0,33372,33723,351
2022-06-02,70042,70050,Blue,1,20155,20628,473
2022-01-11,70054,70060,Blue,1,67303,67838,535
2022-07-13,70048,70052,Blue,1,28111,28334,223
2022-09-25,70059,70043,Blue,0,74394,75255,861
2022-02-08,70038,70050,Blue,1,26954,27527,573
2022-07-17,70054,70056,Blue,1,52187,52234,47
2022-03-10,70057,70049,Blue,0,32139,32633,494
2022-06-04,70044,70048,Blue,1,22672,22991,319
2022-03-10,70055,70838,Blue,0,22951,24136,1185
2022-06-14,70038,70060,Blue,1,27248,28411,1163
2022-02-09,70056,70058,Blue,1,87493,87566,73
2022-11-16,70056,70060,Blue,1,42403,42581,178
2022-01-14,70044,70058,Blue,1,71697,72539,842
2022-04-05,70055,70049,Blue,0,45685,45975,290
2022-03-18,70059,70053,Blue,0,27181,27403,222
2022-07-08,70059,70043,Blue,0,82975,83810,835
2022-06-04,70042,70050,Blue,1,40053,40576,523
2022-08-08,70044,70046,Blue,1,38027,38133,106
2022-09-30,70049,70047,Blue,0,84907,84967,60
2022-02-17,70051,70041,Blue,0,59447,60055,608
2022-10-06,70042,70060,Blue,1,61305,62267,962
2022-09-18,70040,70044,Blue,1,38406,38502,96
2022-01-27,70038,70060,Blue,1,57434,58681,1247
2022-08-18,70038,70060,Blue,1,27420,28579,1159
2022-05-18,70040,70046,Blue,1,30034,30369,335
2022-02-13,70049,70041,Blue,0,62415,62878,463
2022-01-23,70047,70043,Blue,0,44726,44976,250
2022-01-04,70038,70044,Blue,1,81652,81844,192
2022-12-24,70044,70046,Blue,1,91364,91467,103
2022-06-29,70048,70052,Blue,1,63706,63955,249
2022-06-04,70045,70041,Blue,0,30037,30252,215
2022-12-23,70053,70838,Blue,0,83590,84457,867
2022-12-06,70040,70046,Blue,1,61588,61865,277
2022-05-24,70043,70039,Blue,0,82365,82490,125
2022-09-01,70043,70039,Blue,0,25343,25445,102
2022-06-21,70053,70039,Blue,0,42142,42973,831
2022-02-16,70047,70041,Blue,0,80738,81135,397
2022-06-05,70045,70043,Blue,0,66027,66140,113
2022-04-04,70051,70039,Blue,0,33310,33949,639
2022-08-11,70038,70056,Blue,1,46702,47658,956
2022-05-24,70045,70838,Blue,0,35202,35634,432
2022-10-11,70043,70041,Blue,0,68436,68464,28
2022-04-01,70040,70042,Blue,1,25106,25141,35
2022-01-02,70057,70041,Blue,0,79013,79918,905
2022-02-01,70055,70049,Blue,0,22215,22592,377
2022-07-15,70055,70053,Blue,0,86719,86765,46
2022-04-04,70059,70051,Blue,0,72636,72939,303
2022-10-08,70042,70044,Blue,1,56253,56280,27
2022-07-26,70053,70838,Blue,0,49170,50094,924
2022-01-25,70059,70055,Blue,0,36358,36506,148
2022-02-06,70050,70058,Blue,1,74283,74687,404
2022-01-03,70045,70838,Blue,0,53545,53907,362
2022-02-28,70053,70043,Blue,0,29709,30347,638
2022-08-08,70057,70055,Blue,0,61227,61328,101
2022-01-09,70047,70045,Blue,0,73346,73443,97
2022-06-07,70045,70039,Blue,0,45404,45732,328
2022-11-04,70059,70041,Blue,0,75686,76622,936
2022-10-13,70049,70047,Blue,0,67617,67672,55
2022-09-09,70047,70043,Blue,0,83698,83997,299
2022-08-06,70045,70043,Blue,0,61337,61431,94
2022-02-23,70055,70047,Blue,0,67352,67750,398
2022-09-21,70055,70047,Blue,0,82082,82421,339
2022-08-10,70048,70054,Blue,1,57362,57751,389
2022-03-21,70040,70058,Blue,1,27921,28936,1015
2022-06-12,70057,70055,Blue,0,72913,72983,70
2022-10-05,70043,70039,Blue,0,45060,45183,123
2022-09-30,70040,70044,Blue,1,64435,64599,164
2022-03-07,70042,70048,Blue,1,83849,84139,290
2022-04-01,70046,70058,Blue,1,68062,68880,818
2022-02-09,70046,70048,Blue,1,61167,61247,80
2022-08-16,70048,70056,Blue,1,33483,33918,435
2022-02-19,70051,70045,Blue,0,67973,68320,347
2022-05-20,70057,70039,Blue,0,61173,62223,1050
2022-10-25,70055,70041,Blue,0,53733,54492,759
2022-09-09,70044,70050,Blue,1,28166,28547,381
2022-09-25,70038,70056,Blue,1,67211,68099,888
2022-06-30,70057,70047,Blue,0,62045,62530,485
2022-09-23,70043,70838,Blue,0,52449,52736,287
2022-06-06,70049,70045,Blue,0,80678,80879,201
2022-05-24,70038,70040,Blue,1,81612,81627,15
2022-07-09,70052,70054,Blue,1,64468,64521,53
2022-12-18,70042,70058,Blue,1,46849,47717,868
2022-05-27,70045,70043,Blue,0,77501,77638,137
2022-02-07,70059,70045,Blue,0,28759,29496,737
2022-08-28,70044,70050,Blue,1,83981,84349,368
2022-05-18,70038,70052,Blue,1,41458,42254,796
2022-01-01,70049,70045,Blue,0,25161,25352,191
2022-01-27,70044,70060,Blue,1,27875,28926,1051
2022-12-25,70044,70056,Blue,1,82543,83223,680
2022-10-29,70040,70046,Blue,1,78015,78276,261
2022-09-07,70042,70054,Blue,1,49911,50554,643
2022-03-14,70051,70047,Blue,0,33299,33490,191
2022-08-16,70049,70043,Blue,0,33652,34045,393
2022-06-23,70049,70045,Blue,0,61129,61335,206
2022-09-23,70040,70052,Blue,1,32860,33503,643
2022-04-07,70051,70039,Blue,0,75827,76406,579
2022-10-30,70042,70044,Blue,1,34063,34093,30
2022-09-28,70046,70060,Blue,1,42397,43123,726
2022-02-26,70055,70039,Blue,0,27819,28667,848
2022-11-21,70050,70052,Blue,1,31221,31338,117
2022-03-01,70040,70042,Blue,1,71004,71033,29
2022-03-08,70057,70053,Blue,0,49850,50036,186
2022-10-05,70038,70060,Blue,1,26258,27448,1190
2022-03-22,70052,70054,Blue,1,45072,45133,61
2022-11-28,70059,70051,Blue,0,63439,63754,315
2022-10-02,70048,70056,Blue,1,70436,70890,454
2022-07-24,70040,70054,Blue,1,27055,27812,757
2022-10-21,70057,70039,Blue,0,62497,63462,965
2022-12-02,70040,70048,Blue,1,67437,67789,352
2022-02-11,70053,70045,Blue,0,84337,84738,401
2022-11-12,70044,70052,Blue,1,24555,25069,514
2022-04-13,70051,70045,Blue,0,61145,61466,321
2022-09-22,70059,70838,Blue,0,40587,41743,1156
2022-10-17,70057,70055,Blue,0,51662,51731,69
2022-02-07,70057,70041,Blue,0,20669,21548,879
2022-10-27,70053,70043,Blue,0,29427,30083,656
2022-12-22,70041,70838,Blue,0,31253,31395,142
2022-10-13,70042,70044,Blue,1,42679,42719,40
2022-06-03,70049,70838,Blue,0,87960,88631,671
2022-07-25,70059,70057,Blue,0,68986,69020,34
2022-07-08,70054,70056,Blue,1,33742,33789,47
2022-02-08,70039,70838,Blue,0,33863,33949,86
2022-11-17,70051,70049,Blue,0,34220,34322,102
2022-01-07,70052,70058,Blue,1,30418,30702,284
2022-02-17,70057,70049,Blue,0,83557,83955,398
2022-03-21,70059,70055,Blue,0,56590,56733,143
2022-11-29,70059,70049,Blue,0,61874,62336,462
2022-01-06,70059,70047,Blue,0,86895,87533,638
2022-07-12,70054,70060,Blue,1,25983,26289,306
2022-09-24,70040,70044,Blue,1,48610,48719,109
2022-02-15,70053,70045,Blue,0,83168,83619,451
2022-05-28,70047,70039,Blue,0,19056,19544,488
2022-03-17,70043,70039,Blue,0,41926,42033,107
2022-10-30,70057,70047,Blue,0,69575,70061,486
2022-07-28,70051,70838,Blue,0,80845,81583,738
2022-04-16,70045,70041,Blue,0,81320,81478,158
2022-06-17,70046,70058,Blue,1,83601,84259,658
2022-11-14,70057,70051,Blue,0,63037,63289,252
2022-09-23,70057,70053,Blue,0,74979,75128,149
2022-06-22,70050,70060,Blue,1,37938,38505,567
2022-03-06,70051,70838,Blue,0,61792,62549,757
2022-01-26,70053,70043,Blue,0,84276,84825,549
2022-08-18,70055,70047,Blue,0,64844,65220,376
2022-09-09,70050,70060,Blue,1,59226,59776,550
2022-12-13,70059,70039,Blue,0,58307,59302,995
2022-07-20,70051,70047,Blue,0,55732,55932,200
2022-02-25,70053,70049,Blue,0,47391,47599,208
2022-07-29,70047,70043,Blue,0,42768,43084,316
2022-04-01,70053,70041,Blue,0,83724,84312,588
2022-11-12,70040,70058,Blue,1,27646,28615,969
2022-04-08,70040,70048,Blue,1,48733,49152,419
2022-11-13,70059,70047,Blue,0,45205,45760,555
2022-12-07,70055,70049,Blue,0,71966,72261,295
2022-07-12,70044,70060,Blue,1,36072,37171,1099
2022-06-08,70049,70039,Blue,0,84798,85351,553
2022-08-01,70040,70042,Blue,1,74273,74305,32
2022-06-11,70048,70052,Blue,1,62626,62840,214
2022-08-11,70059,70838,Blue,0,68653,69677,1024
2022-11-05,70048,70056,Blue,1,67364,67758,394
2022-12-20,70048,70054,Blue,1,68610,68920,310
2022-09-26,70040,70044,Blue,1,54601,54720,119
2022-04-08,70040,70056,Blue,1,53774,54569,795
2022-06-13,70054,70056,Blue,1,72873,72919,46
2022-09-01,70055,70047,Blue,0,49648,50079,431
2022-06-12,70038,70052,Blue,1,58573,59366,793
2022-10-16,70038,70052,Blue,1,68296,69024,728
2022-06-17,70058,70060,Blue,1,87763,87835,72
2022-12-07,70046,70052,Blue,1,53761,54100,339
2022-04-08,70042,70058,Blue,1,72104,72924,820
2022-07-15,70054,70056,Blue,1,62328,62374,46
2022-03-06,70059,70051,Blue,0,64094,64440,346
2022-09-22,70050,70056,Blue,1,28067,28385,318
2022-03-21,70059,70045,Blue,0,55696,56372,676
2022-03-10,70051,70045,Blue,0,22876,23377,501
2022-04-03,70042,70054,Blue,1,50076,50695,619
2022-11-20,70059,70045,Blue,0,33134,33844,710
2022-06-12,70048,70050,Blue,1,79645,79704,59
2022-07-14,70055,70041,Blue,0,57392,58123,731
2022-07-10,70053,70041,Blue,0,25651,26292,641
2022-10-06,70045,70838,Blue,0,23386,23759,373
2022-12-18,70044,70056,Blue,1,65813,66547,734
2022-08-14,70056,70060,Blue,1,50382,50559,177
2022-01-27,70038,70050,Blue,1,49214,49831,617
2022-07-07,70056,70060,Blue,1,69084,69258,174
2022-12-06,70046,70056,Blue,1,24473,25152,679
2022-03-30,70049,70043,Blue,0,22527,22901,374
2022-04-18,70059,70055,Blue,0,53895,54037,142
2022-04-14,70048,70050,Blue,1,87609,87667,58
2022-03-15,70049,70039,Blue,0,35245,36072,827
2022-12-29,70051,70047,Blue,0,26591,26785,194
2022-11-02,70053,70051,Blue,0,85225,85275,50
2022-11-29,70044,70054,Blue,1,82193,82795,602
2022-11-28,70041,70838,Blue,0,80210,80320,110
2022-07-12,70057,70051,Blue,0,19606,19880,274
2022-07-05,70040,70058,Blue,1,63861,64790,929
2022-01-20,70040,70042,Blue,1,78686,78723,37
2022-04-16,70059,70049,Blue,0,88226,88817,591
2022-01-21,70053,70049,Blue,0,64070,64260,190
2022-12-12,70038,70042,Blue,1,76408,76538,130
2022-08-27,70045,70838,Blue,0,53206,53740,534
2022-07-31,70045,70838,Blue,0,23786,24151,365
2022-01-17,70059,70838,Blue,0,27621,28785,1164
2022-03-03,70057,70838,Blue,0,26741,27885,1144
2022-12-25,70055,70039,Blue,0,51854,52653,799
2022-08-19,70049,70039,Blue,0,60593,61131,538
2022-03-06,70055,70043,Blue,0,76151,76817,666
2022-07-19,70055,70045,Blue,0,63069,63568,499
2022-03-26,70053,70047,Blue,0,39238,39535,297
2022-06-23,70040,70050,Blue,1,88329,88835,506
2022-06-06,70043,70838,Blue,0,29042,29241,199
2022-12-28,70047,70041,Blue,0,25101,25435,334
2022-06-10,70044,70052,Blue,1,25974,26522,548
2022-12-16,70038,70060,Blue,1,27380,28689,1309
2022-10-16,70053,70043,Blue,0,70825,71362,537
2022-12-03,70044,70046,Blue,1,76837,76946,109
2022-12-17,70038,70040,Blue,1,32289,32306,17
2022-09-08,70048,70060,Blue,1,26475,27172,697
2022-07-22,70057,70043,Blue,0,25172,25975,803
2022-04-22,70054,70060,Blue,1,69453,69788,335
2022-07-07,70059,70049,Blue,0,60370,60846,476
2022-09-04,70040,70056,Blue,1,69434,70207,773
2022-11-10,70059,70047,Blue,0,75377,75904,527
2022-10-16,70040,70060,Blue,1,26964,27987,1023
2022-12-28,70053,70049,Blue,0,67120,67320,200
2022-08-20,70046,70056,Blue,1,38739,39230,491
2022-10-20,70038,70052,Blue,1,65356,66180,824
2022-02-20,70053,70051,Blue,0,25033,25120,87
2022-03-08,70046,70052,Blue,1,57491,57815,324
2022-07-09,70055,70045,Blue,0,55881,56391,510
2022-02-28,70055,70053,Blue,0,61882,61958,76
2022-11-19,70055,70838,Blue,0,34288,35206,918
2022-01-14,70057,70045,Blue,0,28839,29487,648
2022-04-14,70042,70060,Blue,1,39934,40996,1062
2022-08-05,70052,70060,Blue,1,26974,27375,401
2022-07-14,70050,70054,Blue,1,24237,24462,225
2022-04-04,70047,70041,Blue,0,61973,62275,302
2022-10-16,70057,70041,Blue,0,29372,30193,821
2022-06-21,70042,70056,Blue,1,52870,53736,866
2022-04-24,70042,70052,Blue,1,49523,50107,584
2022-11-22,70059,70838,Blue,0,79297,80339,1042
2022-08-04,70050,70056,Blue,1,44236,44554,318
2022-10-13,70055,70053,Blue,0,82993,83037,44
2022-12-05,70040,70048,Blue,1,84205,84592,387
2022-08-16,70053,70043,Blue,0,50208,50818,610
2022-10-27,70051,70049,Blue,0,69076,69179,103
2022-03-21,70038,70054,Blue,1,78009,78964,955
2022-05-18,70057,70049,Blue,0,55172,55544,372
2022-06-27,70051,70043,Blue,0,53431,53950,519
2022-10-14,70038,70040,Blue,1,35296,35312,16
2022-11-23,70052,70054,Blue,1,52530,52584,54
2022-10-07,70038,70050,Blue,1,28573,29082,509
2022-10-18,70038,70046,Blue,1,61395,61714,319
2022-01-10,70059,70041,Blue,0,82872,83777,905
2022-01-21,70046,70060,Blue,1,30008,30787,779
2022-01-24,70059,70043,Blue,0,25160,26061,901
2022-05-15,70059,70053,Blue,0,40209,40451,242
2022-03-01,70040,70056,Blue,1,64597,65479,882
2022-02-10,70050,70054,Blue,1,56211,56407,196
2022-07-10,70047,70041,Blue,0,36827,37146,319
2022-05-14,70053,70047,Blue,0,77894,78203,309
2022-11-21,70048,70050,Blue,1,83153,83214,61
2022-11-26,70051,70043,Blue,0,88666,89182,516
2022-03-26,70055,70838,Blue,0,32659,33598,939
2022-11-28,70059,70838,Blue,0,58758,59864,1106
2022-01-08,70048,70050,Blue,1,25435,25491,56
2022-04-15,70038,70044,Blue,1,30006,30181,175
2022-07-06,70055,70039,Blue,0,55052,55948,896
2022-11-28,70052,70058,Blue,1,23011,23273,262
2022-03-02,70043,70838,Blue,0,25807,26009,202
2022-11-13,70057,70055,Blue,0,23926,24000,74
2022-07-16,70038,70042,Blue,1,84604,84713,109
2022-02-07,70057,70041,Blue,0,28226,29177,951
2022-09-03,70054,70058,Blue,1,32635,32786,151
2022-01-18,70055,70041,Blue,0,72819,73596,777
2022-04-18,70038,70054,Blue,1,25447,26248,801
2022-02-20,70042,70056,Blue,1,70059,70818,759
2022-09-27,70041,70838,Blue,0,76885,77027,142
2022-08-26,70053,70045,Blue,0,47087,47539,452
2022-09-24,70057,70838,Blue,0,71971,72974,1003
2022-04-11,70045,70043,Blue,0,29045,29142,97
2022-05-22,70040,70046,Blue,1,30977,31274,297
2022-02-18,70059,70051,Blue,0,30642,30984,342
2022-10-07,70040,70056,Blue,1,25700,26516,816
2022-09-30,70047,70045,Blue,0,67321,67418,97
2022-03-11,70059,70838,Blue,0,64033,65099,1066
2022-03-26,70038,70054,Blue,1,62059,62934,875
2022-01-15,70057,70051,Blue,0,32007,32280,273
2022-10-28,70045,70039,Blue,0,21211,21476,265
2022-02-08,70051,70039,Blue,0,52328,53006,678
2022-08-23,70057,70053,Blue,0,45342,45495,153
2022-12-23,70039,70838,Blue,0,67563,67598,35
2022-08-31,70044,70058,Blue,1,77753,78606,853
2022-06-17,70042,70048,Blue,1,59101,59489,388
2022-01-03,70052,70058,Blue,1,55081,55341,260
2022-02-21,70055,70041,Blue,0,35888,36645,757
2022-07-04,70040,70042,Blue,1,60486,60516,30
2022-01-06,70042,70052,Blue,1,54378,54934,556
2022-04-11,70059,70043,Blue,0,54230,55155,925
2022-02-06,70047,70045,Blue,0,25991,26085,94
2022-11-29,70052,70058,Blue,1,49152,49403,251
2022-12-30,70055,70041,Blue,0,29592,30331,739
2022-04-19,70053,70045,Blue,0,75740,76234,494
2022-11-08,70042,70044,Blue,1,27645,27685,40
2022-04-24,70040,70046,Blue,1,44367,44620,253
2022-08-06,70040,70058,Blue,1,64822,65770,948
2022-07-12,70038,70050,Blue,1,49224,49843,619
2022-01-26,70047,70045,Blue,0,87548,87653,105
2022-03-19,70053,70049,Blue,0,42455,42646,191
2022-10-29,70059,70045,Blue,0,66496,67176,680
2022-09-16,70054,70056,Blue,1,31614,31670,56
2022-11-12,70043,70838,Blue,0,68080,68373,293
2022-05-19,70059,70055,Blue,0,28459,28630,171
2022-05-13,70055,70047,Blue,0,70410,70802,392
2022-06-01,70040,70046,Blue,1,36033,36352,319
2022-08-21,70047,70041,Blue,0,49594,49934,340
2022-07-30,70051,70045,Blue,0,53360,53692,332
2022-08-08,70050,70056,Blue,1,30169,30485,316
2022-11-20,70038,70056,Blue,1,65594,66539,945
2022-11-30,70055,70045,Blue,0,62132,62662,530
2022-09-29,70049,70041,Blue,0,51527,51952,425
2022-07-29,70059,70041,Blue,0,61885,62979,1094
2022-03-08,70043,70041,Blue,0,56553,56581,28
2022-07-02,70039,70838,Blue,0,27602,27635,33
2022-07-10,70054,70060,Blue,1,78358,78650,292
2022-08-20,70044,70060,Blue,1,45580,46492,912
2022-10-23,70048,70050,Blue,1,70926,70986,60
2022-03-11,70050,70060,Blue,1,64043,64549,506
2022-11-06,70051,70045,Blue,0,88661,88976,315
2022-08-05,70054,70058,Blue,1,38690,38858,168
2022-05-29,70042,70048,Blue,1,45458,45830,372
2022-05-20,70043,70039,Blue,0,43797,43914,117
2022-07-26,70055,70838,Blue,0,34137,35178,1041
2022-12-12,70040,70058,Blue,1,25724,26691,967
2022-03-24,70038,70058,Blue,1,24305,25373,1068
2022-07-16,70044,70050,Blue,1,48787,49142,355
2022-11-03,70050,70058,Blue,1,43940,44350,410
2022-08-28,70044,70056,Blue,1,50151,50772,621
2022-09-26,70059,70057,Blue,0,53532,53567,35
2022-06-21,70038,70044,Blue,1,39536,39736,200
2022-01-06,70059,70041,Blue,0,63497,64431,934
2022-09-25,70052,70058,Blue,1,64327,64588,261
2022-01-21,70052,70056,Blue,1,49958,50097,139
2022-05-31,70042,70044,Blue,1,27365,27396,31
2022-08-27,70045,70041,Blue,0,44529,44713,184
2022-01-02,70044,70052,Blue,1,69615,70127,512
2022-01-04,70050,70052,Blue,1,34781,34918,137
2022-01-28,70042,70056,Blue,1,26974,27779,805
2022-08-26,70049,70043,Blue,0,75442,75849,407
2022-10-12,70046,70054,Blue,1,44739,45181,442
2022-07-25,70052,70054,Blue,1,28581,28661,80
2022-11-02,70049,70045,Blue,0,87814,88014,200
2022-12-21,70048,70058,Blue,1,37464,37978,514
2022-03-07,70047,70045,Blue,0,37163,37276,113
2022-11-18,70051,70049,Blue,0,81593,81695,102
2022-06-19,70055,70043,Blue,0,60280,61029,749
2022-12-07,70042,70054,Blue,1,35914,36540,626
2022-12-01,70044,70048,Blue,1,70846,71070,224
2022-04-12,70047,70045,Blue,0,45024,45137,113
2022-09-13,70057,70051,Blue,0,71850,72097,247
2022-12-04,70053,70045,Blue,0,66555,67035,480
2022-09-10,70044,70048,Blue,1,37980,38224,244
2022-04-10,70050,70056,Blue,1,29007,29318,311
2022-02-15,70050,70052,Blue,1,34744,34877,133
2022-07-31,70049,70043,Blue,0,68915,69269,354
2022-04-12,70038,70042,Blue,1,77496,77629,133
2022-01-28,70051,70049,Blue,0,53687,53792,105
2022-08-19,70043,70041,Blue,0,74737,74768,31
2022-04-19,70038,70048,Blue,1,62536,62977,441
2022-10-23,70055,70838,Blue,0,64810,65679,869
2022-06-16,70042,70056,Blue,1,63616,64450,834
2022-12-16,70055,70041,Blue,0,57907,58669,762
2022-10-10,70053,70049,Blue,0,50208,50405,197
2022-12-02,70049,70045,Blue,0,20947,21142,195
2022-01-15,70047,70041,Blue,0,39758,40106,348
2022-12-07,70059,70039,Blue,0,87429,88441,1012
2022-12-27,70059,70053,Blue,0,61442,61670,228
2022-06-26,70052,70056,Blue,1,49688,49841,153
2022-12-09,70040,70042,Blue,1,56264,56296,32
2022-09-14,70049,70045,Blue,0,25259,25458,199
2022-10-26,70059,70838,Blue,0,73007,74271,1264
2022-04-18,70057,70045,Blue,0,32123,32836,713
2022-07-18,70049,70039,Blue,0,65748,66283,535
2022-07-07,70049,70043,Blue,0,28176,28615,439
2022-11-18,70059,70039,Blue,0,25399,26525,1126
2022-03-29,70057,70039,Blue,0,64767,65734,967
2022-02-01,70058,70060,Blue,1,65987,66115,128
2022-06-23,70059,70041,Blue,0,34400,35449,1049
2022-05-11,70054,70060,Blue,1,26697,26955,258
2022-10-19,70040,70060,Blue,1,55123,56264,1141
2022-06-09,70051,70043,Blue,0,24636,25145,509
2022-07-23,70042,70046,Blue,1,27075,27237,162
2022-02-15,70038,70056,Blue,1,27901,28846,945
2022-08-29,70051,70043,Blue,0,35752,36228,476
2022-01-11,70050,70058,Blue,1,26048,26692,644
2022-11-25,70057,70041,Blue,0,20907,21727,820
2022-08-18,70057,70053,Blue,0,28541,28693,152
2022-06-11,70049,70047,Blue,0,31386,31444,58
2022-05-10,70059,70053,Blue,0,33104,33330,226
2022-12-16,70048,70050,Blue,1,33372,33430,58
2022-07-13,70059,70053,Blue,0,25092,25329,237
2022-01-02,70044,70054,Blue,1,85764,86358,594
2022-08-01,70053,70039,Blue,0,55624,56392,768
2022-12-13,70042,70056,Blue,1,76239,77016,777
2022-11-09,70041,70039,Blue,0,51506,51542,36
2022-11-04,70049,70838,Blue,0,60109,60781,672
2022-08-25,70046,70056,Blue,1,65354,65879,525
2022-06-14,70040,70046,Blue,1,57652,57966,314
2022-01-20,70053,70045,Blue,0,25191,25641,450
2022-11-24,70057,70051,Blue,0,87391,87625,234
2022-06-30,70046,70058,Blue,1,33724,34446,722
2022-06-20,70055,70838,Blue,0,56117,57279,1162
2022-11-01,70040,70058,Blue,1,36833,37838,1005
2022-09-13,70050,70052,Blue,1,52428,52545,117
2022-09-04,70047,70039,Blue,0,65804,66249,445
2022-11-21,70038,70044,Blue,1,62719,62898,179
2022-07-18,70048,70060,Blue,1,40972,41635,663
2022-09-16,70053,70838,Blue,0,46036,46856,820
2022-01-26,70059,70055,Blue,0,19543,19687,144
2022-07-10,70057,70047,Blue,0,74973,75444,471
2022-03-14,70059,70057,Blue,0,47652,47692,40
2022-03-26,70055,70838,Blue,0,23656,24626,970
2022-01-11,70040,70054,Blue,1,69489,70323,834
2022-10-15,70059,70043,Blue,0,69203,70003,800
2022-09-07,70039,70838,Blue,0,75907,75941,34
2022-04-14,70051,70043,Blue,0,21705,22263,558
2022-09-29,70053,70043,Blue,0,49134,49728,594
2022-07-14,70055,70053,Blue,0,62203,62250,47
2022-11-14,70059,70055,Blue,0,25097,25245,148
2022-09-30,70041,70838,Blue,0,43744,43858,114
2022-12-25,70040,70044,Blue,1,79233,79342,109
2022-09-25,70051,70043,Blue,0,76872,77344,472
2022-06-09,70050,70054,Blue,1,21374,21642,268
2022-01-19,70048,70052,Blue,1,58395,58625,230
2022-07-05,70047,70039,Blue,0,33093,33522,429
2022-03-30,70048,70060,Blue,1,83238,83859,621
2022-09-09,70043,70838,Blue,0,56015,56237,222
2022-09-18,70046,70056,Blue,1,82081,82592,511
2022-08-30,70047,70041,Blue,0,64070,64403,333
2022-04-12,70049,70043,Blue,0,25981,26383,402
2022-06-13,70055,70039,Blue,0,54999,55898,899
2022-01-26,70057,70041,Blue,0,62678,63633,955
2022-10-23,70055,70049,Blue,0,49144,49411,267
2022-06-13,70050,70060,Blue,1,32394,33061,667
2022-03-21,70044,70054,Blue,1,82789,83490,701
2022-04-11,70049,70041,Blue,0,25373,25873,500
2022-09-04,70059,70838,Blue,0,45732,46824,1092
2022-04-22,70040,70054,Blue,1,23712,24456,744
2022-02-01,70038,70060,Blue,1,61026,62351,1325
2022-09-02,70053,70049,Blue,0,26206,26414,208
2022-12-03,70054,70060,Blue,1,88222,88498,276
2022-11-25,70040,70042,Blue,1,46718,46749,31
2022-04-21,70054,70058,Blue,1,64084,64247,163
2022-04-07,70045,70043,Blue,0,55817,55907,90
2022-09-25,70049,70043,Blue,0,60921,61268,347
2022-02-22,70059,70049,Blue,0,50725,51192,467
2022-10-14,70040,70042,Blue,1,64934,64966,32
2022-01-15,70049,70043,Blue,0,49186,49537,351
2022-02-13,70051,70049,Blue,0,60696,60801,105
2022-10-27,70047,70838,Blue,0,47496,47988,492
2022-11-11,70042,70060,Blue,1,43681,44668,987
2022-02-07,70053,70051,Blue,0,34987,35046,59
2022-12-27,70057,70051,Blue,0,28703,28944,241
2022-08-31,70040,70050,Blue,1,47713,48186,473
2022-04-05,70055,70053,Blue,0,86483,86533,50
2022-08-06,70059,70045,Blue,0,41691,42393,702
2022-12-13,70042,70046,Blue,1,33351,33528,177
2022-01-08,70042,70046,Blue,1,34658,34840,182
2022-07-04,70046,70060,Blue,1,31144,31932,788
2022-11-12,70054,70058,Blue,1,27765,27923,158
2022-10-14,70049,70041,Blue,0,85473,85918,445
2022-10-31,70054,70058,Blue,1,55356,55515,159
2022-09-03,70040,70060,Blue,1,56214,57255,1041
2022-03-25,70041,70838,Blue,0,53355,53556,201
2022-01-03,70047,70043,Blue,0,30844,31062,218
2022-08-29,70056,70060,Blue,1,70435,70632,197
2022-06-16,70044,70052,Blue,1,81224,81739,515
2022-08-30,70038,70054,Blue,1,27356,28129,773
2022-03-03,70059,70045,Blue,0,60799,61588,789
2022-02-05,70059,70047,Blue,0,34100,34659,559
2022-05-18,70057,70055,Blue,0,28843,28914,71
2022-11-26,70057,70838,Blue,0,40128,41141,1013
2022-03-25,70040,70052,Blue,1,75253,75975,722
2022-04-08,70057,70838,Blue,0,81267,82332,1065
2022-08-23,70055,70051,Blue,0,70112,70258,146
2022-06-29,70038,70058,Blue,1,60378,61553,1175
2022-04-06,70040,70048,Blue,1,32722,33106,384
2022-01-26,70054,70060,Blue,1,52395,52649,254
2022-12-23,70059,70057,Blue,0,24541,24583,42
2022-11-15,70040,70044,Blue,1,27374,27490,116
2022-09-22,70055,70043,Blue,0,52155,52823,668
2022-03-28,70045,70043,Blue,0,85894,85985,91
2022-01-12,70059,70051,Blue,0,57794,58161,367
2022-10-20,70059,70039,Blue,0,50956,52038,1082
2022-12-21,70057,70041,Blue,0,79422,80346,924
2022-05-13,70059,70049,Blue,0,58969,59527,558
2022-02-25,70044,70054,Blue,1,65163,65795,632
2022-11-22,70048,70050,Blue,1,74696,74753,57
2022-11-21,70049,70041,Blue,0,87801,88210,409
2022-08-22,70052,70056,Blue,1,30294,30454,160
2022-08-12,70053,70039,Blue,0,33345,34102,757
2022-02-14,70042,70054,Blue,1,55826,56497,671
2022-01-18,70046,70056,Blue,1,87616,88117,501
2022-11-07,70044,70060,Blue,1,79991,80821,830
2022-12-31,70047,70043,Blue,0,65138,65396,258
2022-04-24,70046,70052,Blue,1,63337,63691,354
2022-09-23,70042,70048,Blue,1,37557,37848,291
2022-12-23,70044,70054,Blue,1,30330,30998,668
2022-09-03,70038,70044,Blue,1,81433,81627,194
2022-02-07,70042,70046,Blue,1,49391,49561,170
2022-02-08,70047,70838,Blue,0,87492,88021,529
2022-04-13,70053,70045,Blue,0,57764,58221,457
2022-09-28,70057,70838,Blue,0,20019,21167,1148
2022-11-22,70038,70052,Blue,1,53958,54688,730
2022-01-19,70044,70052,Blue,1,77074,77542,468
2022-05-19,70043,70838,Blue,0,42677,42859,182
2022-07-04,70040,70060,Blue,1,49724,50841,1117
2022-02-24,70040,70046,Blue,1,32177,32446,269
2022-07-23,70042,70048,Blue,1,83664,84016,352
2022-03-28,70044,70050,Blue,1,54262,54618,356
2022-12-03,70053,70838,Blue,0,23743,24550,807
2022-12-15,70058,70060,Blue,1,83700,83773,73
2022-03-01,70055,70838,Blue,0,53309,54293,984
2022-01-21,70048,70056,Blue,1,48156,48610,454
2022-07-16,70042,70056,Blue,1,45402,46141,739
2022-01-02,70046,70048,Blue,1,41459,41537,78
2022-10-29,70050,70052,Blue,1,37286,37398,112
2022-03-03,70043,70838,Blue,0,33384,33600,216
2022-09-11,70051,70049,Blue,0,61760,61861,101
2022-04-03,70045,70838,Blue,0,41632,42009,377
2022-01-06,70038,70052,Blue,1,45138,45823,685
2022-01-25,70049,70045,Blue,0,61045,61240,195
2022-07-15,70044,70046,Blue,1,21526,21649,123
2022-05-18,70038,70046,Blue,1,86252,86604,352
2022-09-29,70053,70039,Blue,0,79689,80423,734
2022-04-12,70053,70049,Blue,0,19389,19617,228
2022-04-19,70040,70054,Blue,1,39109,39905,796
2022-09-07,70046,70060,Blue,1,46439,47128,689
2022-01-07,70052,70060,Blue,1,67415,67902,487
2022-09-17,70048,70058,Blue,1,45843,46319,476
2022-05-19,70040,70044,Blue,1,87817,87951,134
2022-06-18,70045,70043,Blue,0,61620,61738,118
2022-01-06,70049,70039,Blue,0,28971,29465,494
2022-05-18,70042,70052,Blue,1,21282,22028,746
2022-07-08,70044,70056,Blue,1,50073,50792,719
2022-03-29,70051,70041,Blue,0,30935,31545,610
2022-11-24,70057,70838,Blue,0,40969,42048,1079
2022-08-22,70048,70054,Blue,1,49729,50039,310
2022-12-09,70056,70060,Blue,1,54390,54566,176
2022-01-21,70045,70043,Blue,0,48915,49015,100
2022-06-26,70047,70041,Blue,0,22182,22582,400
2022-09-18,70053,70043,Blue,0,26513,27126,613
2022-01-05,70053,70045,Blue,0,68745,69141,396
2022-09-05,70042,70044,Blue,1,46322,46350,28
2022-07-18,70057,70051,Blue,0,39099,39367,268
2022-02-23,70053,70041,Blue,0,64391,65110,719
2022-11-01,70044,70052,Blue,1,87570,88054,484
2022-03-03,70042,70046,Blue,1,73691,73893,202
2022-07-16,70047,70838,Blue,0,57437,57951,514
2022-04-28,70059,70049,Blue,0,68836,69282,446
2022-03-11,70040,70050,Blue,1,55380,55859,479
2022-04-07,70049,70045,Blue,0,28088,28300,212
2022-10-14,70049,70041,Blue,0,57175,57696,521
2022-11-01,70052,70058,Blue,1,22615,23101,486
2022-07-19,70045,70043,Blue,0,77226,77314,88
2022-12-31,70059,70049,Blue,0,19515,19990,475
2022-11-05,70049,70043,Blue,0,57294,57671,377
2022-07-16,70040,70052,Blue,1,74536,75179,643
2022-01-28,70057,70045,Blue,0,28549,29213,664
2022-11-03,70050,70056,Blue,1,42706,43009,303
2022-03-07,70054,70060,Blue,1,67663,67955,292
2022-01-15,70048,70058,Blue,1,72186,72777,591
2022-06-23,70043,70838,Blue,0,64565,64754,189
2022-12-08,70057,70043,Blue,0,35155,36145,990
2022-08-29,70057,70043,Blue,0,79431,80145,714
2022-04-10,70043,70039,Blue,0,56336,56446,110
2022-09-09,70044,70056,Blue,1,22755,23497,742
2022-03-01,70044,70054,Blue,1,27784,28388,604
2022-06-14,70044,70060,Blue,1,65464,66661,1197
2022-01-13,70038,70048,Blue,1,29581,30069,488
2022-01-17,70045,70041,Blue,0,40822,41024,202
2022-03-06,70047,70039,Blue,0,87033,87440,407
2022-07-16,70038,70044,Blue,1,75557,75731,174
2022-08-15,70057,70041,Blue,0,66344,67191,847
2022-03-05,70048,70056,Blue,1,79144,79528,384
2022-06-22,70038,70056,Blue,1,63843,64833,990
2022-01-27,70048,70060,Blue,1,87592,88168,576
2022-09-02,70059,70049,Blue,0,74920,75433,513
2022-01-29,70048,70050,Blue,1,84775,84847,72
2022-08-05,70051,70039,Blue,0,27988,28662,674
2022-02-13,70040,70046,Blue,1,73763,74036,273
2022-03-21,70053,70051,Blue,0,76319,76374,55
2022-03-24,70043,70041,Blue,0,83913,83947,34
2022-05-02,70057,70053,Blue,0,42425,42580,155
2022-01-03,70044,70052,Blue,1,20882,21400,518
2022-08-20,70057,70053,Blue,0,40652,40805,153
2022-04-04,70059,70057,Blue,0,55093,55128,35
2022-10-29,70038,70042,Blue,1,43155,43248,93
2022-12-30,70047,70043,Blue,0,31030,31267,237
2022-09-23,70046,70048,Blue,1,47068,47138,70
2022-09-20,70046,70052,Blue,1,46555,46889,334
2022-11-02,70040,70056,Blue,1,61232,62125,893
2022-03-12,70038,70040,Blue,1,55037,55055,18
2022-02-17,70041,70838,Blue,0,65775,65894,119
2022-05-24,70048,70050,Blue,1,29239,29301,62
2022-04-19,70046,70060,Blue,1,52368,53204,836
2022-01-22,70046,70060,Blue,1,72694,73435,741
2022-10-14,70054,70058,Blue,1,67038,67214,176
2022-12-05,70053,70838,Blue,0,72566,73384,818
2022-09-04,70044,70054,Blue,1,50716,51271,555
2022-07-06,70046,70056,Blue,1,68190,68884,694
2022-04-25,70051,70047,Blue,0,84944,85421,477
2022-10-02,70050,70052,Blue,1,69383,69486,103
2022-12-12,70042,70044,Blue,1,38352,38378,26
2022-05-19,70051,70838,Blue,0,87825,88673,848
2022-07-01,70055,70047,Blue,0,19727,20121,394
2022-06-15,70047,70041,Blue,0,58202,58567,365
2022-03-25,70054,70058,Blue,1,86865,87027,162
2022-07-15,70042,70058,Blue,1,75763,76691,928
2022-09-17,70041,70039,Blue,0,69091,69122,31
2022-03-22,70044,70050,Blue,1,53944,54283,339
2022-03-03,70048,70060,Blue,1,65197,65842,645
2022-01-17,70056,70060,Blue,1,36076,36265,189
2022-09-16,70047,70838,Blue,0,76002,76534,532
2022-03-19,70044,70052,Blue,1,21867,22372,505
2022-03-13,70040,70056,Blue,1,62425,63253,828
2022-10-04,70047,70043,Blue,0,24924,25191,267
2022-06-19,70057,70039,Blue,0,62433,63416,983
2022-01-06,70046,70048,Blue,1,71805,71883,78
2022-01-07,70040,70046,Blue,1,61700,61941,241
2022-08-02,70055,70049,Blue,0,39361,39688,327
2022-08-01,70057,70053,Blue,0,47370,47517,147
2022-03-02,70043,70041,Blue,0,66237,66264,27
2022-05-12,70059,70049,Blue,0,46517,47017,500
2022-12-08,70041,70039,Blue,0,58819,58851,32
2022-12-18,70042,70056,Blue,1,78749,79540,791
2022-07-24,70043,70041,Blue,0,74172,74200,28
2022-07-05,70042,70058,Blue,1,77524,78457,933
2022-07-04,70057,70051,Blue,0,67612,67876,264
2022-01-18,70045,70041,Blue,0,39402,39578,176
2022-11-25,70040,70054,Blue,1,67443,68185,742
2022-04-11,70043,70041,Blue,0,25255,25286,31
2022-10-05,70044,70050,Blue,1,32136,32463,327
2022-09-29,70043,70039,Blue,0,28789,28905,116
2022-04-18,70059,70049,Blue,0,47659,48113,454
2022-09-27,70040,70054,Blue,1,63978,64767,789
2022-03-14,70043,70039,Blue,0,33844,33952,108
2022-11-01,70050,70056,Blue,1,62543,62845,302
2022-06-11,70044,70058,Blue,1,69310,70134,824
2022-06-09,70048,70054,Blue,1,67940,68255,315
2022-03-23,70042,70056,Blue,1,68824,69637,813
2022-04-13,70059,70049,Blue,0,28754,29282,528
2022-03-23,70048,70060,Blue,1,78070,78760,690
2022-03-10,70057,70055,Blue,0,57276,57345,69
2022-02-25,70059,70057,Blue,0,54807,54841,34
2022-10-03,70040,70046,Blue,1,59990,60278,288
2022-10-01,70039,70838,Blue,0,77514,77548,34
2022-08-28,70055,70045,Blue,0,63247,63780,533
2022-03-18,70057,70051,Blue,0,53975,54217,242
2022-07-23,70038,70048,Blue,1,60433,60953,520
2022-04-11,70047,70045,Blue,0,37718,37843,125
2022-05-19,70051,70041,Blue,0,76449,77264,815
2022-07-17,70038,70044,Blue,1,70446,70640,194
2022-12-18,70053,70047,Blue,0,33545,33835,290
2022-02-14,70057,70047,Blue,0,24335,24889,554
2022-08-03,70047,70041,Blue,0,56786,57165,379
2022-11-06,70055,70043,Blue,0,54012,54636,624
2022-10-07,70055,70045,Blue,0,70422,71017,595
2022-04-04,70056,70060,Blue,1,32570,32765,195
2022-05-26,70044,70050,Blue,1,26916,27301,385
2022-07-06,70055,70051,Blue,0,26589,26739,150
2022-06-08,70040,70050,Blue,1,86469,87025,556
2022-06-14,70049,70045,Blue,0,29028,29245,217
2022-11-18,70046,70060,Blue,1,37655,38403,748
2022-03-04,70047,70045,Blue,0,53144,53249,105
2022-08-15,70043,70838,Blue,0,26929,27133,204
2022-12-10,70046,70056,Blue,1,70533,71069,536
2022-12-18,70040,70060,Blue,1,83049,84121,1072
2022-08-20,70057,70039,Blue,0,85783,87039,1256
2022-08-09,70059,70039,Blue,0,27619,28690,1071
2022-10-16,70049,70041,Blue,0,26658,27064,406
2022-12-01,70059,70057,Blue,0,58464,58501,37
2022-09-14,70054,70058,Blue,1,55371,55533,162
2022-08-20,70052,70060,Blue,1,61792,62152,360
2022-10-29,70059,70039,Blue,0,55776,56854,1078
2022-09-12,70059,70053,Blue,0,54074,54314,240
2022-07-28,70048,70054,Blue,1,56987,57430,443
2022-08-22,70053,70838,Blue,0,80688,81508,820
2022-11-14,70048,70052,Blue,1,30341,30555,214
2022-05-14,70050,70052,Blue,1,88551,88656,105
2022-03-21,70050,70058,Blue,1,31776,32198,422
2022-06-26,70038,70044,Blue,1,39013,39192,179
2022-07-15,70042,70058,Blue,1,50969,51990,1021
2022-02-19,70048,70054,Blue,1,85175,85479,304
2022-03-07,70044,70050,Blue,1,48295,48610,315
2022-08-22,70053,70049,Blue,0,23814,24013,199
2022-09-10,70038,70054,Blue,1,29107,29935,828
2022-10-09,70048,70060,Blue,1,33611,34204,593
2022-01-26,70051,70047,Blue,0,78150,78333,183
2022-03-19,70052,70060,Blue,1,43381,43740,359
2022-11-25,70054,70056,Blue,1,77141,77188,47
2022-08-26,70053,70051,Blue,0,52632,52690,58
2022-11-17,70053,70051,Blue,0,24038,24091,53
2022-02-26,70056,70058,Blue,1,78895,78967,72
2022-12-25,70040,70054,Blue,1,41707,42405,698
2022-07-17,70046,70050,Blue,1,64895,65076,181
2022-05-20,70052,70056,Blue,1,61022,61174,152
2022-09-17,70044,70052,Blue,1,54282,54782,500
2022-01-12,70051,70043,Blue,0,43053,43554,501
2022-03-28,70051,70039,Blue,0,22086,22890,804
2022-02-24,70059,70053,Blue,0,32359,32597,238
2022-02-25,70059,70039,Blue,0,71019,72023,1004
2022-06-27,70055,70045,Blue,0,38188,38734,546
2022-12-21,70057,70055,Blue,0,40418,40486,68
2022-11-05,70048,70052,Blue,1,77122,77326,204
2022-11-20,70044,70060,Blue,1,24763,25667,904
2022-12-25,70046,70054,Blue,1,48679,49080,401
2022-12-16,70044,70056,Blue,1,74922,75635,713
2022-04-09,70057,70045,Blue,0,82408,83033,625
2022-04-11,70040,70048,Blue,1,67431,67879,448
2022-08-30,70055,70045,Blue,0,75011,75523,512
2022-08-22,70051,70047,Blue,0,79548,79741,193
2022-09-09,70047,70039,Blue,0,63045,63508,463
2022-08-22,70042,70046,Blue,1,29652,29833,181
2022-08-24,70040,70044,Blue,1,21465,21567,102
2022-01-14,70055,70838,Blue,0,25637,26635,998
2022-03-26,70044,70050,Blue,1,30408,30773,365
2022-01-28,70053,70041,Blue,0,83159,83863,704
2022-08-21,70053,70043,Blue,0,49786,50369,583
2022-12-18,70048,70052,Blue,1,48292,48509,217
2022-06-22,70055,70041,Blue,0,32024,32824,800
2022-01-03,70053,70047,Blue,0,19778,20072,294
2022-06-09,70055,70053,Blue,0,29859,29909,50
2022-09-26,70057,70838,Blue,0,48981,50014,1033
2022-06-14,70042,70052,Blue,1,34943,35569,626
2022-09-01,70042,70046,Blue,1,29130,29298,168
2022-11-10,70044,70048,Blue,1,39085,39329,244
2022-07-03,70046,70052,Blue,1,71985,72315,330
2022-09-26,70043,70039,Blue,0,80136,80234,98
2022-08-10,70043,70838,Blue,0,30698,30921,223
2022-01-24,70043,70041,Blue,0,65345,65373,28
2022-12-31,70038,70046,Blue,1,90816,91120,304
2022-05-20,70044,70056,Blue,1,41195,42044,849
2022-06-30,70051,70043,Blue,0,75640,76092,452
2022-04-14,70052,70056,Blue,1,32020,32165,145
2022-03-21,70039,70838,Blue,0,40963,41000,37
2022-01-14,70042,70050,Blue,1,86736,87178,442
2022-02-16,70042,70054,Blue,1,49407,50168,761
2022-07-23,70044,70058,Blue,1,81358,82315,957
2022-03-17,70046,70052,Blue,1,56364,56716,352
2022-06-28,70055,70043,Blue,0,87660,88308,648
2022-01-01,70044,70054,Blue,1,57180,57777,597
2022-11-13,70059,70055,Blue,0,72770,72912,142
2022-07-06,70055,70051,Blue,0,38165,38351,186
2022-02-24,70045,70041,Blue,0,27186,27362,176
2022-02-21,70042,70048,Blue,1,32005,32331,326
2022-03-10,70053,70041,Blue,0,84281,84909,628
2022-03-08,70043,70838,Blue,0,54524,54700,176
2022-04-15,70042,70048,Blue,1,30148,30516,368
2022-08-07,70054,70056,Blue,1,71351,71399,48
2022-05-07,70057,70049,Blue,0,34904,35322,418
2022-11-03,70047,70039,Blue,0,20199,20674,475
2022-03-15,70051,70047,Blue,0,26113,26308,195
2022-06-16,70047,70041,Blue,0,30621,31022,401
2022-08-28,70046,70052,Blue,1,78611,78964,353
2022-02-07,70046,70056,Blue,1,36560,37152,592
2022-03-30,70057,70051,Blue,0,27050,27322,272
2022-10-27,70038,70052,Blue,1,27315,28044,729
2022-09-13,70057,70041,Blue,0,50023,50882,859
2022-02-21,70057,70053,Blue,0,55821,55991,170
2022-11-06,70059,70051,Blue,0,44661,44975,314
2022-03-15,70053,70045,Blue,0,81435,81830,395
2022-01-05,70055,70838,Blue,0,25121,26239,1118
2022-07-25,70051,70039,Blue,0,56044,56728,684
2022-12-25,70055,70045,Blue,0,37697,38205,508
2022-07-14,70053,70039,Blue,0,43009,43896,887
2022-01-24,70038,70042,Blue,1,87148,87237,89
2022-10-02,70038,70060,Blue,1,65057,66195,1138
2022-07-02,70051,70047,Blue,0,84365,84561,196
2022-08-06,70055,70047,Blue,0,40751,41106,355
2022-01-24,70044,70052,Blue,1,59506,60027,521
2022-04-30,70050,70056,Blue,1,56783,57086,303
2022-11-03,70059,70051,Blue,0,54940,55278,338
2022-01-12,70044,70052,Blue,1,73191,73734,543
2022-01-29,70044,70052,Blue,1,83441,84379,938
2022-09-05,70057,70838,Blue,0,83711,84846,1135
2022-02-02,70038,70040,Blue,1,22686,22708,22
2022-07-07,70044,70046,Blue,1,72154,72273,119
2022-10-07,70055,70051,Blue,0,30735,30865,130
2022-09-26,70059,70051,Blue,0,26789,27146,357
2022-04-02,70046,70060,Blue,1,47311,48030,719
2022-09-06,70043,70041,Blue,0,77954,77982,28
2022-04-21,70051,70049,Blue,0,65675,65780,105
2022-06-11,70049,70047,Blue,0,18931,18988,57
2022-03-18,70055,70045,Blue,0,88313,88849,536
2022-08-17,70038,70042,Blue,1,46945,47214,269
2022-04-04,70057,70047,Blue,0,69591,70067,476
2022-03-22,70038,70040,Blue,1,55934,55951,17
2022-06-01,70048,70050,Blue,1,70960,71020,60
2022-06-01,70040,70048,Blue,1,36626,37107,481
2022-02-04,70059,70053,Blue,0,57088,57354,266
2022-09-02,70055,70053,Blue,0,41781,41828,47
2022-07-17,70042,70052,Blue,1,67915,68476,561
2022-04-15,70049,70838,Blue,0,63683,64259,576
2022-11-29,70049,70041,Blue,0,84725,85126,401
2022-04-07,70040,70060,Blue,1,19917,21042,1125
2022-10-24,70052,70054,Blue,1,56420,56480,60
2022-12-21,70045,70043,Blue,0,63584,63675,91
2022-11-23,70038,70048,Blue,1,45173,45653,480
2022-06-24,70046,70054,Blue,1,60757,61273,516
2022-09-24,70050,70052,Blue,1,20503,20618,115
2022-07-08,70056,70060,Blue,1,61884,62180,296
2022-09-26,70057,70047,Blue,0,48050,48577,527
2022-06-19,70044,70048,Blue,1,68603,68856,253
2022-04-24,70046,70054,Blue,1,69731,70206,475
2022-09-09,70057,70051,Blue,0,76587,76827,240
2022-02-18,70055,70041,Blue,0,85355,86182,827
2022-06-26,70049,70041,Blue,0,44639,45092,453
2022-04-20,70055,70838,Blue,0,22957,23917,960
2022-09-13,70055,70049,Blue,0,41796,42121,325
2022-04-21,70053,70041,Blue,0,86602,87354,752
2022-06-11,70053,70039,Blue,0,80844,81701,857
2022-07-27,70057,70039,Blue,0,23068,23971,903
2022-02-08,70059,70045,Blue,0,77179,77959,780
2022-11-16,70043,70039,Blue,0,25922,26037,115
2022-06-23,70044,70054,Blue,1,79325,80049,724
2022-09-10,70044,70052,Blue,1,89312,89814,502
2022-12-10,70046,70058,Blue,1,35069,35714,645
2022-03-12,70054,70056,Blue,1,39251,39299,48
2022-07-06,70045,70043,Blue,0,27751,27878,127
2022-04-17,70057,70041,Blue,0,23134,23932,798
2022-04-24,70057,70051,Blue,0,64173,64424,251
2022-12-21,70053,70045,Blue,0,86255,86978,723
2022-03-09,70045,70043,Blue,0,67027,67131,104
2022-10-31,70038,70046,Blue,1,24133,24447,314
2022-10-24,70038,70056,Blue,1,60249,61247,998
2022-07-22,70040,70056,Blue,1,34977,35784,807
2022-06-12,70055,70043,Blue,0,30326,31053,727
2022-06-23,70038,70042,Blue,1,30268,30360,92
2022-04-25,70057,70055,Blue,0,86966,87035,69
2022-05-25,70040,70044,Blue,1,38534,38647,113
2022-09-20,70042,70054,Blue,1,85853,86572,719
2022-10-10,70057,70045,Blue,0,32725,33332,607
2022-04-16,70059,70049,Blue,0,40577,41055,478
2022-05-26,70044,70048,Blue,1,78871,79120,249
2022-06-23,70048,70056,Blue,1,62448,62871,423
2022-03-17,70059,70838,Blue,0,59596,60672,1076
2022-05-17,70054,70056,Blue,1,30402,30449,47
2022-06-14,70053,70051,Blue,0,86039,86116,77
2022-09-02,70040,70046,Blue,1,65435,65690,255
2022-03-29,70055,70053,Blue,0,75064,75108,44
2022-02-10,70042,70048,Blue,1,49401,49729,328
2022-07-08,70059,70041,Blue,0,83615,84554,939
2022-10-07,70044,70058,Blue,1,75455,76261,806
2022-06-20,70041,70838,Blue,0,68327,68434,107
2022-07-05,70041,70039,Blue,0,31651,31683,32
2022-03-31,70059,70039,Blue,0,29360,30370,1010
2022-08-10,70057,70051,Blue,0,57570,58057,487
2022-04-03,70052,70058,Blue,1,66890,67128,238
2022-11-09,70059,70838,Blue,0,63439,64538,1099
2022-03-11,70047,70838,Blue,0,78366,78856,490
2022-01-08,70053,70043,Blue,0,60337,60937,600
2022-12-04,70042,70048,Blue,1,71172,71488,316
2022-03-08,70040,70060,Blue,1,88523,89659,1136
2022-12-06,70040,70044,Blue,1,63869,63986,117
2022-02-07,70056,70058,Blue,1,68873,68948,75
2022-09-07,70041,70838,Blue,0,34602,34757,155
2022-09-16,70038,70040,Blue,1,65261,65275,14
2022-01-11,70046,70058,Blue,1,30982,31760,778
2022-09-19,70051,70838,Blue,0,50026,50849,823
2022-08-18,70038,70040,Blue,1,50317,50334,17
2022-11-14,70040,70052,Blue,1,71110,71743,633
2022-09-23,70049,70041,Blue,0,87022,87483,461
2022-03-04,70038,70044,Blue,1,79152,79330,178
2022-08-28,70044,70060,Blue,1,56686,57556,870
2022-04-03,70055,70838,Blue,0,22443,23315,872
2022-08-11,70044,70054,Blue,1,36748,37443,695
2022-06-25,70059,70057,Blue,0,57677,57727,50
2022-02-05,70051,70045,Blue,0,59356,59678,322
2022-09-02,70057,70045,Blue,0,23920,24522,602
2022-07-16,70059,70049,Blue,0,85696,86167,471
2022-10-07,70047,70041,Blue,0,22247,22607,360
2022-07-17,70042,70048,Blue,1,75485,75785,300
2022-09-28,70059,70043,Blue,0,67170,68010,840
2022-11-05,70040,70056,Blue,1,36726,37493,767
2022-10-04,70057,70043,Blue,0,62492,63249,757
2022-01-26,70038,70046,Blue,1,32345,32636,291
2022-02-16,70059,70041,Blue,0,76646,77712,1066
2022-03-18,70042,70058,Blue,1,56676,57607,931
2022-12-25,70052,70056,Blue,1,64231,64373,142
2022-12-13,70047,70045,Blue,0,53809,53903,94
2022-11-01,70047,70045,Blue,0,68742,68839,97
2022-12-12,70058,70060,Blue,1,43772,43848,76
2022-07-13,70055,70039,Blue,0,56588,57526,938
2022-01-24,70057,70051,Blue,0,55769,56023,254
2022-10-04,70055,70047,Blue,0,57376,57747,371
2022-09-06,70042,70048,Blue,1,87499,87785,286
2022-02-27,70052,70054,Blue,1,59886,59939,53
2022-07-29,70054,70058,Blue,1,29032,29187,155
2022-07-17,70046,70054,Blue,1,65465,65909,444
2022-02-06,70049,70045,Blue,0,88801,89024,223
2022-02-19,70040,70052,Blue,1,36733,37475,742
2022-08-05,70052,70058,Blue,1,79195,79462,267
2022-02-19,70047,70041,Blue,0,33639,33963,324
2022-11-11,70045,70039,Blue,0,62663,62914,251
2022-07-07,70047,70838,Blue,0,52913,53423,510
2022-05-19,70050,70052,Blue,1,57488,57595,107
2022-03-07,70049,70041,Blue,0,32541,32932,391
2022-05-01,70058,70060,Blue,1,63124,63193,69
2022-08-09,70046,70058,Blue,1,24485,25152,667
2022-10-16,70038,70052,Blue,1,47414,48167,753
2022-08-10,70048,70060,Blue,1,47377,48026,649
2022-11-09,70051,70047,Blue,0,57035,57232,197
2022-08-16,70045,70838,Blue,0,19253,19649,396
2022-06-21,70051,70047,Blue,0,34941,35176,235
2022-10-03,70057,70047,Blue,0,56731,57224,493
2022-12-10,70059,70045,Blue,0,20180,20876,696
2022-06-26,70051,70045,Blue,0,41195,41539,344
2022-07-28,70051,70049,Blue,0,49232,49334,102
2022-06-28,70057,70047,Blue,0,65187,65681,494
2022-04-04,70048,70056,Blue,1,34671,35056,385
2022-01-06,70059,70055,Blue,0,53914,54053,139
2022-01-22,70038,70056,Blue,1,42074,42932,858
2022-04-24,70053,70049,Blue,0,69229,69418,189
2022-01-13,70046,70060,Blue,1,37704,38474,770
2022-09-26,70042,70052,Blue,1,69602,70230,628
2022-11-29,70042,70052,Blue,1,43787,44382,595
2022-07-21,70040,70054,Blue,1,60346,61191,845
2022-09-26,70041,70838,Blue,0,40075,40202,127
2022-10-13,70052,70056,Blue,1,50165,50306,141
2022-11-07,70044,70058,Blue,1,31951,32744,793
2022-01-11,70051,70043,Blue,0,27352,27846,494
2022-04-06,70038,70058,Blue,1,45804,46788,984
2022-11-13,70050,70060,Blue,1,87971,88511,540
2022-06-29,70045,70043,Blue,0,38820,38943,123
2022-03-23,70049,70043,Blue,0,66074,66420,346
2022-12-02,70046,70056,Blue,1,24831,25363,532
2022-06-27,70046,70060,Blue,1,35389,36178,789
2022-02-19,70049,70045,Blue,0,70803,70999,196
2022-01-28,70038,70040,Blue,1,36199,36216,17
2022-05-19,70044,70060,Blue,1,22431,23467,1036
2022-02-18,70038,70056,Blue,1,73610,74544,934
2022-11-17,70059,70047,Blue,0,48313,48879,566
2022-09-23,70038,70056,Blue,1,53030,53975,945
2022-12-08,70046,70054,Blue,1,31058,31530,472
2022-06-13,70039,70838,Blue,0,70171,70208,37
2022-10-28,70048,70054,Blue,1,27868,28179,311
2022-01-13,70053,70041,Blue,0,23949,24689,740
2022-12-22,70044,70060,Blue,1,68948,69911,963
2022-04-13,70057,70043,Blue,0,65078,65807,729
2022-09-19,70053,70043,Blue,0,66038,66581,543
2022-09-15,70044,70060,Blue,1,27686,28672,986
2022-03-13,70044,70052,Blue,1,32551,33095,544
2022-02-09,70057,70039,Blue,0,32745,33736,991
2022-11-18,70055,70049,Blue,0,72991,73300,309
2022-08-22,70054,70056,Blue,1,61532,61579,47
2022-10-04,70057,70051,Blue,0,43985,44240,255
2022-06-13,70050,70060,Blue,1,23415,24002,587
2022-07-18,70042,70058,Blue,1,46264,47130,866
2022-03-02,70042,70050,Blue,1,57274,57672,398
2022-10-02,70048,70050,Blue,1,72031,72091,60
2022-09-12,70040,70042,Blue,1,47721,47753,32
2022-01-07,70057,70049,Blue,0,21419,21895,476
2022-06-22,70048,70054,Blue,1,56483,56819,336
2022-03-04,70055,70039,Blue,0,28643,29588,945
2022-12-31,70054,70058,Blue,1,42366,42565,199
2022-08-26,70042,70044,Blue,1,77220,77252,32
2022-03-14,70055,70047,Blue,0,32881,33245,364
2022-03-30,70059,70055,Blue,0,76040,76192,152
2022-12-06,70042,70050,Blue,1,59606,60084,478
2022-02-07,70038,70048,Blue,1,68234,68675,441
2022-04-11,70054,70058,Blue,1,52845,53030,185
2022-01-12,70042,70044,Blue,1,58783,58820,37
2022-03-12,70050,70056,Blue,1,62656,62949,293
2022-12-27,70042,70056,Blue,1,72644,73371,727
2022-09-01,70053,70049,Blue,0,50210,50407,197
2022-08-08,70059,70039,Blue,0,45844,46937,1093
2022-01-11,70038,70048,Blue,1,73513,73969,456
2022-06-22,70053,70047,Blue,0,19828,20141,313
2022-02-27,70042,70052,Blue,1,26375,26998,623
2022-11-27,70053,70051,Blue,0,61128,61182,54
2022-01-13,70038,70052,Blue,1,42990,43746,756
2022-12-21,70038,70054,Blue,1,50717,51689,972
2022-10-10,70052,70060,Blue,1,60871,61285,414
2022-08-04,70043,70838,Blue,0,59651,59848,197
2022-08-31,70052,70060,Blue,1,38751,39147,396
2022-03-24,70038,70044,Blue,1,44665,44895,230
2022-10-06,70044,70052,Blue,1,46328,46852,524
2022-02-12,70055,70045,Blue,0,37512,38016,504
2022-06-23,70046,70060,Blue,1,32920,33680,760
2022-07-05,70054,70056,Blue,1,53536,53583,47
2022-06-25,70053,70041,Blue,0,62450,63161,711
2022-12-09,70056,70060,Blue,1,64355,64537,182
2022-02-26,70059,70041,Blue,0,20837,21898,1061
2022-12-28,70057,70053,Blue,0,72041,72245,204
2022-10-14,70043,70039,Blue,0,45097,45206,109
2022-12-08,70045,70043,Blue,0,26725,26822,97
2022-09-25,70059,70053,Blue,0,68415,68659,244
2022-06-15,70055,70045,Blue,0,63984,64554,570
2022-07-25,70049,70041,Blue,0,47915,48325,410
2022-09-08,70048,70050,Blue,1,35528,35584,56
2022-10-07,70050,70052,Blue,1,66727,66841,114
2022-12-18,70046,70054,Blue,1,70956,71396,440
2022-04-23,70038,70040,Blue,1,26947,26965,18
2022-04-11,70040,70058,Blue,1,79784,80760,976
2022-02-28,70057,70051,Blue,0,62363,62595,232
2022-02-03,70055,70047,Blue,0,72800,73162,362
2022-02-01,70044,70046,Blue,1,34383,34495,112
2022-02-08,70053,70838,Blue,0,78084,78944,860
2022-04-19,70055,70045,Blue,0,43018,43627,609
2022-02-16,70039,70838,Blue,0,83320,83352,32
2022-06-18,70038,70048,Blue,1,53472,53985,513
2022-12-09,70046,70054,Blue,1,49652,50103,451
2022-04-11,70057,70049,Blue,0,62079,62473,394
2022-07-13,70047,70043,Blue,0,31572,31824,252
2022-04-11,70042,70046,Blue,1,81140,81347,207
2022-04-05,70049,70041,Blue,0,33830,34281,451
2022-09-28,70038,70060,Blue,1,65185,66375,1190
2022-10-01,70044,70050,Blue,1,50630,50968,338
2022-07-16,70040,70048,Blue,1,27003,27360,357
2022-09-20,70055,70041,Blue,0,31594,32425,831
2022-10-28,70040,70060,Blue,1,22877,23979,1102
2022-12-28,70042,70044,Blue,1,53069,53096,27
2022-11-22,70044,70058,Blue,1,63192,63971,779
2022-02-08,70040,70056,Blue,1,63364,64231,867
2022-01-26,70046,70060,Blue,1,73341,74104,763
2022-09-01,70041,70838,Blue,0,49848,49967,119
2022-01-08,70057,70051,Blue,0,33105,33389,284
2022-10-04,70057,70051,Blue,0,28982,29240,258
2022-09-06,70057,70045,Blue,0,67653,68264,611
2022-11-10,70044,70050,Blue,1,43208,43577,369
2022-08-09,70059,70045,Blue,0,76453,77094,641
2022-02-14,70057,70043,Blue,0,24659,25513,854
2022-01-11,70044,70054,Blue,1,47138,47787,649
2022-07-15,70053,70039,Blue,0,71139,72122,983
2022-07-05,70047,70039,Blue,0,38694,39343,649
2022-12-24,70047,70045,Blue,0,62243,62343,100
2022-04-09,70045,70039,Blue,0,50569,50858,289
2022-10-25,70053,70039,Blue,0,61133,61876,743
2022-03-25,70059,70838,Blue,0,60801,61842,1041
2022-10-30,70042,70054,Blue,1,67353,67977,624
2022-09-05,70038,70056,Blue,1,66137,66989,852
2022-05-02,70051,70049,Blue,0,67324,67435,111
2022-03-18,70053,70039,Blue,0,24914,25693,779
2022-07-31,70046,70054,Blue,1,85019,85459,440
2022-12-04,70044,70048,Blue,1,36511,36742,231
2022-10-09,70047,70043,Blue,0,47408,47638,230
2022-02-04,70048,70052,Blue,1,32327,32542,215
2022-07-26,70039,70838,Blue,0,52710,52743,33
2022-06-16,70051,70041,Blue,0,64482,65139,657
2022-03-24,70059,70041,Blue,0,52515,53477,962
2022-02-03,70038,70052,Blue,1,60145,61116,971
2022-08-18,70046,70048,Blue,1,26866,26959,93
2022-12-09,70046,70054,Blue,1,48030,48454,424
2022-06-29,70042,70060,Blue,1,84466,85459,993
2022-09-20,70042,70044,Blue,1,65563,65589,26
2022-02-03,70059,70043,Blue,0,54498,55374,876
2022-09-05,70047,70043,Blue,0,47551,47843,292
2022-04-01,70047,70039,Blue,0,74333,74697,364
2022-04-30,70059,70047,Blue,0,36016,36745,729
2022-08-20,70051,70838,Blue,0,81010,81786,776
2022-03-18,70044,70046,Blue,1,55035,55146,111
2022-03-27,70040,70048,Blue,1,39085,39493,408
2022-03-23,70042,70048,Blue,1,30105,30516,411
2022-04-12,70048,70054,Blue,1,46067,46417,350
2022-11-18,70038,70040,Blue,1,49812,49827,15
2022-01-18,70041,70838,Blue,0,25033,25154,121
2022-05-18,70039,70838,Blue,0,62271,62303,32
2022-02-06,70055,70053,Blue,0,71840,71909,69
2022-12-16,70057,70041,Blue,0,25049,25977,928
2022-04-14,70041,70039,Blue,0,45106,45152,46
2022-09-09,70056,70060,Blue,1,31723,31890,167
2022-01-18,70057,70053,Blue,0,76109,76304,195
2022-11-16,70054,70060,Blue,1,26943,27214,271
2022-03-13,70040,70056,Blue,1,57025,57899,874
2022-06-15,70055,70053,Blue,0,28377,28424,47
2022-06-15,70049,70045,Blue,0,52733,52942,209
2022-09-29,70053,70049,Blue,0,72046,72272,226
2022-10-02,70053,70043,Blue,0,76244,76852,608
2022-08-29,70038,70044,Blue,1,55988,56168,180
2022-04-06,70038,70040,Blue,1,50778,50797,19
2022-10-13,70055,70045,Blue,0,86142,86669,527
2022-01-04,70040,70060,Blue,1,77465,78484,1019
2022-03-25,70052,70054,Blue,1,21192,21254,62
2022-02-24,70042,70046,Blue,1,31401,31567,166
2022-11-15,70040,70060,Blue,1,32834,33937,1103
2022-10-19,70057,70039,Blue,0,77566,78547,981
2022-06-16,70038,70058,Blue,1,65642,66811,1169
2022-03-01,70055,70039,Blue,0,50414,51212,798
2022-04-02,70050,70056,Blue,1,35643,35927,284
2022-07-20,70049,70039,Blue,0,30257,30867,610
2022-11-28,70043,70838,Blue,0,43174,43375,201
2022-05-13,70053,70051,Blue,0,33762,33820,58
2022-06-21,70049,70047,Blue,0,52217,52273,56
2022-08-04,70038,70060,Blue,1,28156,29205,1049
2022-04-14,70043,70838,Blue,0,87718,87886,168
2022-04-21,70046,70058,Blue,1,24903,25555,652
2022-01-20,70048,70052,Blue,1,63642,63849,207
2022-06-17,70042,70048,Blue,1,67466,67805,339
2022-12-16,70038,70052,Blue,1,32897,33589,692
2022-06-13,70047,70045,Blue,0,27848,27951,103
2022-12-01,70042,70058,Blue,1,82040,82892,852
2022-07-09,70044,70060,Blue,1,53676,54659,983
2022-07-19,70048,70060,Blue,1,25026,25647,621
2022-06-25,70048,70058,Blue,1,64588,65126,538
2022-08-15,70038,70046,Blue,1,58651,59018,367
2022-12-28,70059,70043,Blue,0,34904,35922,1018
2022-11-09,70045,70039,Blue,0,75631,75867,236
2022-09-19,70049,70039,Blue,0,35435,36034,599
2022-05-19,70055,70049,Blue,0,31059,31392,333
2022-06-28,70056,70058,Blue,1,36751,36828,77
2022-10-13,70042,70060,Blue,1,55354,56280,926
2022-03-29,70051,70045,Blue,0,30349,30714,365
2022-12-24,70051,70043,Blue,0,66832,67277,445
2022-12-20,70046,70056,Blue,1,20974,21497,523
2022-10-31,70052,70054,Blue,1,39623,39681,58
2022-07-13,70048,70050,Blue,1,25441,25499,58
2022-11-17,70052,70056,Blue,1,29047,29186,139
2022-07-14,70050,70060,Blue,1,23494,24029,535
2022-07-18,70055,70049,Blue,0,54878,55141,263
2022-01-13,70042,70058,Blue,1,27132,28056,924
2022-07-09,70047,70041,Blue,0,87966,88340,374
2022-12-13,70038,70050,Blue,1,50772,51316,544
2022-10-25,70050,70058,Blue,1,37295,37697,402
2022-04-21,70042,70048,Blue,1,28914,29251,337
2022-03-25,70048,70058,Blue,1,66389,66986,597
2022-02-25,70047,70041,Blue,0,32218,32556,338
2022-03-15,70054,70060,Blue,1,65517,65938,421
2022-01-24,70038,70056,Blue,1,32058,33056,998
2022-03-04,70050,70056,Blue,1,68598,68930,332
2022-06-27,70059,70047,Blue,0,35237,35854,617
2022-02-24,70046,70050,Blue,1,61527,61698,171
2022-10-31,70046,70054,Blue,1,29854,30268,414
2022-11-09,70057,70051,Blue,0,62487,62726,239
2022-09-20,70055,70041,Blue,0,61518,62249,731
2022-11-15,70049,70043,Blue,0,61397,62210,813
2022-08-10,70040,70054,Blue,1,69565,70349,784
2022-03-31,70042,70054,Blue,1,86210,86860,650
2022-01-17,70046,70054,Blue,1,22786,23225,439
2022-07-06,70041,70838,Blue,0,49446,49588,142
2022-08-07,70051,70049,Blue,0,48931,49037,106
2022-01-29,70044,70052,Blue,1,54763,55475,712
2022-01-21,70055,70053,Blue,0,23615,23696,81
2022-09-09,70052,70056,Blue,1,73683,73824,141
2022-09-20,70059,70053,Blue,0,33910,34136,226
2022-08-02,70051,70049,Blue,0,78657,78761,104
2022-07-01,70044,70048,Blue,1,54827,55213,386
2022-10-13,70057,70051,Blue,0,47364,47600,236
2022-09-26,70051,70045,Blue,0,47659,48048,389
2022-08-16,70047,70041,Blue,0,62692,63031,339
2022-02-19,70049,70043,Blue,0,30882,31300,418
2022-10-04,70040,70052,Blue,1,88298,88958,660
2022-04-17,70048,70054,Blue,1,69329,69621,292
2022-06-15,70044,70058,Blue,1,22057,22890,833
2022-08-12,70055,70053,Blue,0,78599,78645,46
2022-10-30,70039,70838,Blue,0,57149,57182,33
2022-02-16,70051,70838,Blue,0,31205,31950,745
2022-06-04,70038,70044,Blue,1,68653,68850,197
2022-12-07,70040,70042,Blue,1,24125,24158,33
2022-01-23,70042,70048,Blue,1,52233,52561,328
2022-04-19,70042,70048,Blue,1,43783,44157,374
2022-08-27,70038,70046,Blue,1,69070,69427,357
2022-07-29,70038,70046,Blue,1,59289,59675,386
2022-04-24,70059,70041,Blue,0,55454,56358,904
2022-05-20,70052,70060,Blue,1,45077,45495,418
2022-07-26,70048,70050,Blue,1,72623,72681,58
2022-06-02,70049,70045,Blue,0,72229,72443,214
2022-06-10,70047,70041,Blue,0,41574,42024,450
2022-09-13,70050,70054,Blue,1,46727,46937,210
2022-03-26,70055,70039,Blue,0,29956,30889,933
2022-04-06,70040,70042,Blue,1,53437,53469,32
2022-04-04,70053,70838,Blue,0,66754,67601,847
2022-12-30,70051,70047,Blue,0,32638,32830,192
2022-06-29,70038,70052,Blue,1,63752,64548,796
2022-02-28,70057,70049,Blue,0,47730,48166,436
2022-10-21,70043,70041,Blue,0,84596,84624,28
2022-07-08,70040,70042,Blue,1,73354,73388,34
2022-04-18,70053,70039,Blue,0,82032,82880,848
2022-07-10,70038,70044,Blue,1,27667,27827,160
2022-03-30,70038,70054,Blue,1,48673,49521,848
2022-07-08,70051,70838,Blue,0,56914,57687,773
2022-08-04,70042,70056,Blue,1,61373,62153,780
2022-07-26,70057,70838,Blue,0,58500,59572,1072
2022-01-23,70042,70046,Blue,1,61407,61576,169
2022-09-20,70057,70051,Blue,0,43245,43513,268
2022-06-23,70044,70054,Blue,1,46474,47236,762
2022-12-03,70045,70043,Blue,0,32175,32269,94
2022-01-24,70044,70060,Blue,1,30759,31716,957
2022-08-11,70051,70039,Blue,0,24206,24863,657
2022-01-15,70057,70049,Blue,0,24214,24613,399
2022-09-13,70044,70052,Blue,1,54088,54553,465
2022-03-30,70057,70043,Blue,0,30942,31685,743
2022-02-08,70047,70838,Blue,0,67780,68234,454
2022-11-28,70040,70060,Blue,1,73679,74666,987
2022-07-30,70048,70054,Blue,1,68507,68864,357
2022-03-13,70053,70838,Blue,0,42436,43320,884
2022-05-20,70048,70056,Blue,1,32095,32555,460
2022-09-09,70053,70051,Blue,0,68510,68575,65
2022-01-23,70049,70838,Blue,0,50530,51209,679
2022-01-26,70057,70055,Blue,0,50308,50377,69
2022-09-22,70053,70041,Blue,0,68382,69035,653
2022-04-15,70059,70053,Blue,0,28472,28738,266
2022-07-25,70057,70053,Blue,0,60253,60430,177
2022-04-29,70053,70051,Blue,0,44397,44457,60
2022-09-18,70049,70041,Blue,0,77547,77955,408
2022-03-10,70054,70060,Blue,1,36232,36524,292
2022-12-08,70040,70048,Blue,1,21426,21806,380
2022-06-24,70047,70039,Blue,0,77170,77594,424
2022-11-11,70052,70060,Blue,1,46853,47196,343
2022-12-05,70053,70838,Blue,0,70466,71215,749
2022-08-05,70042,70046,Blue,1,36902,37101,199
2022-12-06,70040,70042,Blue,1,59937,59978,41
2022-04-10,70059,70057,Blue,0,35536,35572,36
2022-12-08,70053,70039,Blue,0,41984,42755,771
2022-12-21,70051,70043,Blue,0,47756,48220,464
2022-04-20,70045,70043,Blue,0,88228,88318,90
2022-02-09,70046,70058,Blue,1,86940,87566,626
2022-01-07,70042,70052,Blue,1,26955,27579,624
2022-08-21,70049,70043,Blue,0,81385,81737,352
2022-04-11,70042,70044,Blue,1,38763,38797,34
2022-09-06,70055,70051,Blue,0,28006,28156,150
2022-12-23,70042,70046,Blue,1,33591,33762,171
2022-07-20,70047,70838,Blue,0,83699,84154,455
2022-05-27,70046,70048,Blue,1,30482,30580,98
2022-11-19,70057,70047,Blue,0,19669,20262,593
2022-12-14,70046,70052,Blue,1,41823,42171,348
2022-10-02,70050,70054,Blue,1,64072,64269,197
2022-09-08,70049,70041,Blue,0,27306,27796,490
2022-06-04,70049,70041,Blue,0,25538,26005,467
2022-03-24,70042,70056,Blue,1,21222,22028,806
2022-04-16,70042,70052,Blue,1,52597,53225,628
2022-07-31,70045,70838,Blue,0,33965,34311,346
2022-07-12,70042,70054,Blue,1,60012,61013,1001
2022-09-28,70059,70045,Blue,0,46815,47544,729
2022-02-25,70055,70053,Blue,0,67704,67761,57
2022-09-23,70059,70053,Blue,0,78753,78971,218
2022-03-25,70059,70047,Blue,0,42686,43279,593
2022-12-05,70040,70056,Blue,1,75257,76063,806
2022-06-20,70049,70039,Blue,0,23095,23638,543
2022-06-16,70049,70041,Blue,0,81065,81495,430
2022-01-11,70049,70041,Blue,0,66689,67076,387
2022-11-25,70048,70056,Blue,1,70000,70382,382
2022-09-08,70049,70047,Blue,0,69241,69295,54
2022-02-09,70046,70048,Blue,1,80143,80227,84
2022-02-11,70056,70060,Blue,1,28533,28732,199
2022-10-16,70040,70054,Blue,1,63498,64274,776
2022-03-01,70048,70052,Blue,1,21277,21501,224
2022-07-11,70046,70058,Blue,1,46547,47202,655
2022-07-26,70038,70054,Blue,1,33325,34190,865
2022-10-25,70047,70045,Blue,0,69277,69374,97
2022-08-18,70045,70041,Blue,0,25798,26002,204
2022-02-02,70047,70043,Blue,0,52698,53090,392
2022-08-13,70053,70838,Blue,0,28952,29882,930
2022-09-28,70057,70043,Blue,0,53136,53928,792
2022-07-02,70059,70055,Blue,0,84018,84161,143
2022-12-21,70044,70050,Blue,1,49666,49987,321
2022-12-27,70052,70054,Blue,1,73243,73284,41
2022-11-13,70044,70052,Blue,1,27868,28342,474
2022-12-21,70046,70052,Blue,1,89216,89609,393
2022-03-01,70059,70053,Blue,0,24555,24832,277
2022-12-04,70049,70043,Blue,0,38940,39316,376
2022-07-22,70045,70041,Blue,0,66038,66229,191
2022-01-19,70059,70043,Blue,0,58695,59543,848
2022-11-07,70057,70047,Blue,0,46907,47381,474
2022-06-28,70042,70046,Blue,1,23482,23675,193
2022-12-14,70059,70043,Blue,0,62954,63842,888
2022-12-17,70038,70044,Blue,1,64746,64947,201
2022-06-23,70055,70047,Blue,0,54275,54712,437
2022-12-27,70046,70050,Blue,1,89643,89832,189
2022-02-07,70057,70838,Blue,0,88177,89599,1422
2022-09-12,70046,70050,Blue,1,51826,52028,202
2022-02-04,70040,70042,Blue,1,64062,64096,34
2022-08-10,70047,70041,Blue,0,29493,29852,359
2022-06-13,70039,70838,Blue,0,35039,35162,123
2022-06-27,70047,70045,Blue,0,23315,23420,105
2022-08-16,70055,70039,Blue,0,35628,36549,921
2022-08-23,70048,70056,Blue,1,25875,26295,420
2022-11-07,70042,70058,Blue,1,81234,82080,846
2022-06-13,70048,70058,Blue,1,65428,65939,511
2022-05-14,70057,70055,Blue,0,64311,64381,70
2022-03-14,70049,70045,Blue,0,22974,23198,224
2022-04-23,70040,70044,Blue,1,44314,44450,136
2022-10-29,70057,70045,Blue,0,66572,67176,604
2022-02-15,70042,70050,Blue,1,26491,26928,437
2022-12-22,70051,70838,Blue,0,86445,87129,684
2022-09-16,70047,70039,Blue,0,64826,65253,427
2022-09-23,70038,70046,Blue,1,71676,72026,350
2022-09-30,70050,70060,Blue,1,22355,23075,720
2022-07-24,70058,70060,Blue,1,66611,66670,59
2022-02-27,70044,70050,Blue,1,56674,57044,370
2022-03-04,70042,70044,Blue,1,82181,82210,29
2022-03-16,70055,70053,Blue,0,62489,62534,45
2022-11-22,70053,70045,Blue,0,52788,53211,423
2022-07-27,70055,70051,Blue,0,74557,74700,143
2022-11-16,70042,70056,Blue,1,67527,68349,822
2022-04-07,70059,70047,Blue,0,77776,78337,561
2022-06-11,70039,70838,Blue,0,55835,55870,35
2022-06-08,70049,70039,Blue,0,72555,73118,563
2022-08-13,70057,70047,Blue,0,77911,78393,482
2022-11-26,70038,70048,Blue,1,86415,86896,481
2022-02-20,70055,70039,Blue,0,66990,67941,951
2022-01-26,70057,70055,Blue,0,29134,29203,69
2022-01-14,70051,70041,Blue,0,69868,70471,603
2022-01-27,70043,70041,Blue,0,57493,57521,28
2022-12-22,70049,70039,Blue,0,32934,33415,481
2022-07-07,70039,70838,Blue,0,21686,21725,39
2022-05-19,70059,70041,Blue,0,30561,31638,1077
2022-11-22,70047,70838,Blue,0,20927,21406,479
2022-08-15,70045,70838,Blue,0,83132,83459,327
2022-01-05,70040,70058,Blue,1,74771,75743,972
2022-07-04,70038,70052,Blue,1,64649,65382,733
2022-08-01,70038,70056,Blue,1,50239,51245,1006
2022-03-09,70050,70058,Blue,1,66508,66937,429
2022-12-28,70057,70055,Blue,0,31400,31470,70
2022-12-20,70055,70049,Blue,0,57236,57525,289
2022-08-27,70058,70060,Blue,1,24641,24700,59
2022-07-16,70045,70838,Blue,0,33226,33567,341
2022-07-09,70053,70039,Blue,0,22483,23366,883
2022-06-01,70047,70041,Blue,0,35840,36180,340
2022-09-04,70058,70060,Blue,1,78456,78515,59
2022-09-01,70038,70046,Blue,1,30265,30584,319
2022-08-10,70040,70048,Blue,1,41044,41454,410
2022-09-27,70052,70058,Blue,1,56224,56468,244
2022-02-11,70049,70047,Blue,0,69593,69649,56
2022-02-28,70049,70838,Blue,0,87987,88540,553
2022-12-29,70049,70838,Blue,0,63105,63703,598
2022-09-11,70046,70052,Blue,1,48716,49047,331
2022-11-01,70051,70049,Blue,0,73188,73290,102
2022-11-16,70058,70060,Blue,1,48216,48278,62
2022-03-14,70048,70056,Blue,1,52495,52907,412
2022-10-12,70051,70041,Blue,0,24993,25571,578
2022-12-15,70051,70838,Blue,0,79047,79799,752
2022-04-22,70040,70058,Blue,1,39679,40581,902
2022-11-29,70053,70045,Blue,0,26947,27391,444
2022-04-06,70053,70045,Blue,0,63392,63847,455
2022-06-09,70048,70050,Blue,1,33805,33871,66
2022-03-17,70038,70044,Blue,1,58931,59126,195
2022-05-26,70041,70838,Blue,0,64011,64140,129
2022-01-18,70042,70050,Blue,1,68841,69241,400
2022-10-08,70055,70838,Blue,0,70466,71388,922
2022-01-28,70050,70052,Blue,1,36069,36192,123
2022-09-06,70042,70054,Blue,1,48837,49502,665
2022-07-23,70051,70045,Blue,0,43641,43987,346
2022-05-12,70056,70058,Blue,1,54071,54142,71
2022-09-22,70052,70056,Blue,1,27676,27830,154
2022-10-30,70055,70838,Blue,0,66437,67397,960
2022-12-16,70051,70047,Blue,0,52863,53063,200
2022-04-16,70042,70058,Blue,1,62240,63116,876
2022-08-01,70038,70060,Blue,1,55994,57131,1137
2022-01-18,70051,70041,Blue,0,38553,39094,541
2022-03-08,70038,70042,Blue,1,50780,50906,126
2022-11-15,70038,70060,Blue,1,39853,41136,1283
2022-09-11,70045,70039,Blue,0,69163,69416,253
2022-12-21,70047,70838,Blue,0,59407,59920,513
2022-10-27,70048,70056,Blue,1,31132,31540,408
2022-04-01,70050,70052,Blue,1,67122,67237,115
2022-09-24,70059,70057,Blue,0,51366,51401,35
2022-04-15,70050,70054,Blue,1,68219,68434,215
2022-10-19,70053,70838,Blue,0,42021,42881,860
2022-08-30,70045,70041,Blue,0,27961,28146,185
2022-08-25,70038,70060,Blue,1,61264,62490,1226
2022-03-01,70048,70058,Blue,1,37293,37870,577
2022-06-03,70040,70044,Blue,1,28690,28801,111
2022-03-10,70050,70056,Blue,1,60469,60755,286
2022-10-23,70045,70838,Blue,0,34726,35082,356
2022-05-25,70049,70041,Blue,0,86571,87074,503
2022-06-12,70040,70050,Blue,1,89181,89739,558
2022-03-05,70059,70057,Blue,0,31392,31428,36
2022-05-19,70053,70045,Blue,0,21244,21791,547
2022-08-31,70052,70054,Blue,1,42744,42803,59
2022-03-04,70047,70043,Blue,0,88089,88335,246
2022-07-02,70058,70060,Blue,1,39365,39440,75
2022-08-27,70039,70838,Blue,0,42182,42217,35
2022-09-20,70042,70046,Blue,1,68094,68267,173
2022-09-10,70040,70054,Blue,1,53493,54884,1391
2022-04-11,70042,70050,Blue,1,60890,61343,453
2022-01-10,70055,70838,Blue,0,66096,67036,940
2022-03-20,70040,70048,Blue,1,51283,51723,440
2022-08-23,70051,70039,Blue,0,67221,67886,665
2022-08-10,70048,70056,Blue,1,79524,79935,411
2022-11-25,70042,70054,Blue,1,80115,80752,637
2022-10-22,70059,70838,Blue,0,41664,42800,1136
2022-04-06,70038,70048,Blue,1,53355,53840,485
2022-07-26,70046,70048,Blue,1,32458,32539,81
2022-04-23,70053,70041,Blue,0,67302,68033,731
2022-01-25,70046,70054,Blue,1,46739,47146,407
2022-10-05,70044,70058,Blue,1,54718,55520,802
2022-06-27,70051,70838,Blue,0,77661,78407,746
2022-03-16,70056,70060,Blue,1,55508,55709,201
2022-10-12,70057,70043,Blue,0,21799,22769,970
2022-03-05,70046,70048,Blue,1,51120,51193,73
2022-12-10,70044,70054,Blue,1,24522,25105,583
2022-11-07,70055,70838,Blue,0,78617,79486,869
2022-11-14,70049,70039,Blue,0,45796,46252,456
2022-04-13,70050,70054,Blue,1,24221,24434,213
2022-08-11,70059,70045,Blue,0,43628,44378,750
2022-02-19,70055,70053,Blue,0,34809,34854,45
2022-04-27,70056,70058,Blue,1,43302,43379,77
2022-07-01,70055,70045,Blue,0,60530,61064,534
2022-11-10,70043,70838,Blue,0,41529,41722,193
2022-08-18,70050,70060,Blue,1,71943,72469,526
2022-07-05,70042,70060,Blue,1,36306,37654,1348
2022-08-10,70050,70060,Blue,1,68017,68640,623
2022-02-04,70059,70051,Blue,0,58579,58929,350
2022-06-27,70038,70048,Blue,1,36664,37151,487
2022-10-10,70057,70049,Blue,0,24832,25229,397
2022-10-21,70050,70054,Blue,1,26749,26959,210
2022-09-08,70053,70043,Blue,0,34368,35034,666
2022-04-04,70055,70045,Blue,0,76206,76848,642
2022-09-05,70041,70039,Blue,0,69900,69928,28
2022-01-26,70051,70041,Blue,0,88467,89054,587
2022-02-14,70053,70041,Blue,0,85476,86163,687
2022-01-01,70042,70048,Blue,1,41142,41437,295
2022-06-22,70050,70052,Blue,1,65085,65204,119
2022-03-07,70040,70050,Blue,1,55748,56322,574
2022-11-18,70040,70056,Blue,1,37333,38188,855
2022-01-16,70049,70838,Blue,0,84314,84921,607
2022-12-30,70041,70838,Blue,0,88470,88587,117
2022-11-10,70055,70047,Blue,0,35440,35870,430
2022-08-17,70042,70046,Blue,1,82745,82929,184
2022-06-30,70056,70060,Blue,1,26303,26699,396
2022-03-20,70040,70056,Blue,1,72144,73031,887
2022-06-14,70057,70055,Blue,0,80678,80746,68
2022-08-12,70059,70049,Blue,0,66557,67029,472
2022-06-15,70059,70047,Blue,0,23958,24563,605
2022-03-22,70051,70049,Blue,0,27358,27491,133
2022-10-18,70045,70838,Blue,0,45181,45510,329
2022-04-11,70044,70056,Blue,1,65464,66106,642
2022-08-20,70050,70056,Blue,1,40560,40848,288
2022-09-07,70053,70045,Blue,0,85227,85630,403
2022-12-14,70045,70039,Blue,0,77242,77493,251
2022-09-07,70057,70051,Blue,0,20489,20727,238
2022-07-21,70042,70054,Blue,1,47830,48558,728
2022-04-01,70053,70041,Blue,0,46927,47607,680
2022-03-01,70053,70051,Blue,0,55317,55366,49
2022-09-07,70042,70048,Blue,1,59118,59431,313
2022-08-01,70047,70838,Blue,0,50028,50581,553
2022-04-17,70044,70052,Blue,1,72838,73347,509
2022-11-05,70052,70056,Blue,1,54195,54339,144
2022-03-24,70044,70050,Blue,1,42629,42999,370
2022-12-21,70044,70050,Blue,1,41569,41924,355
2022-07-02,70047,70045,Blue,0,79707,79821,114
2022-01-30,70040,70048,Blue,1,86694,87228,534
2022-01-01,70040,70050,Blue,1,75927,76407,480
2022-02-05,70051,70045,Blue,0,36095,36448,353
2022-04-13,70048,70056,Blue,1,30744,31146,402
2022-08-12,70047,70838,Blue,0,36567,37121,554
2022-05-21,70041,70838,Blue,0,69712,69987,275
2022-10-25,70038,70040,Blue,1,71586,71602,16
2022-01-23,70050,70060,Blue,1,49504,50035,531
2022-06-01,70042,70048,Blue,1,67735,68101,366
2022-06-16,70044,70046,Blue,1,26273,26389,116
2022-02-17,70051,70047,Blue,0,56683,56881,198
2022-07-17,70056,70058,Blue,1,32527,32602,75
2022-11-24,70041,70838,Blue,0,70444,70558,114
2022-03-29,70046,70056,Blue,1,80882,81475,593
2022-03-04,70051,70047,Blue,0,54525,54707,182
2022-04-06,70043,70041,Blue,0,68696,68723,27
2022-12-16,70046,70050,Blue,1,86170,86359,189
2022-03-01,70055,70043,Blue,0,34331,35090,759
2022-11-15,70056,70058,Blue,1,82852,82929,77
2022-03-25,70059,70055,Blue,0,46638,46784,146
2022-05-31,70047,70041,Blue,0,47671,48049,378
2022-07-31,70043,70041,Blue,0,48273,48301,28
2022-08-01,70059,70041,Blue,0,37964,38891,927
2022-03-02,70057,70045,Blue,0,47189,47831,642
2022-02-15,70055,70045,Blue,0,26283,26876,593
2022-03-12,70040,70050,Blue,1,86514,87084,570
2022-11-01,70040,70054,Blue,1,57631,58521,890
2022-03-03,70038,70042,Blue,1,28496,28598,102
2022-06-13,70059,70053,Blue,0,59597,59820,223
2022-11-15,70051,70043,Blue,0,38346,38837,491
2022-08-28,70055,70043,Blue,0,69144,69799,655
2022-08-10,70053,70045,Blue,0,21110,21540,430
2022-04-21,70057,70051,Blue,0,28248,28504,256
2022-05-28,70048,70050,Blue,1,33198,33257,59
2022-01-17,70047,70043,Blue,0,82915,83134,219
2022-07-02,70051,70043,Blue,0,81071,81582,511
2022-08-25,70053,70041,Blue,0,63166,63915,749
2022-02-24,70050,70052,Blue,1,83791,83920,129
2022-06-22,70048,70052,Blue,1,52933,53142,209
2022-04-18,70056,70058,Blue,1,43041,43113,72
2022-01-27,70042,70054,Blue,1,62098,62777,679
2022-01-06,70050,70054,Blue,1,72020,72230,210
2022-02-22,70046,70052,Blue,1,67394,67758,364
2022-09-29,70052,70060,Blue,1,55288,55640,352
2022-12-30,70046,70060,Blue,1,44836,45578,742
2022-06-17,70057,70043,Blue,0,46198,47027,829
2022-07-15,70044,70060,Blue,1,22094,23039,945
2022-07-27,70042,70048,Blue,1,29150,29442,292
2022-04-15,70049,70039,Blue,0,42061,42572,511
2022-01-22,70043,70838,Blue,0,85016,85212,196
2022-09-08,70059,70039,Blue,0,75453,76464,1011
2022-11-23,70049,70039,Blue,0,33072,33574,502
2022-07-22,70042,70048,Blue,1,44207,44518,311
2022-07-30,70048,70058,Blue,1,54500,55029,529
2022-02-28,70051,70043,Blue,0,43588,44063,475
2022-03-25,70055,70047,Blue,0,58873,59246,373
2022-01-04,70055,70838,Blue,0,57369,58216,847
2022-01-27,70054,70058,Blue,1,43062,43248,186
2022-03-31,70050,70060,Blue,1,35059,35645,586
2022-11-28,70057,70045,Blue,0,74993,75563,570
2022-11-03,70051,70047,Blue,0,66917,67116,199
2022-12-10,70044,70052,Blue,1,69329,69833,504
2022-08-04,70054,70058,Blue,1,58577,58736,159
2022-03-30,70038,70056,Blue,1,78666,79660,994
2022-06-25,70052,70056,Blue,1,41262,41428,166
2022-11-29,70038,70046,Blue,1,60728,61115,387
2022-08-26,70057,70838,Blue,0,26467,27626,1159
2022-02-04,70040,70046,Blue,1,84401,84659,258
2022-06-13,70045,70043,Blue,0,73428,73550,122
2022-10-22,70045,70838,Blue,0,57565,57941,376
2022-10-05,70051,70049,Blue,0,30519,30626,107
2022-12-14,70045,70043,Blue,0,57665,57745,80
2022-07-06,70038,70056,Blue,1,80073,80982,909
2022-12-01,70055,70049,Blue,0,57154,57441,287
2022-03-13,70054,70060,Blue,1,64919,65196,277
2022-07-27,70051,70047,Blue,0,70591,70792,201
2022-11-21,70059,70043,Blue,0,19948,20898,950
2022-11-04,70059,70039,Blue,0,66348,67702,1354
2022-07-05,70050,70060,Blue,1,60462,60965,503
2022-05-06,70050,70056,Blue,1,51585,51879,294
2022-11-20,70038,70058,Blue,1,68295,69337,1042
2022-11-26,70043,70041,Blue,0,27386,27413,27
2022-04-19,70052,70060,Blue,1,67817,68209,392
2022-09-16,70045,70043,Blue,0,49158,49262,104
2022-03-13,70051,70045,Blue,0,37247,37587,340
2022-07-14,70057,70049,Blue,0,23109,23545,436
2022-11-27,70044,70058,Blue,1,77695,78502,807
2022-01-11,70055,70051,Blue,0,29847,30013,166
2022-11-14,70057,70051,Blue,0,40194,40466,272
2022-01-12,70038,70046,Blue,1,83112,83456,344
2022-06-03,70047,70039,Blue,0,88056,88540,484
2022-02-01,70056,70058,Blue,1,82295,82367,72
2022-09-11,70043,70039,Blue,0,29423,29524,101
2022-03-25,70046,70050,Blue,1,82973,83139,166
2022-03-19,70057,70055,Blue,0,47667,47735,68
2022-02-22,70059,70043,Blue,0,28460,29406,946
2022-03-26,70055,70051,Blue,0,49405,49538,133
2022-11-22,70039,70838,Blue,0,74778,74812,34
2022-03-17,70040,70042,Blue,1,21938,21972,34
2022-01-06,70053,70043,Blue,0,40947,41623,676
2022-01-26,70056,70060,Blue,1,56937,57191,254
2022-07-09,70052,70060,Blue,1,69877,70239,362
2022-04-14,70049,70047,Blue,0,63677,63734,57
2022-06-06,70047,70045,Blue,0,78813,78923,110
2022-07-08,70050,70060,Blue,1,54787,55312,525
2022-08-26,70057,70053,Blue,0,80448,80608,160
2022-06-07,70038,70052,Blue,1,76214,77065,851
2022-03-18,70043,70039,Blue,0,51616,51726,110
2022-11-02,70054,70060,Blue,1,70390,70664,274
2022-01-21,70053,70049,Blue,0,75192,75392,200
2022-07-06,70059,70039,Blue,0,86666,87649,983
2022-08-15,70059,70043,Blue,0,88688,89511,823
2022-12-04,70053,70043,Blue,0,76259,76822,563
2022-01-04,70050,70052,Blue,1,66717,66835,118
2022-04-19,70046,70056,Blue,1,69326,69838,512
2022-08-17,70042,70060,Blue,1,58726,59724,998
2022-11-09,70040,70042,Blue,1,42490,42522,32
2022-10-19,70055,70047,Blue,0,55760,56163,403
2022-08-10,70057,70053,Blue,0,53006,53162,156
2022-08-16,70052,70054,Blue,1,71294,71352,58
2022-01-25,70049,70838,Blue,0,30377,31002,625
2022-08-13,70046,70058,Blue,1,82595,83264,669
2022-10-19,70040,70058,Blue,1,82719,83709,990
2022-12-10,70048,70054,Blue,1,80464,80768,304
2022-02-03,70059,70057,Blue,0,65897,65934,37
2022-11-06,70045,70043,Blue,0,58361,58449,88
2022-10-06,70040,70046,Blue,1,26960,27219,259
2022-04-17,70042,70056,Blue,1,68981,69704,723
2022-01-27,70055,70047,Blue,0,50011,50431,420
2022-03-09,70046,70056,Blue,1,61424,61951,527
2022-12-10,70050,70054,Blue,1,44843,45044,201
2022-11-21,70055,70041,Blue,0,68860,69663,803
2022-11-23,70043,70039,Blue,0,55773,55897,124
2022-01-10,70055,70041,Blue,0,23250,24135,885
2022-07-14,70059,70057,Blue,0,81139,81174,35
2022-04-22,70053,70041,Blue,0,41213,41920,707
2022-10-26,70042,70046,Blue,1,88341,88521,180
2022-09-13,70056,70060,Blue,1,89955,90124,169
2022-09-10,70058,70060,Blue,1,58837,58897,60
2022-01-22,70058,70060,Blue,1,77159,77226,67
2022-10-05,70046,70056,Blue,1,45487,46025,538
2022-02-24,70059,70045,Blue,0,48675,49367,692
2022-10-09,70057,70047,Blue,0,71193,71834,641
2022-08-09,70050,70058,Blue,1,48309,48698,389
2022-07-21,70053,70041,Blue,0,35632,36361,729
2022-03-08,70040,70054,Blue,1,32454,33227,773
2022-05-20,70038,70042,Blue,1,58367,58467,100
2022-04-18,70044,70054,Blue,1,72218,72810,592
2022-12-17,70041,70838,Blue,0,25148,25278,130
2022-05-26,70038,70050,Blue,1,79215,79868,653
2022-07-14,70053,70045,Blue,0,65339,65918,579
2022-11-17,70055,70053,Blue,0,61024,61071,47
2022-08-16,70048,70056,Blue,1,62978,63454,476
2022-01-05,70057,70045,Blue,0,57871,58513,642
2022-08-15,70057,70047,Blue,0,79528,80019,491
2022-12-12,70042,70058,Blue,1,43352,44270,918
2022-02-18,70049,70041,Blue,0,48196,48659,463
2022-04-24,70042,70048,Blue,1,34830,35156,326
2022-02-01,70051,70049,Blue,0,78731,78840,109
2022-07-31,70053,70043,Blue,0,35796,36391,595
2022-12-26,70057,70055,Blue,0,71190,71259,69
2022-03-20,70040,70042,Blue,1,64046,64081,35
2022-05-28,70038,70052,Blue,1,63259,64115,856
2022-06-28,70043,70838,Blue,0,85964,86280,316
2022-03-08,70042,70050,Blue,1,62093,62506,413
2022-04-11,70041,70039,Blue,0,29545,29577,32
2022-10-12,70046,70052,Blue,1,85278,85605,327
2022-12-25,70047,70039,Blue,0,67960,68356,396
2022-07-12,70043,70039,Blue,0,88202,88301,99
2022-07-15,70040,70050,Blue,1,55056,55546,490
2022-03-31,70043,70838,Blue,0,22262,22470,208
2022-08-11,70054,70058,Blue,1,62384,62544,160
2022-09-13,70046,70058,Blue,1,27296,27910,614
2022-01-10,70045,70043,Blue,0,42858,42946,88
2022-08-01,70055,70043,Blue,0,39195,39921,726
2022-08-20,70055,70838,Blue,0,67293,68263,970
2022-02-04,70059,70051,Blue,0,69898,70261,363
2022-04-15,70046,70060,Blue,1,29675,30533,858
2022-12-11,70055,70047,Blue,0,54028,54406,378
2022-11-09,70043,70041,Blue,0,42967,42996,29
2022-04-05,70058,70060,Blue,1,72527,72606,79
2022-04-15,70048,70054,Blue,1,66117,66424,307
2022-03-18,70049,70039,Blue,0,50733,51280,547
2022-11-15,70052,70054,Blue,1,32675,32733,58
2022-06-13,70041,70039,Blue,0,71563,71598,35
2022-02-20,70057,70049,Blue,0,50122,50505,383
2022-09-14,70048,70054,Blue,1,59145,59476,331
2022-02-13,70055,70041,Blue,0,31882,32645,763
2022-02-01,70057,70047,Blue,0,57918,58405,487
2022-03-27,70045,70838,Blue,0,50281,50625,344
2022-04-05,70049,70043,Blue,0,28106,28499,393
2022-07-26,70053,70838,Blue,0,77739,78664,925
2022-12-05,70055,70045,Blue,0,87498,88030,532
2022-02-20,70059,70055,Blue,0,33197,33339,142
2022-01-16,70057,70045,Blue,0,86489,87152,663
2022-07-05,70059,70838,Blue,0,84485,85576,1091
2022-01-20,70046,70056,Blue,1,28906,29476,570
2022-06-11,70038,70056,Blue,1,64772,65752,980
2022-12-20,70040,70044,Blue,1,84681,84797,116
2022-06-23,70038,70052,Blue,1,38724,39541,817
2022-06-16,70059,70057,Blue,0,26056,26107,51
2022-11-26,70051,70039,Blue,0,40408,41055,647
2022-09-29,70059,70838,Blue,0,54074,55192,1118
2022-11-12,70044,70048,Blue,1,70513,70772,259
2022-03-02,70049,70838,Blue,0,48700,49294,594
2022-07-06,70049,70838,Blue,0,64326,64959,633
2022-04-27,70057,70049,Blue,0,82960,83384,424
2022-11-02,70038,70042,Blue,1,46634,46717,83
2022-04-18,70040,70050,Blue,1,47596,48136,540
2022-01-17,70047,70045,Blue,0,35851,35963,112
2022-09-14,70047,70043,Blue,0,57470,57715,245
2022-03-13,70039,70838,Blue,0,32603,32638,35
2022-04-14,70049,70047,Blue,0,29311,29377,66
2022-01-15,70051,70047,Blue,0,71896,72098,202
2022-09-16,70038,70058,Blue,1,83396,84451,1055
2022-08-18,70055,70838,Blue,0,21887,22952,1065
2022-10-19,70040,70056,Blue,1,53565,54560,995
2022-07-02,70053,70039,Blue,0,63530,64318,788
2022-03-24,70038,70054,Blue,1,76339,77171,832
2022-04-22,70042,70044,Blue,1,19971,20001,30
2022-03-03,70053,70041,Blue,0,27244,27953,709
2022-03-07,70051,70049,Blue,0,30947,31051,104
2022-01-11,70044,70058,Blue,1,25996,26956,960
2022-08-11,70040,70054,Blue,1,51459,52240,781
2022-10-26,70045,70838,Blue,0,70409,70782,373
2022-04-12,70059,70041,Blue,0,20592,21494,902
2022-12-27,70042,70052,Blue,1,67847,68398,551
2022-11-27,70057,70041,Blue,0,22296,23123,827
2022-04-11,70038,70056,Blue,1,86029,86951,922
2022-02-02,70047,70041,Blue,0,25466,25835,369
2022-02-06,70059,70047,Blue,0,65718,66327,609
2022-12-09,70044,70054,Blue,1,26279,26872,593
2022-04-22,70055,70043,Blue,0,59199,59895,696
2022-12-19,70042,70046,Blue,1,76609,76788,179
2022-09-08,70047,70041,Blue,0,66438,66800,362
2022-11-04,70044,70056,Blue,1,56037,56676,639
2022-12-30,70053,70838,Blue,0,84738,85521,783
2022-04-16,70046,70048,Blue,1,45672,45765,93
2022-04-14,70039,70838,Blue,0,64826,64872,46
2022-10-27,70053,70045,Blue,0,82461,82886,425
2022-03-24,70057,70043,Blue,0,25831,26634,803
2022-11-02,70051,70049,Blue,0,27946,28048,102
2022-11-30,70052,70054,Blue,1,26828,26878,50
2022-06-10,70044,70052,Blue,1,69361,70191,830
2022-02-16,70045,70039,Blue,0,34040,34319,279
2022-09-02,70045,70043,Blue,0,27983,28075,92
2022-11-16,70059,70053,Blue,0,34888,35134,246
2022-04-23,70041,70838,Blue,0,45981,46123,142
2022-08-16,70038,70048,Blue,1,84318,84777,459
2022-12-02,70040,70052,Blue,1,38415,39063,648
2022-10-18,70050,70056,Blue,1,55991,56313,322
2022-12-29,70044,70054,Blue,1,63016,63609,593
2022-08-29,70042,70050,Blue,1,61347,61780,433
2022-10-18,70059,70043,Blue,0,82823,83654,831
2022-06-10,70040,70048,Blue,1,33141,33586,445
2022-03-13,70038,70046,Blue,1,28454,28757,303
2022-04-07,70048,70056,Blue,1,32570,32971,401
2022-08-12,70049,70045,Blue,0,66098,66287,189
2022-07-11,70059,70049,Blue,0,75917,76373,456
2022-11-21,70055,70838,Blue,0,56838,57827,989
2022-10-02,70047,70043,Blue,0,29917,30174,257
2022-06-19,70040,70042,Blue,1,67819,67853,34
2022-02-28,70046,70056,Blue,1,52322,52925,603
2022-12-29,70057,70047,Blue,0,23418,23894,476
2022-10-31,70057,70053,Blue,0,47904,48049,145
2022-11-21,70050,70052,Blue,1,53582,53696,114
2022-09-15,70053,70838,Blue,0,62145,62962,817
2022-07-13,70038,70042,Blue,1,90022,90918,896
2022-05-02,70057,70047,Blue,0,66525,67311,786
2022-04-18,70052,70058,Blue,1,88591,88850,259
2022-09-25,70059,70043,Blue,0,75976,76811,835
2022-12-04,70055,70039,Blue,0,69687,70522,835
2022-04-06,70047,70045,Blue,0,71114,71219,105
2022-02-02,70051,70039,Blue,0,65347,66095,748
2022-02-28,70044,70054,Blue,1,55907,56523,616
2022-01-27,70057,70053,Blue,0,71073,71238,165
2022-03-28,70057,70053,Blue,0,37086,37247,161
2022-01-26,70059,70039,Blue,0,55145,56361,1216
2022-08-18,70051,70838,Blue,0,74339,75038,699
2022-07-27,70038,70052,Blue,1,31549,32283,734
2022-04-05,70059,70053,Blue,0,63790,64014,224
2022-09-24,70053,70838,Blue,0,78030,78825,795
2022-06-13,70038,70048,Blue,1,65830,66367,537
2022-09-30,70051,70047,Blue,0,60435,60636,201
2022-01-19,70042,70056,Blue,1,50929,51787,858
2022-06-08,70045,70039,Blue,0,47554,47835,281
2022-03-17,70054,70058,Blue,1,63996,64465,469
2022-10-20,70044,70054,Blue,1,30503,31153,650
2022-07-01,70046,70048,Blue,1,54766,54866,100
2022-01-24,70049,70045,Blue,0,71468,71679,211
2022-09-09,70047,70838,Blue,0,25532,26072,540
2022-12-31,70049,70045,Blue,0,80621,80829,208
2022-03-09,70049,70838,Blue,0,54173,54857,684
2022-01-09,70046,70060,Blue,1,49784,50529,745
2022-07-22,70039,70838,Blue,0,87307,87341,34
2022-04-06,70046,70052,Blue,1,22530,22881,351
2022-05-19,70041,70838,Blue,0,74369,74480,111
2022-09-19,70059,70049,Blue,0,69919,70398,479
2022-11-24,70040,70042,Blue,1,38409,38441,32
2022-03-29,70044,70058,Blue,1,44355,45272,917
2022-04-22,70042,70056,Blue,1,59379,60138,759
2022-11-13,70043,70838,Blue,0,66594,66772,178
2022-03-07,70047,70045,Blue,0,84596,84696,100
2022-10-10,70038,70052,Blue,1,46132,46897,765
2022-12-01,70038,70046,Blue,1,55993,56547,554
2022-04-18,70058,70060,Blue,1,61326,61507,181
2022-08-06,70059,70039,Blue,0,87375,88401,1026
2022-02-01,70059,70051,Blue,0,53596,53922,326
2022-04-21,70044,70058,Blue,1,66626,67387,761
2022-04-14,70041,70039,Blue,0,75423,75457,34
2022-03-30,70053,70041,Blue,0,43013,43796,783
2022-08-09,70046,70050,Blue,1,74657,74845,188
2022-10-07,70048,70054,Blue,1,87087,87412,325
2022-02-22,70040,70056,Blue,1,82682,83547,865
2022-02-11,70038,70044,Blue,1,84247,84450,203
2022-06-13,70046,70058,Blue,1,36120,36806,686
2022-02-17,70046,70050,Blue,1,42525,42731,206
2022-03-31,70057,70047,Blue,0,69182,69642,460
2022-08-17,70055,70838,Blue,0,21040,22079,1039
2022-06-29,70047,70045,Blue,0,69950,70033,83
2022-09-01,70050,70052,Blue,1,88847,88973,126
2022-07-22,70051,70043,Blue,0,29246,29763,517
2022-12-31,70049,70838,Blue,0,89763,90377,614
2022-12-02,70059,70057,Blue,0,35799,35835,36
2022-05-09,70058,70060,Blue,1,60136,60204,68
2022-10-30,70038,70054,Blue,1,44323,45194,871
2022-07-26,70049,70039,Blue,0,79659,80195,536
2022-12-02,70052,70054,Blue,1,70307,70358,51
2022-03-27,70055,70838,Blue,0,71839,72724,885
2022-08-20,70048,70058,Blue,1,66949,67493,544
2022-01-05,70057,70838,Blue,0,57573,58610,1037
2022-02-08,70042,70058,Blue,1,86707,87560,853
2022-04-01,70042,70050,Blue,1,67489,67887,398
2022-01-04,70053,70043,Blue,0,54167,54732,565
2022-09-16,70049,70838,Blue,0,78624,79224,600
2022-03-10,70050,70060,Blue,1,55162,55969,807
2022-09-29,70048,70052,Blue,1,33790,34030,240
2022-07-06,70038,70046,Blue,1,73155,73572,417
2022-12-12,70059,70053,Blue,0,70699,70918,219
2022-02-26,70038,70044,Blue,1,28593,28769,176
2022-09-12,70042,70056,Blue,1,25450,26222,772
2022-02-23,70052,70060,Blue,1,49496,49854,358
2022-05-22,70044,70048,Blue,1,52811,53130,319
2022-08-30,70055,70047,Blue,0,67771,68137,366
2022-04-21,70050,70052,Blue,1,27817,27922,105
2022-08-02,70057,70055,Blue,0,30217,30285,68
2022-09-05,70050,70052,Blue,1,68844,68950,106
2022-10-27,70059,70055,Blue,0,75372,75529,157
2022-11-21,70038,70040,Blue,1,67948,67966,18
2022-06-22,70051,70047,Blue,0,49857,50074,217
2022-02-14,70040,70056,Blue,1,21064,21941,877
2022-08-05,70049,70041,Blue,0,23077,23497,420
2022-11-23,70047,70041,Blue,0,40141,40476,335
2022-02-27,70055,70838,Blue,0,69682,70588,906
2022-09-06,70040,70052,Blue,1,29489,30144,655
2022-02-28,70050,70058,Blue,1,73097,73514,417
2022-08-02,70038,70056,Blue,1,46383,47329,946
2022-09-04,70044,70052,Blue,1,62019,62502,483
2022-06-14,70049,70039,Blue,0,81145,81674,529
2022-02-09,70050,70058,Blue,1,80369,80789,420
2022-01-25,70051,70039,Blue,0,27916,28629,713
2022-03-31,70051,70838,Blue,0,29437,30230,793
2022-12-26,70049,70041,Blue,0,84253,84635,382
2022-08-08,70038,70048,Blue,1,69518,70057,539
2022-12-19,70046,70052,Blue,1,85538,85881,343
2022-07-12,70046,70056,Blue,1,54341,54858,517
2022-01-20,70057,70043,Blue,0,31836,32621,785
2022-12-30,70059,70045,Blue,0,44836,45587,751
2022-08-06,70057,70039,Blue,0,66033,67123,1090
2022-06-13,70038,70052,Blue,1,48698,49475,777
2022-06-19,70059,70057,Blue,0,83780,83823,43
2022-08-17,70059,70041,Blue,0,37962,39068,1106
2022-08-09,70047,70045,Blue,0,67841,67928,87
2022-04-21,70040,70044,Blue,1,87193,87305,112
2022-10-06,70051,70039,Blue,0,22127,22792,665
2022-08-16,70040,70054,Blue,1,68016,68820,804
2022-10-18,70044,70060,Blue,1,35497,36359,862
2022-04-22,70048,70060,Blue,1,20800,21461,661
2022-07-25,70057,70051,Blue,0,36483,36746,263
2022-11-24,70046,70048,Blue,1,80732,80810,78
2022-03-02,70048,70058,Blue,1,25734,26261,527
2022-01-31,70038,70056,Blue,1,87200,88089,889
2022-05-20,70042,70058,Blue,1,24229,25210,981
2022-12-21,70055,70049,Blue,0,43744,44054,310
2022-03-06,70046,70050,Blue,1,26522,26731,209
2022-10-02,70043,70838,Blue,0,71459,71637,178
2022-09-07,70049,70043,Blue,0,61348,61674,326
2022-11-07,70059,70055,Blue,0,79755,79895,140
2022-10-26,70046,70058,Blue,1,37708,38387,679
2022-10-29,70038,70056,Blue,1,83781,84785,1004
2022-08-27,70056,70060,Blue,1,39221,39382,161
2022-04-13,70045,70041,Blue,0,53380,53565,185
2022-04-08,70041,70039,Blue,0,45189,45221,32
2022-09-23,70041,70838,Blue,0,57373,57489,116
2022-03-13,70040,70054,Blue,1,37767,38474,707
2022-08-09,70055,70053,Blue,0,75547,75592,45
2022-10-19,70046,70050,Blue,1,61582,61776,194
2022-11-03,70057,70039,Blue,0,33155,34194,1039
2022-12-09,70046,70058,Blue,1,37507,38216,709
2022-02-15,70052,70056,Blue,1,55764,55897,133
2022-12-02,70055,70838,Blue,0,49044,49992,948
2022-04-18,70053,70043,Blue,0,55066,55617,551
2022-05-31,70042,70048,Blue,1,61968,62381,413
2022-01-19,70046,70060,Blue,1,84113,84797,684
2022-09-05,70048,70056,Blue,1,40834,41215,381
2022-07-25,70046,70058,Blue,1,49594,50218,624
2022-06-13,70057,70041,Blue,0,69601,70445,844
2022-10-13,70059,70043,Blue,0,64468,65322,854
2022-11-25,70044,70054,Blue,1,86503,87106,603
2022-04-22,70058,70060,Blue,1,60006,60116,110
2022-12-03,70042,70052,Blue,1,37930,38489,559
2022-01-27,70050,70060,Blue,1,26105,27180,1075
2022-12-01,70054,70056,Blue,1,31501,31550,49
2022-03-10,70057,70041,Blue,0,52189,53054,865
2022-08-27,70044,70058,Blue,1,69978,70776,798
2022-09-16,70057,70053,Blue,0,67498,67650,152
2022-07-24,70049,70039,Blue,0,39354,39870,516
2022-11-09,70042,70046,Blue,1,46318,46516,198
2022-07-13,70057,70049,Blue,0,25173,25591,418
2022-02-15,70042,70048,Blue,1,66009,66342,333
2022-08-03,70053,70043,Blue,0,59569,60222,653
2022-06-22,70055,70051,Blue,0,80896,81039,143
2022-03-21,70042,70044,Blue,1,31301,31331,30
2022-08-18,70038,70054,Blue,1,26480,27358,878
2022-02-25,70047,70838,Blue,0,74382,74830,448
2022-01-23,70057,70039,Blue,0,53370,54306,936
2022-05-10,70056,70060,Blue,1,24246,24418,172
2022-11-04,70055,70041,Blue,0,48867,49602,735
2022-08-08,70056,70058,Blue,1,55587,55726,139
2022-06-30,70044,70050,Blue,1,20119,20477,358
2022-07-12,70053,70838,Blue,0,55381,56259,878
2022-11-03,70046,70050,Blue,1,37710,37926,216
2022-09-28,70055,70049,Blue,0,84372,84670,298
2022-08-22,70053,70039,Blue,0,38932,39767,835
2022-09-30,70050,70060,Blue,1,88881,89412,531
2022-04-08,70057,70043,Blue,0,49828,50597,769
2022-09-30,70057,70051,Blue,0,46953,47199,246
2022-12-18,70044,70046,Blue,1,67634,67751,117
2022-07-17,70045,70039,Blue,0,55143,55413,270
2022-11-04,70048,70058,Blue,1,33459,33955,496
2022-02-09,70055,70051,Blue,0,22994,23160,166
2022-08-29,70053,70039,Blue,0,32524,33377,853
2022-09-03,70038,70040,Blue,1,70693,70708,15
2022-07-14,70054,70058,Blue,1,88997,89148,151
2022-12-31,70044,70054,Blue,1,60669,61238,569
2022-10-02,70049,70838,Blue,0,68928,69538,610
2022-02-24,70042,70058,Blue,1,70058,70971,913
2022-08-17,70056,70058,Blue,1,81742,81815,73
2022-12-01,70055,70049,Blue,0,24441,24729,288
2022-10-22,70043,70039,Blue,0,41481,41601,120
2022-12-07,70048,70050,Blue,1,30345,30407,62
2022-11-16,70059,70045,Blue,0,39947,40727,780
2022-09-26,70059,70041,Blue,0,25938,27047,1109
2022-06-15,70045,70838,Blue,0,57376,57876,500
2022-09-22,70048,70050,Blue,1,85418,85478,60
2022-02-03,70047,70041,Blue,0,64535,64863,328
2022-05-04,70050,70054,Blue,1,52624,52821,197
2022-12-29,70040,70052,Blue,1,34770,35427,657
2022-06-03,70040,70050,Blue,1,27771,28302,531
2022-05-06,70052,70054,Blue,1,47802,47862,60
2022-07-13,70043,70838,Blue,0,60553,60746,193
2022-06-30,70055,70838,Blue,0,79179,80102,923
2022-11-23,70059,70047,Blue,0,38410,39005,595
2022-12-07,70042,70058,Blue,1,59670,60636,966
2022-11-05,70056,70060,Blue,1,55473,55649,176
2022-05-22,70047,70838,Blue,0,31110,31737,627
2022-01-31,70059,70045,Blue,0,57797,58535,738
2022-10-29,70046,70050,Blue,1,48031,48219,188
2022-11-08,70046,70048,Blue,1,79996,80068,72
2022-06-11,70042,70046,Blue,1,50884,51082,198
2022-06-22,70053,70043,Blue,0,39322,40071,749
2022-07-22,70045,70041,Blue,0,21637,21809,172
2022-11-08,70042,70058,Blue,1,54418,55263,845
2022-05-19,70044,70052,Blue,1,64399,64988,589
2022-07-01,70053,70051,Blue,0,51307,51370,63
2022-02-09,70059,70039,Blue,0,23354,24528,1174
2022-03-18,70054,70056,Blue,1,24532,24580,48
2022-03-28,70049,70838,Blue,0,85117,85691,574
2022-08-19,70040,70046,Blue,1,44607,44895,288
2022-09-07,70051,70049,Blue,0,38933,39163,230
2022-09-24,70051,70043,Blue,0,21231,21759,528
2022-06-28,70057,70045,Blue,0,31630,32301,671
2022-10-18,70050,70054,Blue,1,81238,81429,191
2022-10-27,70038,70060,Blue,1,43644,44783,1139
2022-07-16,70057,70055,Blue,0,56885,56953,68
2022-08-25,70049,70838,Blue,0,84151,84758,607
2022-10-22,70055,70051,Blue,0,24324,24469,145
2022-09-27,70053,70047,Blue,0,22039,22497,458
2022-06-17,70038,70058,Blue,1,69099,70298,1199
2022-03-10,70059,70057,Blue,0,74355,74389,34
2022-07-24,70050,70054,Blue,1,84344,84569,225
2022-02-17,70038,70056,Blue,1,42523,43562,1039
2022-02-11,70057,70838,Blue,0,67957,69095,1138
2022-08-23,70042,70046,Blue,1,25081,25254,173
2022-07-22,70044,70052,Blue,1,23472,23992,520
2022-08-28,70038,70058,Blue,1,71535,72565,1030
2022-03-14,70038,70040,Blue,1,54317,54333,16
2022-02-05,70059,70041,Blue,0,30312,31305,993
2022-03-15,70050,70052,Blue,1,78597,78701,104
2022-11-08,70055,70838,Blue,0,34482,35417,935
2022-04-14,70046,70050,Blue,1,62920,63118,198
2022-11-14,70048,70052,Blue,1,43574,43808,234
2022-08-06,70049,70041,Blue,0,76965,77390,425
2022-12-21,70038,70056,Blue,1,27634,28506,872
2022-12-22,70055,70053,Blue,0,65992,66044,52
2022-07-18,70042,70058,Blue,1,31742,32769,1027
2022-07-04,70049,70045,Blue,0,35146,35357,211
2022-08-08,70042,70048,Blue,1,53818,54129,311
2022-12-15,70057,70053,Blue,0,31373,31530,157
2022-11-15,70049,70043,Blue,0,62334,62765,431
2022-07-10,70050,70054,Blue,1,46786,46990,204
2022-06-18,70049,70039,Blue,0,18943,19487,544
2022-03-12,70048,70050,Blue,1,69694,69755,61
2022-12-09,70044,70056,Blue,1,38810,39557,747
2022-09-22,70042,70048,Blue,1,71768,72088,320
2022-03-31,70059,70047,Blue,0,66135,66661,526
2022-07-27,70059,70057,Blue,0,73823,73858,35
2022-11-08,70059,70047,Blue,0,85962,86519,557
2022-10-22,70050,70058,Blue,1,88895,89319,424
2022-09-04,70045,70041,Blue,0,80317,80539,222
2022-07-24,70046,70056,Blue,1,31939,32457,518
2022-11-02,70046,70060,Blue,1,71491,72243,752
2022-10-05,70042,70044,Blue,1,26449,26478,29
2022-06-18,70052,70060,Blue,1,55578,55921,343
2022-04-12,70038,70046,Blue,1,67632,67997,365
2022-10-03,70053,70047,Blue,0,77202,77488,286
2022-01-25,70047,70039,Blue,0,87546,87973,427
2022-03-24,70057,70047,Blue,0,30647,31168,521
2022-02-26,70052,70058,Blue,1,62385,62662,277
2022-08-04,70042,70054,Blue,1,81730,82354,624
2022-09-29,70044,70050,Blue,1,36057,36402,345
2022-04-21,70040,70048,Blue,1,27912,28305,393
2022-11-07,70049,70838,Blue,0,38081,38830,749
2022-07-04,70055,70047,Blue,0,83646,84001,355
2022-08-16,70053,70039,Blue,0,40852,41687,835
2022-01-31,70042,70046,Blue,1,30912,31134,222
2022-12-21,70059,70043,Blue,0,30169,31107,938
2022-01-21,70059,70055,Blue,0,42072,42210,138
2022-02-07,70040,70060,Blue,1,81606,82712,1106
2022-10-22,70059,70041,Blue,0,29775,30746,971
2022-02-22,70048,70058,Blue,1,25497,26012,515
2022-03-13,70057,70053,Blue,0,51749,51906,157
2022-12-02,70042,70046,Blue,1,53018,53180,162
2022-03-30,70057,70041,Blue,0,57257,58050,793
2022-07-04,70057,70045,Blue,0,38496,39128,632
2022-12-03,70055,70041,Blue,0,58260,59148,888
2022-07-21,70055,70043,Blue,0,69593,70311,718
2022-10-20,70048,70056,Blue,1,32837,33220,383
2022-11-05,70047,70043,Blue,0,67365,67603,238
2022-12-13,70057,70051,Blue,0,72865,73092,227
2022-10-06,70053,70047,Blue,0,63709,63989,280
2022-12-25,70059,70039,Blue,0,37514,38595,1081
2022-10-14,70048,70056,Blue,1,83894,84299,405
2022-09-22,70044,70060,Blue,1,35486,36347,861
2022-11-16,70058,70060,Blue,1,60494,60570,76
2022-01-01,70038,70042,Blue,1,22987,23084,97
2022-09-12,70044,70056,Blue,1,64518,65182,664
2022-03-20,70055,70838,Blue,0,67083,68036,953
2022-02-25,70043,70041,Blue,0,45905,45929,24
2022-05-05,70052,70056,Blue,1,79919,80063,144
2022-03-03,70042,70058,Blue,1,70660,71498,838
2022-10-02,70055,70838,Blue,0,71278,72221,943
2022-02-12,70055,70049,Blue,0,85035,85359,324
2022-11-29,70044,70060,Blue,1,56767,57637,870
2022-01-23,70053,70047,Blue,0,53563,53838,275
2022-01-10,70038,70048,Blue,1,71428,71896,468
2022-01-18,70040,70052,Blue,1,21909,22599,690
2022-10-28,70038,70052,Blue,1,44025,44734,709
2022-02-12,70051,70047,Blue,0,55534,55727,193
2022-11-26,70051,70047,Blue,0,86066,86259,193
2022-07-03,70045,70041,Blue,0,63290,63489,199
2022-08-22,70045,70041,Blue,0,58757,58930,173
2022-04-20,70051,70039,Blue,0,62085,62791,706
2022-03-13,70050,70060,Blue,1,74293,74805,512
2022-02-10,70050,70054,Blue,1,68536,68754,218
2022-01-06,70040,70060,Blue,1,34848,36058,1210
2022-11-21,70044,70048,Blue,1,21174,21410,236
2022-06-02,70046,70050,Blue,1,27261,27472,211
2022-06-13,70055,70049,Blue,0,29245,29535,290
2022-07-20,70053,70049,Blue,0,69797,70004,207
2022-11-12,70047,70039,Blue,0,33710,34137,427
2022-06-17,70052,70056,Blue,1,36230,36367,137
2022-03-25,70044,70056,Blue,1,54326,55029,703
2022-08-12,70048,70052,Blue,1,65943,66166,223
2022-04-10,70051,70838,Blue,0,77934,78606,672
2022-04-14,70038,70054,Blue,1,51746,52645,899
2022-07-12,70046,70052,Blue,1,46562,46907,345
2022-02-15,70048,70058,Blue,1,36714,37330,616
2022-03-25,70040,70044,Blue,1,32719,32828,109
2022-03-31,70045,70041,Blue,0,65822,65961,139
2022-06-15,70038,70060,Blue,1,24310,25651,1341
2022-08-31,70044,70048,Blue,1,58853,59092,239
2022-02-07,70059,70057,Blue,0,63200,63236,36
2022-10-06,70038,70042,Blue,1,32351,32437,86
2022-03-07,70042,70054,Blue,1,59764,60492,728
2022-02-09,70059,70051,Blue,0,28154,28502,348
2022-02-05,70055,70039,Blue,0,38641,39541,900
2022-08-31,70057,70039,Blue,0,35935,36923,988
2022-07-19,70046,70052,Blue,1,51843,52194,351
2022-01-22,70040,70048,Blue,1,22475,22837,362
2022-04-11,70038,70042,Blue,1,48692,48803,111
2022-07-18,70055,70051,Blue,0,23193,23347,154
2022-11-14,70055,70051,Blue,0,39072,39210,138
2022-06-10,70055,70049,Blue,0,88283,88536,253
2022-09-10,70053,70049,Blue,0,70571,70768,197
2022-11-14,70059,70055,Blue,0,50415,50561,146
2022-03-12,70038,70046,Blue,1,48015,48356,341
2022-03-08,70045,70043,Blue,0,76233,76333,100
2022-02-11,70044,70056,Blue,1,64793,65464,671
2022-02-28,70042,70060,Blue,1,31535,32675,1140
2022-02-17,70042,70054,Blue,1,80462,81124,662
2022-02-16,70038,70054,Blue,1,28153,29012,859
2022-08-04,70044,70054,Blue,1,59367,59961,594
2022-06-09,70059,70043,Blue,0,57496,58409,913
2022-11-19,70054,70060,Blue,1,59670,59929,259
2022-06-16,70059,70053,Blue,0,22758,23037,279
2022-12-16,70042,70060,Blue,1,68637,69657,1020
2022-01-21,70059,70053,Blue,0,58096,58326,230
2022-02-24,70038,70050,Blue,1,33556,34136,580
2022-12-13,70038,70046,Blue,1,38464,38855,391
2022-08-28,70051,70039,Blue,0,28873,29730,857
2022-11-15,70052,70060,Blue,1,26775,27180,405
2022-07-18,70044,70058,Blue,1,41830,42705,875
2022-12-09,70057,70041,Blue,0,43236,44120,884
2022-07-16,70057,70053,Blue,0,41728,41879,151
2022-02-21,70048,70058,Blue,1,48073,48593,520
2022-06-22,70059,70041,Blue,0,67233,68226,993
2022-04-07,70044,70056,Blue,1,68158,68948,790
2022-11-23,70038,70058,Blue,1,89113,90133,1020
2022-06-17,70053,70051,Blue,0,58650,58712,62
2022-08-10,70051,70049,Blue,0,70039,70141,102
2022-01-27,70048,70052,Blue,1,74620,74824,204
2022-01-21,70042,70044,Blue,1,28676,28706,30
2022-12-25,70057,70838,Blue,0,69571,70559,988
2022-08-07,70048,70052,Blue,1,59694,59897,203
2022-03-24,70038,70044,Blue,1,21853,22039,186
2022-10-14,70056,70060,Blue,1,63369,63551,182
2022-11-02,70044,70050,Blue,1,22046,22408,362
2022-08-10,70057,70055,Blue,0,42738,42808,70
2022-11-10,70044,70054,Blue,1,35991,36693,702
2022-07-16,70059,70051,Blue,0,28697,29011,314
2022-01-03,70057,70053,Blue,0,56692,56864,172
2022-03-16,70048,70054,Blue,1,81564,81887,323
2022-05-13,70050,70056,Blue,1,63770,64081,311
2022-02-03,70049,70045,Blue,0,26964,27200,236
2022-11-09,70046,70054,Blue,1,77101,77503,402
2022-05-18,70046,70052,Blue,1,53014,53508,494
2022-09-19,70056,70060,Blue,1,72564,72739,175
2022-06-30,70059,70055,Blue,0,33693,33832,139
2022-10-09,70041,70838,Blue,0,22513,22649,136
2022-02-11,70059,70057,Blue,0,57793,57828,35
2022-01-27,70044,70054,Blue,1,64014,64645,631
2022-04-02,70059,70047,Blue,0,79094,79645,551
2022-03-02,70042,70044,Blue,1,23190,23229,39
2022-06-09,70047,70041,Blue,0,30087,30501,414
2022-06-16,70053,70047,Blue,0,62918,63243,325
2022-08-30,70057,70041,Blue,0,55128,55979,851
2022-03-18,70045,70043,Blue,0,37787,37874,87
2022-05-18,70044,70058,Blue,1,54348,55255,907
2022-08-02,70048,70054,Blue,1,29480,29865,385
2022-04-24,70043,70039,Blue,0,85655,85763,108
2022-06-23,70042,70052,Blue,1,59994,60677,683
2022-04-11,70040,70054,Blue,1,24371,25188,817
2022-06-27,70045,70041,Blue,0,84391,84564,173
2022-03-23,70043,70041,Blue,0,63785,63814,29
2022-03-05,70040,70050,Blue,1,37832,38362,530
2022-02-01,70046,70060,Blue,1,25962,26707,745
2022-03-18,70047,70043,Blue,0,63171,63405,234
2022-04-07,70044,70052,Blue,1,22984,23524,540
2022-07-28,70055,70047,Blue,0,56639,57033,394
2022-08-27,70049,70043,Blue,0,20672,21026,354
2022-04-12,70047,70043,Blue,0,67123,67368,245
2022-10-17,70049,70043,Blue,0,72288,72637,349
2022-04-16,70047,70838,Blue,0,82932,83408,476
2022-12-22,70038,70056,Blue,1,28499,29368,869
2022-02-04,70058,70060,Blue,1,58041,58107,66
2022-10-24,70057,70043,Blue,0,76612,77374,762
2022-03-14,70038,70048,Blue,1,37341,37839,498
2022-11-05,70051,70047,Blue,0,24553,24754,201
2022-11-02,70054,70058,Blue,1,84228,84384,156
2022-12-03,70055,70053,Blue,0,47249,47306,57
2022-04-20,70046,70058,Blue,1,47288,48047,759
2022-07-05,70044,70046,Blue,1,73360,73492,132
2022-12-07,70049,70041,Blue,0,33544,33980,436
2022-08-24,70040,70052,Blue,1,74351,74990,639
2022-04-18,70051,70041,Blue,0,82125,82792,667
2022-02-21,70059,70053,Blue,0,46514,46802,288
2022-04-12,70046,70060,Blue,1,64423,65223,800
2022-10-18,70049,70039,Blue,0,79811,80271,460
2022-09-22,70055,70049,Blue,0,72433,72699,266
2022-07-07,70050,70056,Blue,1,72309,72671,362
2022-03-15,70044,70058,Blue,1,80562,81362,800
2022-03-17,70048,70054,Blue,1,57422,57749,327
2022-04-25,70050,70054,Blue,1,67224,67416,192
2022-12-12,70051,70838,Blue,0,34322,35100,778
2022-11-14,70042,70044,Blue,1,20240,20278,38
2022-06-11,70050,70058,Blue,1,36235,36654,419
2022-09-12,70057,70043,Blue,0,79958,80735,777
2022-12-27,70052,70060,Blue,1,32916,33260,344
2022-02-03,70057,70053,Blue,0,28536,28711,175
2022-09-06,70040,70054,Blue,1,65950,66708,758
2022-09-16,70045,70039,Blue,0,71425,71662,237
2022-03-12,70042,70056,Blue,1,73011,73907,896
2022-03-20,70044,70056,Blue,1,63220,63934,714
2022-09-14,70053,70049,Blue,0,88376,88563,187
2022-04-16,70048,70054,Blue,1,79785,80068,283
2022-10-22,70040,70046,Blue,1,72906,73166,260
2022-03-31,70046,70058,Blue,1,86432,87077,645
2022-02-12,70038,70050,Blue,1,38583,39210,627
2022-11-26,70038,70040,Blue,1,72843,72859,16
2022-01-07,70057,70045,Blue,0,54583,55227,644
2022-04-11,70040,70058,Blue,1,40817,41794,977
2022-11-05,70046,70060,Blue,1,36489,37158,669
2022-12-30,70055,70039,Blue,0,41181,42017,836
2022-12-25,70046,70054,Blue,1,43343,43750,407
2022-11-06,70055,70838,Blue,0,54012,54870,858
2022-08-10,70059,70045,Blue,0,32236,33039,803
2022-01-02,70055,70049,Blue,0,25688,25974,286
2022-08-29,70057,70051,Blue,0,28963,29228,265
2022-03-17,70038,70044,Blue,1,25747,25898,151
2022-12-05,70038,70046,Blue,1,31935,32235,300
2022-04-16,70038,70052,Blue,1,62593,63363,770
2022-12-05,70048,70056,Blue,1,55430,55906,476
2022-11-08,70057,70053,Blue,0,51562,51719,157
2022-06-20,70059,70039,Blue,0,22581,23638,1057
2022-10-13,70049,70039,Blue,0,34454,34981,527
2022-01-11,70044,70046,Blue,1,26563,26763,200
2022-02-09,70042,70052,Blue,1,59703,60286,583
2022-08-14,70044,70058,Blue,1,83212,84005,793
2022-10-08,70048,70056,Blue,1,76073,76445,372
2022-11-09,70055,70051,Blue,0,48030,48178,148
2022-12-27,70059,70838,Blue,0,30747,31870,1123
2022-02-21,70053,70051,Blue,0,85985,86048,63
2022-10-17,70049,70838,Blue,0,62967,63537,570
2022-02-12,70042,70056,Blue,1,61810,62587,777
2022-06-25,70043,70041,Blue,0,46902,46934,32
2022-07-02,70054,70056,Blue,1,20894,20942,48
2022-01-03,70049,70045,Blue,0,66527,66912,385
2022-02-28,70049,70043,Blue,0,47124,47482,358
2022-01-18,70045,70039,Blue,0,79123,79387,264
2022-03-24,70042,70054,Blue,1,32840,33569,729
2022-08-14,70053,70049,Blue,0,56813,57039,226
2022-09-12,70055,70047,Blue,0,64942,65313,371
2022-11-21,70046,70060,Blue,1,34989,35797,808
2022-12-31,70059,70055,Blue,0,69300,69445,145
2022-09-14,70055,70838,Blue,0,45956,46882,926
2022-09-14,70055,70838,Blue,0,61754,62682,928
2022-04-12,70042,70050,Blue,1,67501,67942,441
2022-09-12,70055,70051,Blue,0,63393,63525,132
2022-12-11,70042,70058,Blue,1,37835,38691,856
2022-07-31,70046,70060,Blue,1,26639,27372,733
2022-09-12,70059,70045,Blue,0,39696,40344,648
2022-08-21,70046,70048,Blue,1,39395,39473,78
2022-12-19,70057,70041,Blue,0,32504,33773,1269
2022-06-20,70045,70039,Blue,0,54821,55085,264
2022-05-02,70054,70056,Blue,1,27535,27581,46
2022-10-27,70040,70046,Blue,1,78988,79267,279
2022-08-02,70038,70040,Blue,1,75208,75221,13
2022-01-09,70059,70053,Blue,0,36854,37089,235
2022-02-07,70053,70041,Blue,0,19424,20071,647
2022-10-20,70059,70053,Blue,0,24260,24483,223
2022-04-26,70050,70060,Blue,1,42764,43250,486
2022-10-07,70047,70043,Blue,0,38159,38398,239
2022-01-03,70054,70060,Blue,1,53044,53321,277
2022-12-06,70040,70054,Blue,1,39564,40319,755
2022-09-23,70045,70043,Blue,0,54913,55001,88
2022-03-07,70048,70060,Blue,1,37276,37941,665
2022-12-08,70054,70056,Blue,1,72941,72988,47
2022-10-01,70040,70060,Blue,1,63080,64189,1109
2022-06-01,70044,70050,Blue,1,57787,58161,374
2022-12-06,70059,70051,Blue,0,58756,59075,319
2022-04-13,70046,70050,Blue,1,79005,79202,197
2022-09-10,70053,70039,Blue,0,24418,25161,743
2022-09-13,70059,70051,Blue,0,72798,73166,368
2022-03-28,70059,70049,Blue,0,26356,26945,589
2022-10-08,70042,70050,Blue,1,23808,24185,377
2022-03-25,70057,70055,Blue,0,27940,28008,68
2022-02-24,70047,70045,Blue,0,34318,34426,108
2022-12-13,70054,70056,Blue,1,76067,76107,40
2022-02-02,70044,70060,Blue,1,24271,25360,1089
2022-03-25,70059,70053,Blue,0,84010,84230,220
2022-01-17,70056,70060,Blue,1,79542,79717,175
2022-04-22,70043,70041,Blue,0,79800,79808,8
2022-09-22,70045,70039,Blue,0,65737,65980,243
2022-10-09,70050,70052,Blue,1,25129,25234,105
2022-10-19,70046,70056,Blue,1,28560,29075,515
2022-12-13,70046,70048,Blue,1,55128,55207,79
2022-04-20,70051,70045,Blue,0,39072,39434,362
2022-10-28,70044,70050,Blue,1,29184,29513,329
2022-12-28,70048,70056,Blue,1,70233,70649,416
2022-01-24,70048,70050,Blue,1,72432,72491,59
2022-02-22,70040,70048,Blue,1,28219,28584,365
2022-02-28,70057,70053,Blue,0,25545,25715,170
2022-04-06,70040,70060,Blue,1,42527,43702,1175
2022-11-28,70040,70058,Blue,1,29048,29982,934
2022-03-07,70050,70054,Blue,1,20545,20749,204
2022-12-22,70046,70054,Blue,1,58354,58857,503
2022-09-16,70039,70838,Blue,0,80363,80399,36
2022-05-20,70055,70838,Blue,0,55339,56398,1059
2022-09-03,70040,70044,Blue,1,30814,30924,110
2022-08-04,70044,70048,Blue,1,75982,76235,253
2022-04-06,70048,70050,Blue,1,80850,80908,58
2022-12-21,70053,70051,Blue,0,28181,28230,49
2022-09-13,70046,70052,Blue,1,38094,38411,317
2022-01-04,70040,70054,Blue,1,56577,57295,718
2022-09-14,70051,70045,Blue,0,55995,56324,329
2022-07-27,70038,70050,Blue,1,21928,22464,536
2022-03-20,70059,70039,Blue,0,61989,62970,981
2022-01-12,70059,70043,Blue,0,24854,25730,876
2022-02-20,70049,70043,Blue,0,86033,86405,372
2022-07-31,70057,70051,Blue,0,86638,86881,243
2022-01-22,70040,70044,Blue,1,46991,47098,107
2022-12-31,70051,70043,Blue,0,22588,23136,548
2022-10-10,70039,70838,Blue,0,81061,81095,34
2022-06-13,70052,70060,Blue,1,71693,72085,392
2022-01-14,70041,70838,Blue,0,51232,51367,135
2022-12-09,70044,70048,Blue,1,29185,29411,226
2022-07-29,70042,70058,Blue,1,53544,54494,950
2022-09-08,70057,70049,Blue,0,25598,26020,422
2022-09-30,70053,70049,Blue,0,66943,67181,238
2022-03-23,70043,70039,Blue,0,87699,87791,92
2022-10-29,70048,70056,Blue,1,81148,81538,390
2022-10-13,70042,70046,Blue,1,87552,87730,178
2022-08-05,70053,70047,Blue,0,42721,43005,284
2022-01-11,70049,70041,Blue,0,59555,59933,378
2022-08-07,70051,70043,Blue,0,69859,70352,493
2022-09-18,70057,70047,Blue,0,62016,62534,518
2022-08-09,70043,70041,Blue,0,63762,63790,28
2022-03-04,70044,70054,Blue,1,34674,35346,672
2022-06-21,70049,70045,Blue,0,20222,20450,228
2022-12-30,70054,70060,Blue,1,57406,57687,281
2022-09-05,70053,70039,Blue,0,46536,47395,859
2022-06-07,70049,70045,Blue,0,66402,66601,199
2022-03-07,70042,70044,Blue,1,44271,44300,29
2022-05-22,70047,70043,Blue,0,35319,35694,375
2022-12-24,70045,70041,Blue,0,37627,37797,170
2022-03-02,70049,70047,Blue,0,79928,79982,54
2022-02-16,70041,70039,Blue,0,23881,23926,45
2022-06-15,70050,70054,Blue,1,43275,43510,235
2022-11-02,70055,70045,Blue,0,31122,31639,517
2022-10-11,70046,70060,Blue,1,53756,54488,732
2022-03-21,70038,70060,Blue,1,83115,84368,1253
2022-03-25,70051,70049,Blue,0,19257,19367,110
2022-11-25,70054,70060,Blue,1,27683,27930,247
2022-05-11,70059,70057,Blue,0,44725,44760,35
2022-12-06,70048,70052,Blue,1,47673,48207,534
2022-03-30,70046,70056,Blue,1,66238,66713,475
2022-04-22,70059,70049,Blue,0,46654,47167,513
2022-07-14,70057,70055,Blue,0,81760,81831,71
2022-02-22,70054,70060,Blue,1,38259,38534,275
2022-01-04,70055,70039,Blue,0,25059,26000,941
2022-01-05,70040,70060,Blue,1,42170,43363,1193
2022-04-01,70055,70051,Blue,0,52717,52874,157
2022-06-28,70059,70039,Blue,0,50999,52049,1050
2022-04-12,70044,70058,Blue,1,65793,66570,777
2022-12-18,70051,70045,Blue,0,50941,51295,354
2022-12-27,70049,70039,Blue,0,88700,89574,874
2022-06-07,70049,70047,Blue,0,66894,66951,57
2022-06-15,70055,70039,Blue,0,60688,61598,910
2022-10-09,70059,70055,Blue,0,36195,36344,149
2022-03-29,70052,70054,Blue,1,74770,74833,63
2022-03-28,70039,70838,Blue,0,65145,65183,38
2022-11-08,70046,70052,Blue,1,61766,62096,330
2022-06-28,70040,70044,Blue,1,28643,28750,107
2022-08-01,70044,70054,Blue,1,72827,73418,591
2022-07-07,70046,70052,Blue,1,47132,47659,527
2022-11-08,70044,70050,Blue,1,65315,65700,385
2022-05-19,70058,70060,Blue,1,64607,64748,141
2022-10-12,70059,70043,Blue,0,59295,60150,855
2022-04-07,70050,70054,Blue,1,70007,70233,226
2022-12-31,70043,70039,Blue,0,60570,60680,110
2022-06-01,70041,70039,Blue,0,32248,32280,32
2022-07-31,70038,70056,Blue,1,44294,45190,896
2022-07-18,70057,70041,Blue,0,24107,25060,953
2022-09-26,70045,70838,Blue,0,73209,73545,336
2022-03-31,70059,70047,Blue,0,44952,45489,537
2022-11-15,70053,70039,Blue,0,31985,32793,808
2022-03-26,70049,70043,Blue,0,54027,54350,323
2022-09-18,70054,70058,Blue,1,59994,60153,159
2022-01-11,70057,70047,Blue,0,41672,42154,482
2022-03-13,70040,70060,Blue,1,57025,58100,1075
2022-03-04,70059,70055,Blue,0,65898,66039,141
2022-02-04,70040,70054,Blue,1,45859,46710,851
2022-03-14,70038,70050,Blue,1,67403,68054,651
2022-08-01,70051,70049,Blue,0,44536,44637,101
2022-06-20,70044,70048,Blue,1,45373,45685,312
2022-09-19,70046,70050,Blue,1,28274,28470,196
2022-06-20,70040,70042,Blue,1,77986,78023,37
2022-06-17,70038,70048,Blue,1,21854,22347,493
2022-09-29,70040,70052,Blue,1,53818,54520,702
2022-02-07,70042,70058,Blue,1,69195,70114,919
2022-09-08,70044,70048,Blue,1,45520,45754,234
2022-11-16,70051,70838,Blue,0,30446,31263,817
2022-09-27,70040,70056,Blue,1,55534,56360,826
2022-02-21,70055,70053,Blue,0,85043,85101,58
2022-06-20,70042,70054,Blue,1,71829,72594,765
2022-12-31,70040,70054,Blue,1,86884,87648,764
2022-01-04,70040,70042,Blue,1,83834,83866,32
2022-05-18,70057,70053,Blue,0,84694,84855,161
2022-06-18,70048,70052,Blue,1,64382,64646,264
2022-07-08,70042,70048,Blue,1,74010,74367,357
2022-03-08,70038,70046,Blue,1,23642,23962,320
2022-01-02,70056,70060,Blue,1,49711,49933,222
2022-07-27,70050,70054,Blue,1,42794,43256,462
2022-09-09,70047,70838,Blue,0,20222,20855,633
2022-06-21,70059,70039,Blue,0,28878,30038,1160
2022-01-22,70040,70044,Blue,1,27547,27659,112
2022-12-12,70059,70053,Blue,0,24259,24510,251
2022-11-21,70057,70043,Blue,0,46243,47019,776
2022-10-12,70045,70039,Blue,0,72014,72249,235
2022-04-21,70055,70045,Blue,0,83661,84224,563
2022-10-01,70042,70046,Blue,1,36804,36974,170
2022-10-07,70040,70044,Blue,1,45236,45349,113
2022-09-15,70051,70049,Blue,0,67890,67994,104
2022-07-18,70059,70055,Blue,0,79024,79175,151
2022-05-01,70050,70056,Blue,1,82361,82656,295
2022-10-07,70055,70049,Blue,0,58410,58693,283
2022-12-12,70057,70053,Blue,0,36913,37148,235
2022-03-02,70053,70039,Blue,0,40831,41770,939
2022-03-30,70049,70838,Blue,0,42026,42579,553
2022-06-07,70047,70045,Blue,0,72781,72883,102
2022-08-30,70051,70838,Blue,0,83032,83723,691
2022-03-28,70057,70051,Blue,0,20673,20908,235
2022-11-01,70038,70058,Blue,1,74710,76053,1343
2022-09-08,70059,70051,Blue,0,65859,66173,314
2022-11-02,70042,70048,Blue,1,73766,74059,293
2022-09-23,70051,70045,Blue,0,57231,57615,384
2022-10-21,70044,70050,Blue,1,64918,65277,359
2022-01-19,70040,70044,Blue,1,48735,48840,105
2022-06-11,70058,70060,Blue,1,61489,61558,69
2022-03-16,70059,70057,Blue,0,22520,22567,47
2022-02-18,70038,70042,Blue,1,29350,29456,106
2022-04-17,70055,70041,Blue,0,72393,73201,808
2022-09-13,70046,70048,Blue,1,48629,48707,78
2022-02-24,70059,70049,Blue,0,76042,76487,445
2022-03-29,70046,70056,Blue,1,20935,21508,573
2022-10-20,70039,70838,Blue,0,75443,75478,35
2022-03-08,70048,70060,Blue,1,75287,75910,623
2022-09-05,70051,70041,Blue,0,35124,35711,587
2022-10-24,70057,70049,Blue,0,74976,75383,407
2022-12-15,70040,70056,Blue,1,61777,62670,893
2022-10-08,70042,70054,Blue,1,39130,39789,659
2022-07-20,70059,70055,Blue,0,55846,55998,152
2022-02-07,70057,70047,Blue,0,53187,53745,558
2022-07-22,70059,70057,Blue,0,74899,74934,35
2022-10-05,70054,70056,Blue,1,86574,86621,47
2022-07-08,70046,70058,Blue,1,51154,51823,669
2022-02-23,70043,70039,Blue,0,30434,30543,109
2022-05-31,70040,70050,Blue,1,24857,25427,570
2022-11-11,70046,70050,Blue,1,79324,79520,196
2022-01-24,70051,70041,Blue,0,33646,34236,590
2022-07-11,70046,70054,Blue,1,26925,27360,435
2022-05-04,70052,70054,Blue,1,61051,61107,56
2022-08-06,70055,70838,Blue,0,30503,31418,915
2022-08-24,70053,70043,Blue,0,34655,35265,610
2022-01-10,70047,70045,Blue,0,51072,51172,100
2022-08-04,70059,70055,Blue,0,66556,66758,202
2022-07-07,70044,70048,Blue,1,71225,71541,316
2022-09-19,70055,70043,Blue,0,48290,49122,832
2022-10-18,70057,70053,Blue,0,31914,32093,179
2022-03-05,70049,70838,Blue,0,18970,19616,646
2022-09-08,70057,70838,Blue,0,33858,34990,1132
2022-04-15,70038,70042,Blue,1,53108,53209,101
2022-11-14,70040,70052,Blue,1,65909,66534,625
2022-07-27,70048,70052,Blue,1,54639,54866,227
2022-03-01,70055,70041,Blue,0,34042,34904,862
2022-04-17,70042,70058,Blue,1,42083,43004,921
2022-02-06,70059,70039,Blue,0,77595,78599,1004
2022-04-19,70042,70048,Blue,1,57313,57646,333
2022-10-25,70040,70048,Blue,1,24238,24651,413
2022-07-19,70038,70058,Blue,1,47688,48701,1013
2022-07-22,70049,70041,Blue,0,87268,87699,431
2022-03-16,70044,70054,Blue,1,51402,52007,605
2022-01-08,70038,70056,Blue,1,39371,40236,865
2022-04-03,70044,70060,Blue,1,82537,83381,844
2022-12-17,70051,70049,Blue,0,74957,75062,105
2022-12-24,70049,70043,Blue,0,37346,37712,366
2022-09-07,70050,70060,Blue,1,25521,26062,541
2022-09-19,70054,70056,Blue,1,41354,41401,47
2022-02-23,70040,70060,Blue,1,67701,68857,1156
2022-11-14,70051,70047,Blue,0,30808,31006,198
2022-08-06,70051,70041,Blue,0,18880,19455,575
2022-05-20,70055,70047,Blue,0,76849,77264,415
2022-02-19,70050,70052,Blue,1,45477,45597,120
2022-11-01,70047,70838,Blue,0,59884,60363,479
2022-04-15,70053,70047,Blue,0,25462,25793,331
2022-08-31,70054,70060,Blue,1,43432,43682,250
2022-08-11,70048,70058,Blue,1,43004,43522,518
2022-11-11,70044,70056,Blue,1,82249,82966,717
2022-01-04,70045,70043,Blue,0,81967,82057,90
2022-11-15,70057,70055,Blue,0,53616,53684,68
2022-12-27,70039,70838,Blue,0,63743,63777,34
2022-09-01,70038,70048,Blue,1,73268,73743,475
2022-07-19,70041,70838,Blue,0,47868,48000,132
2022-01-28,70050,70052,Blue,1,52766,52897,131
2022-09-29,70059,70043,Blue,0,56180,57111,931
2022-09-13,70051,70838,Blue,0,85512,86208,696
2022-09-06,70056,70060,Blue,1,83077,83250,173
2022-06-30,70038,70040,Blue,1,57690,57706,16
2022-07-13,70055,70045,Blue,0,42426,43190,764
2022-01-23,70057,70043,Blue,0,57691,58460,769
2022-07-15,70057,70055,Blue,0,69984,70054,70
2022-04-08,70053,70838,Blue,0,51815,52602,787
2022-04-19,70038,70042,Blue,1,26745,26855,110
2022-07-25,70038,70050,Blue,1,48734,49260,526
2022-10-08,70040,70052,Blue,1,79357,79990,633
2022-07-26,70043,70838,Blue,0,43997,44237,240
2022-07-28,70051,70041,Blue,0,73167,73720,553
2022-03-01,70052,70056,Blue,1,71668,71800,132
2022-11-09,70053,70043,Blue,0,26166,26836,670
2022-10-16,70054,70060,Blue,1,85433,85697,264
2022-02-03,70042,70052,Blue,1,30991,31671,680
2022-09-02,70059,70041,Blue,0,79469,80559,1090
2022-09-02,70046,70050,Blue,1,54096,54273,177
2022-04-22,70038,70052,Blue,1,59833,60550,717
2022-02-02,70038,70052,Blue,1,61034,61821,787
2022-10-16,70048,70058,Blue,1,87880,88392,512
2022-02-07,70046,70050,Blue,1,64999,65170,171
2022-03-21,70052,70056,Blue,1,45536,45708,172
2022-11-04,70042,70060,Blue,1,54818,55793,975
2022-01-26,70042,70058,Blue,1,87259,88030,771
2022-06-12,70054,70060,Blue,1,56802,57070,268
2022-08-23,70046,70058,Blue,1,50547,51268,721
2022-09-02,70051,70039,Blue,0,38881,39556,675
2022-03-27,70057,70055,Blue,0,71732,71801,69
2022-04-19,70049,70043,Blue,0,51501,51877,376
2022-03-18,70058,70060,Blue,1,72067,72133,66
2022-06-15,70050,70054,Blue,1,54716,54969,253
2022-04-03,70057,70045,Blue,0,27807,28412,605
2022-12-13,70051,70045,Blue,0,34147,34536,389
2022-07-13,70057,70039,Blue,0,84620,85662,1042
2022-08-25,70049,70045,Blue,0,61430,61621,191
2022-10-26,70059,70057,Blue,0,48895,48931,36
2022-04-24,70053,70041,Blue,0,45516,46188,672
2022-06-13,70052,70054,Blue,1,79974,80028,54
2022-08-24,70057,70039,Blue,0,63416,64360,944
2022-03-11,70044,70050,Blue,1,68174,68574,400
2022-06-27,70056,70058,Blue,1,37725,37830,105
2022-08-16,70053,70051,Blue,0,34232,34289,57
2022-02-19,70038,70042,Blue,1,67985,68081,96
2022-08-20,70042,70046,Blue,1,73008,73211,203
2022-11-18,70040,70048,Blue,1,64886,65308,422
2022-09-02,70045,70039,Blue,0,30078,30366,288
2022-02-19,70046,70048,Blue,1,57072,57163,91
2022-07-12,70040,70042,Blue,1,60383,60421,38
2022-09-20,70038,70046,Blue,1,30440,30754,314
2022-01-27,70057,70838,Blue,0,77253,78876,1623
2022-06-17,70059,70047,Blue,0,84017,84555,538
2022-04-14,70046,70050,Blue,1,65952,66151,199
2022-10-14,70042,70048,Blue,1,32958,33286,328
2022-08-13,70049,70047,Blue,0,76300,76356,56
2022-12-31,70055,70838,Blue,0,63727,64640,913
2022-06-16,70045,70039,Blue,0,59689,60003,314
2022-12-15,70040,70050,Blue,1,53589,54108,519
2022-06-20,70046,70052,Blue,1,62905,63236,331
2022-03-11,70054,70058,Blue,1,33885,34042,157
2022-03-17,70053,70049,Blue,0,33884,34111,227
2022-01-22,70047,70043,Blue,0,26591,26852,261
2022-02-27,70048,70050,Blue,1,35174,35229,55
2022-07-31,70053,70051,Blue,0,77313,77365,52
2022-08-06,70042,70048,Blue,1,76773,77102,329
2022-06-25,70045,70041,Blue,0,87289,87470,181
2022-06-19,70043,70041,Blue,0,25846,25874,28
2022-11-23,70048,70056,Blue,1,47262,47634,372
2022-01-12,70048,70056,Blue,1,49479,49851,372
2022-11-20,70047,70039,Blue,0,86123,86500,377
2022-11-25,70055,70045,Blue,0,72981,73491,510
2022-06-26,70045,70041,Blue,0,73066,73254,188
2022-02-16,70051,70039,Blue,0,38540,39169,629
2022-08-03,70059,70041,Blue,0,53054,54029,975
2022-10-13,70055,70838,Blue,0,57278,58148,870
2022-09-18,70054,70060,Blue,1,55649,55902,253
2022-04-01,70046,70054,Blue,1,55472,55904,432
2022-03-10,70042,70052,Blue,1,33068,33609,541
2022-07-24,70050,70056,Blue,1,62430,62750,320
2022-03-19,70053,70039,Blue,0,58664,59389,725
2022-09-15,70053,70051,Blue,0,62792,62848,56
2022-09-10,70058,70060,Blue,1,25300,25366,66
2022-04-02,70049,70043,Blue,0,68584,68905,321
2022-04-29,70059,70055,Blue,0,67014,67163,149
2022-04-14,70042,70050,Blue,1,36341,36789,448
2022-10-04,70043,70838,Blue,0,51291,51491,200
2022-04-23,70057,70045,Blue,0,57430,58078,648
2022-08-26,70054,70058,Blue,1,41525,41714,189
2022-02-02,70042,70060,Blue,1,28635,29630,995
2022-08-31,70053,70051,Blue,0,81542,81591,49
2022-06-27,70056,70058,Blue,1,27671,27755,84
2022-12-23,70038,70050,Blue,1,36872,37455,583
2022-04-16,70040,70054,Blue,1,21738,22500,762
2022-12-19,70045,70041,Blue,0,33349,33773,424
2022-01-27,70048,70050,Blue,1,45730,45790,60
2022-04-05,70053,70047,Blue,0,36134,36485,351
2022-08-14,70046,70056,Blue,1,73550,74105,555
2022-07-18,70046,70058,Blue,1,23481,24162,681
2022-11-06,70059,70043,Blue,0,51141,52007,866
2022-11-10,70059,70041,Blue,0,58214,59111,897
2022-07-03,70044,70054,Blue,1,66888,67567,679
2022-10-07,70044,70050,Blue,1,64519,64891,372
2022-02-03,70057,70041,Blue,0,72696,73532,836
2022-06-19,70039,70838,Blue,0,45820,45855,35
2022-03-14,70053,70039,Blue,0,27235,28017,782
2022-04-03,70048,70054,Blue,1,32104,32422,318
2022-02-22,70055,70039,Blue,0,44032,44950,918
2022-11-14,70043,70838,Blue,0,64366,64550,184
2022-03-19,70049,70838,Blue,0,63748,64348,600
2022-08-24,70038,70044,Blue,1,78949,79151,202
2022-10-06,70038,70048,Blue,1,85831,86333,502
2022-06-30,70057,70051,Blue,0,67033,67291,258
2022-04-19,70040,70046,Blue,1,61701,61965,264
2022-07-08,70059,70041,Blue,0,26396,27464,1068
2022-05-20,70051,70047,Blue,0,45507,45696,189
2022-05-23,70042,70050,Blue,1,74573,75133,560
2022-07-01,70048,70056,Blue,1,51412,51892,480
2022-06-22,70043,70039,Blue,0,44422,44526,104
2022-02-26,70047,70045,Blue,0,41151,41269,118
2022-01-15,70051,70039,Blue,0,62260,63106,846
2022-02-11,70057,70838,Blue,0,87555,88478,923
2022-07-08,70044,70056,Blue,1,80249,80973,724
2022-09-14,70048,70050,Blue,1,44287,44345,58
2022-04-03,70051,70043,Blue,0,37222,37696,474
2022-11-30,70051,70041,Blue,0,27536,28100,564
2022-02-27,70051,70043,Blue,0,26550,27042,492
2022-09-27,70038,70060,Blue,1,49475,50659,1184
2022-04-12,70051,70039,Blue,0,45311,45965,654
2022-05-19,70044,70054,Blue,1,21118,21882,764
2022-09-29,70049,70838,Blue,0,51082,51690,608
2022-01-03,70045,70838,Blue,0,84280,84614,334
2022-10-26,70051,70049,Blue,0,88509,88610,101
2022-11-23,70038,70042,Blue,1,72095,72193,98
2022-02-03,70053,70049,Blue,0,74631,74815,184
2022-03-05,70044,70046,Blue,1,32581,32691,110
2022-03-31,70042,70046,Blue,1,25338,25523,185
2022-07-17,70053,70051,Blue,0,53587,53638,51
2022-12-06,70042,70060,Blue,1,84561,85544,983
2022-08-28,70046,70060,Blue,1,79478,80178,700
2022-10-27,70057,70047,Blue,0,57832,58321,489
2022-10-14,70053,70049,Blue,0,67835,68027,192
2022-08-19,70059,70055,Blue,0,23862,24029,167
2022-07-28,70045,70041,Blue,0,76677,76853,176
2022-05-27,70042,70044,Blue,1,39882,39919,37
2022-04-08,70050,70052,Blue,1,63769,63884,115
2022-12-03,70053,70047,Blue,0,31689,31976,287
2022-06-11,70057,70043,Blue,0,26143,26933,790
2022-01-04,70055,70053,Blue,0,79093,79148,55
2022-12-16,70059,70041,Blue,0,25634,26623,989
2022-03-19,70040,70044,Blue,1,78756,78873,117
2022-06-10,70048,70050,Blue,1,56959,57017,58
2022-09-22,70044,70052,Blue,1,25406,25866,460
2022-11-20,70050,70054,Blue,1,43543,43779,236
2022-10-11,70054,70058,Blue,1,87307,87466,159
2022-02-15,70046,70052,Blue,1,71355,71692,337
2022-03-02,70049,70039,Blue,0,20047,20586,539
2022-03-04,70042,70054,Blue,1,89329,90007,678
2022-04-03,70051,70838,Blue,0,63362,64080,718
2022-08-03,70038,70060,Blue,1,79940,81107,1167
2022-07-06,70044,70056,Blue,1,52190,53054,864
2022-04-03,70040,70052,Blue,1,59192,59881,689
2022-04-02,70044,70048,Blue,1,71447,71668,221
2022-06-23,70059,70043,Blue,0,84091,85040,949
2022-10-09,70038,70052,Blue,1,47774,48526,752
2022-03-24,70058,70060,Blue,1,66831,67029,198
2022-03-18,70045,70039,Blue,0,71778,72038,260
2022-12-03,70059,70838,Blue,0,19517,20723,1206
2022-06-17,70043,70041,Blue,0,66755,66783,28
2022-07-03,70057,70045,Blue,0,64196,64816,620
2022-10-21,70049,70039,Blue,0,52876,53467,591
2022-09-20,70042,70054,Blue,1,89268,89935,667
2022-03-10,70038,70056,Blue,1,34761,35633,872
2022-12-24,70043,70039,Blue,0,31879,31987,108
2022-12-31,70044,70060,Blue,1,44986,45880,894
2022-12-11,70059,70053,Blue,0,71653,71891,238
2022-09-07,70047,70045,Blue,0,47907,48013,106
2022-06-20,70038,70048,Blue,1,62792,63309,517
2022-05-12,70057,70051,Blue,0,22235,22476,241
2022-02-23,70049,70047,Blue,0,82255,82312,57
2022-09-06,70053,70041,Blue,0,40943,41632,689
2022-02-03,70040,70048,Blue,1,43575,43966,391
2022-05-19,70055,70053,Blue,0,67756,67803,47
2022-10-02,70040,70044,Blue,1,77001,77107,106
2022-10-14,70048,70054,Blue,1,77285,77602,317
2022-12-29,70038,70048,Blue,1,55152,55620,468
2022-10-18,70056,70058,Blue,1,32553,32630,77
2022-10-26,70055,70047,Blue,0,73679,74043,364
2022-09-29,70038,70040,Blue,1,78469,78483,14
2022-04-02,70040,70044,Blue,1,36761,36893,132
2022-08-09,70051,70045,Blue,0,58577,58910,333
2022-02-17,70045,70043,Blue,0,55224,55327,103
2022-07-25,70057,70055,Blue,0,51043,51113,70
2022-10-12,70055,70045,Blue,0,52710,53243,533
2022-12-29,70040,70044,Blue,1,89302,89406,104
2022-02-03,70057,70045,Blue,0,83757,84402,645
2022-11-17,70045,70043,Blue,0,31451,31535,84
2022-12-10,70040,70042,Blue,1,64284,64316,32
2022-09-19,70052,70058,Blue,1,48943,49290,347
2022-11-03,70040,70044,Blue,1,56549,57142,593
2022-10-26,70044,70056,Blue,1,30652,31313,661
2022-12-10,70057,70053,Blue,0,26624,26906,282
2022-11-26,70042,70056,Blue,1,31950,32705,755
2022-11-10,70041,70039,Blue,0,57228,57259,31
2022-11-19,70050,70054,Blue,1,80537,80743,206
2022-01-04,70059,70053,Blue,0,28158,28434,276
2022-06-19,70055,70041,Blue,0,70899,71647,748
2022-09-05,70053,70838,Blue,0,63277,64103,826
2022-03-31,70051,70838,Blue,0,35642,36579,937
2022-11-26,70051,70039,Blue,0,74404,75038,634
2022-03-24,70050,70058,Blue,1,87167,87581,414
2022-01-28,70055,70039,Blue,0,68364,69286,922
2022-12-20,70040,70054,Blue,1,56049,56781,732
2022-03-20,70049,70047,Blue,0,32865,32922,57
2022-04-14,70049,70045,Blue,0,86862,87101,239
2022-04-22,70055,70039,Blue,0,33239,34121,882
2022-09-06,70055,70045,Blue,0,36160,36780,620
2022-04-12,70059,70051,Blue,0,51555,51862,307
2022-12-09,70051,70838,Blue,0,67933,68654,721
2022-01-13,70042,70046,Blue,1,60568,60757,189
2022-09-17,70043,70041,Blue,0,57263,57291,28
2022-07-01,70058,70060,Blue,1,38186,38247,61
2022-06-02,70038,70050,Blue,1,19995,20628,633
2022-10-06,70057,70045,Blue,0,42690,43390,700
2022-08-30,70038,70056,Blue,1,72601,73518,917
2022-04-25,70049,70047,Blue,0,30733,30780,47
2022-02-03,70057,70049,Blue,0,30121,30554,433
2022-12-30,70040,70050,Blue,1,58099,58558,459
2022-10-25,70051,70045,Blue,0,30925,31288,363
2022-07-23,70052,70058,Blue,1,79828,80105,277
2022-10-08,70040,70054,Blue,1,32409,33197,788
2022-08-05,70048,70054,Blue,1,46105,46412,307
2022-08-29,70053,70049,Blue,0,53806,54080,274
2022-02-05,70044,70048,Blue,1,72505,72779,274
2022-10-29,70051,70049,Blue,0,37135,37236,101
2022-09-02,70053,70045,Blue,0,54100,54541,441
2022-02-03,70050,70054,Blue,1,62668,62889,221
2022-12-20,70059,70051,Blue,0,48084,48427,343
2022-01-21,70046,70058,Blue,1,61260,61973,713
2022-08-06,70057,70045,Blue,0,40648,41240,592
2022-04-06,70041,70838,Blue,0,34880,35063,183
2022-07-29,70050,70058,Blue,1,87194,87671,477
2022-02-15,70055,70047,Blue,0,63086,63522,436
2022-04-23,70046,70054,Blue,1,47900,48332,432
2022-06-17,70052,70058,Blue,1,62532,62774,242
2022-12-16,70044,70046,Blue,1,88435,88540,105
2022-05-18,70051,70043,Blue,0,31818,32496,678
2022-09-15,70038,70044,Blue,1,81440,81595,155
2022-12-18,70059,70055,Blue,0,53844,53996,152
2022-02-09,70042,70048,Blue,1,66897,67183,286
2022-10-20,70051,70041,Blue,0,32534,33118,584
2022-04-16,70051,70043,Blue,0,61484,62048,564
2022-10-06,70051,70039,Blue,0,64468,65101,633
2022-10-17,70045,70043,Blue,0,68125,68222,97
2022-08-04,70044,70048,Blue,1,65591,65824,233
2022-01-21,70042,70046,Blue,1,67489,67670,181
2022-04-08,70059,70043,Blue,0,47112,48018,906
2022-04-19,70043,70041,Blue,0,81101,81131,30
2022-03-14,70053,70047,Blue,0,32961,33245,284
2022-01-26,70055,70041,Blue,0,80773,81513,740
2022-06-15,70038,70056,Blue,1,60127,61146,1019
2022-10-16,70051,70838,Blue,0,67708,68388,680
2022-08-15,70047,70043,Blue,0,28266,28520,254
2022-01-24,70057,70838,Blue,0,38189,39290,1101
2022-06-13,70057,70838,Blue,0,57279,58310,1031
2022-12-15,70057,70051,Blue,0,74434,74685,251
2022-08-19,70043,70041,Blue,0,27416,27448,32
2022-05-27,70038,70044,Blue,1,31997,32184,187
2022-12-23,70050,70054,Blue,1,31545,31799,254
2022-02-10,70051,70049,Blue,0,41931,42034,103
2022-08-21,70042,70046,Blue,1,79873,80062,189
2022-02-16,70055,70041,Blue,0,77355,78062,707
2022-11-18,70038,70054,Blue,1,34033,34852,819
2022-10-29,70050,70060,Blue,1,57895,58435,540
2022-02-16,70051,70041,Blue,0,20617,21235,618
2022-04-15,70053,70041,Blue,0,40090,40827,737
2022-08-24,70045,70838,Blue,0,22956,23440,484
2022-03-24,70051,70049,Blue,0,65938,66039,101
2022-09-29,70045,70039,Blue,0,26858,27175,317
2022-01-21,70048,70056,Blue,1,55312,55695,383
2022-11-28,70045,70043,Blue,0,40282,40369,87
2022-01-19,70050,70054,Blue,1,59889,60129,240
2022-09-22,70059,70055,Blue,0,35910,36066,156
2022-09-05,70055,70047,Blue,0,87521,87917,396
2022-03-24,70051,70041,Blue,0,56325,56857,532
2022-07-25,70058,70060,Blue,1,26653,26719,66
2022-12-05,70046,70048,Blue,1,50610,50691,81
2022-03-26,70040,70044,Blue,1,55095,55204,109
2022-01-21,70055,70039,Blue,0,66072,66854,782
2022-06-25,70040,70060,Blue,1,79335,80418,1083
2022-03-08,70055,70041,Blue,0,61268,61987,719
2022-01-14,70059,70049,Blue,0,62008,62482,474
2022-08-27,70059,70039,Blue,0,30859,31907,1048
2022-03-22,70055,70051,Blue,0,67703,67855,152
2022-10-17,70055,70051,Blue,0,79052,79250,198
2022-12-28,70048,70056,Blue,1,58657,59095,438
2022-02-10,70052,70054,Blue,1,55942,55999,57
2022-09-01,70055,70051,Blue,0,35079,35225,146
2022-08-07,70038,70048,Blue,1,37026,37481,455
2022-05-27,70046,70050,Blue,1,87005,87183,178
2022-10-29,70043,70041,Blue,0,74471,74499,28
2022-12-27,70057,70838,Blue,0,74029,75010,981
2022-06-17,70059,70838,Blue,0,54504,55661,1157
2022-11-23,70038,70042,Blue,1,26472,26567,95
2022-04-02,70038,70054,Blue,1,73398,74193,795
2022-02-28,70057,70838,Blue,0,85828,86773,945
2022-02-23,70042,70060,Blue,1,21040,22119,1079
2022-12-02,70040,70054,Blue,1,50309,51129,820
2022-10-30,70049,70045,Blue,0,50095,50317,222
2022-07-27,70059,70057,Blue,0,70217,70254,37
2022-06-30,70057,70838,Blue,0,42511,43645,1134
2022-01-15,70042,70056,Blue,1,45465,46205,740
2022-04-01,70044,70054,Blue,1,47237,47881,644
2022-11-30,70040,70060,Blue,1,76994,78279,1285
2022-08-10,70057,70043,Blue,0,34472,35307,835
2022-01-10,70052,70054,Blue,1,48853,48892,39
2022-01-02,70046,70052,Blue,1,54282,54614,332
2022-04-15,70046,70056,Blue,1,66579,67140,561
2022-07-22,70046,70048,Blue,1,67301,67391,90
2022-02-11,70038,70040,Blue,1,52460,52475,15
2022-11-18,70055,70039,Blue,0,38668,39601,933
2022-07-09,70046,70060,Blue,1,86061,86872,811
2022-01-09,70048,70058,Blue,1,53690,54206,516
2022-11-30,70048,70060,Blue,1,76745,77437,692
2022-04-14,70038,70056,Blue,1,67662,68627,965
2022-01-15,70057,70049,Blue,0,61097,61805,708
2022-11-25,70059,70838,Blue,0,29714,30817,1103
2022-12-11,70055,70039,Blue,0,71839,72646,807
2022-11-28,70049,70838,Blue,0,88581,89544,963
2022-04-09,70049,70041,Blue,0,36758,37204,446
2022-03-28,70049,70039,Blue,0,67325,67821,496
2022-07-21,70048,70054,Blue,1,47836,48176,340
2022-11-17,70042,70054,Blue,1,40585,41262,677
2022-02-10,70054,70058,Blue,1,28137,28303,166
2022-07-29,70050,70052,Blue,1,30551,30678,127
2022-04-09,70044,70048,Blue,1,61749,61992,243
2022-01-22,70048,70052,Blue,1,65380,65604,224
2022-11-21,70047,70041,Blue,0,21035,21350,315
2022-07-26,70038,70056,Blue,1,23690,24691,1001
2022-04-18,70040,70048,Blue,1,52821,53204,383
2022-07-26,70040,70052,Blue,1,24021,25125,1104
2022-11-26,70042,70060,Blue,1,68132,69066,934
2022-01-17,70051,70047,Blue,0,83551,83745,194
2022-10-20,70050,70058,Blue,1,37352,37757,405
2022-06-09,70046,70056,Blue,1,73019,73544,525
2022-11-16,70050,70060,Blue,1,69051,69565,514
2022-11-12,70050,70052,Blue,1,47536,47662,126
2022-03-29,70055,70047,Blue,0,20447,20856,409
2022-03-18,70059,70051,Blue,0,59305,59620,315
2022-03-10,70046,70056,Blue,1,67691,68232,541
2022-06-30,70045,70041,Blue,0,76213,76435,222
2022-08-01,70054,70056,Blue,1,23243,23290,47
2022-03-26,70059,70055,Blue,0,22814,22966,152
2022-04-13,70048,70050,Blue,1,50824,50881,57
2022-06-11,70048,70060,Blue,1,80694,81426,732
2022-07-04,70040,70042,Blue,1,53182,53214,32
2022-08-19,70045,70043,Blue,0,21626,21715,89
2022-04-19,70042,70058,Blue,1,43783,44750,967
2022-10-03,70042,70044,Blue,1,58244,58270,26
2022-07-04,70046,70060,Blue,1,85677,86461,784
2022-06-16,70046,70054,Blue,1,24371,24840,469
2022-07-20,70055,70039,Blue,0,58248,59031,783
2022-12-11,70053,70049,Blue,0,81815,82014,199
2022-01-28,70059,70041,Blue,0,73215,74276,1061
2022-12-29,70039,70838,Blue,0,63968,64001,33
2022-09-14,70053,70051,Blue,0,28079,28137,58
2022-10-29,70051,70045,Blue,0,29684,30021,337
2022-10-05,70057,70047,Blue,0,35971,36464,493
2022-07-26,70047,70838,Blue,0,26361,26900,539
2022-12-27,70053,70049,Blue,0,23524,23724,200
2022-12-12,70038,70052,Blue,1,44665,45360,695
2022-03-01,70048,70058,Blue,1,56230,56779,549
2022-12-19,70052,70058,Blue,1,69733,70068,335
2022-12-13,70042,70054,Blue,1,45393,46149,756
2022-10-22,70047,70043,Blue,0,51426,51668,242
2022-11-25,70055,70039,Blue,0,54830,55624,794
2022-08-01,70053,70043,Blue,0,77189,77741,552
2022-06-18,70051,70041,Blue,0,39306,39913,607
2022-07-31,70047,70039,Blue,0,58201,58608,407
2022-07-15,70045,70041,Blue,0,55546,55742,196
2022-11-23,70042,70060,Blue,1,65509,66439,930
2022-03-17,70051,70045,Blue,0,36764,37129,365
2022-02-10,70040,70058,Blue,1,24717,25750,1033
2022-02-08,70042,70056,Blue,1,31101,31972,871
2022-10-02,70047,70838,Blue,0,64200,64683,483
2022-04-02,70059,70838,Blue,0,69199,70344,1145
2022-12-13,70038,70052,Blue,1,50372,51066,694
2022-08-28,70055,70043,Blue,0,24805,25468,663
2022-09-06,70049,70039,Blue,0,49932,50423,491
2022-11-20,70053,70043,Blue,0,51964,52522,558
2022-04-02,70056,70060,Blue,1,20618,20780,162
2022-06-19,70057,70045,Blue,0,34850,35488,638
2022-05-26,70042,70048,Blue,1,35547,35864,317
2022-01-13,70049,70045,Blue,0,46041,46252,211
2022-01-13,70057,70047,Blue,0,49837,50383,546
2022-03-31,70042,70048,Blue,1,61794,62085,291
2022-01-07,70038,70058,Blue,1,49366,50418,1052
2022-06-24,70049,70043,Blue,0,83706,84090,384
2022-02-23,70044,70056,Blue,1,43719,44418,699
2022-11-19,70057,70045,Blue,0,71435,72056,621
2022-03-18,70038,70054,Blue,1,67336,68125,789
2022-07-11,70052,70054,Blue,1,28710,28788,78
2022-08-19,70056,70058,Blue,1,24969,25044,75
2022-06-21,70046,70056,Blue,1,70699,71287,588
2022-03-31,70048,70052,Blue,1,85966,86174,208
2022-07-06,70050,70056,Blue,1,81420,81714,294
2022-11-19,70051,70039,Blue,0,72232,72828,596
2022-02-09,70057,70039,Blue,0,54892,55986,1094
2022-09-29,70043,70041,Blue,0,60955,60984,29
2022-03-14,70048,70052,Blue,1,56228,56433,205
2022-05-18,70055,70051,Blue,0,42483,42618,135
2022-02-13,70048,70060,Blue,1,77420,78041,621
2022-12-17,70053,70045,Blue,0,36515,36964,449
2022-10-06,70051,70838,Blue,0,86382,87075,693
2022-06-17,70053,70049,Blue,0,32367,32588,221
2022-03-08,70055,70043,Blue,0,24750,25485,735
2022-11-01,70047,70045,Blue,0,67510,67621,111
2022-04-27,70059,70055,Blue,0,24680,24835,155
2022-06-14,70059,70053,Blue,0,46102,46351,249
2022-09-24,70040,70042,Blue,1,66339,66372,33
2022-03-10,70044,70054,Blue,1,68167,68762,595
2022-09-27,70041,70838,Blue,0,35511,35621,110
2022-02-05,70048,70058,Blue,1,63604,64167,563
2022-10-24,70038,70054,Blue,1,83517,84639,1122
2022-01-05,70053,70051,Blue,0,76930,76988,58
2022-07-10,70044,70054,Blue,1,82590,83266,676
2022-02-06,70045,70039,Blue,0,46089,46363,274
2022-04-08,70038,70050,Blue,1,38621,39213,592
2022-02-08,70057,70838,Blue,0,27041,28298,1257
2022-07-25,70040,70044,Blue,1,57857,57980,123
2022-07-17,70055,70039,Blue,0,69680,70674,994
2022-02-10,70042,70046,Blue,1,70848,71029,181
2022-11-17,70057,70049,Blue,0,55173,55551,378
2022-09-26,70038,70044,Blue,1,25682,25879,197
2022-02-27,70059,70043,Blue,0,70572,71405,833
2022-02-24,70052,70056,Blue,1,56767,56918,151
2022-01-04,70057,70838,Blue,0,75560,76666,1106
2022-03-28,70049,70041,Blue,0,25419,25882,463
2022-12-26,70055,70049,Blue,0,63208,63489,281
2022-09-27,70055,70049,Blue,0,73505,73775,270
2022-04-17,70057,70039,Blue,0,23134,24011,877
2022-11-21,70044,70056,Blue,1,35159,35876,717
2022-07-14,70049,70045,Blue,0,52219,52425,206
2022-07-29,70052,70058,Blue,1,61933,62227,294
2022-07-20,70057,70053,Blue,0,33160,33317,157
2022-12-30,70044,70050,Blue,1,50925,51259,334
2022-10-11,70041,70838,Blue,0,30488,30627,139
2022-12-30,70043,70041,Blue,0,62652,62680,28
2022-02-28,70053,70838,Blue,0,28509,29498,989
2022-07-04,70041,70039,Blue,0,71530,71565,35
2022-09-10,70038,70054,Blue,1,31273,32078,805
2022-01-21,70046,70054,Blue,1,66260,66728,468
2022-12-31,70040,70054,Blue,1,85044,85783,739
2022-04-15,70051,70049,Blue,0,30943,31055,112
2022-06-13,70055,70045,Blue,0,26848,27412,564
2022-02-13,70040,70050,Blue,1,65790,66336,546
2022-06-29,70059,70055,Blue,0,40384,40547,163
2022-09-26,70038,70058,Blue,1,59893,60956,1063
2022-09-27,70049,70039,Blue,0,57716,58248,532
2022-07-19,70038,70046,Blue,1,65474,65804,330
2022-07-01,70038,70052,Blue,1,28199,29014,815
2022-10-25,70045,70039,Blue,0,56468,56719,251
2022-10-13,70038,70042,Blue,1,43512,43613,101
2022-01-18,70059,70055,Blue,0,27199,27349,150
2022-08-28,70044,70050,Blue,1,79326,79649,323
2022-12-07,70049,70045,Blue,0,60310,60492,182
2022-11-04,70048,70058,Blue,1,28223,28737,514
2022-10-13,70050,70054,Blue,1,30823,31035,212
2022-11-12,70044,70054,Blue,1,36864,37414,550
2022-12-28,70051,70041,Blue,0,26687,27223,536
2022-06-17,70044,70052,Blue,1,59470,60087,617
2022-04-14,70042,70050,Blue,1,28600,29037,437
2022-07-09,70051,70043,Blue,0,60931,61442,511
2022-12-01,70051,70045,Blue,0,46669,47020,351
2022-09-16,70059,70041,Blue,0,82070,82970,900
2022-09-01,70042,70044,Blue,1,27067,27102,35
2022-04-10,70050,70058,Blue,1,36865,37258,393
2022-07-27,70048,70056,Blue,1,28182,28580,398
2022-01-25,70038,70046,Blue,1,23071,23411,340
2022-10-07,70042,70046,Blue,1,51547,51733,186
2022-08-04,70047,70838,Blue,0,51585,52111,526
2022-01-27,70038,70050,Blue,1,59232,59801,569
2022-11-10,70051,70049,Blue,0,43941,44044,103
2022-05-06,70049,70047,Blue,0,25225,25264,39
2022-09-03,70059,70057,Blue,0,60555,60589,34
2022-07-21,70042,70058,Blue,1,51562,52443,881
2022-10-24,70040,70050,Blue,1,57151,57686,535
2022-09-19,70043,70041,Blue,0,39071,39101,30
2022-01-26,70055,70043,Blue,0,34034,34893,859
2022-12-02,70040,70042,Blue,1,26532,26563,31
2022-10-03,70050,70054,Blue,1,72078,72320,242
2022-08-09,70049,70043,Blue,0,60292,60641,349
2022-10-24,70057,70838,Blue,0,39656,40734,1078
2022-03-30,70044,70060,Blue,1,45645,46590,945
2022-10-17,70040,70050,Blue,1,42216,42831,615
2022-06-23,70059,70041,Blue,0,49393,50384,991
2022-05-21,70052,70060,Blue,1,56528,56918,390
2022-09-30,70048,70052,Blue,1,64347,64573,226
2022-03-23,70038,70040,Blue,1,84848,84866,18
2022-10-25,70046,70056,Blue,1,62800,63296,496
2022-06-04,70043,70039,Blue,0,41093,41207,114
2022-05-02,70059,70051,Blue,0,37520,37877,357
2022-03-24,70049,70039,Blue,0,21814,22321,507
2022-05-09,70051,70047,Blue,0,37265,37544,279
2022-03-15,70040,70060,Blue,1,75246,76304,1058
2022-02-19,70048,70058,Blue,1,87847,88381,534
2022-10-20,70059,70051,Blue,0,56181,56512,331
2022-03-24,70048,70052,Blue,1,34919,35221,302
2022-12-06,70049,70043,Blue,0,37401,37767,366
2022-02-16,70049,70041,Blue,0,40938,41409,471
2022-10-10,70059,70053,Blue,0,54088,54327,239
2022-01-25,70051,70047,Blue,0,30672,30873,201
2022-04-04,70056,70060,Blue,1,83082,83249,167
2022-10-27,70053,70041,Blue,0,38446,39185,739
2022-02-24,70047,70043,Blue,0,55818,56088,270
2022-09-30,70040,70048,Blue,1,39029,39447,418
2022-09-29,70055,70041,Blue,0,85928,86662,734
2022-03-20,70044,70060,Blue,1,30208,31039,831
2022-01-02,70049,70043,Blue,0,86947,87274,327
2022-02-24,70050,70056,Blue,1,35838,36192,354
2022-08-19,70042,70058,Blue,1,55457,56388,931
2022-06-15,70055,70838,Blue,0,45709,46715,1006
2022-12-21,70053,70039,Blue,0,55673,56451,778
2022-10-20,70047,70043,Blue,0,30784,31060,276
2022-02-20,70042,70048,Blue,1,67358,67686,328
2022-01-03,70038,70044,Blue,1,65235,65409,174
2022-03-24,70059,70049,Blue,0,66340,66807,467
2022-12-06,70044,70054,Blue,1,36614,37211,597
2022-06-18,70053,70041,Blue,0,22522,23352,830
2022-06-26,70044,70056,Blue,1,80032,80783,751
2022-08-29,70059,70049,Blue,0,46820,47278,458
2022-02-27,70038,70060,Blue,1,29292,30519,1227
2022-01-18,70046,70060,Blue,1,57400,58242,842
2022-02-01,70054,70058,Blue,1,53928,54246,318
2022-07-06,70043,70838,Blue,0,55830,56040,210
2022-03-07,70059,70049,Blue,0,55994,56465,471
2022-08-04,70042,70054,Blue,1,48547,49345,798
2022-12-05,70049,70043,Blue,0,40616,40980,364
2022-10-24,70055,70047,Blue,0,79996,80371,375
2022-08-05,70043,70838,Blue,0,30735,30948,213
2022-04-19,70055,70051,Blue,0,32560,32726,166
2022-08-31,70059,70057,Blue,0,36969,37004,35
2022-06-20,70057,70049,Blue,0,54597,55004,407
2022-12-12,70045,70041,Blue,0,58442,58598,156
2022-03-02,70053,70838,Blue,0,76302,77131,829
2022-03-06,70043,70838,Blue,0,43139,43362,223
2022-09-23,70053,70047,Blue,0,54892,55170,278
2022-09-21,70057,70047,Blue,0,19614,20195,581
2022-06-28,70047,70838,Blue,0,68018,68544,526
2022-08-16,70055,70045,Blue,0,67757,68256,499
2022-08-26,70056,70060,Blue,1,80159,80338,179
2022-05-01,70056,70058,Blue,1,62650,62724,74
2022-03-28,70044,70048,Blue,1,84692,84977,285
2022-08-29,70048,70058,Blue,1,43029,43573,544
2022-08-26,70052,70060,Blue,1,25300,25649,349
2022-09-19,70042,70054,Blue,1,76883,77501,618
2022-03-12,70049,70043,Blue,0,50255,50611,356
2022-02-19,70038,70046,Blue,1,22388,22731,343
2022-02-01,70046,70050,Blue,1,72874,73052,178
2022-01-14,70044,70046,Blue,1,63040,63244,204
2022-04-19,70055,70041,Blue,0,70698,71582,884
2022-07-26,70045,70043,Blue,0,36840,36945,105
2022-08-02,70038,70050,Blue,1,37465,38034,569
2022-09-28,70053,70838,Blue,0,67046,67893,847
2022-07-20,70057,70041,Blue,0,77005,77838,833
2022-06-11,70045,70838,Blue,0,59363,59742,379
2022-07-22,70054,70056,Blue,1,85382,85429,47
2022-02-09,70059,70053,Blue,0,60795,61033,238
2022-08-10,70040,70052,Blue,1,52121,52754,633
2022-06-03,70042,70052,Blue,1,61438,62186,748
2022-06-14,70054,70058,Blue,1,49065,49218,153
2022-06-16,70038,70046,Blue,1,67988,68328,340
2022-03-12,70057,70043,Blue,0,35251,36054,803
2022-01-14,70057,70039,Blue,0,81289,82206,917
2022-08-01,70049,70047,Blue,0,86297,86351,54
2022-01-12,70059,70055,Blue,0,87487,87626,139
2022-07-23,70050,70056,Blue,1,24902,25183,281
2022-03-05,70040,70054,Blue,1,50787,51528,741
2022-01-29,70044,70054,Blue,1,67446,68627,1181
2022-02-06,70051,70047,Blue,0,73076,73262,186
2022-03-09,70045,70041,Blue,0,75200,75384,184
2022-05-18,70042,70058,Blue,1,67772,68957,1185
2022-08-29,70059,70043,Blue,0,54615,55457,842
2022-11-08,70051,70045,Blue,0,73141,73488,347
2022-01-18,70053,70043,Blue,0,66478,67090,612
2022-10-21,70048,70058,Blue,1,75270,75791,521
2022-04-08,70053,70041,Blue,0,38421,39113,692
2022-11-14,70054,70060,Blue,1,37206,37476,270
2022-11-13,70038,70060,Blue,1,76429,77604,1175
2022-04-15,70038,70048,Blue,1,26058,26521,463
2022-02-01,70046,70056,Blue,1,25371,25935,564
2022-04-21,70051,70047,Blue,0,63280,63490,210
2022-07-11,70051,70047,Blue,0,63039,63219,180
2022-07-25,70044,70046,Blue,1,78530,78631,101
2022-01-24,70043,70039,Blue,0,63858,63962,104
2022-09-09,70053,70051,Blue,0,34538,34597,59
2022-04-20,70042,70060,Blue,1,75426,76403,977
2022-04-01,70038,70060,Blue,1,37946,39037,1091
2022-11-25,70044,70050,Blue,1,59058,59373,315
2022-03-10,70055,70043,Blue,0,68066,68791,725
2022-10-04,70046,70060,Blue,1,72435,73181,746
2022-06-09,70057,70039,Blue,0,33355,34390,1035
2022-08-02,70042,70044,Blue,1,63551,63590,39
2022-04-07,70055,70043,Blue,0,63378,64028,650
2022-10-19,70053,70047,Blue,0,62736,63016,280
2022-09-28,70040,70050,Blue,1,79714,80211,497
2022-04-30,70059,70049,Blue,0,56407,56856,449
2022-02-24,70052,70056,Blue,1,32344,32493,149
2022-01-12,70046,70048,Blue,1,44529,44623,94
2022-06-18,70053,70047,Blue,0,67532,67816,284
2022-07-10,70040,70054,Blue,1,48913,49722,809
2022-06-29,70055,70045,Blue,0,27443,27992,549
2022-12-07,70051,70043,Blue,0,45018,45484,466
2022-02-10,70045,70039,Blue,0,45248,45587,339
2022-06-30,70044,70056,Blue,1,64638,65354,716
2022-08-14,70048,70052,Blue,1,49363,49577,214
2022-06-29,70049,70043,Blue,0,76940,77311,371
2022-03-11,70044,70054,Blue,1,35702,36298,596
2022-06-04,70038,70044,Blue,1,39256,39462,206
2022-11-05,70059,70057,Blue,0,55693,55728,35
2022-08-06,70056,70058,Blue,1,59868,59937,69
2022-12-01,70059,70045,Blue,0,51486,52175,689
2022-03-21,70055,70039,Blue,0,44548,45393,845
2022-07-14,70045,70043,Blue,0,55208,55313,105
2022-11-13,70038,70042,Blue,1,30804,30888,84
2022-04-18,70046,70056,Blue,1,47315,47827,512
2022-03-20,70044,70052,Blue,1,45167,45662,495
2022-06-25,70055,70043,Blue,0,43484,44192,708
2022-09-02,70055,70041,Blue,0,24430,25164,734
2022-02-15,70045,70043,Blue,0,29287,29418,131
2022-03-16,70052,70056,Blue,1,37517,37693,176
2022-02-16,70038,70046,Blue,1,50769,51178,409
2022-06-28,70057,70051,Blue,0,35138,35477,339
2022-10-11,70053,70041,Blue,0,26636,27388,752
2022-02-08,70054,70058,Blue,1,54571,54727,156
2022-05-15,70055,70053,Blue,0,59611,59660,49
2022-01-28,70042,70054,Blue,1,55498,56150,652
2022-11-25,70043,70838,Blue,0,86623,86813,190
2022-04-01,70039,70838,Blue,0,78831,78865,34
2022-02-19,70059,70053,Blue,0,50296,50549,253
2022-06-21,70053,70049,Blue,0,47665,47860,195
2022-12-02,70049,70039,Blue,0,61488,62016,528
2022-04-19,70040,70050,Blue,1,85042,85570,528
2022-09-24,70040,70058,Blue,1,23760,24717,957
2022-06-15,70057,70055,Blue,0,53194,53263,69
2022-06-21,70046,70048,Blue,1,54960,55066,106
2022-08-04,70053,70043,Blue,0,86239,86764,525
2022-03-29,70040,70054,Blue,1,71021,71791,770
2022-03-23,70054,70058,Blue,1,52954,53112,158
2022-10-05,70059,70053,Blue,0,19936,20170,234
2022-08-04,70054,70058,Blue,1,28422,28581,159
2022-07-26,70042,70050,Blue,1,61531,61968,437
2022-09-25,70040,70052,Blue,1,48457,49147,690
2022-07-20,70052,70058,Blue,1,82083,82333,250
2022-08-19,70042,70056,Blue,1,49425,50562,1137
2022-10-10,70038,70042,Blue,1,81329,81430,101
2022-01-06,70041,70838,Blue,0,57533,57662,129
2022-03-03,70038,70042,Blue,1,52452,52545,93
2022-02-26,70038,70046,Blue,1,27495,27810,315
2022-06-01,70044,70048,Blue,1,42923,43247,324
2022-03-17,70059,70047,Blue,0,74895,75442,547
2022-01-22,70059,70041,Blue,0,84110,85045,935
2022-08-19,70043,70838,Blue,0,33144,33327,183
2022-06-25,70057,70047,Blue,0,80515,80989,474
2022-09-04,70038,70052,Blue,1,37997,38787,790
2022-08-17,70053,70047,Blue,0,53366,53656,290
2022-08-10,70047,70043,Blue,0,29112,29387,275
2022-02-11,70059,70057,Blue,0,20958,20994,36
2022-11-25,70051,70049,Blue,0,59122,59224,102
2022-06-13,70038,70052,Blue,1,37877,38654,777
2022-06-22,70059,70039,Blue,0,27619,28668,1049
2022-09-14,70040,70044,Blue,1,86606,86706,100
2022-12-22,70044,70056,Blue,1,54408,55131,723
2022-03-10,70057,70043,Blue,0,68539,69271,732
2022-05-11,70053,70051,Blue,0,30828,30888,60
2022-03-05,70047,70838,Blue,0,61178,61692,514
2022-02-15,70042,70046,Blue,1,57623,57808,185
2022-07-26,70042,70058,Blue,1,69783,70683,900
2022-08-07,70044,70054,Blue,1,77153,77770,617
2022-12-13,70044,70050,Blue,1,59979,60321,342
2022-04-06,70044,70060,Blue,1,75466,76397,931
2022-11-04,70051,70049,Blue,0,56033,56134,101
2022-01-03,70055,70039,Blue,0,23242,24034,792
2022-05-01,70056,70058,Blue,1,43489,43566,77
2022-12-31,70039,70838,Blue,0,70674,70706,32
2022-07-17,70045,70838,Blue,0,80428,80759,331
2022-06-18,70045,70838,Blue,0,36026,36404,378
2022-06-20,70041,70838,Blue,0,60254,60462,208
2022-07-26,70044,70060,Blue,1,39954,40985,1031
2022-03-16,70042,70060,Blue,1,87880,88917,1037
2022-10-30,70046,70060,Blue,1,57297,58014,717
2022-02-01,70057,70041,Blue,0,28011,29009,998
2022-01-28,70050,70058,Blue,1,56910,57309,399
2022-11-22,70038,70040,Blue,1,66913,66929,16
2022-08-30,70054,70060,Blue,1,60898,61173,275
2022-08-25,70057,70049,Blue,0,48579,48984,405
2022-10-10,70048,70058,Blue,1,57561,58080,519
2022-10-10,70048,70052,Blue,1,39313,39534,221
2022-06-22,70043,70838,Blue,0,31950,32146,196
2022-06-20,70057,70053,Blue,0,77591,77742,151
2022-04-08,70038,70058,Blue,1,36752,37916,1164
2022-09-16,70059,70041,Blue,0,58669,59640,971
2022-03-23,70038,70056,Blue,1,24584,25547,963
2022-12-27,70044,70058,Blue,1,41449,42270,821
2022-09-27,70047,70045,Blue,0,60610,60705,95
2022-02-11,70042,70058,Blue,1,51417,52255,838
2022-06-11,70052,70054,Blue,1,54207,54259,52
2022-03-04,70038,70040,Blue,1,56836,56861,25
2022-11-23,70051,70043,Blue,0,37214,38124,910
2022-11-15,70056,70058,Blue,1,43966,44039,73
2022-12-12,70059,70041,Blue,0,25944,26901,957
2022-06-10,70046,70056,Blue,1,51181,51721,540
2022-02-09,70053,70051,Blue,0,34316,34370,54
2022-09-25,70038,70044,Blue,1,79688,79884,196
2022-10-25,70044,70058,Blue,1,27030,27860,830
2022-05-08,70053,70051,Blue,0,26069,26130,61
2022-08-26,70057,70039,Blue,0,19641,20705,1064
2022-06-30,70046,70058,Blue,1,42294,43038,744
2022-03-26,70053,70045,Blue,0,62451,62863,412
2022-07-30,70052,70054,Blue,1,29298,29361,63
2022-01-28,70050,70054,Blue,1,75348,75576,228
2022-05-12,70052,70054,Blue,1,21654,21708,54
2022-12-19,70044,70060,Blue,1,45851,46718,867
2022-11-07,70045,70043,Blue,0,26492,26595,103
2022-12-06,70040,70050,Blue,1,24970,25475,505
2022-02-28,70057,70041,Blue,0,62069,62905,836
2022-06-21,70054,70058,Blue,1,36891,37049,158
2022-04-01,70040,70050,Blue,1,20395,20980,585
2022-09-07,70040,70042,Blue,1,30033,30065,32
2022-12-29,70050,70054,Blue,1,55381,55594,213
2022-04-28,70059,70057,Blue,0,32241,32275,34
2022-09-08,70040,70048,Blue,1,73222,73603,381
2022-10-09,70053,70838,Blue,0,77860,78690,830
2022-04-02,70040,70052,Blue,1,85573,86211,638
2022-05-27,70040,70052,Blue,1,47543,48317,774
2022-01-27,70040,70054,Blue,1,59296,60068,772
2022-09-29,70040,70058,Blue,1,39087,40099,1012
2022-09-16,70055,70043,Blue,0,45952,46603,651
2022-07-01,70044,70058,Blue,1,74149,75111,962
2022-07-27,70040,70044,Blue,1,54154,54277,123
2022-03-12,70059,70051,Blue,0,52996,53331,335
2022-07-28,70046,70050,Blue,1,34583,34772,189
2022-03-22,70048,70060,Blue,1,62946,63606,660
2022-01-07,70040,70054,Blue,1,25696,26429,733
2022-04-02,70055,70047,Blue,0,43514,43910,396
2022-03-09,70040,70054,Blue,1,66487,67220,733
2022-01-25,70038,70054,Blue,1,39112,39954,842
2022-02-19,70053,70041,Blue,0,62445,63098,653
2022-12-12,70040,70056,Blue,1,60772,61602,830
2022-01-01,70054,70056,Blue,1,52985,53033,48
2022-08-25,70053,70041,Blue,0,86897,87551,654
2022-03-14,70048,70052,Blue,1,25589,25785,196
2022-04-11,70059,70049,Blue,0,67938,68379,441
2022-02-03,70055,70049,Blue,0,25977,26305,328
2022-03-20,70047,70043,Blue,0,46542,46850,308
2022-10-01,70040,70052,Blue,1,37299,37956,657
2022-08-04,70044,70058,Blue,1,69198,70076,878
2022-09-17,70049,70043,Blue,0,35675,36016,341
2022-10-08,70042,70050,Blue,1,67607,68026,419
2022-08-24,70048,70060,Blue,1,80544,81165,621
2022-09-06,70049,70047,Blue,0,26904,26966,62
2022-10-04,70052,70058,Blue,1,74334,74586,252
2022-04-13,70057,70043,Blue,0,58787,59652,865
2022-12-20,70050,70052,Blue,1,32003,32120,117
2022-03-06,70045,70039,Blue,0,63236,63481,245
2022-06-22,70057,70053,Blue,0,65683,65835,152
2022-11-01,70050,70052,Blue,1,27264,27386,122
2022-12-17,70038,70056,Blue,1,49101,49941,840
2022-07-16,70042,70054,Blue,1,51978,52712,734
2022-09-23,70053,70045,Blue,0,39767,40203,436
2022-12-07,70055,70053,Blue,0,40670,40718,48
2022-11-08,70038,70058,Blue,1,30252,31221,969
2022-09-12,70038,70040,Blue,1,46100,46117,17
2022-03-15,70057,70043,Blue,0,59675,60511,836
2022-08-15,70051,70047,Blue,0,31387,31606,219
2022-12-30,70057,70045,Blue,0,44257,44906,649
2022-06-05,70041,70838,Blue,0,83149,83267,118
2022-01-18,70051,70041,Blue,0,63536,64071,535
2022-10-25,70049,70039,Blue,0,34017,34560,543
2022-01-04,70040,70052,Blue,1,29397,29999,602
2022-09-22,70051,70049,Blue,0,29265,29374,109
2022-04-06,70057,70041,Blue,0,20679,21627,948
2022-05-18,70048,70052,Blue,1,28011,28221,210
2022-01-05,70038,70056,Blue,1,24899,25782,883
2022-08-24,70038,70052,Blue,1,63903,64759,856
2022-09-18,70055,70047,Blue,0,57827,58201,374
2022-07-18,70039,70838,Blue,0,81511,81542,31
2022-03-03,70050,70054,Blue,1,35066,35431,365
2022-03-08,70050,70060,Blue,1,81411,81930,519
2022-01-27,70050,70054,Blue,1,20578,20797,219
2022-09-21,70059,70039,Blue,0,29300,30435,1135
2022-11-19,70054,70056,Blue,1,26468,26515,47
2022-07-15,70052,70056,Blue,1,37215,37364,149
2022-07-31,70048,70054,Blue,1,72590,72946,356
2022-02-15,70055,70838,Blue,0,86468,87462,994
2022-01-17,70038,70044,Blue,1,39629,39802,173
2022-07-14,70040,70052,Blue,1,58231,58928,697
2022-04-18,70049,70039,Blue,0,24150,24628,478
2022-07-15,70044,70056,Blue,1,73775,74497,722
2022-07-07,70049,70047,Blue,0,66024,66079,55
2022-01-21,70039,70838,Blue,0,53013,53055,42
2022-02-14,70050,70052,Blue,1,27284,27408,124
2022-01-24,70046,70054,Blue,1,52425,52870,445
2022-02-24,70057,70047,Blue,0,46170,46761,591
2022-03-09,70055,70049,Blue,0,72255,72550,295
2022-06-16,70051,70043,Blue,0,58577,59104,527
2022-03-07,70038,70050,Blue,1,26347,26882,535
2022-06-16,70046,70058,Blue,1,67625,68317,692
2022-12-30,70050,70058,Blue,1,31557,31969,412
2022-07-19,70042,70054,Blue,1,55765,56493,728
2022-04-14,70038,70050,Blue,1,36203,36789,586
2022-04-08,70050,70052,Blue,1,22218,22331,113
2022-01-12,70051,70041,Blue,0,82125,82657,532
2022-11-22,70055,70838,Blue,0,60596,61488,892
2022-08-24,70055,70053,Blue,0,21702,21751,49
2022-07-10,70047,70041,Blue,0,29082,29392,310
2022-06-01,70046,70052,Blue,1,25758,26174,416
2022-08-05,70038,70046,Blue,1,40902,41275,373
2022-04-16,70042,70052,Blue,1,28784,29366,582
2022-12-15,70054,70056,Blue,1,56719,56767,48
2022-07-01,70042,70060,Blue,1,40843,41999,1156
2022-08-05,70044,70046,Blue,1,75540,75646,106
2022-08-30,70044,70048,Blue,1,45451,45679,228
2022-09-21,70046,70058,Blue,1,41885,42553,668
2022-09-09,70059,70041,Blue,0,60846,61776,930
2022-07-05,70038,70046,Blue,1,85769,86077,308
2022-09-27,70053,70051,Blue,0,50829,50885,56
2022-08-21,70040,70050,Blue,1,77530,78017,487
2022-11-23,70059,70043,Blue,0,43544,44591,1047
2022-01-04,70042,70044,Blue,1,68088,68125,37
2022-05-31,70049,70043,Blue,0,33294,33733,439
2022-03-20,70038,70042,Blue,1,78560,78650,90
2022-09-28,70059,70041,Blue,0,43168,44202,1034
2022-11-18,70051,70047,Blue,0,67510,67760,250
2022-02-15,70040,70042,Blue,1,67993,68025,32
2022-12-15,70059,70043,Blue,0,63980,64819,839
2022-12-13,70040,70042,Blue,1,35845,35884,39
2022-09-28,70059,70051,Blue,0,45267,45612,345
2022-03-08,70052,70056,Blue,1,69189,69316,127
2022-08-03,70048,70054,Blue,1,58581,58900,319
2022-06-07,70049,70047,Blue,0,50563,50617,54
2022-01-29,70040,70056,Blue,1,80736,82365,1629
2022-07-30,70055,70041,Blue,0,44532,45323,791
2022-05-04,70050,70060,Blue,1,63920,64407,487
2022-06-14,70050,70054,Blue,1,58711,58928,217
2022-08-02,70042,70058,Blue,1,65124,66017,893
2022-08-20,70055,70051,Blue,0,31025,31158,133
2022-07-23,70052,70060,Blue,1,27134,27531,397
2022-08-29,70040,70054,Blue,1,64359,65135,776
2022-11-06,70044,70056,Blue,1,49605,50283,678
2022-03-16,70040,70048,Blue,1,61154,61577,423
2022-11-07,70042,70046,Blue,1,22067,22498,431
2022-12-22,70054,70060,Blue,1,63441,63729,288
2022-02-11,70038,70060,Blue,1,60734,61948,1214
2022-03-23,70041,70838,Blue,0,38152,38284,132
2022-03-14,70045,70039,Blue,0,41716,41969,253
2022-09-05,70047,70041,Blue,0,39447,39764,317
2022-09-13,70038,70050,Blue,1,64351,64891,540
2022-06-16,70052,70060,Blue,1,79455,79826,371
2022-08-17,70056,70060,Blue,1,82709,82916,207
2022-03-23,70047,70838,Blue,0,67377,67882,505
2022-07-14,70044,70050,Blue,1,77092,77471,379
2022-12-12,70042,70046,Blue,1,63517,63727,210
2022-10-27,70049,70043,Blue,0,26365,26751,386
2022-02-11,70051,70049,Blue,0,63301,63411,110
2022-04-09,70055,70053,Blue,0,86711,86758,47
2022-04-14,70056,70058,Blue,1,62071,62146,75
2022-03-01,70038,70054,Blue,1,59420,60353,933
2022-10-07,70055,70049,Blue,0,85934,86205,271
2022-10-03,70038,70048,Blue,1,36797,37257,460
2022-02-08,70044,70050,Blue,1,34919,35307,388
2022-07-22,70055,70838,Blue,0,67332,68300,968
2022-09-07,70044,70054,Blue,1,36649,37287,638
2022-01-22,70048,70056,Blue,1,43080,43422,342
2022-09-11,70050,70052,Blue,1,53240,53350,110
2022-06-16,70059,70045,Blue,0,51551,52231,680
2022-06-21,70048,70052,Blue,1,63606,63818,212
2022-12-27,70041,70838,Blue,0,85951,86075,124
2022-06-22,70059,70055,Blue,0,27256,27420,164
2022-04-16,70055,70047,Blue,0,36988,37453,465
2022-01-10,70038,70040,Blue,1,65225,65240,15
2022-06-16,70042,70054,Blue,1,47205,47967,762
2022-11-25,70044,70054,Blue,1,25009,25602,593
2022-06-14,70038,70042,Blue,1,31756,31846,90
2022-07-29,70057,70051,Blue,0,71094,71340,246
2022-08-29,70057,70055,Blue,0,53827,53896,69
2022-11-18,70044,70046,Blue,1,24219,24334,115
2022-04-07,70050,70060,Blue,1,26980,27613,633
2022-04-23,70043,70041,Blue,0,89698,89729,31
2022-01-07,70040,70044,Blue,1,61430,61537,107
2022-04-05,70042,70056,Blue,1,46522,47219,697
2022-03-25,70042,70044,Blue,1,32510,32539,29
2022-12-15,70059,70045,Blue,0,66553,67246,693
2022-09-29,70057,70045,Blue,0,42686,43438,752
2022-10-12,70051,70039,Blue,0,26435,27385,950
2022-06-11,70046,70056,Blue,1,57701,58255,554
2022-06-27,70058,70060,Blue,1,25503,25611,108
2022-07-24,70044,70060,Blue,1,50155,51020,865
2022-11-03,70053,70838,Blue,0,58895,59751,856
2022-08-24,70040,70052,Blue,1,28343,28993,650
2022-11-02,70059,70053,Blue,0,82859,83088,229
2022-03-11,70053,70051,Blue,0,57161,57220,59
2022-07-13,70044,70056,Blue,1,23458,24210,752
2022-10-10,70041,70838,Blue,0,46238,46346,108
2022-02-23,70053,70039,Blue,0,31435,32230,795
2022-09-04,70055,70041,Blue,0,37606,38593,987
2022-04-23,70053,70045,Blue,0,24431,24874,443
2022-09-21,70043,70039,Blue,0,37940,38060,120
2022-04-22,70048,70050,Blue,1,21164,21223,59
2022-08-04,70044,70050,Blue,1,74944,75302,358
2022-05-26,70038,70050,Blue,1,69923,70529,606
2022-10-31,70042,70058,Blue,1,24267,25087,820
2022-08-30,70057,70838,Blue,0,80550,81573,1023
2022-06-13,70038,70058,Blue,1,26953,27936,983
2022-09-04,70046,70054,Blue,1,48687,49099,412
2022-10-10,70051,70045,Blue,0,67930,68256,326
2022-07-11,70054,70058,Blue,1,81742,81892,150
2022-12-12,70038,70042,Blue,1,79959,80047,88
2022-07-14,70042,70046,Blue,1,24742,24935,193
2022-12-12,70045,70838,Blue,0,52695,53010,315
2022-07-14,70040,70044,Blue,1,87435,87535,100
2022-01-14,70049,70041,Blue,0,62229,62667,438
2022-03-16,70057,70053,Blue,0,61467,61617,150
2022-02-02,70059,70053,Blue,0,75491,75720,229
2022-11-30,70057,70838,Blue,0,42732,43868,1136
2022-10-29,70043,70838,Blue,0,42081,42281,200
2022-02-24,70049,70047,Blue,0,74845,74901,56
2022-04-01,70042,70052,Blue,1,65684,66274,590
2022-12-29,70051,70043,Blue,0,25724,26229,505
2022-10-14,70044,70054,Blue,1,28421,29080,659
2022-12-09,70050,70058,Blue,1,77938,78337,399
2022-08-24,70040,70052,Blue,1,51364,51988,624
2022-09-23,70053,70049,Blue,0,58782,58989,207
2022-04-03,70043,70838,Blue,0,42438,42644,206
2022-08-12,70038,70044,Blue,1,44208,44395,187
2022-01-17,70038,70040,Blue,1,72949,72964,15
2022-06-12,70054,70058,Blue,1,43891,44054,163
2022-08-27,70047,70043,Blue,0,56322,56574,252
2022-12-02,70048,70060,Blue,1,68198,68812,614
2022-06-09,70042,70056,Blue,1,33402,34253,851
2022-04-24,70038,70050,Blue,1,81673,82241,568
2022-01-08,70051,70041,Blue,0,29047,29582,535
2022-08-22,70059,70051,Blue,0,46817,47136,319
2022-04-15,70038,70042,Blue,1,58932,59025,93
2022-11-23,70050,70060,Blue,1,88814,89331,517
2022-12-31,70054,70056,Blue,1,90101,90150,49
2022-03-03,70057,70039,Blue,0,24259,25225,966
2022-04-23,70054,70058,Blue,1,64055,64211,156
2022-12-01,70044,70048,Blue,1,48877,49107,230
2022-07-31,70040,70052,Blue,1,83049,83695,646
2022-04-14,70053,70041,Blue,0,24835,25655,820
2022-06-30,70042,70060,Blue,1,55613,56676,1063
2022-03-27,70046,70050,Blue,1,50325,50512,187
2022-08-19,70057,70055,Blue,0,85250,85320,70
2022-03-15,70038,70060,Blue,1,39260,40497,1237
2022-04-15,70053,70041,Blue,0,25187,25953,766
2022-08-21,70047,70041,Blue,0,40889,41237,348
2022-06-27,70053,70041,Blue,0,35941,36668,727
2022-01-25,70053,70047,Blue,0,44596,44959,363
2022-09-18,70049,70043,Blue,0,78756,79106,350
2022-03-31,70058,70060,Blue,1,59754,59825,71
2022-04-06,70041,70039,Blue,0,47096,47132,36
2022-03-15,70040,70050,Blue,1,49078,49580,502
2022-01-25,70042,70048,Blue,1,31761,32080,319
2022-11-24,70057,70055,Blue,0,31708,31777,69
2022-02-16,70052,70058,Blue,1,28965,29218,253
2022-10-01,70051,70838,Blue,0,53369,54171,802
2022-03-03,70038,70052,Blue,1,25527,26236,709
2022-01-27,70054,70056,Blue,1,28156,28203,47
2022-12-22,70038,70060,Blue,1,28248,29389,1141
2022-03-01,70050,70054,Blue,1,75506,75720,214
2022-09-07,70058,70060,Blue,1,68456,68516,60
2022-06-15,70059,70047,Blue,0,20968,21576,608
2022-12-25,70057,70043,Blue,0,69571,70312,741
2022-08-24,70044,70054,Blue,1,33421,34052,631
2022-01-03,70059,70039,Blue,0,26059,27178,1119
2022-09-26,70040,70050,Blue,1,80709,81188,479
2022-06-09,70049,70043,Blue,0,65625,66001,376
2022-12-01,70059,70039,Blue,0,85774,86761,987
2022-07-06,70042,70044,Blue,1,71382,71413,31
2022-01-06,70046,70050,Blue,1,72809,72995,186
2022-04-23,70046,70052,Blue,1,40313,40671,358
2022-05-13,70055,70051,Blue,0,86626,86780,154
2022-09-20,70040,70058,Blue,1,47215,48137,922
2022-04-06,70055,70838,Blue,0,74531,75478,947
2022-03-15,70048,70050,Blue,1,36767,36824,57
2022-03-16,70056,70058,Blue,1,53164,53236,72
2022-02-16,70038,70058,Blue,1,66428,67537,1109
2022-03-15,70042,70050,Blue,1,63313,63786,473
2022-09-08,70038,70046,Blue,1,36403,36719,316
2022-01-23,70040,70054,Blue,1,52151,52907,756
2022-05-24,70045,70041,Blue,0,57110,57323,213
2022-06-10,70053,70838,Blue,0,82009,82875,866
2022-02-25,70038,70048,Blue,1,22753,23224,471
2022-10-06,70044,70060,Blue,1,81693,82654,961
2022-12-28,70044,70060,Blue,1,34905,36061,1156
2022-11-11,70056,70060,Blue,1,51877,52056,179
2022-02-19,70059,70045,Blue,0,22159,22913,754
2022-04-13,70055,70039,Blue,0,20769,21567,798
2022-11-06,70038,70058,Blue,1,56946,57982,1036
2022-10-28,70042,70052,Blue,1,70182,70761,579
2022-08-30,70042,70050,Blue,1,33462,33919,457
2022-07-07,70057,70047,Blue,0,62299,62783,484
2022-11-23,70059,70838,Blue,0,71237,72305,1068
2022-05-19,70040,70044,Blue,1,53525,53639,114
2022-08-12,70040,70050,Blue,1,26018,26531,513
2022-12-23,70040,70054,Blue,1,64184,65012,828
2022-04-02,70053,70838,Blue,0,76049,76836,787
2022-11-24,70048,70054,Blue,1,28926,29230,304
2022-02-28,70049,70043,Blue,0,25699,26074,375
2022-04-13,70059,70047,Blue,0,53896,54473,577
2022-08-27,70059,70043,Blue,0,27619,28484,865
2022-03-25,70047,70045,Blue,0,26135,26250,115
2022-06-23,70046,70050,Blue,1,68391,68593,202
2022-06-15,70046,70056,Blue,1,45702,46259,557
2022-10-18,70057,70043,Blue,0,79948,80748,800
2022-09-03,70053,70041,Blue,0,47842,48532,690
2022-04-19,70044,70048,Blue,1,66981,67231,250
2022-06-25,70047,70041,Blue,0,49963,50340,377
2022-06-27,70053,70051,Blue,0,54272,54332,60
2022-03-31,70046,70048,Blue,1,54418,54498,80
2022-05-27,70042,70052,Blue,1,44668,45657,989
2022-12-16,70047,70045,Blue,0,49980,50071,91
2022-07-18,70044,70060,Blue,1,64251,65191,940
2022-08-07,70040,70050,Blue,1,81992,82509,517
2022-10-17,70044,70056,Blue,1,45056,45780,724
2022-02-19,70040,70044,Blue,1,85637,85763,126
2022-03-04,70051,70838,Blue,0,50598,51365,767
2022-07-21,70050,70054,Blue,1,60968,61191,223
2022-06-26,70055,70039,Blue,0,30268,31160,892
2022-10-17,70038,70046,Blue,1,42642,42965,323
2022-06-23,70049,70838,Blue,0,81226,81863,637
2022-08-15,70049,70043,Blue,0,76940,77298,358
2022-12-29,70038,70058,Blue,1,73434,74477,1043
2022-06-18,70049,70041,Blue,0,41635,42132,497
2022-01-14,70055,70838,Blue,0,23880,24942,1062
2022-02-14,70046,70058,Blue,1,49032,49647,615
2022-11-21,70042,70058,Blue,1,23665,24600,935
2022-08-03,70040,70052,Blue,1,35535,36181,646
2022-08-08,70042,70054,Blue,1,53818,54489,671
2022-03-30,70057,70053,Blue,0,29763,29925,162
2022-04-08,70059,70049,Blue,0,54496,54954,458
2022-05-20,70057,70041,Blue,0,55231,56233,1002
2022-03-04,70055,70043,Blue,0,25936,26759,823
2022-12-02,70049,70838,Blue,0,46780,47345,565
2022-10-03,70049,70039,Blue,0,43841,44384,543
2022-08-19,70055,70043,Blue,0,41546,42411,865
2022-08-07,70045,70838,Blue,0,66091,66424,333
2022-09-03,70049,70041,Blue,0,82082,82541,459
2022-08-10,70050,70056,Blue,1,27866,28166,300
2022-09-20,70055,70041,Blue,0,68816,69629,813
2022-12-05,70053,70043,Blue,0,55599,56202,603
2022-01-21,70046,70052,Blue,1,68586,68939,353
2022-10-19,70053,70039,Blue,0,42021,42792,771
2022-09-29,70049,70043,Blue,0,36917,37258,341
2022-08-14,70053,70838,Blue,0,74077,74883,806
2022-03-29,70038,70050,Blue,1,24864,25455,591
2022-09-10,70042,70046,Blue,1,26430,26600,170
2022-01-05,70054,70058,Blue,1,64926,65088,162
2022-11-15,70045,70838,Blue,0,45414,45747,333
2022-06-27,70038,70046,Blue,1,36084,36476,392
2022-10-25,70045,70039,Blue,0,61101,61425,324
2022-12-31,70038,70042,Blue,1,48006,48097,91
2022-08-10,70059,70051,Blue,0,48854,49179,325
2022-07-01,70048,70060,Blue,1,63909,64538,629
2022-05-19,70038,70060,Blue,1,35431,36838,1407
2022-04-06,70055,70051,Blue,0,47311,47457,146
2022-03-04,70041,70838,Blue,0,80447,80578,131
2022-10-24,70054,70056,Blue,1,68783,68829,46
2022-07-24,70044,70054,Blue,1,58290,58889,599
2022-01-19,70045,70043,Blue,0,63035,63121,86
2022-07-19,70040,70056,Blue,1,31265,32224,959
2022-03-31,70059,70045,Blue,0,75497,76177,680
2022-08-24,70055,70039,Blue,0,33678,34585,907
2022-08-02,70038,70048,Blue,1,77832,78277,445
2022-11-27,70039,70838,Blue,0,62460,62493,33
2022-12-18,70045,70039,Blue,0,85394,85626,232
2022-12-17,70048,70050,Blue,1,60991,61050,59
2022-11-23,70045,70039,Blue,0,69837,70072,235
2022-02-16,70057,70049,Blue,0,27929,28315,386
2022-02-06,70043,70039,Blue,0,80488,80592,104
2022-04-23,70046,70056,Blue,1,84986,85475,489
2022-02-19,70040,70060,Blue,1,62135,63222,1087
2022-07-24,70042,70052,Blue,1,27795,28330,535
2022-02-16,70057,70838,Blue,0,62979,64053,1074
2022-09-22,70059,70039,Blue,0,27618,28810,1192
2022-03-28,70059,70057,Blue,0,32066,32102,36
2022-01-31,70045,70043,Blue,0,72657,72783,126
2022-12-30,70052,70060,Blue,1,61442,61819,377
2022-06-14,70044,70048,Blue,1,24866,25149,283
2022-08-29,70042,70058,Blue,1,82086,82968,882
2022-06-04,70038,70040,Blue,1,35662,35678,16
2022-01-03,70038,70042,Blue,1,60171,60265,94
2022-10-17,70038,70052,Blue,1,23148,23875,727
2022-03-07,70055,70043,Blue,0,54971,55601,630
2022-12-19,70040,70048,Blue,1,86366,86757,391
2022-07-09,70051,70047,Blue,0,45816,46018,202
2022-05-22,70041,70039,Blue,0,35411,35446,35
2022-10-29,70059,70045,Blue,0,84013,84742,729
2022-04-19,70038,70058,Blue,1,66135,67150,1015
2022-12-02,70042,70054,Blue,1,53849,54534,685
2022-11-12,70042,70056,Blue,1,73591,74368,777
2022-10-01,70043,70039,Blue,0,46915,47029,114
2022-03-10,70051,70045,Blue,0,84394,84711,317
2022-10-16,70051,70045,Blue,0,41829,42152,323
2022-03-25,70051,70043,Blue,0,70340,70812,472
2022-09-06,70042,70056,Blue,1,78538,79281,743
2022-02-10,70050,70060,Blue,1,21080,21622,542
2022-10-05,70047,70043,Blue,0,61936,62180,244
2022-08-15,70055,70051,Blue,0,45483,45625,142
2022-08-26,70051,70045,Blue,0,26318,26678,360
2022-06-28,70038,70044,Blue,1,60956,61147,191
2022-06-09,70047,70838,Blue,0,23543,24119,576
2022-04-01,70055,70041,Blue,0,84200,85002,802
2022-04-02,70038,70048,Blue,1,48554,49053,499
2022-09-18,70045,70039,Blue,0,66634,66932,298
2022-10-17,70055,70045,Blue,0,69859,70408,549
2022-01-01,70044,70050,Blue,1,83988,84343,355
2022-08-12,70055,70049,Blue,0,48563,48827,264
2022-11-18,70048,70050,Blue,1,51777,51831,54
2022-11-26,70053,70043,Blue,0,30022,30553,531
2022-01-07,70057,70045,Blue,0,27633,28305,672
2022-01-04,70053,70039,Blue,0,29348,30103,755
2022-10-09,70055,70043,Blue,0,58877,59556,679
2022-02-09,70040,70056,Blue,1,33921,34776,855
2022-03-28,70058,70060,Blue,1,75690,75763,73
2022-07-06,70038,70040,Blue,1,23235,23252,17
2022-10-07,70047,70041,Blue,0,48516,48870,354
2022-07-11,70038,70060,Blue,1,27035,28152,1117
2022-10-03,70051,70049,Blue,0,75724,75850,126
2022-10-18,70050,70058,Blue,1,30249,30668,419
2022-04-02,70045,70041,Blue,0,38655,38844,189
2022-03-25,70059,70053,Blue,0,43965,44220,255
2022-07-24,70057,70039,Blue,0,53915,54873,958
2022-11-04,70044,70056,Blue,1,26494,27151,657
2022-02-02,70055,70838,Blue,0,21274,22399,1125
2022-03-03,70042,70060,Blue,1,28011,29095,1084
2022-03-01,70051,70049,Blue,0,65796,65904,108
2022-10-28,70042,70060,Blue,1,77432,78393,961
2022-11-30,70052,70060,Blue,1,39589,40025,436
2022-08-08,70051,70049,Blue,0,80399,80502,103
2022-11-09,70055,70045,Blue,0,58392,58898,506
2022-06-17,70059,70041,Blue,0,31458,32438,980
2022-04-25,70055,70053,Blue,0,38937,38995,58
2022-05-03,70057,70055,Blue,0,21835,21907,72
2022-11-11,70044,70048,Blue,1,30885,31121,236
2022-01-06,70052,70054,Blue,1,37519,37570,51
2022-07-02,70040,70048,Blue,1,51086,51572,486
2022-02-16,70057,70041,Blue,0,86364,87229,865
2022-02-28,70049,70047,Blue,0,50725,50777,52
2022-12-27,70057,70045,Blue,0,58894,59501,607
2022-04-08,70059,70838,Blue,0,31753,32959,1206
2022-08-21,70046,70058,Blue,1,69378,70066,688
2022-11-09,70054,70058,Blue,1,28659,28811,152
2022-01-17,70038,70052,Blue,1,58817,59590,773
2022-01-12,70049,70838,Blue,0,26895,27501,606
2022-08-18,70055,70051,Blue,0,53737,53884,147
2022-01-10,70045,70838,Blue,0,23181,23547,366
2022-06-06,70038,70048,Blue,1,67057,67628,571
2022-11-21,70045,70838,Blue,0,61607,61947,340
2022-01-26,70059,70051,Blue,0,64702,65058,356
2022-08-24,70044,70054,Blue,1,54646,55234,588
2022-02-14,70047,70041,Blue,0,70079,70403,324
2022-09-16,70048,70052,Blue,1,42936,43145,209
2022-07-18,70047,70041,Blue,0,53323,53680,357
2022-12-10,70038,70056,Blue,1,30732,31651,919
2022-02-11,70044,70060,Blue,1,86791,87794,1003
2022-06-12,70057,70045,Blue,0,43538,44142,604
2022-09-21,70047,70041,Blue,0,36530,36899,369
2022-03-23,70044,70056,Blue,1,52559,53273,714
2022-10-24,70052,70054,Blue,1,31161,31211,50
2022-04-04,70042,70050,Blue,1,34900,35329,429
2022-07-19,70054,70056,Blue,1,53757,53803,46
2022-02-10,70048,70052,Blue,1,21234,21433,199
2022-03-25,70042,70054,Blue,1,63882,64673,791
2022-03-31,70055,70043,Blue,0,72266,72950,684
2022-03-17,70048,70050,Blue,1,87052,87110,58
2022-10-31,70048,70058,Blue,1,57681,58207,526
2022-03-09,70050,70056,Blue,1,61144,61446,302
2022-08-02,70042,70050,Blue,1,52654,53074,420
2022-03-04,70047,70039,Blue,0,84625,85015,390
2022-10-27,70051,70045,Blue,0,80286,80622,336
2022-08-02,70048,70050,Blue,1,63557,63614,57
2022-07-03,70055,70053,Blue,0,47533,47578,45
2022-11-03,70043,70039,Blue,0,69497,69606,109
2022-11-01,70057,70051,Blue,0,27708,27979,271
2022-01-24,70051,70043,Blue,0,30943,31503,560
2022-06-21,70040,70060,Blue,1,40178,41374,1196
2022-01-16,70042,70046,Blue,1,31087,31275,188
2022-12-27,70057,70045,Blue,0,29623,30256,633
2022-07-26,70050,70054,Blue,1,65905,66120,215
2022-06-27,70038,70048,Blue,1,30379,30835,456
2022-10-27,70038,70056,Blue,1,63817,64731,914
2022-03-10,70042,70048,Blue,1,64800,65139,339
2022-12-01,70054,70056,Blue,1,66441,66488,47
2022-01-11,70047,70039,Blue,0,38179,38580,401
2022-03-11,70057,70055,Blue,0,87556,87624,68
2022-03-31,70055,70049,Blue,0,51732,52014,282
2022-10-26,70055,70041,Blue,0,56841,57636,795
2022-10-18,70038,70042,Blue,1,42240,42341,101
2022-11-28,70042,70056,Blue,1,60455,61256,801
2022-01-20,70055,70838,Blue,0,45693,46678,985
2022-10-07,70052,70054,Blue,1,76584,76657,73
2022-10-28,70057,70049,Blue,0,44853,45254,401
2022-06-09,70040,70044,Blue,1,58697,59114,417
2022-06-01,70042,70050,Blue,1,58084,58573,489
2022-01-17,70040,70046,Blue,1,78670,78945,275
2022-10-07,70057,70045,Blue,0,55171,55786,615
2022-03-26,70057,70838,Blue,0,26073,27060,987
2022-08-10,70052,70060,Blue,1,58453,58855,402
2022-07-12,70040,70044,Blue,1,77529,77665,136
2022-02-15,70048,70052,Blue,1,87110,87312,202
2022-01-05,70038,70054,Blue,1,56233,57010,777
2022-04-30,70053,70049,Blue,0,45879,46114,235
2022-06-22,70041,70838,Blue,0,81732,81868,136
2022-06-20,70042,70060,Blue,1,33847,34879,1032
2022-10-06,70045,70043,Blue,0,30700,30794,94
2022-03-30,70057,70039,Blue,0,72144,73018,874
2022-05-27,70039,70838,Blue,0,83512,83544,32
2022-01-02,70048,70060,Blue,1,31268,31842,574
2022-02-05,70053,70043,Blue,0,56538,57160,622
2022-07-05,70040,70060,Blue,1,76974,78180,1206
2022-10-06,70042,70056,Blue,1,72221,72981,760
2022-09-24,70051,70838,Blue,0,48489,49280,791
2022-11-04,70046,70052,Blue,1,70033,70565,532
2022-06-25,70046,70058,Blue,1,42553,43199,646
2022-09-21,70043,70838,Blue,0,37940,38157,217
2022-08-28,70055,70045,Blue,0,70747,71232,485
2022-02-21,70044,70048,Blue,1,26732,26954,222
2022-10-10,70052,70054,Blue,1,75466,75513,47
2022-12-20,70052,70056,Blue,1,77231,77375,144
2022-12-21,70038,70058,Blue,1,67425,68448,1023
2022-08-19,70047,70041,Blue,0,60689,61052,363
2022-10-28,70042,70050,Blue,1,27516,27928,412
2022-07-19,70054,70060,Blue,1,79538,79801,263
2022-09-30,70039,70838,Blue,0,49138,49175,37
2022-09-09,70057,70049,Blue,0,51559,51935,376
2022-10-08,70047,70041,Blue,0,62841,63191,350
2022-01-07,70040,70056,Blue,1,77074,77986,912
2022-02-12,70042,70048,Blue,1,54114,54447,333
2022-07-28,70046,70060,Blue,1,33286,34056,770
2022-03-23,70050,70058,Blue,1,31758,32170,412
2022-05-23,70047,70041,Blue,0,31535,31981,446
2022-12-25,70042,70052,Blue,1,60867,61412,545
2022-09-24,70047,70045,Blue,0,77713,77801,88
2022-10-20,70055,70043,Blue,0,31609,32356,747
2022-07-21,70051,70047,Blue,0,81129,81327,198
2022-02-18,70055,70039,Blue,0,54068,54919,851
2022-12-12,70052,70056,Blue,1,52209,52355,146
2022-06-24,70049,70041,Blue,0,45221,45678,457
2022-04-21,70059,70045,Blue,0,26958,27734,776
2022-09-08,70052,70060,Blue,1,37141,37520,379
2022-02-01,70041,70838,Blue,0,25593,25732,139
2022-09-27,70053,70049,Blue,0,87574,87789,215
2022-06-08,70047,70045,Blue,0,35346,35470,124
2022-11-24,70044,70046,Blue,1,42694,42798,104
2022-11-22,70050,70060,Blue,1,72662,73173,511
2022-04-03,70055,70041,Blue,0,79948,80667,719
2022-12-21,70042,70054,Blue,1,79089,79776,687
2022-09-03,70059,70041,Blue,0,87423,88314,891
2022-11-02,70044,70050,Blue,1,45238,45593,355
2022-01-21,70041,70838,Blue,0,36905,37021,116
2022-11-27,70046,70050,Blue,1,70282,70475,193
2022-07-19,70038,70054,Blue,1,40005,40870,865
2022-12-27,70040,70058,Blue,1,72565,73487,922
2022-04-18,70055,70049,Blue,0,53773,54040,267
2022-01-06,70059,70053,Blue,0,67537,67764,227
2022-07-28,70052,70056,Blue,1,58782,58951,169
2022-06-11,70050,70060,Blue,1,49172,49703,531
2022-05-19,70047,70045,Blue,0,55320,55507,187
2022-06-15,70042,70052,Blue,1,63938,64565,627
2022-10-25,70053,70051,Blue,0,51783,51841,58
2022-11-14,70055,70039,Blue,0,55339,56182,843
2022-04-20,70038,70052,Blue,1,25148,25806,658
2022-03-21,70043,70041,Blue,0,80936,80965,29
2022-03-02,70038,70054,Blue,1,57934,58908,974
2022-06-22,70043,70039,Blue,0,22381,22505,124
2022-10-14,70052,70056,Blue,1,33052,33194,142
2022-11-10,70057,70047,Blue,0,67074,67537,463
2022-02-09,70042,70044,Blue,1,60576,60602,26
2022-04-13,70052,70054,Blue,1,33998,34057,59
2022-03-04,70042,70046,Blue,1,21957,22139,182
2022-12-24,70059,70041,Blue,0,27239,28162,923
2022-12-23,70053,70039,Blue,0,30225,31007,782
2022-11-23,70046,70060,Blue,1,23883,24594,711
2022-01-26,70053,70049,Blue,0,66776,66976,200
2022-08-21,70043,70039,Blue,0,57985,58094,109
2022-01-10,70038,70058,Blue,1,57678,58786,1108
2022-03-05,70043,70838,Blue,0,62521,62715,194
2022-11-12,70057,70047,Blue,0,52537,53061,524
2022-12-29,70039,70838,Blue,0,69011,69075,64
2022-07-06,70051,70039,Blue,0,37704,38514,810
2022-06-28,70046,70050,Blue,1,42330,42512,182
2022-11-30,70038,70060,Blue,1,63067,64263,1196
2022-10-08,70051,70041,Blue,0,27466,28106,640
2022-07-18,70038,70060,Blue,1,49232,50371,1139
2022-10-25,70041,70039,Blue,0,38022,38055,33
2022-03-30,70042,70056,Blue,1,53521,54321,800
2022-10-20,70049,70041,Blue,0,66553,66992,439
2022-02-11,70042,70056,Blue,1,51417,52149,732
2022-06-19,70043,70838,Blue,0,47220,47418,198
2022-04-23,70053,70049,Blue,0,57620,57817,197
2022-12-19,70059,70051,Blue,0,30250,30562,312
2022-07-25,70058,70060,Blue,1,52820,52890,70
2022-01-18,70038,70042,Blue,1,45918,46020,102
2022-08-27,70057,70838,Blue,0,27702,28739,1037
2022-03-24,70057,70041,Blue,0,32731,33621,890
2022-09-09,70038,70044,Blue,1,24603,24794,191
2022-11-03,70046,70058,Blue,1,24469,25145,676
2022-10-12,70043,70039,Blue,0,63826,63947,121
2022-09-30,70055,70043,Blue,0,23629,24446,817
2022-02-12,70040,70042,Blue,1,72944,72975,31
2022-11-07,70038,70048,Blue,1,30825,31348,523
2022-09-10,70055,70047,Blue,0,32139,32505,366
2022-12-05,70053,70051,Blue,0,62667,62720,53
2022-07-14,70050,70058,Blue,1,34891,35380,489
2022-01-04,70051,70047,Blue,0,73644,73866,222
2022-06-11,70054,70060,Blue,1,78159,78416,257
2022-09-09,70044,70060,Blue,1,66002,67105,1103
2022-10-05,70051,70039,Blue,0,42523,43174,651
2022-02-04,70059,70838,Blue,0,49753,50998,1245
2022-04-08,70049,70041,Blue,0,80531,80955,424
2022-07-31,70045,70838,Blue,0,29240,29579,339
2022-01-03,70038,70046,Blue,1,31459,31797,338
2022-03-27,70050,70060,Blue,1,32946,33480,534
2022-03-20,70057,70838,Blue,0,71186,72152,966
2022-02-13,70047,70045,Blue,0,69603,69701,98
2022-07-08,70040,70044,Blue,1,62257,62391,134
2022-04-05,70059,70057,Blue,0,28764,28802,38
2022-12-20,70053,70043,Blue,0,19489,20090,601
2022-03-21,70038,70044,Blue,1,22149,22298,149
2022-11-09,70053,70838,Blue,0,63701,64538,837
2022-12-18,70052,70056,Blue,1,26111,26251,140
2022-08-10,70044,70050,Blue,1,69759,70099,340
2022-09-16,70047,70039,Blue,0,66252,66659,407
2022-06-23,70057,70049,Blue,0,28962,29354,392
2022-06-13,70038,70052,Blue,1,39062,39854,792
2022-01-23,70038,70046,Blue,1,57523,57841,318
2022-06-10,70045,70043,Blue,0,23722,23831,109
2022-03-28,70046,70050,Blue,1,44519,44719,200
2022-08-19,70053,70838,Blue,0,48768,49651,883
2022-10-12,70059,70039,Blue,0,41394,42614,1220
2022-02-07,70049,70045,Blue,0,29625,29818,193
2022-09-03,70040,70054,Blue,1,26349,27028,679
2022-07-16,70042,70052,Blue,1,62404,63001,597
2022-09-22,70057,70045,Blue,0,48468,49122,654
2022-10-14,70046,70060,Blue,1,22134,22837,703
2022-04-20,70059,70053,Blue,0,66501,66731,230
2022-10-08,70045,70043,Blue,0,20983,21079,96
2022-08-27,70055,70043,Blue,0,29414,30061,647
2022-07-30,70048,70050,Blue,1,60966,61027,61
2022-07-30,70046,70054,Blue,1,39746,40158,412
2022-09-12,70040,70060,Blue,1,42319,43348,1029
2022-12-10,70038,70054,Blue,1,66917,67787,870
2022-03-27,70053,70043,Blue,0,63295,63869,574
2022-10-23,70057,70053,Blue,0,77666,77820,154
2022-09-30,70045,70039,Blue,0,54982,55255,273
2022-09-16,70050,70058,Blue,1,27097,27523,426
2022-02-10,70048,70058,Blue,1,85818,86290,472
2022-07-12,70045,70039,Blue,0,84165,84412,247
2022-06-23,70043,70041,Blue,0,27790,27819,29
2022-08-17,70051,70041,Blue,0,29612,30234,622
2022-03-01,70038,70052,Blue,1,63020,63776,756
2022-01-21,70057,70047,Blue,0,47184,47664,480
2022-10-17,70042,70052,Blue,1,21107,21974,867
2022-11-22,70048,70056,Blue,1,25289,25711,422
2022-02-17,70045,70838,Blue,0,41261,41623,362
2022-04-15,70044,70060,Blue,1,72641,73547,906
2022-07-26,70051,70049,Blue,0,61937,62040,103
2022-04-08,70055,70039,Blue,0,85327,86187,860
2022-11-18,70048,70050,Blue,1,31981,32038,57
2022-02-15,70059,70047,Blue,0,42676,43294,618
2022-11-12,70042,70056,Blue,1,71920,72658,738
2022-06-18,70055,70053,Blue,0,81764,81811,47
2022-11-28,70057,70838,Blue,0,45804,46747,943
2022-03-05,70050,70060,Blue,1,32401,32910,509
2022-09-09,70055,70049,Blue,0,52704,52981,277
2022-07-14,70054,70058,Blue,1,78476,78636,160
2022-08-21,70042,70056,Blue,1,69140,69935,795
2022-07-14,70038,70048,Blue,1,52101,52574,473
2022-02-22,70038,70052,Blue,1,36733,37425,692
2022-11-03,70057,70049,Blue,0,46905,47301,396
2022-02-06,70046,70054,Blue,1,78368,78808,440
2022-10-10,70047,70041,Blue,0,31589,31972,383
2022-04-05,70058,70060,Blue,1,28658,28733,75
2022-10-28,70041,70838,Blue,0,88734,88870,136
2022-01-10,70049,70045,Blue,0,64161,64349,188
2022-10-27,70038,70046,Blue,1,84927,85332,405
2022-11-28,70038,70046,Blue,1,30252,30552,300
2022-09-21,70052,70058,Blue,1,61666,61912,246
2022-11-15,70057,70049,Blue,0,39466,39882,416
2022-03-13,70053,70039,Blue,0,26446,27275,829
2022-07-08,70038,70052,Blue,1,74817,75594,777
2022-12-31,70038,70042,Blue,1,60450,60540,90
2022-03-04,70059,70051,Blue,0,53596,53923,327
2022-09-20,70053,70049,Blue,0,81441,81656,215
2022-02-23,70055,70045,Blue,0,24735,25246,511
2022-05-05,70058,70060,Blue,1,71586,71649,63
2022-02-09,70040,70056,Blue,1,29718,30670,952
2022-01-18,70057,70043,Blue,0,49296,50135,839
2022-12-31,70042,70050,Blue,1,73782,74191,409
2022-07-31,70040,70056,Blue,1,57566,58413,847
2022-01-19,70038,70046,Blue,1,63432,63751,319
2022-06-16,70053,70045,Blue,0,57206,57648,442
2022-09-06,70045,70039,Blue,0,88095,88334,239
2022-07-01,70055,70041,Blue,0,59495,60297,802
2022-06-22,70051,70047,Blue,0,87768,87955,187
2022-01-26,70038,70044,Blue,1,24552,24725,173
2022-07-14,70059,70047,Blue,0,69296,69882,586
2022-03-04,70050,70054,Blue,1,60614,60826,212
2022-06-11,70046,70056,Blue,1,63208,63752,544
2022-07-11,70039,70838,Blue,0,88451,88487,36
2022-04-19,70059,70045,Blue,0,60434,61174,740
2022-01-05,70053,70043,Blue,0,26376,27013,637
2022-09-03,70054,70058,Blue,1,72189,72354,165
2022-12-27,70050,70056,Blue,1,27628,27919,291
2022-06-24,70040,70044,Blue,1,51472,51596,124
2022-04-14,70053,70043,Blue,0,63158,63775,617
2022-04-10,70038,70058,Blue,1,23769,24780,1011
2022-12-03,70040,70056,Blue,1,83014,83875,861
2022-01-13,70044,70058,Blue,1,21779,22681,902
2022-01-14,70059,70057,Blue,0,66796,66831,35
2022-03-04,70040,70054,Blue,1,29436,30122,686
2022-10-04,70038,70040,Blue,1,74224,74238,14
2022-08-21,70055,70047,Blue,0,63737,64104,367
2022-07-22,70054,70060,Blue,1,61990,62259,269
2022-10-19,70050,70052,Blue,1,48245,48364,119
2022-01-24,70040,70046,Blue,1,60211,60486,275
2022-06-17,70053,70838,Blue,0,66149,66994,845
2022-11-24,70040,70046,Blue,1,63507,63764,257
2022-12-31,70057,70041,Blue,0,66606,67419,813
2022-03-07,70040,70058,Blue,1,62188,63381,1193
2022-01-02,70040,70058,Blue,1,71606,72530,924
2022-12-02,70056,70058,Blue,1,37423,37500,77
2022-10-02,70048,70052,Blue,1,44166,44357,191
2022-11-25,70044,70048,Blue,1,44255,44496,241
2022-05-19,70051,70838,Blue,0,22409,23296,887
2022-08-02,70046,70058,Blue,1,65369,66017,648
2022-04-30,70055,70049,Blue,0,88505,88763,258
2022-04-08,70048,70058,Blue,1,25057,25528,471
2022-04-15,70050,70058,Blue,1,80925,81331,406
2022-02-22,70055,70838,Blue,0,45137,46106,969
2022-11-04,70057,70041,Blue,0,51167,52041,874
2022-12-28,70050,70058,Blue,1,26007,26419,412
2022-11-28,70048,70056,Blue,1,69458,69848,390
2022-06-12,70053,70838,Blue,0,72481,73361,880
2022-11-19,70059,70043,Blue,0,31405,32251,846
2022-06-20,70051,70039,Blue,0,29242,29937,695
2022-03-15,70053,70045,Blue,0,54159,54587,428
2022-01-24,70051,70045,Blue,0,80953,81289,336
2022-05-20,70038,70042,Blue,1,28849,28950,101
2022-03-26,70048,70050,Blue,1,74419,74477,58
2022-02-24,70038,70050,Blue,1,74731,75371,640
2022-03-26,70046,70050,Blue,1,66757,66927,170
2022-04-13,70055,70045,Blue,0,59481,60033,552
2022-06-11,70038,70042,Blue,1,42612,42724,112
2022-07-06,70046,70052,Blue,1,44063,44449,386
2022-01-06,70041,70039,Blue,0,41012,41043,31
2022-04-21,70038,70052,Blue,1,86567,87341,774
2022-04-15,70056,70060,Blue,1,85542,85749,207
2022-11-28,70043,70838,Blue,0,41576,41775,199
2022-12-22,70038,70048,Blue,1,24701,25222,521
2022-01-08,70047,70045,Blue,0,22358,22467,109
2022-01-25,70040,70060,Blue,1,37965,39094,1129
2022-01-13,70050,70054,Blue,1,57774,58062,288
2022-06-18,70042,70058,Blue,1,50911,51905,994
2022-09-06,70038,70052,Blue,1,26146,26984,838
2022-03-23,70044,70052,Blue,1,77067,77534,467
2022-08-19,70040,70052,Blue,1,34181,34818,637
2022-12-12,70057,70049,Blue,0,85880,86258,378
2022-09-02,70053,70049,Blue,0,33937,34134,197
2022-01-04,70059,70057,Blue,0,31753,31797,44
2022-11-05,70056,70058,Blue,1,31048,31117,69
2022-04-23,70053,70043,Blue,0,64062,64657,595
2022-03-18,70038,70040,Blue,1,35353,35370,17
2022-02-23,70046,70058,Blue,1,43316,43933,617
2022-06-04,70043,70838,Blue,0,83671,83868,197
2022-10-21,70055,70838,Blue,0,33695,34647,952
2022-02-23,70051,70045,Blue,0,30074,30414,340
2022-01-07,70040,70044,Blue,1,75855,75967,112
2022-03-21,70053,70039,Blue,0,26641,27451,810
2022-12-13,70055,70047,Blue,0,80208,80579,371
2022-06-22,70044,70056,Blue,1,51884,52614,730
2022-07-04,70051,70838,Blue,0,85911,86659,748
2022-08-05,70043,70041,Blue,0,66207,66235,28
2022-09-16,70045,70041,Blue,0,77708,77882,174
2022-08-23,70050,70052,Blue,1,47593,47719,126
2022-06-25,70059,70043,Blue,0,78196,79057,861
2022-03-05,70058,70060,Blue,1,72838,72905,67
2022-12-18,70040,70048,Blue,1,64678,65200,522
2022-01-29,70055,70838,Blue,0,81287,83094,1807
2022-12-15,70041,70039,Blue,0,28189,28223,34
2022-02-08,70052,70054,Blue,1,29961,30020,59
2022-06-15,70059,70057,Blue,0,80599,80634,35
2022-10-17,70053,70049,Blue,0,61399,61585,186
2022-06-20,70046,70060,Blue,1,74609,75377,768
2022-11-28,70038,70058,Blue,1,75799,76815,1016
2022-08-28,70046,70052,Blue,1,65945,66247,302
2022-10-23,70059,70057,Blue,0,50052,50087,35
2022-09-27,70055,70041,Blue,0,49518,50273,755
2022-09-10,70038,70046,Blue,1,61503,61836,333
2022-01-15,70040,70044,Blue,1,25023,25130,107
2022-06-10,70043,70041,Blue,0,55177,55209,32
2022-12-01,70042,70054,Blue,1,76471,77162,691
2022-01-23,70043,70041,Blue,0,50473,50502,29
2022-10-21,70050,70052,Blue,1,55007,55130,123
2022-07-26,70046,70060,Blue,1,55250,56089,839
2022-04-12,70046,70054,Blue,1,30920,31357,437
2022-03-23,70045,70838,Blue,0,54041,54428,387
2022-11-10,70038,70042,Blue,1,32425,32518,93
2022-10-03,70049,70047,Blue,0,50926,50991,65
2022-04-10,70051,70047,Blue,0,71527,71715,188
2022-09-14,70038,70058,Blue,1,82629,83664,1035
2022-04-29,70052,70056,Blue,1,42253,42398,145
2022-09-04,70051,70039,Blue,0,54022,54713,691
2022-01-28,70045,70039,Blue,0,25000,25252,252
2022-12-06,70042,70046,Blue,1,36522,36728,206
2022-03-05,70038,70042,Blue,1,83766,83874,108
2022-02-28,70038,70044,Blue,1,84852,85020,168
2022-08-24,70041,70039,Blue,0,89380,89414,34
2022-02-13,70055,70051,Blue,0,64297,64485,188
2022-10-19,70053,70838,Blue,0,32517,33372,855
2022-04-05,70057,70051,Blue,0,56677,56932,255
2022-01-28,70040,70058,Blue,1,51895,52908,1013
2022-01-27,70048,70058,Blue,1,24878,25792,914
2022-12-27,70055,70041,Blue,0,38626,39403,777
2022-09-14,70040,70052,Blue,1,72775,73429,654
2022-07-07,70040,70048,Blue,1,41856,42286,430
2022-02-04,70052,70060,Blue,1,24460,25446,986
2022-01-01,70043,70838,Blue,0,45039,45252,213
2022-06-06,70040,70052,Blue,1,78671,79668,997
2022-12-16,70041,70838,Blue,0,51357,51470,113
2022-11-03,70043,70041,Blue,0,78120,78149,29
2022-08-12,70053,70049,Blue,0,36208,36419,211
2022-06-28,70055,70039,Blue,0,77392,78224,832
2022-03-21,70042,70044,Blue,1,73098,73125,27
2022-01-05,70040,70054,Blue,1,90340,91188,848
2022-01-14,70059,70057,Blue,0,30864,30901,37
2022-11-29,70050,70058,Blue,1,62832,63234,402
2022-05-05,70050,70056,Blue,1,71787,72107,320
2022-10-10,70038,70046,Blue,1,84375,84719,344
2022-06-11,70047,70043,Blue,0,39079,39378,299
2022-03-06,70044,70058,Blue,1,26353,27234,881
2022-06-30,70044,70046,Blue,1,63696,63817,121
2022-01-04,70053,70039,Blue,0,58380,59150,770
2022-03-26,70042,70048,Blue,1,53035,53339,304
2022-08-15,70053,70043,Blue,0,76720,77298,578
2022-11-12,70050,70052,Blue,1,24216,24334,118
2022-12-22,70042,70060,Blue,1,49910,50920,1010
2022-08-11,70055,70053,Blue,0,21919,21964,45
2022-09-23,70051,70838,Blue,0,46261,47056,795
2022-01-11,70038,70058,Blue,1,49216,50418,1202
2022-07-18,70053,70049,Blue,0,33759,33972,213
2022-02-18,70046,70060,Blue,1,23419,24326,907
2022-08-03,70051,70043,Blue,0,80366,80823,457
2022-08-12,70038,70056,Blue,1,79805,80754,949
2022-05-29,70046,70052,Blue,1,84717,85158,441
2022-05-18,70048,70054,Blue,1,58376,58714,338
2022-12-17,70040,70060,Blue,1,35655,36808,1153
2022-05-01,70050,70052,Blue,1,26920,27035,115
2022-05-29,70044,70048,Blue,1,77341,77630,289
2022-09-11,70048,70060,Blue,1,62295,62931,636
2022-09-14,70043,70039,Blue,0,78360,78460,100
2022-03-11,70044,70060,Blue,1,23261,24304,1043
2022-01-25,70046,70052,Blue,1,88744,89095,351
2022-01-24,70045,70043,Blue,0,71254,71366,112
2022-12-12,70059,70051,Blue,0,67111,67429,318
2022-02-01,70050,70060,Blue,1,68332,69421,1089
2022-02-09,70053,70043,Blue,0,64353,64935,582
2022-02-07,70044,70056,Blue,1,42569,43566,997
2022-07-04,70053,70041,Blue,0,27347,28047,700
2022-06-22,70044,70052,Blue,1,86777,87369,592
2022-04-19,70040,70052,Blue,1,31232,31906,674
2022-02-05,70050,70054,Blue,1,83782,84031,249
2022-06-03,70043,70039,Blue,0,25551,25669,118
2022-01-12,70056,70058,Blue,1,74458,74528,70
2022-08-30,70049,70041,Blue,0,72671,73078,407
2022-08-09,70057,70047,Blue,0,48025,48516,491
2022-11-10,70038,70044,Blue,1,26432,26605,173
2022-09-26,70057,70043,Blue,0,50017,50835,818
2022-01-19,70044,70048,Blue,1,62738,62993,255
2022-12-01,70044,70050,Blue,1,47936,48284,348
2022-03-16,70055,70045,Blue,0,49931,50455,524
2022-10-17,70042,70058,Blue,1,26409,27368,959
2022-08-28,70052,70058,Blue,1,78505,78755,250
2022-12-27,70059,70047,Blue,0,51296,51883,587
2022-09-02,70046,70056,Blue,1,66318,66875,557
2022-03-30,70056,70058,Blue,1,72039,72130,91
2022-06-17,70038,70060,Blue,1,30256,31477,1221
2022-03-22,70043,70039,Blue,0,60444,60553,109
2022-10-24,70044,70060,Blue,1,60540,61474,934
2022-08-27,70055,70043,Blue,0,37512,38150,638
2022-01-15,70049,70838,Blue,0,25316,25988,672
2022-08-24,70052,70060,Blue,1,51318,51678,360
2022-08-03,70048,70056,Blue,1,53421,53814,393
2022-05-21,70042,70058,Blue,1,35724,36616,892
2022-07-23,70053,70039,Blue,0,43551,44360,809
2022-09-26,70038,70054,Blue,1,76017,76822,805
2022-09-08,70059,70049,Blue,0,25956,26440,484
2022-09-08,70056,70058,Blue,1,36021,36095,74
2022-02-16,70046,70052,Blue,1,48443,48743,300
2022-03-18,70052,70060,Blue,1,63292,63833,541
2022-03-01,70057,70838,Blue,0,42752,43788,1036
2022-10-11,70057,70047,Blue,0,79888,80371,483
2022-07-11,70055,70049,Blue,0,49581,49876,295
2022-02-18,70044,70050,Blue,1,21382,21776,394
2022-09-28,70054,70058,Blue,1,88138,88291,153
2022-03-01,70057,70051,Blue,0,26448,26738,290
2022-02-22,70059,70045,Blue,0,25157,25872,715
2022-09-27,70057,70045,Blue,0,30122,30835,713
2022-08-02,70044,70046,Blue,1,59893,59995,102
2022-01-08,70046,70054,Blue,1,33257,33714,457
2022-08-06,70044,70058,Blue,1,62975,63765,790
2022-04-13,70048,70052,Blue,1,70364,70568,204
2022-10-27,70048,70058,Blue,1,67079,67590,511
2022-06-22,70040,70060,Blue,1,78547,79702,1155
2022-03-31,70038,70044,Blue,1,61930,62176,246
2022-02-24,70042,70054,Blue,1,36354,37218,864
2022-03-31,70057,70039,Blue,0,77252,78223,971
2022-09-21,70046,70050,Blue,1,47049,47213,164
2022-12-08,70044,70054,Blue,1,88420,89000,580
2022-04-13,70045,70041,Blue,0,71843,72025,182
2022-03-13,70051,70838,Blue,0,62844,63655,811
2022-06-22,70046,70054,Blue,1,28250,28732,482
2022-03-29,70042,70054,Blue,1,64076,64786,710
2022-06-17,70038,70054,Blue,1,65890,66787,897
2022-08-13,70057,70043,Blue,0,35245,36223,978
2022-10-01,70040,70052,Blue,1,76696,77351,655
2022-08-06,70048,70056,Blue,1,61538,61931,393
2022-01-01,70046,70048,Blue,1,71355,71445,90
2022-08-04,70056,70058,Blue,1,63866,63950,84
2022-01-23,70044,70056,Blue,1,58859,59606,747
2022-01-03,70059,70053,Blue,0,24286,24516,230
2022-09-06,70046,70060,Blue,1,50267,51006,739
2022-08-09,70057,70049,Blue,0,53143,53568,425
2022-11-17,70059,70057,Blue,0,53057,53093,36
2022-08-31,70059,70041,Blue,0,20014,21128,1114
2022-06-27,70057,70041,Blue,0,63709,64841,1132
2022-06-23,70044,70052,Blue,1,71145,71697,552
2022-01-22,70055,70838,Blue,0,73218,74168,950
2022-12-19,70044,70050,Blue,1,22655,22997,342
2022-10-18,70044,70054,Blue,1,53101,53665,564
2022-02-15,70049,70039,Blue,0,88669,89414,745
2022-07-13,70049,70039,Blue,0,73122,73639,517
2022-07-21,70038,70056,Blue,1,49858,50818,960
2022-10-18,70059,70053,Blue,0,60846,61070,224
2022-06-17,70053,70049,Blue,0,28159,28511,352
2022-08-13,70055,70039,Blue,0,21795,22663,868
2022-05-19,70055,70039,Blue,0,25364,26379,1015
2022-12-29,70048,70052,Blue,1,31455,31680,225
2022-04-11,70040,70046,Blue,1,52815,53084,269
2022-04-08,70053,70051,Blue,0,82005,82068,63
2022-07-11,70042,70058,Blue,1,48390,49318,928
2022-12-09,70038,70056,Blue,1,64421,65380,959
2022-04-30,70054,70060,Blue,1,59994,60241,247
2022-06-09,70059,70838,Blue,0,52548,53782,1234
2022-11-20,70043,70838,Blue,0,64459,64656,197
2022-04-09,70055,70051,Blue,0,60757,60898,141
2022-08-25,70052,70056,Blue,1,23561,23705,144
2022-06-16,70057,70045,Blue,0,27644,28288,644
2022-02-11,70053,70045,Blue,0,34968,35403,435
2022-08-16,70051,70043,Blue,0,43294,43794,500
2022-06-19,70057,70053,Blue,0,56924,57084,160
2022-08-22,70049,70838,Blue,0,87847,88542,695
2022-11-13,70055,70043,Blue,0,60015,60689,674
2022-11-17,70057,70047,Blue,0,48877,49360,483
2022-03-16,70046,70060,Blue,1,37768,38564,796
2022-04-15,70043,70838,Blue,0,29565,29784,219
2022-10-22,70059,70041,Blue,0,21497,22447,950
2022-10-04,70055,70039,Blue,0,20119,21034,915
2022-02-21,70053,70039,Blue,0,22446,23229,783
2022-11-19,70042,70056,Blue,1,86566,87317,751
2022-08-02,70059,70838,Blue,0,50415,51546,1131
2022-04-19,70040,70060,Blue,1,72136,73192,1056
2022-04-08,70049,70838,Blue,0,82842,83399,557
2022-09-01,70053,70045,Blue,0,60352,60763,411
2022-09-29,70047,70838,Blue,0,70384,70931,547
2022-04-07,70044,70052,Blue,1,29021,29541,520
2022-02-22,70044,70054,Blue,1,64557,65160,603
2022-02-04,70048,70056,Blue,1,22329,22807,478
2022-02-20,70049,70045,Blue,0,78081,78277,196
2022-04-14,70046,70060,Blue,1,81429,82262,833
2022-06-13,70045,70838,Blue,0,80240,80593,353
2022-04-11,70040,70050,Blue,1,26416,26953,537
2022-01-11,70042,70048,Blue,1,63299,63636,337
2022-11-14,70046,70048,Blue,1,33968,34050,82
2022-12-15,70049,70043,Blue,0,86709,87053,344
2022-10-17,70053,70045,Blue,0,58097,58552,455
2022-08-22,70050,70060,Blue,1,59192,59728,536
2022-10-28,70051,70045,Blue,0,76796,77129,333
2022-11-21,70055,70039,Blue,0,62668,63464,796
2022-04-01,70058,70060,Blue,1,82471,82533,62
2022-03-30,70054,70056,Blue,1,56509,56558,49
2022-02-15,70053,70039,Blue,0,61085,61864,779
2022-09-19,70055,70039,Blue,0,46613,47681,1068
2022-02-26,70045,70043,Blue,0,53202,53299,97
2022-03-08,70055,70838,Blue,0,79642,80561,919
2022-06-30,70043,70039,Blue,0,60110,60219,109
2022-03-07,70055,70047,Blue,0,58279,58690,411
2022-06-16,70040,70054,Blue,1,23115,24148,1033
2022-01-23,70059,70039,Blue,0,80898,81908,1010
2022-01-25,70051,70039,Blue,0,43817,44573,756
2022-12-14,70052,70058,Blue,1,68508,68777,269
2022-09-06,70057,70053,Blue,0,31478,31634,156
2022-06-15,70046,70054,Blue,1,66555,67040,485
2022-04-05,70057,70039,Blue,0,86378,87369,991
2022-10-14,70057,70051,Blue,0,58519,58754,235
2022-09-25,70048,70060,Blue,1,71459,72037,578
2022-07-24,70040,70054,Blue,1,27723,28434,711
2022-02-12,70055,70043,Blue,0,47780,48495,715
2022-10-04,70050,70058,Blue,1,76934,77369,435
2022-08-01,70049,70047,Blue,0,37934,37992,58
2022-11-02,70042,70048,Blue,1,68047,68374,327
2022-09-29,70055,70049,Blue,0,57395,57712,317
2022-09-14,70053,70049,Blue,0,54892,55098,206
2022-03-29,70042,70058,Blue,1,44284,45272,988
2022-01-08,70055,70043,Blue,0,37512,38157,645
2022-06-28,70046,70060,Blue,1,76649,77442,793
2022-12-03,70042,70056,Blue,1,78090,78838,748
2022-07-29,70050,70052,Blue,1,23443,23575,132
2022-01-07,70044,70054,Blue,1,76527,77071,544
2022-03-05,70048,70054,Blue,1,44216,44528,312
2022-05-13,70059,70055,Blue,0,66506,66653,147
2022-10-22,70050,70060,Blue,1,33510,34048,538
2022-01-06,70042,70060,Blue,1,43509,44527,1018
2022-03-07,70054,70058,Blue,1,68783,68941,158
2022-09-03,70040,70044,Blue,1,48081,48194,113
2022-04-04,70051,70039,Blue,0,19573,20330,757
2022-11-24,70042,70056,Blue,1,64125,64865,740
2022-03-07,70053,70043,Blue,0,65876,66477,601
2022-06-06,70041,70039,Blue,0,87723,87758,35
2022-03-21,70059,70047,Blue,0,29066,29663,597
2022-01-20,70039,70838,Blue,0,56774,56897,123
2022-07-20,70059,70039,Blue,0,40302,41600,1298
2022-08-28,70040,70048,Blue,1,37140,37564,424
2022-09-12,70048,70052,Blue,1,21881,22099,218
2022-07-05,70049,70838,Blue,0,51480,52168,688
2022-12-28,70050,70054,Blue,1,58253,58486,233
2022-01-13,70045,70838,Blue,0,66422,66783,361
2022-04-06,70044,70048,Blue,1,20033,20305,272
2022-12-04,70055,70049,Blue,0,75080,75357,277
2022-11-14,70041,70838,Blue,0,20582,20717,135
2022-07-08,70056,70060,Blue,1,60004,60189,185
2022-02-09,70048,70052,Blue,1,31622,31833,211
2022-10-25,70051,70043,Blue,0,48345,48842,497
2022-07-27,70047,70838,Blue,0,22428,23038,610
2022-11-08,70054,70060,Blue,1,27388,27669,281
2022-03-03,70042,70050,Blue,1,58196,58584,388
2022-11-01,70057,70043,Blue,0,44798,45610,812
2022-09-29,70040,70048,Blue,1,54590,54985,395
2022-02-13,70043,70041,Blue,0,43121,43149,28
2022-04-08,70049,70043,Blue,0,34133,34578,445
2022-04-20,70040,70046,Blue,1,76412,76667,255
2022-01-13,70056,70060,Blue,1,59684,59887,203
2022-03-25,70044,70048,Blue,1,78816,79059,243
2022-07-14,70049,70041,Blue,0,62011,62452,441
2022-08-19,70038,70040,Blue,1,67005,67020,15
2022-04-11,70045,70838,Blue,0,29612,29996,384
2022-10-28,70051,70039,Blue,0,28164,28832,668
2022-03-11,70059,70057,Blue,0,54493,54530,37
2022-04-01,70051,70047,Blue,0,70390,70589,199
2022-02-24,70046,70060,Blue,1,36582,37530,948
2022-06-13,70055,70053,Blue,0,42892,42939,47
2022-09-01,70048,70056,Blue,1,23805,24196,391
2022-03-28,70057,70838,Blue,0,42191,43343,1152
2022-03-05,70057,70043,Blue,0,32015,32814,799
2022-04-21,70038,70048,Blue,1,38552,39105,553
2022-03-25,70054,70060,Blue,1,74890,75142,252
2022-02-03,70057,70838,Blue,0,60693,61923,1230
2022-02-15,70038,70058,Blue,1,22145,23111,966
2022-07-09,70049,70041,Blue,0,74067,74509,442
2022-08-24,70042,70056,Blue,1,73339,74029,690
2022-09-24,70057,70047,Blue,0,66602,67065,463
2022-09-09,70049,70838,Blue,0,27720,28353,633
2022-04-24,70059,70041,Blue,0,50598,51638,1040
2022-06-20,70057,70047,Blue,0,30415,30952,537
2022-11-28,70051,70041,Blue,0,84547,85082,535
2022-01-28,70038,70054,Blue,1,26653,27500,847
2022-01-23,70049,70043,Blue,0,70775,71192,417
2022-08-06,70044,70052,Blue,1,29320,29816,496
2022-06-28,70046,70052,Blue,1,82294,82679,385
2022-01-25,70051,70049,Blue,0,71401,71523,122
2022-08-29,70042,70054,Blue,1,76542,77179,637
2022-12-31,70050,70054,Blue,1,66584,66798,214
2022-11-23,70043,70039,Blue,0,79593,79691,98
2022-01-17,70046,70054,Blue,1,52324,52772,448
2022-03-07,70040,70042,Blue,1,61623,61655,32
2022-02-18,70057,70043,Blue,0,49830,50724,894
2022-12-24,70055,70053,Blue,0,39142,39188,46
2022-12-18,70038,70042,Blue,1,78097,78205,108
2022-08-08,70050,70054,Blue,1,40156,40412,256
2022-10-03,70054,70056,Blue,1,37295,37343,48
2022-11-03,70046,70056,Blue,1,73537,74053,516
2022-06-21,70049,70838,Blue,0,26453,27109,656
2022-05-03,70053,70051,Blue,0,32084,32138,54
2022-01-26,70046,70048,Blue,1,20169,20283,114
2022-11-13,70048,70054,Blue,1,87858,88202,344
2022-07-30,70053,70041,Blue,0,19786,20436,650
2022-08-28,70040,70048,Blue,1,82396,82757,361
2022-07-15,70044,70046,Blue,1,31904,32008,104
2022-09-25,70048,70052,Blue,1,82204,82407,203
2022-10-04,70055,70838,Blue,0,78425,79271,846
2022-10-15,70059,70045,Blue,0,79096,79789,693
2022-01-06,70044,70052,Blue,1,53430,53918,488
2022-04-05,70054,70058,Blue,1,32081,32233,152
2022-11-30,70047,70041,Blue,0,60162,60500,338
2022-02-09,70059,70057,Blue,0,88100,88138,38
2022-04-06,70040,70050,Blue,1,45445,45960,515
2022-04-08,70042,70052,Blue,1,61497,62083,586
2022-12-22,70051,70043,Blue,0,53725,54193,468
2022-08-29,70053,70051,Blue,0,50718,50773,55
2022-03-04,70048,70058,Blue,1,52609,53111,502
2022-02-14,70055,70047,Blue,0,83656,84062,406
2022-03-30,70059,70051,Blue,0,56295,56615,320
2022-02-09,70046,70056,Blue,1,43876,44432,556
2022-03-30,70051,70838,Blue,0,84974,85678,704
2022-01-27,70046,70060,Blue,1,50673,51423,750
2022-10-03,70059,70049,Blue,0,68315,68803,488
2022-10-08,70040,70048,Blue,1,73997,74380,383
2022-12-20,70054,70058,Blue,1,32694,32882,188
2022-02-09,70047,70838,Blue,0,25199,25730,531
2022-09-13,70046,70054,Blue,1,43375,43795,420
2022-08-26,70055,70053,Blue,0,77259,77307,48
2022-03-04,70053,70043,Blue,0,63463,64032,569
2022-10-26,70044,70048,Blue,1,80864,81102,238
2022-02-08,70045,70039,Blue,0,47404,47663,259
2022-02-17,70057,70055,Blue,0,69569,69638,69
2022-12-06,70055,70051,Blue,0,80012,80192,180
2022-03-11,70056,70058,Blue,1,84120,84195,75
2022-06-23,70053,70051,Blue,0,56388,56450,62
2022-12-11,70057,70053,Blue,0,27803,27955,152
2022-03-11,70051,70049,Blue,0,59898,60001,103
2022-04-06,70055,70041,Blue,0,32245,33087,842
2022-08-11,70051,70045,Blue,0,54181,54528,347
2022-07-20,70048,70054,Blue,1,26777,27115,338
2022-08-30,70053,70039,Blue,0,42572,43356,784
2022-04-10,70040,70044,Blue,1,65678,65795,117
2022-03-21,70053,70043,Blue,0,74020,74620,600
2022-02-24,70044,70050,Blue,1,83951,84296,345
2022-04-15,70051,70045,Blue,0,48574,48904,330
2022-03-16,70059,70047,Blue,0,28162,28807,645
2022-09-04,70041,70039,Blue,0,39323,39359,36
2022-12-31,70040,70042,Blue,1,21067,21100,33
2022-10-24,70055,70045,Blue,0,88297,88845,548
2022-04-21,70047,70043,Blue,0,71083,71326,243
2022-10-26,70049,70039,Blue,0,21336,21848,512
2022-05-03,70059,70053,Blue,0,84615,84846,231
2022-01-05,70045,70838,Blue,0,56801,57193,392
2022-08-01,70055,70045,Blue,0,79635,80115,480
2022-08-26,70038,70044,Blue,1,24793,24955,162
2022-08-27,70059,70047,Blue,0,82335,82890,555
2022-04-30,70052,70054,Blue,1,24644,24697,53
2022-12-22,70051,70041,Blue,0,38974,39567,593
2022-06-06,70040,70046,Blue,1,57036,57346,310
2022-02-24,70050,70060,Blue,1,56610,57145,535
2022-02-27,70046,70048,Blue,1,83359,83455,96
2022-06-28,70055,70838,Blue,0,44387,45320,933
2022-01-24,70057,70039,Blue,0,78985,79973,988
2022-11-11,70038,70048,Blue,1,76313,76792,479
2022-01-04,70038,70046,Blue,1,53358,53724,366
2022-07-27,70038,70054,Blue,1,63346,64264,918
2022-12-27,70047,70045,Blue,0,64284,64377,93
2022-11-16,70038,70040,Blue,1,36733,36748,15
2022-03-25,70046,70054,Blue,1,25311,25779,468
2022-02-18,70059,70047,Blue,0,59294,59886,592
2022-01-10,70057,70039,Blue,0,62971,63907,936
2022-12-13,70040,70046,Blue,1,55200,55464,264
2022-05-10,70053,70051,Blue,0,46784,46848,64
2022-04-28,70052,70054,Blue,1,25801,25855,54
2022-09-21,70047,70039,Blue,0,47460,47908,448
2022-12-04,70055,70041,Blue,0,63807,64558,751
2022-05-28,70046,70050,Blue,1,37224,37430,206
2022-11-08,70044,70058,Blue,1,30979,31796,817
2022-07-13,70050,70060,Blue,1,38221,38773,552
2022-03-10,70044,70060,Blue,1,63052,64203,1151
2022-10-27,70038,70042,Blue,1,59610,59714,104
2022-02-07,70055,70047,Blue,0,20432,20882,450
2022-09-19,70040,70060,Blue,1,26953,28082,1129
2022-07-01,70042,70050,Blue,1,41858,42361,503
2022-11-25,70059,70838,Blue,0,51531,52664,1133
2022-11-22,70044,70056,Blue,1,78075,78744,669
2022-02-28,70043,70838,Blue,0,83724,83926,202
2022-07-19,70038,70040,Blue,1,48292,48310,18
2022-06-08,70040,70044,Blue,1,76281,76406,125
2022-07-24,70046,70052,Blue,1,31146,31467,321
2022-07-19,70055,70047,Blue,0,27004,27419,415
2022-12-07,70057,70055,Blue,0,44679,44751,72
2022-01-08,70043,70041,Blue,0,66870,66898,28
2022-10-01,70047,70838,Blue,0,67132,67657,525
2022-12-30,70051,70043,Blue,0,57480,57957,477
2022-01-22,70040,70058,Blue,1,65902,66852,950
2022-02-17,70051,70045,Blue,0,58165,58500,335
2022-02-23,70059,70057,Blue,0,67516,67551,35
2022-07-19,70057,70051,Blue,0,74974,75220,246
2022-03-10,70042,70044,Blue,1,48285,48313,28
2022-07-02,70044,70058,Blue,1,55274,56088,814
2022-03-02,70055,70041,Blue,0,68675,69506,831
2022-08-20,70057,70047,Blue,0,23570,24054,484
2022-10-30,70044,70050,Blue,1,39929,40277,348
2022-10-07,70054,70060,Blue,1,45744,46007,263
2022-10-24,70040,70056,Blue,1,59743,60639,896
2022-09-05,70055,70053,Blue,0,60487,60532,45
2022-01-26,70057,70043,Blue,0,33114,34219,1105
2022-11-12,70055,70039,Blue,0,39157,40031,874
2022-09-04,70048,70050,Blue,1,28121,28175,54
2022-04-24,70059,70043,Blue,0,55454,56276,822
2022-06-24,70049,70039,Blue,0,37035,37575,540
2022-04-06,70055,70039,Blue,0,52388,53234,846
2022-10-24,70046,70056,Blue,1,53703,54227,524
2022-06-28,70057,70838,Blue,0,28127,29263,1136
2022-09-15,70051,70039,Blue,0,58082,58708,626
2022-08-24,70059,70047,Blue,0,65257,65798,541
2022-07-19,70048,70052,Blue,1,41325,41541,216
2022-12-08,70041,70039,Blue,0,35354,35384,30
2022-10-29,70045,70043,Blue,0,72608,72698,90
2022-03-24,70040,70050,Blue,1,76400,76919,519
2022-07-13,70046,70058,Blue,1,81168,81850,682
2022-10-11,70053,70039,Blue,0,34672,35439,767
2022-09-07,70050,70060,Blue,1,60769,61334,565
2022-02-24,70050,70054,Blue,1,74869,75085,216
2022-04-16,70050,70056,Blue,1,41608,41895,287
2022-01-28,70053,70047,Blue,0,32680,32977,297
2022-04-16,70042,70058,Blue,1,73537,74408,871
2022-10-09,70055,70049,Blue,0,63349,63609,260
2022-03-17,70057,70051,Blue,0,37599,37855,256
2022-03-23,70040,70046,Blue,1,52903,53193,290
2022-01-01,70041,70039,Blue,0,82690,82725,35
2022-02-21,70041,70039,Blue,0,34021,34056,35
2022-07-18,70046,70054,Blue,1,72997,73443,446
2022-02-12,70053,70041,Blue,0,19780,20423,643
2022-06-08,70040,70046,Blue,1,33977,34269,292
2022-11-26,70044,70056,Blue,1,26517,27180,663
2022-06-30,70045,70041,Blue,0,34500,34715,215
2022-02-04,70051,70045,Blue,0,28396,28751,355
2022-04-06,70040,70050,Blue,1,62534,63044,510
2022-07-28,70042,70048,Blue,1,22382,22678,296
2022-08-15,70052,70056,Blue,1,43904,44061,157
2022-10-06,70055,70049,Blue,0,53327,53613,286
2022-09-11,70045,70039,Blue,0,35477,35717,240
2022-12-04,70046,70058,Blue,1,71404,72085,681
2022-12-31,70053,70047,Blue,0,93197,93474,277
2022-05-30,70048,70050,Blue,1,59037,59095,58
2022-05-20,70042,70050,Blue,1,26798,27274,476
2022-03-09,70057,70047,Blue,0,70589,71054,465
2022-01-03,70047,70043,Blue,0,24615,24852,237
2022-10-20,70059,70047,Blue,0,57199,57751,552
2022-08-01,70040,70048,Blue,1,39370,39744,374
2022-11-16,70038,70048,Blue,1,54916,55383,467
2022-12-09,70044,70056,Blue,1,88492,89213,721
2022-05-19,70055,70047,Blue,0,55313,55730,417
2022-07-04,70050,70054,Blue,1,71729,71971,242
2022-08-05,70052,70054,Blue,1,64196,64267,71
2022-04-01,70040,70048,Blue,1,27024,27449,425
2022-01-21,70057,70049,Blue,0,35957,36366,409
2022-06-12,70057,70047,Blue,0,60948,61425,477
2022-09-05,70051,70039,Blue,0,32770,33419,649
2022-07-17,70057,70039,Blue,0,23919,24895,976
2022-11-05,70042,70054,Blue,1,43824,44482,658
2022-11-13,70051,70045,Blue,0,34320,34658,338
2022-03-21,70053,70045,Blue,0,58998,59463,465
2022-04-19,70042,70050,Blue,1,23501,23948,447
2022-02-03,70046,70058,Blue,1,89500,90106,606
2022-02-16,70055,70039,Blue,0,35412,36255,843
2022-07-14,70057,70045,Blue,0,77589,78177,588
2022-04-17,70048,70052,Blue,1,63469,63673,204
2022-09-02,70038,70060,Blue,1,43595,44783,1188
2022-04-06,70049,70043,Blue,0,54860,55243,383
2022-01-12,70049,70039,Blue,0,85180,85740,560
2022-09-29,70050,70058,Blue,1,65155,65605,450
2022-06-21,70046,70060,Blue,1,47259,48021,762
2022-12-03,70046,70048,Blue,1,85943,86030,87
2022-12-22,70055,70043,Blue,0,86977,87629,652
2022-06-19,70055,70047,Blue,0,38374,38753,379
2022-03-05,70052,70058,Blue,1,37052,37279,227
2022-09-03,70059,70049,Blue,0,67032,67483,451
2022-07-18,70050,70058,Blue,1,23738,24162,424
2022-07-18,70047,70039,Blue,0,33769,34200,431
2022-05-18,70042,70054,Blue,1,51980,52970,990
2022-05-13,70053,70047,Blue,0,33762,34063,301
2022-03-29,70058,70060,Blue,1,51856,51922,66
2022-01-08,70050,70052,Blue,1,62152,62263,111
2022-06-30,70053,70838,Blue,0,33761,34688,927
2022-07-24,70049,70047,Blue,0,76488,76544,56
2022-04-14,70043,70039,Blue,0,52029,52143,114
2022-10-07,70040,70046,Blue,1,20059,20319,260
2022-08-10,70040,70042,Blue,1,82939,82969,30
2022-09-13,70059,70049,Blue,0,73332,73790,458
2022-11-24,70045,70041,Blue,0,81644,81828,184
2022-09-06,70039,70838,Blue,0,25720,25752,32
2022-08-27,70055,70047,Blue,0,50484,50872,388
2022-01-27,70038,70046,Blue,1,67398,67755,357
2022-09-11,70049,70041,Blue,0,26298,26739,441
2022-09-10,70049,70043,Blue,0,35664,35989,325
2022-03-21,70055,70041,Blue,0,55875,56583,708
2022-04-05,70048,70054,Blue,1,25056,25362,306
2022-06-28,70050,70060,Blue,1,40285,40894,609
2022-03-24,70038,70050,Blue,1,37337,37941,604
2022-10-12,70050,70056,Blue,1,29714,30000,286
2022-12-03,70053,70047,Blue,0,70005,70288,283
2022-02-05,70049,70047,Blue,0,23113,23168,55
2022-08-20,70047,70039,Blue,0,84621,85081,460
2022-06-25,70053,70043,Blue,0,35977,36546,569
2022-10-10,70042,70050,Blue,1,76891,77301,410
2022-06-09,70044,70048,Blue,1,34089,34351,262
2022-10-28,70040,70044,Blue,1,79115,79264,149
2022-11-05,70055,70047,Blue,0,75971,76337,366
2022-04-22,70048,70056,Blue,1,60347,60728,381
2022-10-27,70046,70058,Blue,1,81194,81927,733
2022-03-17,70057,70838,Blue,0,29426,30458,1032
2022-10-05,70051,70039,Blue,0,50305,50971,666
2022-09-02,70046,70058,Blue,1,36641,37363,722
2022-03-28,70046,70048,Blue,1,71822,71916,94
2022-11-22,70038,70042,Blue,1,48196,48289,93
2022-09-21,70046,70058,Blue,1,57048,57754,706
2022-01-20,70059,70053,Blue,0,65899,66163,264
2022-03-01,70048,70058,Blue,1,73504,74003,499
2022-08-06,70044,70046,Blue,1,32020,32125,105
2022-01-21,70053,70039,Blue,0,69733,70441,708
2022-07-18,70038,70048,Blue,1,73629,74072,443
2022-10-15,70059,70838,Blue,0,34489,35588,1099
2022-03-16,70055,70049,Blue,0,25737,26030,293
2022-02-25,70050,70060,Blue,1,29949,30592,643
2022-01-09,70049,70041,Blue,0,77593,78011,418
2022-03-10,70051,70043,Blue,0,22167,22698,531
2022-04-21,70058,70060,Blue,1,47392,47452,60
2022-11-12,70040,70050,Blue,1,71366,71891,525
2022-07-30,70055,70043,Blue,0,55885,56586,701
2022-11-30,70059,70043,Blue,0,75914,76739,825
2022-09-28,70057,70049,Blue,0,40125,40558,433
2022-09-17,70057,70053,Blue,0,53075,53227,152
2022-12-23,70057,70053,Blue,0,26199,26404,205
2022-12-27,70038,70042,Blue,1,21494,21580,86
2022-12-12,70046,70056,Blue,1,46032,46611,579
2022-11-30,70038,70056,Blue,1,56506,57424,918
2022-01-23,70049,70039,Blue,0,85348,85931,583
2022-07-22,70040,70056,Blue,1,71199,72051,852
2022-06-10,70057,70053,Blue,0,50824,50987,163
2022-04-01,70051,70838,Blue,0,29161,29938,777
2022-12-05,70055,70051,Blue,0,77658,77790,132
2022-03-22,70040,70042,Blue,1,41283,41315,32
2022-01-04,70053,70043,Blue,0,84300,84838,538
2022-03-10,70040,70044,Blue,1,52841,52962,121
2022-09-07,70053,70041,Blue,0,67406,68044,638
2022-08-24,70043,70838,Blue,0,47440,47637,197
2022-11-10,70042,70058,Blue,1,72758,73602,844
2022-03-27,70042,70052,Blue,1,48448,48964,516
2022-05-11,70057,70053,Blue,0,44185,44334,149
2022-03-27,70047,70039,Blue,0,76010,76427,417
2022-07-16,70040,70058,Blue,1,41001,41932,931
2022-03-05,70038,70046,Blue,1,22988,23294,306
2022-09-22,70038,70058,Blue,1,87424,88461,1037
2022-06-23,70050,70058,Blue,1,87233,87660,427
2022-06-15,70059,70039,Blue,0,31167,32294,1127
2022-05-07,70054,70058,Blue,1,93311,93467,156
2022-07-14,70038,70056,Blue,1,47109,48077,968
2022-07-14,70053,70047,Blue,0,32091,32416,325
2022-06-29,70051,70041,Blue,0,72543,73094,551
2022-01-04,70042,70046,Blue,1,77026,77205,179
2022-04-28,70052,70058,Blue,1,76662,76912,250
2022-12-01,70048,70056,Blue,1,75766,76164,398
2022-01-03,70038,70044,Blue,1,81526,81708,182
2022-02-21,70051,70047,Blue,0,52328,52520,192
2022-12-21,70044,70056,Blue,1,56994,57672,678
2022-01-13,70045,70043,Blue,0,65798,65920,122
2022-02-27,70048,70060,Blue,1,74209,74793,584
2022-03-03,70059,70051,Blue,0,41533,41850,317
2022-11-10,70038,70054,Blue,1,38880,39727,847
2022-04-22,70046,70058,Blue,1,25626,26285,659
2022-02-03,70051,70045,Blue,0,30962,31339,377
2022-08-02,70059,70045,Blue,0,65778,66449,671
2022-07-18,70051,70047,Blue,0,51319,51520,201
2022-07-12,70051,70047,Blue,0,63192,63392,200
2022-05-28,70045,70838,Blue,0,59024,59450,426
2022-10-13,70047,70039,Blue,0,65659,66051,392
2022-06-25,70042,70056,Blue,1,47094,48036,942
2022-10-05,70049,70047,Blue,0,54594,54650,56
2022-10-23,70057,70053,Blue,0,29373,29522,149
2022-11-07,70043,70041,Blue,0,58898,58927,29
2022-02-23,70055,70051,Blue,0,26657,26867,210
2022-07-10,70041,70039,Blue,0,72228,72257,29
2022-12-02,70053,70051,Blue,0,64723,64778,55
2022-10-22,70045,70041,Blue,0,49488,49684,196
2022-10-03,70055,70049,Blue,0,24823,25115,292
2022-10-31,70040,70054,Blue,1,45619,46371,752
2022-06-20,70057,70045,Blue,0,88395,89095,700
2022-03-19,70057,70053,Blue,0,59009,59161,152
2022-08-11,70053,70047,Blue,0,24109,24397,288
2022-07-05,70051,70039,Blue,0,22944,23648,704
2022-11-09,70056,70058,Blue,1,27378,27449,71
2022-10-07,70049,70039,Blue,0,47783,48284,501
2022-02-03,70043,70838,Blue,0,52512,52716,204
2022-09-21,70048,70060,Blue,1,86257,86877,620
2022-07-12,70059,70049,Blue,0,36305,36864,559
2022-08-23,70048,70056,Blue,1,51381,51801,420
2022-02-10,70050,70052,Blue,1,62532,62639,107
2022-03-13,70053,70043,Blue,0,37112,37719,607
2022-04-24,70046,70054,Blue,1,49238,49690,452
2022-06-29,70040,70060,Blue,1,39589,40733,1144
2022-06-26,70055,70045,Blue,0,60150,60663,513
2022-02-26,70051,70039,Blue,0,55032,55720,688
2022-02-18,70042,70050,Blue,1,47736,48197,461
2022-03-07,70053,70039,Blue,0,64996,65765,769
2022-10-13,70044,70048,Blue,1,88428,88683,255
2022-03-26,70040,70044,Blue,1,30265,30371,106
2022-12-17,70052,70058,Blue,1,84580,84849,269
2022-09-10,70048,70052,Blue,1,50162,50365,203
2022-06-22,70043,70039,Blue,0,57569,57677,108
2022-08-26,70053,70838,Blue,0,78763,79846,1083
2022-05-05,70054,70056,Blue,1,25070,25116,46
2022-12-29,70038,70052,Blue,1,51933,52671,738
2022-09-29,70038,70044,Blue,1,68956,69145,189
2022-12-27,70050,70052,Blue,1,45003,45120,117
2022-04-22,70038,70058,Blue,1,45793,46770,977
2022-01-11,70042,70052,Blue,1,27432,28117,685
2022-09-17,70049,70041,Blue,0,58377,58827,450
2022-06-25,70057,70838,Blue,0,38495,39566,1071
2022-06-13,70038,70050,Blue,1,48698,49317,619
2022-11-25,70051,70039,Blue,0,79069,79721,652
2022-03-28,70047,70838,Blue,0,52366,52889,523
2022-10-14,70057,70838,Blue,0,33156,34213,1057
2022-03-23,70050,70058,Blue,1,28521,28943,422
2022-12-26,70045,70838,Blue,0,48043,48350,307
2022-01-07,70047,70045,Blue,0,66809,66911,102
2022-03-07,70044,70050,Blue,1,36459,36818,359
2022-04-14,70051,70041,Blue,0,55782,56391,609
2022-09-02,70049,70041,Blue,0,28979,29455,476
2022-02-14,70057,70045,Blue,0,59671,60319,648
2022-09-30,70041,70039,Blue,0,56426,56457,31
2022-01-20,70053,70838,Blue,0,51025,51881,856
2022-07-11,70059,70045,Blue,0,60554,61259,705
2022-08-05,70052,70060,Blue,1,85485,85908,423
2022-10-13,70055,70043,Blue,0,60216,60885,669
2022-06-14,70044,70060,Blue,1,23569,24534,965
2022-10-07,70053,70045,Blue,0,31496,31928,432
2022-08-29,70049,70838,Blue,0,42641,43258,617
2022-06-13,70053,70039,Blue,0,28734,29529,795
2022-01-09,70040,70052,Blue,1,71596,72248,652
2022-02-12,70057,70039,Blue,0,66027,66957,930
2022-09-01,70040,70052,Blue,1,75275,75941,666
2022-01-06,70055,70838,Blue,0,21899,22874,975
2022-07-09,70038,70044,Blue,1,53413,53616,203
2022-06-13,70044,70058,Blue,1,34983,35850,867
2022-04-17,70055,70049,Blue,0,54027,54350,323
2022-06-09,70038,70042,Blue,1,76386,76492,106
2022-03-01,70049,70041,Blue,0,28362,28778,416
2022-02-03,70039,70838,Blue,0,22123,22171,48
2022-01-08,70040,70056,Blue,1,64827,65665,838
2022-12-17,70038,70060,Blue,1,56182,57293,1111
2022-05-01,70054,70058,Blue,1,33116,33258,142
2022-04-18,70047,70838,Blue,0,61409,62034,625
2022-09-14,70043,70039,Blue,0,72634,72731,97
2022-12-20,70053,70051,Blue,0,19724,19773,49
2022-04-22,70048,70060,Blue,1,23640,24341,701
2022-08-12,70054,70058,Blue,1,70557,70718,161
2022-02-03,70048,70050,Blue,1,59606,59666,60
2022-10-16,70053,70047,Blue,0,38433,38706,273
2022-07-09,70038,70060,Blue,1,54495,55656,1161
2022-10-06,70049,70047,Blue,0,31487,31545,58
2022-07-26,70057,70047,Blue,0,25375,25910,535
2022-12-02,70048,70056,Blue,1,49244,49665,421
2022-08-16,70057,70051,Blue,0,31909,32174,265
2022-01-04,70038,70042,Blue,1,23422,23520,98
2022-03-17,70049,70045,Blue,0,80535,80717,182
2022-11-16,70055,70041,Blue,0,32841,33654,813
2022-06-16,70038,70054,Blue,1,24938,25778,840
2022-05-07,70051,70049,Blue,0,76396,76549,153
2022-11-03,70059,70838,Blue,0,30917,32071,1154
2022-11-19,70053,70045,Blue,0,28940,29353,413
2022-02-28,70040,70054,Blue,1,87194,87928,734
2022-06-10,70044,70056,Blue,1,68669,69483,814
2022-07-06,70052,70054,Blue,1,62439,62529,90
2022-11-13,70045,70043,Blue,0,24645,24734,89
2022-08-09,70053,70051,Blue,0,64255,64354,99
2022-12-24,70044,70050,Blue,1,52556,52904,348
2022-11-15,70053,70039,Blue,0,29032,29814,782
2022-06-29,70049,70045,Blue,0,48333,48517,184
2022-01-25,70050,70056,Blue,1,30568,30877,309
2022-05-19,70042,70054,Blue,1,31803,32684,881
2022-03-10,70059,70041,Blue,0,39332,40363,1031
2022-08-07,70046,70056,Blue,1,28010,28520,510
2022-04-27,70052,70054,Blue,1,56253,56312,59
2022-04-08,70048,70052,Blue,1,20410,20636,226
2022-01-13,70046,70060,Blue,1,51786,52596,810
2022-03-16,70051,70041,Blue,0,25089,25691,602
2022-01-21,70053,70041,Blue,0,53412,54118,706
2022-04-06,70050,70052,Blue,1,26102,26225,123
2022-02-12,70057,70039,Blue,0,85779,86707,928
2022-07-04,70059,70047,Blue,0,40042,40599,557
2022-05-16,70051,70049,Blue,0,57738,57844,106
2022-02-08,70055,70049,Blue,0,76823,77112,289
2022-04-24,70044,70058,Blue,1,80595,81396,801
2022-06-17,70040,70056,Blue,1,66198,67054,856
2022-07-05,70048,70056,Blue,1,58732,59137,405
2022-07-12,70044,70046,Blue,1,45347,45497,150
2022-06-19,70055,70041,Blue,0,46465,47247,782
2022-11-07,70055,70039,Blue,0,31208,32503,1295
2022-12-25,70046,70054,Blue,1,40036,40618,582
2022-11-28,70044,70052,Blue,1,54128,54626,498
2022-08-16,70046,70056,Blue,1,42464,43038,574
2022-09-19,70057,70051,Blue,0,81995,82233,238
2022-02-12,70059,70053,Blue,0,30315,30561,246
2022-08-29,70051,70045,Blue,0,55457,55816,359
2022-04-05,70059,70057,Blue,0,58697,58736,39
2022-08-22,70059,70055,Blue,0,24688,24832,144
2022-01-22,70039,70838,Blue,0,62246,62281,35
2022-03-16,70059,70053,Blue,0,54493,54716,223
2022-07-16,70055,70041,Blue,0,74236,75008,772
2022-02-13,70045,70043,Blue,0,28830,28929,99
2022-11-09,70040,70050,Blue,1,34625,35125,500
2022-10-06,70046,70054,Blue,1,35241,35714,473
2022-06-30,70055,70041,Blue,0,76109,76887,778
2022-09-21,70043,70838,Blue,0,23638,23864,226
2022-07-25,70046,70050,Blue,1,42766,42954,188
2022-12-27,70050,70060,Blue,1,28230,28724,494
2022-12-02,70038,70052,Blue,1,39484,40219,735
2022-02-24,70042,70044,Blue,1,73140,73171,31
2022-01-12,70056,70060,Blue,1,39066,39289,223
2022-02-09,70040,70046,Blue,1,46458,46707,249
2022-04-08,70038,70056,Blue,1,55631,56552,921
2022-02-09,70053,70041,Blue,0,65581,66234,653
2022-05-28,70043,70041,Blue,0,36167,36195,28
2022-03-28,70040,70058,Blue,1,71503,72457,954
2022-11-04,70046,70058,Blue,1,27707,28356,649
2022-01-06,70051,70039,Blue,0,32110,32736,626
2022-10-22,70038,70050,Blue,1,72842,73406,564
2022-09-23,70040,70056,Blue,1,35971,36870,899
2022-01-10,70043,70838,Blue,0,58832,59057,225
2022-05-17,70053,70051,Blue,0,31281,31340,59
2022-01-18,70051,70041,Blue,0,54544,55130,586
2022-07-22,70048,70052,Blue,1,37952,38179,227
2022-06-29,70045,70041,Blue,0,81967,82147,180
2022-12-18,70045,70838,Blue,0,37032,37389,357
2022-06-03,70040,70048,Blue,1,41708,42163,455
2022-01-26,70054,70056,Blue,1,68532,68579,47
2022-04-01,70052,70058,Blue,1,40902,41157,255
2022-12-20,70048,70058,Blue,1,70094,71145,1051
2022-11-18,70045,70838,Blue,0,29574,29931,357
2022-10-14,70057,70055,Blue,0,36456,36525,69
2022-01-26,70038,70046,Blue,1,39078,39405,327
2022-09-07,70039,70838,Blue,0,37634,37666,32
2022-11-02,70053,70041,Blue,0,75169,75847,678
2022-08-19,70038,70048,Blue,1,25365,25874,509
2022-09-30,70051,70838,Blue,0,56006,56741,735
2022-03-19,70042,70056,Blue,1,29798,30586,788
2022-06-24,70053,70051,Blue,0,44982,45043,61
2022-08-20,70050,70060,Blue,1,52412,52933,521
2022-01-06,70057,70045,Blue,0,49413,50089,676
2022-02-08,70038,70054,Blue,1,43052,43827,775
2022-09-13,70040,70054,Blue,1,26678,27435,757
2022-01-07,70048,70052,Blue,1,62097,62316,219
2022-12-12,70057,70055,Blue,0,56266,56334,68
2022-11-16,70042,70044,Blue,1,48816,48848,32
2022-04-02,70053,70051,Blue,0,51651,51712,61
2022-09-03,70059,70041,Blue,0,34105,35071,966
2022-01-23,70050,70058,Blue,1,49939,50369,430
2022-12-16,70049,70045,Blue,0,26521,26747,226
2022-09-08,70040,70056,Blue,1,31257,32172,915
2022-02-25,70059,70045,Blue,0,76036,76805,769
2022-12-23,70057,70043,Blue,0,36989,38291,1302
2022-06-10,70049,70041,Blue,0,79932,80362,430
2022-02-25,70059,70043,Blue,0,36314,37413,1099
2022-09-12,70044,70054,Blue,1,38009,38662,653
2022-01-15,70049,70043,Blue,0,32448,32845,397
2022-11-12,70040,70058,Blue,1,22407,23341,934
2022-04-24,70048,70050,Blue,1,32096,32181,85
2022-02-17,70059,70039,Blue,0,79476,80433,957
2022-07-20,70053,70045,Blue,0,86932,87365,433
2022-12-05,70059,70053,Blue,0,62899,63133,234
2022-05-19,70042,70048,Blue,1,55523,55919,396
2022-01-01,70053,70051,Blue,0,35057,35111,54
2022-04-15,70057,70039,Blue,0,38212,39226,1014
2022-06-25,70055,70053,Blue,0,46158,46203,45
2022-02-03,70051,70838,Blue,0,41979,42762,783
2022-02-08,70056,70058,Blue,1,53969,54100,131
2022-03-30,70053,70041,Blue,0,26642,27364,722
2022-12-04,70044,70048,Blue,1,51556,51781,225
2022-08-27,70047,70041,Blue,0,35786,36098,312
2022-08-22,70046,70048,Blue,1,25736,25814,78
2022-02-08,70051,70047,Blue,0,78805,79009,204
2022-07-04,70040,70044,Blue,1,61733,61836,103
2022-09-19,70052,70060,Blue,1,84874,85230,356
2022-11-20,70055,70041,Blue,0,83965,84683,718
2022-01-11,70059,70047,Blue,0,26358,26991,633
2022-11-04,70059,70039,Blue,0,66985,68115,1130
2022-08-03,70059,70838,Blue,0,84854,85962,1108
2022-03-01,70043,70838,Blue,0,63991,64321,330
2022-02-08,70042,70054,Blue,1,19979,20677,698
2022-12-07,70049,70043,Blue,0,30154,30539,385
2022-01-04,70040,70052,Blue,1,67685,68251,566
2022-12-03,70053,70039,Blue,0,77424,78143,719
2022-09-09,70053,70043,Blue,0,75625,76382,757
2022-03-23,70059,70045,Blue,0,78912,79614,702
2022-12-19,70050,70060,Blue,1,54692,55292,600
2022-01-09,70038,70044,Blue,1,44297,44498,201
2022-07-22,70048,70054,Blue,1,43540,43844,304
2022-06-30,70038,70046,Blue,1,67072,67417,345
2022-12-15,70038,70054,Blue,1,54428,55309,881
2022-08-13,70049,70047,Blue,0,25958,26011,53
2022-12-05,70044,70050,Blue,1,23741,24083,342
2022-12-03,70059,70043,Blue,0,63787,64682,895
2022-12-08,70049,70838,Blue,0,33067,33706,639
2022-03-03,70054,70058,Blue,1,68153,68313,160
2022-08-23,70053,70039,Blue,0,59916,60691,775
2022-05-15,70059,70051,Blue,0,40209,40547,338
2022-04-22,70055,70053,Blue,0,51728,51773,45
2022-06-18,70040,70060,Blue,1,31318,32448,1130
2022-06-15,70040,70060,Blue,1,86646,87770,1124
2022-01-20,70041,70838,Blue,0,65935,66142,207
2022-06-09,70048,70052,Blue,1,25981,26211,230
2022-07-23,70049,70047,Blue,0,63775,63830,55
2022-12-02,70038,70060,Blue,1,61146,62243,1097
2022-10-13,70038,70056,Blue,1,33665,34546,881
2022-04-05,70046,70052,Blue,1,51202,51569,367
2022-10-17,70042,70060,Blue,1,38976,40042,1066
2022-03-04,70038,70044,Blue,1,67088,67297,209
2022-03-09,70048,70050,Blue,1,71910,71966,56
2022-11-09,70048,70060,Blue,1,31366,31998,632
2022-01-09,70053,70045,Blue,0,54135,54583,448
2022-10-16,70056,70058,Blue,1,33998,34067,69
2022-04-08,70055,70051,Blue,0,77374,77508,134
2022-07-06,70038,70042,Blue,1,60513,60606,93
2022-03-16,70042,70044,Blue,1,46534,46562,28
2022-03-14,70059,70047,Blue,0,66240,66793,553
2022-01-31,70038,70050,Blue,1,43518,44106,588
2022-09-29,70040,70046,Blue,1,26551,26812,261
2022-11-17,70053,70041,Blue,0,62156,62805,649
2022-04-02,70040,70052,Blue,1,48199,48896,697
2022-11-11,70059,70049,Blue,0,27627,28088,461
2022-02-19,70038,70044,Blue,1,36671,36852,181
2022-03-01,70044,70050,Blue,1,22076,22437,361
2022-08-04,70038,70050,Blue,1,76322,76974,652
2022-09-19,70042,70046,Blue,1,62647,62817,170
2022-04-25,70057,70053,Blue,0,77370,77516,146
2022-04-15,70051,70043,Blue,0,27008,27518,510
2022-04-21,70038,70044,Blue,1,42022,42227,205
2022-06-18,70044,70054,Blue,1,47151,47798,647
2022-01-26,70055,70047,Blue,0,31045,31436,391
2022-12-27,70053,70043,Blue,0,82648,83187,539
2022-10-11,70038,70050,Blue,1,25933,26430,497
2022-01-23,70057,70043,Blue,0,23137,24079,942
2022-12-07,70059,70838,Blue,0,46272,47367,1095
2022-09-29,70044,70048,Blue,1,55374,55593,219
2022-08-16,70040,70054,Blue,1,63872,64704,832
2022-03-29,70046,70054,Blue,1,53135,53555,420
2022-06-01,70049,70039,Blue,0,34267,34827,560
2022-05-27,70045,70043,Blue,0,33070,33177,107
2022-12-29,70047,70039,Blue,0,21977,22520,543
2022-02-18,70059,70057,Blue,0,20965,21005,40
2022-02-03,70053,70051,Blue,0,60901,60959,58
2022-12-05,70057,70043,Blue,0,40678,41491,813
2022-02-08,70042,70054,Blue,1,49903,50512,609
2022-10-09,70057,70838,Blue,0,32490,33585,1095
2022-04-09,70055,70053,Blue,0,20367,20418,51
2022-12-06,70038,70044,Blue,1,57031,57225,194
2022-08-30,70055,70838,Blue,0,30323,31343,1020
2022-07-06,70046,70052,Blue,1,51766,52154,388
2022-01-03,70053,70045,Blue,0,55349,55745,396
2022-10-21,70046,70052,Blue,1,27310,27650,340
2022-09-24,70042,70048,Blue,1,65474,65801,327
2022-11-06,70045,70039,Blue,0,87145,87380,235
2022-09-06,70055,70043,Blue,0,53300,53975,675
2022-07-04,70046,70060,Blue,1,84490,85299,809
2022-01-30,70059,70039,Blue,0,72478,74102,1624
2022-07-19,70059,70039,Blue,0,74071,75112,1041
2022-09-09,70059,70041,Blue,0,49936,50893,957
2022-11-06,70051,70041,Blue,0,39875,40472,597
2022-01-19,70049,70838,Blue,0,84029,84649,620
2022-09-29,70055,70047,Blue,0,41784,42207,423
2022-12-27,70056,70060,Blue,1,30754,30934,180
2022-07-16,70054,70056,Blue,1,25757,25804,47
2022-08-22,70047,70045,Blue,0,65201,65300,99
2022-12-17,70052,70058,Blue,1,28237,28489,252
2022-06-15,70045,70039,Blue,0,26074,26353,279
2022-04-22,70038,70050,Blue,1,40834,41395,561
2022-12-30,70053,70043,Blue,0,47680,48303,623
2022-10-14,70049,70039,Blue,0,21323,21822,499
2022-12-24,70059,70838,Blue,0,47677,48734,1057
2022-01-13,70057,70053,Blue,0,65969,66139,170
2022-02-27,70051,70039,Blue,0,41815,42416,601
2022-03-01,70048,70052,Blue,1,87682,87935,253
2022-01-05,70055,70045,Blue,0,51119,51666,547
2022-08-27,70044,70046,Blue,1,70411,70520,109
2022-03-04,70057,70045,Blue,0,31250,31917,667
2022-08-11,70054,70060,Blue,1,66839,67102,263
2022-03-04,70057,70053,Blue,0,30331,30496,165
2022-11-14,70055,70053,Blue,0,24665,24711,46
2022-08-22,70041,70039,Blue,0,26603,26634,31
2022-02-17,70043,70041,Blue,0,35785,35814,29
2022-02-03,70057,70053,Blue,0,23156,23344,188
2022-07-29,70044,70046,Blue,1,61020,61126,106
2022-01-31,70038,70044,Blue,1,91142,91786,644
2022-06-24,70055,70043,Blue,0,54751,55452,701
2022-10-06,70044,70052,Blue,1,21582,22086,504
2022-01-14,70059,70838,Blue,0,56327,57540,1213
2022-12-29,70057,70055,Blue,0,20876,20966,90
2022-02-25,70059,70051,Blue,0,20595,20983,388
2022-06-26,70040,70054,Blue,1,24640,25385,745
2022-06-28,70040,70044,Blue,1,49344,49465,121
2022-03-21,70046,70058,Blue,1,51178,51872,694
2022-12-23,70042,70056,Blue,1,45759,46575,816
2022-06-29,70042,70060,Blue,1,82078,83142,1064
2022-07-09,70038,70042,Blue,1,31273,31370,97
2022-07-05,70051,70047,Blue,0,46276,46520,244
2022-06-01,70043,70039,Blue,0,30947,31074,127
2022-08-05,70051,70043,Blue,0,22939,23413,474
2022-12-12,70057,70047,Blue,0,29834,30340,506
2022-12-22,70046,70054,Blue,1,69373,69815,442
2022-12-15,70056,70060,Blue,1,77410,77587,177
2022-12-20,70053,70049,Blue,0,78997,79207,210
2022-06-25,70043,70039,Blue,0,55742,55881,139
2022-10-27,70055,70053,Blue,0,63612,63659,47
2022-04-03,70050,70052,Blue,1,37616,37724,108
2022-11-01,70048,70050,Blue,1,24249,24312,63
2022-12-13,70050,70052,Blue,1,31711,31835,124
2022-01-20,70053,70051,Blue,0,55370,55423,53
2022-02-06,70047,70041,Blue,0,62524,62850,326
2022-09-29,70040,70044,Blue,1,58356,58453,97
2022-08-12,70038,70054,Blue,1,30737,31593,856
2022-08-11,70046,70054,Blue,1,76632,77033,401
2022-08-09,70047,70043,Blue,0,55703,55950,247
2022-01-05,70053,70045,Blue,0,71337,71794,457
2022-10-21,70050,70052,Blue,1,30163,30279,116
2022-09-02,70046,70058,Blue,1,28946,29549,603
2022-02-24,70052,70056,Blue,1,75571,75719,148
2022-09-13,70046,70058,Blue,1,70392,71007,615
2022-07-06,70054,70058,Blue,1,32176,32339,163
2022-11-09,70050,70054,Blue,1,69043,69278,235
2022-11-09,70047,70039,Blue,0,40585,41058,473
2022-07-26,70042,70056,Blue,1,67628,68392,764
2022-02-23,70040,70044,Blue,1,29703,29812,109
2022-01-03,70040,70044,Blue,1,63372,63491,119
2022-08-06,70055,70838,Blue,0,24978,25920,942
2022-09-12,70048,70060,Blue,1,33455,34141,686
2022-07-16,70040,70060,Blue,1,53005,54151,1146
2022-04-01,70042,70058,Blue,1,37464,38322,858
2022-03-29,70038,70048,Blue,1,62834,63318,484
2022-04-21,70059,70043,Blue,0,59592,60475,883
2022-09-17,70040,70052,Blue,1,56173,56787,614
2022-08-13,70046,70050,Blue,1,22035,22220,185
2022-02-17,70046,70054,Blue,1,31533,32007,474
2022-09-12,70048,70060,Blue,1,43238,43899,661
2022-05-21,70044,70054,Blue,1,60914,61600,686
2022-02-19,70038,70060,Blue,1,22995,24135,1140
2022-12-06,70055,70047,Blue,0,48624,49005,381
2022-09-19,70038,70056,Blue,1,50522,51372,850
2022-08-10,70048,70052,Blue,1,27776,27972,196
2022-11-25,70046,70052,Blue,1,21765,22121,356
2022-07-03,70059,70047,Blue,0,32412,32961,549
2022-02-15,70041,70838,Blue,0,76438,76546,108
2022-07-27,70046,70056,Blue,1,77777,78324,547
2022-05-30,70049,70047,Blue,0,74191,74249,58
2022-08-05,70052,70058,Blue,1,45921,46185,264
2022-01-24,70057,70838,Blue,0,53187,54245,1058
2022-06-29,70045,70838,Blue,0,26710,27064,354
2022-01-26,70054,70060,Blue,1,86935,87242,307
2022-04-03,70053,70045,Blue,0,41755,42220,465
2022-11-13,70038,70050,Blue,1,64534,65119,585
2022-07-11,70057,70041,Blue,0,66098,67027,929
2022-10-24,70038,70042,Blue,1,61939,62022,83
2022-08-10,70051,70043,Blue,0,75707,76175,468
2022-10-05,70055,70043,Blue,0,54804,55453,649
2022-07-14,70052,70058,Blue,1,61995,62264,269
2022-05-12,70052,70056,Blue,1,21997,22140,143
2022-05-05,70059,70057,Blue,0,25935,25970,35
2022-08-08,70045,70041,Blue,0,44966,45174,208
2022-08-10,70044,70058,Blue,1,22914,23683,769
2022-11-01,70050,70054,Blue,1,31696,31913,217
2022-07-16,70046,70052,Blue,1,79015,79356,341
2022-01-31,70045,70838,Blue,0,66166,66541,375
2022-01-19,70038,70058,Blue,1,62532,63569,1037
2022-06-21,70044,70052,Blue,1,49064,49699,635
2022-02-09,70046,70060,Blue,1,62909,63771,862
2022-10-19,70040,70046,Blue,1,37921,38157,236
2022-08-28,70053,70043,Blue,0,31931,32510,579
2022-10-22,70042,70058,Blue,1,50339,51240,901
2022-05-24,70040,70046,Blue,1,84691,84983,292
2022-10-20,70057,70039,Blue,0,31173,32065,892
2022-03-07,70052,70060,Blue,1,35567,35980,413
2022-06-20,70046,70058,Blue,1,71549,72248,699
2022-12-18,70045,70838,Blue,0,55655,55982,327
2022-10-15,70040,70048,Blue,1,52424,52818,394
2022-01-21,70056,70058,Blue,1,64003,64074,71
2022-10-26,70051,70039,Blue,0,49280,49930,650
2022-04-19,70056,70060,Blue,1,64374,64593,219
2022-08-19,70047,70045,Blue,0,48164,48255,91
2022-02-03,70055,70053,Blue,0,20823,20895,72
2022-07-12,70052,70058,Blue,1,63139,63453,314
2022-10-24,70042,70052,Blue,1,46246,46837,591
2022-04-04,70059,70043,Blue,0,25169,26061,892
2022-05-29,70038,70042,Blue,1,31507,31623,116
2022-04-13,70050,70054,Blue,1,54703,54914,211
2022-12-12,70047,70838,Blue,0,31652,32193,541
2022-02-12,70038,70056,Blue,1,22430,23368,938
2022-09-07,70040,70048,Blue,1,27633,27994,361
2022-10-16,70049,70838,Blue,0,28227,28855,628
2022-01-10,70059,70041,Blue,0,73214,74169,955
2022-03-09,70059,70055,Blue,0,49217,49372,155
2022-06-11,70054,70058,Blue,1,73183,73339,156
2022-02-03,70055,70051,Blue,0,61918,62098,180
2022-12-12,70051,70043,Blue,0,41569,42054,485
2022-06-22,70049,70047,Blue,0,58406,58460,54
2022-08-15,70054,70060,Blue,1,64763,65031,268
2022-10-18,70053,70047,Blue,0,35176,35499,323
2022-03-11,70039,70838,Blue,0,31897,31936,39
2022-09-21,70057,70049,Blue,0,50014,50433,419
2022-06-29,70057,70041,Blue,0,83664,84483,819
2022-07-08,70044,70048,Blue,1,44233,44485,252
2022-12-26,70038,70058,Blue,1,51008,52063,1055
2022-11-06,70059,70047,Blue,0,52753,53294,541
2022-03-10,70040,70042,Blue,1,70603,70637,34
2022-01-24,70046,70058,Blue,1,28554,29246,692
2022-04-09,70051,70049,Blue,0,38796,38901,105
2022-03-27,70040,70048,Blue,1,45011,45370,359
2022-01-25,70044,70056,Blue,1,68434,69051,617
2022-04-20,70044,70046,Blue,1,24165,24276,111
2022-07-10,70044,70054,Blue,1,44612,45230,618
2022-04-21,70055,70039,Blue,0,30489,31367,878
2022-11-28,70059,70051,Blue,0,30016,30354,338
2022-07-27,70059,70051,Blue,0,59812,60126,314
2022-03-02,70051,70041,Blue,0,68315,68969,654
2022-03-04,70055,70053,Blue,0,44178,44225,47
2022-03-08,70040,70052,Blue,1,57190,57815,625
2022-10-28,70042,70056,Blue,1,25762,26462,700
2022-04-03,70059,70041,Blue,0,40155,41016,861
2022-12-21,70042,70046,Blue,1,25514,25685,171
2022-07-17,70040,70048,Blue,1,46290,46719,429
2022-02-22,70053,70838,Blue,0,74671,75558,887
2022-07-12,70059,70055,Blue,0,50414,50574,160
2022-07-06,70053,70039,Blue,0,36162,36992,830
2022-02-05,70044,70046,Blue,1,67658,67767,109
2022-08-29,70045,70039,Blue,0,41328,41596,268
2022-10-04,70059,70838,Blue,0,25951,27262,1311
2022-11-02,70055,70053,Blue,0,70394,70442,48
2022-01-28,70042,70058,Blue,1,70088,70933,845
2022-11-01,70052,70060,Blue,1,59543,59914,371
2022-09-19,70051,70039,Blue,0,37839,38539,700
2022-08-25,70051,70039,Blue,0,55478,56135,657
2022-11-01,70045,70838,Blue,0,67293,67639,346
2022-02-25,70042,70050,Blue,1,30402,30826,424
2022-09-19,70049,70043,Blue,0,32407,32844,437
2022-12-02,70059,70055,Blue,0,52276,52422,146
2022-04-07,70045,70043,Blue,0,60343,60430,87
2022-02-28,70050,70056,Blue,1,69183,69469,286
2022-11-13,70045,70039,Blue,0,26936,27165,229
2022-07-17,70059,70047,Blue,0,44724,45337,613
2022-01-06,70040,70054,Blue,1,81609,82403,794
2022-07-13,70046,70052,Blue,1,24955,25332,377
2022-10-28,70040,70056,Blue,1,90829,91796,967
2022-04-24,70042,70052,Blue,1,73266,73838,572
2022-07-02,70043,70838,Blue,0,53572,53777,205
2022-07-15,70040,70050,Blue,1,61053,61620,567
2022-08-01,70041,70039,Blue,0,57646,57678,32
2022-03-11,70057,70043,Blue,0,62374,63150,776
2022-12-02,70054,70056,Blue,1,68543,68590,47
2022-10-06,70038,70056,Blue,1,46633,47487,854
2022-10-31,70059,70045,Blue,0,22403,23108,705
2022-02-20,70054,70056,Blue,1,55065,55111,46
2022-01-03,70059,70057,Blue,0,86930,86969,39
2022-12-31,70052,70058,Blue,1,82528,82799,271
2022-06-28,70040,70048,Blue,1,29546,29946,400
2022-07-21,70055,70041,Blue,0,61030,61788,758
2022-06-13,70038,70044,Blue,1,58108,58333,225
2022-09-22,70041,70838,Blue,0,59745,59866,121
2022-06-27,70046,70054,Blue,1,69439,69907,468
2022-02-23,70040,70050,Blue,1,62495,63057,562
2022-03-24,70053,70051,Blue,0,84886,84937,51
2022-01-10,70050,70060,Blue,1,36616,37162,546
2022-12-02,70040,70046,Blue,1,46168,46444,276
2022-04-07,70051,70045,Blue,0,44236,44611,375
2022-01-23,70048,70054,Blue,1,70420,70725,305
2022-10-04,70059,70039,Blue,0,23835,24899,1064
2022-03-07,70043,70041,Blue,0,28748,28777,29
2022-01-27,70049,70041,Blue,0,30499,30993,494
2022-01-15,70054,70056,Blue,1,45051,45098,47
2022-10-21,70038,70058,Blue,1,28200,29181,981
2022-04-11,70055,70041,Blue,0,62859,63640,781
2022-03-24,70052,70058,Blue,1,35256,35514,258
2022-04-04,70057,70039,Blue,0,25831,26780,949
2022-03-08,70049,70041,Blue,0,48689,49127,438
2022-12-06,70049,70047,Blue,0,33682,33738,56
2022-03-29,70052,70060,Blue,1,27168,27547,379
2022-09-23,70048,70058,Blue,1,40246,40776,530
2022-02-26,70038,70044,Blue,1,71774,71949,175
2022-08-07,70059,70047,Blue,0,23053,23593,540
2022-12-20,70046,70052,Blue,1,51146,51508,362
2022-07-02,70050,70052,Blue,1,22288,22403,115
2022-07-08,70057,70041,Blue,0,23488,24346,858
2022-09-18,70038,70046,Blue,1,64042,64442,400
2022-01-03,70042,70044,Blue,1,23763,23790,27
2022-10-08,70038,70060,Blue,1,26311,27476,1165
2022-07-26,70050,70054,Blue,1,30673,30906,233
2022-01-22,70044,70054,Blue,1,55915,56579,664
2022-06-19,70057,70055,Blue,0,50662,50730,68
2022-01-20,70046,70060,Blue,1,28268,29016,748
2022-03-22,70043,70838,Blue,0,53663,53860,197
2022-11-27,70049,70838,Blue,0,41257,41906,649
2022-03-08,70038,70058,Blue,1,70516,71503,987
2022-10-19,70053,70051,Blue,0,61907,61960,53
2022-11-07,70051,70043,Blue,0,54275,54761,486
2022-01-13,70053,70838,Blue,0,79163,79963,800
2022-06-16,70055,70041,Blue,0,39998,41187,1189
2022-04-17,70041,70838,Blue,0,57520,57639,119
2022-12-13,70051,70049,Blue,0,80381,80489,108
2022-07-13,70055,70053,Blue,0,37463,37514,51
2022-11-14,70041,70039,Blue,0,64990,65027,37
2022-06-16,70042,70052,Blue,1,58561,59196,635
2022-09-14,70049,70838,Blue,0,82353,82885,532
2022-08-10,70047,70043,Blue,0,33741,34050,309
2022-04-13,70040,70048,Blue,1,78682,79095,413
2022-02-18,70053,70039,Blue,0,30699,31557,858
2022-02-13,70038,70060,Blue,1,68828,70034,1206
2022-04-06,70038,70040,Blue,1,32059,32077,18
2022-03-29,70045,70043,Blue,0,65731,65819,88
2022-07-13,70051,70047,Blue,0,38747,38957,210
2022-07-01,70049,70039,Blue,0,73016,73556,540
2022-12-25,70047,70039,Blue,0,61478,61867,389
2022-06-27,70049,70041,Blue,0,54041,54518,477
2022-05-26,70050,70052,Blue,1,35064,35258,194
2022-07-23,70059,70057,Blue,0,44894,44928,34
2022-03-01,70057,70039,Blue,0,55766,56688,922
2022-08-20,70044,70048,Blue,1,88458,88688,230
2022-06-10,70053,70051,Blue,0,25152,25215,63
2022-07-20,70040,70056,Blue,1,64397,65241,844
2022-11-08,70052,70054,Blue,1,80348,80394,46
2022-10-04,70040,70052,Blue,1,70126,70804,678
2022-01-15,70051,70049,Blue,0,20543,20649,106
2022-01-08,70042,70052,Blue,1,37401,37970,569
2022-11-09,70059,70051,Blue,0,83410,83710,300
2022-08-05,70043,70041,Blue,0,59703,59731,28
2022-07-14,70050,70054,Blue,1,51081,51312,231
2022-08-04,70046,70058,Blue,1,29594,30297,703
2022-10-26,70059,70838,Blue,0,60853,62013,1160
2022-01-11,70059,70041,Blue,0,56592,57527,935
2022-06-13,70047,70045,Blue,0,26396,26499,103
2022-08-08,70044,70056,Blue,1,63644,64348,704
2022-07-08,70055,70053,Blue,0,41435,41483,48
2022-09-09,70053,70039,Blue,0,36173,36999,826
2022-06-28,70053,70039,Blue,0,68025,68714,689
2022-11-07,70046,70048,Blue,1,73561,73640,79
2022-04-12,70042,70058,Blue,1,87890,88807,917
2022-11-29,70051,70049,Blue,0,43585,43688,103
2022-05-02,70049,70047,Blue,0,52738,52762,24
2022-12-19,70053,70045,Blue,0,40407,40912,505
2022-10-01,70038,70058,Blue,1,53438,54510,1072
2022-09-03,70042,70060,Blue,1,57344,58310,966
2022-02-15,70044,70054,Blue,1,49948,50518,570
2022-07-04,70044,70058,Blue,1,51444,52591,1147
2022-09-12,70044,70056,Blue,1,60168,60841,673
2022-07-21,70043,70838,Blue,0,74141,74333,192
2022-01-21,70059,70041,Blue,0,38132,39145,1013
2022-09-25,70057,70051,Blue,0,30143,30385,242
2022-07-13,70053,70049,Blue,0,70277,70469,192
2022-07-14,70050,70054,Blue,1,75833,76040,207
2022-08-04,70044,70050,Blue,1,71837,72187,350
2022-12-22,70051,70039,Blue,0,53725,54343,618
2022-09-30,70049,70045,Blue,0,30704,30914,210
2022-10-08,70052,70054,Blue,1,79389,79456,67
2022-02-24,70040,70060,Blue,1,42031,43169,1138
2022-01-01,70057,70049,Blue,0,54995,55413,418
2022-09-11,70038,70046,Blue,1,75850,76178,328
2022-07-29,70047,70041,Blue,0,73740,74072,332
2022-06-22,70057,70051,Blue,0,62616,62854,238
2022-05-21,70053,70041,Blue,0,44070,44859,789
2022-04-23,70049,70041,Blue,0,87591,87988,397
2022-04-04,70040,70048,Blue,1,42543,42971,428
2022-02-17,70057,70047,Blue,0,68545,69029,484
2022-03-14,70042,70048,Blue,1,57015,57364,349
2022-12-02,70059,70041,Blue,0,45736,46708,972
2022-06-18,70053,70043,Blue,0,54937,55565,628
2022-02-09,70057,70049,Blue,0,23435,23894,459
2022-12-16,70051,70049,Blue,0,63794,63913,119
2022-03-02,70040,70054,Blue,1,27637,28481,844
2022-12-02,70042,70058,Blue,1,61839,62777,938
2022-08-07,70059,70838,Blue,0,37520,38676,1156
2022-07-25,70057,70045,Blue,0,70337,70922,585
2022-07-31,70052,70054,Blue,1,45703,45780,77
2022-07-15,70044,70046,Blue,1,40981,41126,145
2022-02-25,70057,70051,Blue,0,61175,61410,235
2022-12-31,70040,70052,Blue,1,74606,75259,653
2022-08-31,70055,70838,Blue,0,66742,67677,935
2022-09-01,70045,70039,Blue,0,60817,61056,239
2022-06-18,70042,70048,Blue,1,63931,64317,386
2022-06-13,70051,70045,Blue,0,25861,26209,348
2022-06-11,70055,70051,Blue,0,60765,60907,142
2022-03-28,70059,70047,Blue,0,58694,59292,598
2022-06-23,70055,70053,Blue,0,49264,49312,48
2022-11-19,70059,70041,Blue,0,26193,27190,997
2022-03-12,70051,70045,Blue,0,37686,38015,329
2022-12-31,70053,70051,Blue,0,86854,86907,53
2022-07-08,70048,70058,Blue,1,54318,54838,520
2022-03-08,70040,70052,Blue,1,78165,78917,752
2022-01-27,70041,70039,Blue,0,69397,69429,32
2022-11-27,70048,70056,Blue,1,56916,57335,419
2022-02-08,70044,70060,Blue,1,60074,61024,950
2022-07-30,70050,70058,Blue,1,38373,38790,417
2022-01-04,70038,70040,Blue,1,71950,71967,17
2022-05-23,70049,70838,Blue,0,55503,56225,722
2022-09-07,70044,70054,Blue,1,53514,54153,639
2022-02-22,70053,70043,Blue,0,60805,61443,638
2022-11-11,70044,70054,Blue,1,28363,28913,550
2022-09-29,70053,70043,Blue,0,71506,72092,586
2022-01-28,70059,70041,Blue,0,31763,32849,1086
2022-02-06,70057,70049,Blue,0,59302,59746,444
2022-12-19,70053,70041,Blue,0,76587,77259,672
2022-11-07,70057,70047,Blue,0,58140,58692,552
2022-11-25,70055,70043,Blue,0,70416,71093,677
2022-06-26,70053,70049,Blue,0,23318,23503,185
2022-04-26,70054,70058,Blue,1,92685,92843,158
2022-09-23,70051,70838,Blue,0,40429,41244,815
2022-02-26,70054,70056,Blue,1,24528,24575,47
2022-03-05,70042,70052,Blue,1,33025,33573,548
2022-09-08,70050,70056,Blue,1,30410,30764,354
2022-01-20,70038,70060,Blue,1,36195,37588,1393
2022-05-24,70042,70048,Blue,1,37483,37862,379
2022-06-26,70044,70054,Blue,1,68499,69171,672
2022-10-06,70043,70838,Blue,0,54968,55178,210
2022-11-06,70042,70054,Blue,1,58724,59341,617
2022-03-22,70047,70041,Blue,0,43380,43785,405
2022-01-02,70059,70041,Blue,0,72198,73203,1005
2022-09-20,70055,70045,Blue,0,24751,25300,549
2022-01-10,70057,70041,Blue,0,54869,55658,789
2022-06-25,70055,70043,Blue,0,63490,64171,681
2022-03-06,70046,70050,Blue,1,60584,60758,174
2022-08-15,70044,70046,Blue,1,44947,45065,118
2022-05-31,70046,70050,Blue,1,43764,44045,281
2022-12-07,70040,70044,Blue,1,34144,34254,110
2022-11-07,70044,70046,Blue,1,63163,63265,102
2022-12-10,70051,70039,Blue,0,41456,42047,591
2022-03-16,70051,70039,Blue,0,33637,34292,655
2022-04-20,70055,70043,Blue,0,70698,71405,707
2022-10-11,70055,70041,Blue,0,78332,79033,701
2022-08-22,70056,70058,Blue,1,62475,62555,80
2022-09-07,70053,70041,Blue,0,36158,36932,774
2022-10-18,70046,70054,Blue,1,48624,49056,432
2022-03-13,70051,70838,Blue,0,49879,50609,730
2022-09-17,70048,70060,Blue,1,42745,43361,616
2022-03-30,70042,70044,Blue,1,44788,44816,28
2022-10-12,70039,70838,Blue,0,27446,27480,34
2022-03-15,70053,70049,Blue,0,35494,35744,250
2022-01-09,70057,70047,Blue,0,51218,51708,490
2022-10-03,70046,70052,Blue,1,71368,71690,322
2022-06-05,70043,70041,Blue,0,85972,86002,30
2022-04-16,70054,70060,Blue,1,75927,76200,273
2022-07-01,70038,70044,Blue,1,85952,86161,209
2022-01-06,70055,70051,Blue,0,50939,51212,273
2022-08-21,70052,70054,Blue,1,70190,70261,71
2022-02-28,70051,70838,Blue,0,40982,41763,781
2022-12-24,70050,70054,Blue,1,30434,30693,259
2022-12-25,70049,70047,Blue,0,73765,73819,54
2022-06-13,70055,70838,Blue,0,73942,74920,978
2022-02-13,70039,70838,Blue,0,29161,29195,34
2022-03-03,70046,70058,Blue,1,56317,56890,573
2022-06-23,70057,70043,Blue,0,51616,52588,972
2022-11-01,70046,70056,Blue,1,60019,60533,514
2022-03-16,70038,70060,Blue,1,62827,64010,1183
2022-10-31,70055,70045,Blue,0,39684,40181,497
2022-04-04,70052,70056,Blue,1,37585,37728,143
2022-03-22,70044,70060,Blue,1,67239,68355,1116
2022-01-25,70057,70045,Blue,0,27887,28513,626
2022-07-08,70042,70044,Blue,1,21248,21284,36
2022-08-17,70053,70838,Blue,0,44982,45885,903
2022-06-11,70046,70054,Blue,1,43678,44143,465
2022-03-05,70043,70041,Blue,0,55033,55062,29
2022-12-19,70057,70053,Blue,0,63907,64060,153
2022-05-19,70038,70042,Blue,1,69502,69604,102
2022-11-06,70053,70045,Blue,0,53605,54041,436
2022-04-04,70057,70039,Blue,0,63870,64736,866
2022-03-19,70057,70047,Blue,0,63871,64349,478
2022-03-22,70053,70039,Blue,0,46879,47592,713
2022-03-10,70054,70058,Blue,1,30450,30624,174
2022-07-20,70057,70047,Blue,0,50488,50955,467
2022-10-22,70042,70060,Blue,1,28180,29133,953
2022-12-05,70059,70053,Blue,0,78359,78583,224
2022-10-21,70055,70838,Blue,0,86757,87655,898
2022-08-23,70053,70041,Blue,0,26585,27344,759
2022-03-11,70056,70058,Blue,1,76732,76810,78
2022-09-16,70059,70039,Blue,0,48385,49440,1055
2022-03-03,70042,70048,Blue,1,86218,86541,323
2022-01-12,70054,70058,Blue,1,24232,24397,165
2022-11-03,70054,70058,Blue,1,32819,32974,155
2022-02-22,70055,70053,Blue,0,24743,24829,86
2022-01-17,70044,70058,Blue,1,25845,26691,846
2022-10-25,70048,70050,Blue,1,37192,37255,63
2022-06-21,70045,70041,Blue,0,79509,79675,166
2022-06-15,70054,70060,Blue,1,54559,55161,602
2022-01-17,70053,70045,Blue,0,29045,29475,430
2022-03-26,70059,70057,Blue,0,59116,59153,37
2022-02-02,70048,70058,Blue,1,26416,26928,512
2022-11-29,70046,70056,Blue,1,68332,68893,561
2022-03-01,70054,70058,Blue,1,73848,74003,155
2022-09-18,70051,70039,Blue,0,38535,39190,655
2022-01-13,70051,70043,Blue,0,40771,41254,483
2022-04-18,70059,70049,Blue,0,77176,77646,470
2022-09-27,70046,70060,Blue,1,72457,73197,740
2022-07-04,70040,70044,Blue,1,42703,42809,106
2022-03-10,70040,70048,Blue,1,88501,88934,433
2022-02-26,70052,70056,Blue,1,50445,50601,156
2022-08-27,70057,70041,Blue,0,64413,65273,860
2022-12-07,70053,70041,Blue,0,53364,54047,683
2022-02-21,70046,70058,Blue,1,22063,22756,693
2022-12-23,70050,70060,Blue,1,54644,55428,784
2022-01-26,70038,70058,Blue,1,64936,65957,1021
2022-09-09,70040,70046,Blue,1,30859,31119,260
2022-12-30,70038,70044,Blue,1,51252,51439,187
2022-03-21,70053,70047,Blue,0,30871,31169,298
2022-03-03,70042,70052,Blue,1,79910,80494,584
2022-07-16,70059,70041,Blue,0,69750,70718,968
2022-03-03,70048,70056,Blue,1,23609,24008,399
2022-09-25,70051,70041,Blue,0,88586,89273,687
2022-12-07,70042,70056,Blue,1,36533,37259,726
2022-10-30,70056,70060,Blue,1,80685,80867,182
2022-02-23,70054,70058,Blue,1,87452,87610,158
2022-04-16,70050,70056,Blue,1,54607,54903,296
2022-04-15,70040,70052,Blue,1,63798,64425,627
2022-01-20,70055,70045,Blue,0,83667,84260,593
2022-07-04,70059,70057,Blue,0,61096,61130,34
2022-10-20,70051,70041,Blue,0,28845,29483,638
2022-07-01,70057,70039,Blue,0,47910,48864,954
2022-01-24,70048,70058,Blue,1,33550,34055,505
2022-05-15,70053,70047,Blue,0,35674,35976,302
2022-10-28,70053,70039,Blue,0,59016,59728,712
2022-05-01,70051,70049,Blue,0,31601,31705,104
2022-06-11,70038,70052,Blue,1,60982,61696,714
2022-04-03,70044,70054,Blue,1,65813,66421,608
2022-09-05,70059,70039,Blue,0,28513,29525,1012
2022-01-31,70049,70045,Blue,0,48614,48815,201
2022-03-20,70042,70054,Blue,1,30947,31595,648
2022-08-15,70047,70039,Blue,0,41333,41802,469
2022-08-21,70055,70049,Blue,0,76705,77017,312
2022-11-03,70048,70060,Blue,1,29951,30778,827
2022-09-26,70047,70039,Blue,0,46451,46883,432
2022-01-31,70046,70050,Blue,1,32267,32556,289
2022-01-26,70052,70058,Blue,1,63019,63272,253
2022-03-22,70059,70045,Blue,0,23117,23861,744
2022-02-23,70049,70043,Blue,0,43240,43634,394
2022-04-04,70040,70052,Blue,1,53474,54185,711
2022-08-01,70042,70060,Blue,1,38555,39669,1114
2022-06-07,70039,70838,Blue,0,35933,35967,34
2022-09-19,70059,70043,Blue,0,44240,45213,973
2022-10-26,70049,70039,Blue,0,28733,29312,579
2022-08-31,70051,70039,Blue,0,27129,27911,782
2022-06-11,70040,70058,Blue,1,52440,53453,1013
2022-02-14,70057,70051,Blue,0,54875,55120,245
2022-12-06,70049,70041,Blue,0,58710,59122,412
2022-02-02,70044,70056,Blue,1,64260,64927,667
2022-06-12,70049,70041,Blue,0,85366,85926,560
2022-06-27,70038,70044,Blue,1,63231,63448,217
2022-01-18,70038,70058,Blue,1,86020,87071,1051
2022-01-27,70042,70058,Blue,1,74278,75199,921
2022-06-30,70044,70060,Blue,1,56748,57744,996
2022-02-22,70043,70039,Blue,0,30680,30799,119
2022-09-18,70057,70051,Blue,0,49596,49861,265
2022-02-20,70048,70056,Blue,1,86913,87279,366
2022-08-07,70053,70041,Blue,0,26435,27107,672
2022-09-19,70046,70058,Blue,1,78216,78823,607
2022-10-26,70040,70060,Blue,1,46745,47727,982
2022-10-22,70059,70055,Blue,0,36264,36413,149
2022-09-16,70047,70045,Blue,0,59276,59397,121
2022-10-28,70045,70041,Blue,0,80118,80277,159
2022-10-28,70054,70060,Blue,1,24036,24300,264
2022-10-25,70052,70060,Blue,1,81377,81704,327
2022-07-04,70040,70058,Blue,1,86171,87204,1033
2022-01-17,70046,70058,Blue,1,33819,34569,750
2022-02-15,70059,70045,Blue,0,55093,55812,719
2022-09-04,70050,70054,Blue,1,86992,87189,197
2022-11-14,70051,70049,Blue,0,51844,51945,101
2022-07-16,70057,70041,Blue,0,53621,54480,859
2022-12-28,70041,70838,Blue,0,58660,58775,115
2022-12-23,70048,70050,Blue,1,39544,39608,64
2022-10-22,70057,70055,Blue,0,76526,76595,69
2022-01-21,70053,70039,Blue,0,76940,77773,833
2022-08-17,70053,70039,Blue,0,63696,64428,732
2022-04-06,70051,70043,Blue,0,74711,75233,522
2022-07-06,70040,70042,Blue,1,22264,22301,37
2022-04-10,70055,70051,Blue,0,72380,72523,143
2022-11-11,70055,70039,Blue,0,78985,79721,736
2022-12-06,70056,70058,Blue,1,81466,81537,71
2022-12-27,70049,70043,Blue,0,72656,73019,363
2022-12-20,70059,70039,Blue,0,32975,33993,1018
2022-08-23,70059,70053,Blue,0,52518,52758,240
2022-03-09,70043,70838,Blue,0,20600,20796,196
2022-02-25,70040,70048,Blue,1,21097,21510,413
2022-12-21,70045,70838,Blue,0,53030,53370,340
2022-12-09,70044,70046,Blue,1,48900,49003,103
2022-02-06,70047,70043,Blue,0,72809,73055,246
2022-06-27,70040,70056,Blue,1,29451,30368,917
2022-10-15,70042,70060,Blue,1,22488,23613,1125
2022-02-03,70053,70043,Blue,0,85444,86057,613
2022-02-15,70047,70039,Blue,0,30853,31386,533
2022-10-07,70040,70056,Blue,1,52563,53437,874
2022-12-04,70046,70060,Blue,1,73543,74297,754
2022-01-03,70057,70039,Blue,0,56980,58403,1423
2022-10-10,70044,70050,Blue,1,26684,27019,335
2022-07-30,70057,70049,Blue,0,26612,26983,371
2022-09-20,70055,70039,Blue,0,24751,25612,861
2022-12-17,70050,70056,Blue,1,87184,87476,292
2022-02-03,70055,70049,Blue,0,64752,65097,345
2022-12-18,70040,70060,Blue,1,44450,45574,1124
2022-08-21,70042,70044,Blue,1,24691,24726,35
2022-12-07,70057,70047,Blue,0,84292,84793,501
2022-01-05,70046,70052,Blue,1,42757,43132,375
2022-11-06,70042,70048,Blue,1,68444,68749,305
2022-10-02,70044,70060,Blue,1,26319,27184,865
2022-09-25,70042,70046,Blue,1,34080,34250,170
2022-03-21,70050,70054,Blue,1,67994,68271,277
2022-09-23,70043,70039,Blue,0,47220,47329,109
2022-07-22,70040,70046,Blue,1,88179,88454,275
2022-07-11,70050,70056,Blue,1,29684,30022,338
2022-09-04,70044,70056,Blue,1,80587,81306,719
2022-04-08,70051,70049,Blue,0,61442,61549,107
2022-09-23,70052,70060,Blue,1,37343,37730,387
2022-07-20,70038,70050,Blue,1,27405,27983,578
2022-02-24,70046,70050,Blue,1,77790,77963,173
2022-07-13,70048,70052,Blue,1,53760,53975,215
2022-06-27,70039,70838,Blue,0,23816,23848,32
2022-04-01,70054,70060,Blue,1,21636,22014,378
2022-10-05,70050,70052,Blue,1,27111,27227,116
2022-12-07,70047,70838,Blue,0,58900,59431,531
2022-03-19,70055,70051,Blue,0,67222,67354,132
2022-04-15,70041,70838,Blue,0,42139,42263,124
2022-12-14,70053,70838,Blue,0,35109,36126,1017
2022-11-27,70059,70043,Blue,0,38719,39584,865
2022-01-13,70058,70060,Blue,1,45761,45828,67
2022-09-14,70046,70054,Blue,1,58688,59134,446
2022-03-16,70046,70052,Blue,1,61484,61830,346
2022-02-02,70040,70048,Blue,1,27016,27390,374
2022-10-29,70042,70048,Blue,1,34199,34520,321
2022-03-01,70055,70838,Blue,0,42260,43226,966
2022-03-16,70042,70046,Blue,1,56654,56850,196
2022-07-29,70040,70046,Blue,1,59937,60222,285
2022-12-27,70055,70047,Blue,0,51382,51769,387
2022-02-12,70043,70041,Blue,0,32907,32936,29
2022-04-02,70038,70044,Blue,1,46393,46559,166
2022-06-22,70053,70049,Blue,0,56453,56647,194
2022-05-19,70046,70056,Blue,1,85555,86071,516
2022-02-23,70059,70838,Blue,0,49216,50358,1142
2022-08-25,70044,70058,Blue,1,61590,62384,794
2022-03-15,70057,70055,Blue,0,65066,65135,69
2022-12-25,70038,70054,Blue,1,76387,77179,792
2022-05-22,70042,70048,Blue,1,55606,56033,427
2022-10-04,70044,70060,Blue,1,76555,77525,970
2022-08-17,70038,70042,Blue,1,51884,51978,94
2022-06-03,70042,70046,Blue,1,80162,80379,217
2022-08-01,70040,70050,Blue,1,78364,78826,462
2022-01-10,70038,70044,Blue,1,25157,25317,160
2022-07-02,70055,70051,Blue,0,40245,40377,132
2022-03-05,70057,70055,Blue,0,62248,62316,68
2022-10-27,70042,70052,Blue,1,21564,22121,557
2022-02-28,70049,70047,Blue,0,87987,88040,53
2022-11-17,70059,70045,Blue,0,30587,31357,770
2022-10-22,70046,70052,Blue,1,64628,64968,340
2022-06-14,70052,70058,Blue,1,85675,85913,238
2022-03-30,70040,70044,Blue,1,69017,69138,121
2022-01-16,70044,70052,Blue,1,65353,65923,570
2022-01-09,70049,70047,Blue,0,42689,42750,61
2022-04-20,70043,70039,Blue,0,59962,60079,117
2022-02-09,70053,70838,Blue,0,67101,68114,1013
2022-12-20,70047,70838,Blue,0,42917,43393,476
2022-08-12,70056,70058,Blue,1,77208,77278,70
2022-07-08,70044,70046,Blue,1,40249,40363,114
2022-03-31,70051,70039,Blue,0,81571,82213,642
2022-07-23,70048,70060,Blue,1,59956,60593,637
2022-12-28,70057,70039,Blue,0,33159,34121,962
2022-03-17,70042,70048,Blue,1,64507,64858,351
2022-01-19,70055,70047,Blue,0,26547,26982,435
2022-07-21,70042,70048,Blue,1,61508,61836,328
2022-08-21,70040,70052,Blue,1,47846,48470,624
2022-04-17,70048,70052,Blue,1,71507,71717,210
2022-09-30,70040,70058,Blue,1,54564,55524,960
2022-03-14,70057,70047,Blue,0,46697,47171,474
2022-02-03,70045,70039,Blue,0,19307,19610,303
2022-03-14,70047,70043,Blue,0,60493,60770,277
2022-04-27,70056,70058,Blue,1,86705,86801,96
2022-06-27,70053,70838,Blue,0,75153,75989,836
2022-06-13,70051,70045,Blue,0,21715,22087,372
2022-03-22,70046,70058,Blue,1,84231,84884,653
2022-03-03,70059,70057,Blue,0,64399,64440,41
2022-04-15,70040,70044,Blue,1,48256,48391,135
2022-02-09,70056,70060,Blue,1,62888,63123,235
2022-09-06,70043,70039,Blue,0,32171,32287,116
2022-09-15,70048,70056,Blue,1,32851,33304,453
2022-03-03,70048,70060,Blue,1,29014,29618,604
2022-07-11,70043,70041,Blue,0,53185,53214,29
2022-04-08,70038,70056,Blue,1,42221,43338,1117
2022-12-21,70053,70045,Blue,0,53854,54270,416
2022-04-03,70055,70053,Blue,0,58351,58396,45
2022-03-19,70051,70047,Blue,0,74403,74597,194
2022-10-01,70057,70053,Blue,0,22233,22382,149
2022-01-22,70054,70056,Blue,1,76403,76451,48
2022-11-29,70059,70055,Blue,0,65542,65687,145
2022-05-21,70047,70043,Blue,0,60417,60791,374
2022-02-23,70049,70043,Blue,0,75416,75807,391
2022-07-11,70053,70047,Blue,0,47616,47915,299
2022-11-11,70050,70054,Blue,1,21705,21942,237
2022-09-04,70044,70048,Blue,1,43867,44138,271
2022-07-20,70057,70039,Blue,0,33574,34564,990
2022-05-07,70053,70049,Blue,0,57547,57743,196
2022-02-11,70038,70050,Blue,1,36203,36765,562
2022-03-27,70053,70047,Blue,0,50858,51141,283
2022-10-09,70059,70049,Blue,0,38836,39310,474
2022-10-02,70055,70039,Blue,0,50789,51707,918
2022-07-10,70054,70058,Blue,1,85648,85815,167
2022-02-07,70057,70838,Blue,0,78423,79536,1113
2022-04-12,70050,70060,Blue,1,32429,33034,605
2022-01-06,70053,70051,Blue,0,23946,24002,56
2022-02-16,70059,70838,Blue,0,66494,67643,1149
2022-08-14,70049,70047,Blue,0,73233,73288,55
2022-07-23,70040,70052,Blue,1,86150,86950,800
2022-08-27,70055,70039,Blue,0,75327,76165,838
2022-10-02,70057,70055,Blue,0,23806,23875,69
2022-10-27,70059,70838,Blue,0,73979,75038,1059
2022-11-23,70040,70048,Blue,1,21851,22206,355
2022-09-29,70056,70058,Blue,1,29156,29262,106
2022-01-11,70048,70058,Blue,1,26392,26956,564
2022-03-16,70057,70053,Blue,0,79541,79706,165
2022-02-09,70038,70040,Blue,1,84388,84406,18
2022-06-24,70038,70060,Blue,1,50800,52159,1359
2022-10-25,70038,70060,Blue,1,60156,61362,1206
2022-07-15,70044,70054,Blue,1,33845,34515,670
2022-01-26,70038,70056,Blue,1,63441,64343,902
2022-04-16,70042,70058,Blue,1,72455,73354,899
2022-04-14,70038,70054,Blue,1,42065,42952,887
2022-04-11,70040,70058,Blue,1,21914,22845,931
2022-10-23,70046,70056,Blue,1,79470,79984,514
2022-03-13,70046,70058,Blue,1,35047,35889,842
2022-02-28,70044,70058,Blue,1,49474,50305,831
2022-03-26,70047,70045,Blue,0,39585,39711,126
2022-10-20,70059,70057,Blue,0,19514,19551,37
2022-12-10,70041,70838,Blue,0,79380,79494,114
2022-08-21,70046,70056,Blue,1,50422,50962,540
2022-12-29,70052,70060,Blue,1,25202,25650,448
2022-02-15,70050,70060,Blue,1,54270,54805,535
2022-02-25,70051,70047,Blue,0,27365,27564,199
2022-01-04,70049,70045,Blue,0,88005,88193,188
2022-06-27,70055,70039,Blue,0,28967,29866,899
2022-11-26,70059,70043,Blue,0,33013,34056,1043
2022-11-20,70051,70838,Blue,0,85849,86576,727
2022-03-15,70049,70039,Blue,0,70015,70492,477
2022-08-13,70051,70039,Blue,0,52862,53554,692
2022-12-24,70059,70049,Blue,0,80658,81122,464
2022-04-18,70042,70044,Blue,1,52910,52939,29
2022-03-03,70049,70041,Blue,0,37079,37577,498
2022-09-21,70053,70045,Blue,0,46547,47007,460
2022-09-19,70042,70060,Blue,1,45317,46281,964
2022-01-15,70054,70060,Blue,1,73552,73874,322
2022-04-11,70051,70838,Blue,0,58171,58953,782
2022-07-27,70047,70838,Blue,0,28710,29264,554
2022-08-03,70042,70050,Blue,1,74395,74812,417
2022-12-01,70040,70044,Blue,1,58133,58270,137
2022-08-26,70040,70048,Blue,1,53462,53837,375
2022-02-28,70057,70047,Blue,0,55472,55989,517
2022-04-01,70043,70041,Blue,0,21503,21531,28
2022-11-30,70046,70054,Blue,1,79608,80112,504
2022-04-04,70038,70056,Blue,1,69428,70298,870
2022-06-17,70048,70058,Blue,1,83322,83834,512
2022-12-03,70057,70053,Blue,0,33637,33791,154
2022-12-21,70048,70054,Blue,1,57281,57586,305
2022-03-22,70051,70049,Blue,0,20012,20120,108
2022-03-18,70056,70060,Blue,1,80643,80824,181
2022-02-09,70045,70043,Blue,0,76832,76987,155
2022-11-11,70045,70043,Blue,0,42392,42487,95
2022-11-14,70046,70048,Blue,1,31469,31561,92
2022-07-06,70042,70048,Blue,1,32982,33315,333
2022-08-16,70045,70041,Blue,0,22974,23167,193
2022-10-25,70057,70838,Blue,0,84331,85356,1025
2022-06-29,70055,70043,Blue,0,44379,45035,656
2022-07-18,70056,70060,Blue,1,25878,26072,194
2022-01-26,70046,70054,Blue,1,71895,72377,482
2022-06-04,70041,70039,Blue,0,77598,77628,30
2022-01-05,70059,70041,Blue,0,26953,27916,963
2022-04-07,70055,70053,Blue,0,28348,28396,48
2022-05-19,70052,70060,Blue,1,29108,29615,507
2022-02-25,70055,70838,Blue,0,66749,67862,1113
2022-03-19,70046,70058,Blue,1,33281,33978,697
2022-10-22,70051,70043,Blue,0,32283,32753,470
2022-07-06,70055,70051,Blue,0,79014,79152,138
2022-07-16,70040,70058,Blue,1,36254,37221,967
2022-05-14,70053,70051,Blue,0,42895,42954,59
2022-07-26,70038,70046,Blue,1,32052,32407,355
2022-02-14,70049,70039,Blue,0,56519,57056,537
2022-04-17,70042,70046,Blue,1,88335,88509,174
2022-08-15,70054,70060,Blue,1,87937,88196,259
2022-09-01,70055,70045,Blue,0,49037,49552,515
2022-06-02,70048,70050,Blue,1,25024,25089,65
2022-05-15,70051,70049,Blue,0,84987,85100,113
2022-09-23,70046,70048,Blue,1,40119,40203,84
2022-07-30,70046,70052,Blue,1,45681,45995,314
2022-03-07,70055,70041,Blue,0,71175,71966,791
2022-06-18,70049,70043,Blue,0,57956,58358,402
2022-12-13,70046,70052,Blue,1,23501,23869,368
2022-01-25,70053,70047,Blue,0,84268,84551,283
2022-07-31,70057,70838,Blue,0,69576,70605,1029
2022-07-04,70047,70043,Blue,0,77524,77787,263
2022-05-19,70040,70048,Blue,1,60955,61462,507
2022-12-08,70059,70055,Blue,0,72851,73002,151
2022-08-12,70042,70048,Blue,1,35961,36281,320
2022-12-03,70055,70053,Blue,0,43835,43901,66
2022-01-20,70051,70838,Blue,0,69422,70205,783
2022-01-25,70056,70058,Blue,1,34510,34583,73
2022-12-29,70053,70043,Blue,0,20353,20915,562
2022-04-05,70051,70045,Blue,0,72399,72718,319
2022-12-19,70053,70838,Blue,0,46413,47451,1038
2022-12-28,70042,70060,Blue,1,23309,24338,1029
2022-10-30,70053,70045,Blue,0,58962,59403,441
2022-03-18,70040,70052,Blue,1,82683,83410,727
2022-11-26,70053,70045,Blue,0,38140,38553,413
2022-04-07,70038,70054,Blue,1,54532,55421,889
2022-09-14,70048,70060,Blue,1,27152,27820,668
2022-12-16,70040,70044,Blue,1,80054,80168,114
2022-12-10,70040,70050,Blue,1,76688,77194,506
2022-07-22,70048,70060,Blue,1,77370,78040,670
2022-02-17,70038,70046,Blue,1,25021,25367,346
2022-02-20,70057,70838,Blue,0,42237,43386,1149
2022-04-20,70059,70055,Blue,0,64464,64611,147
2022-10-05,70049,70838,Blue,0,42286,42879,593
2022-03-17,70053,70051,Blue,0,71269,71331,62
2022-08-31,70040,70050,Blue,1,56126,56604,478
2022-02-08,70042,70054,Blue,1,75505,76186,681
2022-08-01,70042,70050,Blue,1,40546,40989,443
2022-11-17,70040,70052,Blue,1,29060,29691,631
2022-08-29,70038,70052,Blue,1,24934,25650,716
2022-11-01,70050,70052,Blue,1,64471,64579,108
2022-07-29,70040,70042,Blue,1,67411,67441,30
2022-11-27,70055,70043,Blue,0,36906,37542,636
2022-02-25,70059,70045,Blue,0,46214,46976,762
2022-03-10,70040,70050,Blue,1,63793,64349,556
2022-07-23,70045,70041,Blue,0,39182,39376,194
2022-07-13,70059,70039,Blue,0,87315,88237,922
2022-08-27,70045,70039,Blue,0,32666,32939,273
2022-03-30,70055,70045,Blue,0,54078,54586,508
2022-10-25,70054,70060,Blue,1,33676,33949,273
2022-04-08,70045,70043,Blue,0,60340,60431,91
2022-09-16,70048,70050,Blue,1,58741,58796,55
2022-09-18,70046,70056,Blue,1,50310,50784,474
2022-01-02,70057,70055,Blue,0,42886,42955,69
2022-01-28,70046,70048,Blue,1,62636,62737,101
2022-01-10,70044,70058,Blue,1,59151,60083,932
2022-12-09,70042,70058,Blue,1,51534,52477,943
2022-03-15,70038,70058,Blue,1,29271,30170,899
2022-11-13,70057,70047,Blue,0,40229,40690,461
2022-02-14,70043,70039,Blue,0,29801,29925,124
2022-01-12,70045,70043,Blue,0,79648,79730,82
2022-03-03,70043,70838,Blue,0,52779,53045,266
2022-03-21,70052,70060,Blue,1,73672,74008,336
2022-11-27,70057,70049,Blue,0,28490,28861,371
2022-03-15,70044,70060,Blue,1,62755,63866,1111
2022-11-29,70057,70053,Blue,0,40112,40300,188
2022-02-08,70044,70056,Blue,1,66629,67275,646
2022-02-01,70040,70042,Blue,1,59898,59930,32
2022-11-16,70058,70060,Blue,1,68491,68548,57
2022-10-09,70052,70054,Blue,1,49028,49078,50
2022-04-20,70046,70056,Blue,1,26080,26562,482
2022-10-17,70055,70045,Blue,0,21037,21557,520
2022-01-05,70057,70051,Blue,0,88175,88420,245
2022-11-07,70042,70054,Blue,1,57516,58543,1027
2022-12-16,70042,70052,Blue,1,39508,40061,553
2022-11-23,70055,70039,Blue,0,26437,27306,869
2022-03-06,70057,70053,Blue,0,53379,53534,155
2022-12-08,70045,70838,Blue,0,49113,49434,321
2022-08-31,70042,70058,Blue,1,32978,33862,884
2022-07-25,70050,70056,Blue,1,25392,25716,324
2022-04-15,70051,70047,Blue,0,62348,62546,198
2022-01-06,70038,70054,Blue,1,71946,72725,779
2022-11-08,70055,70053,Blue,0,51238,51288,50
2022-06-15,70049,70043,Blue,0,61024,61432,408
2022-06-16,70051,70047,Blue,0,57123,57326,203
2022-03-11,70055,70047,Blue,0,76833,77253,420
2022-09-20,70048,70056,Blue,1,32527,32926,399
2022-11-19,70053,70039,Blue,0,41442,42150,708
2022-08-08,70045,70043,Blue,0,65544,65660,116
2022-02-03,70059,70047,Blue,0,74353,74910,557
2022-09-05,70038,70040,Blue,1,87305,87320,15
2022-07-01,70057,70055,Blue,0,67966,68036,70
2022-12-05,70042,70048,Blue,1,81370,81675,305
2022-09-07,70047,70039,Blue,0,30889,31410,521
2022-09-23,70052,70056,Blue,1,39708,39865,157
2022-08-13,70049,70838,Blue,0,43251,43853,602
2022-07-22,70044,70058,Blue,1,75788,76585,797
2022-10-21,70044,70056,Blue,1,65172,65925,753
2022-04-19,70046,70056,Blue,1,31028,31621,593
2022-04-04,70038,70056,Blue,1,26679,27577,898
2022-05-18,70053,70041,Blue,0,84896,85750,854
2022-06-19,70042,70060,Blue,1,61437,62433,996
2022-12-26,70057,70051,Blue,0,41553,41791,238
2022-07-26,70051,70045,Blue,0,77293,77621,328
2022-01-15,70041,70838,Blue,0,73734,73858,124
2022-05-27,70047,70838,Blue,0,26188,26777,589
2022-12-04,70040,70052,Blue,1,71082,71771,689
2022-09-29,70055,70043,Blue,0,62054,62732,678
2022-12-26,70054,70056,Blue,1,41265,41315,50
2022-12-04,70046,70060,Blue,1,44598,45381,783
2022-06-26,70042,70058,Blue,1,59905,60844,939
2022-05-19,70047,70838,Blue,0,47768,48410,642
2022-03-01,70055,70049,Blue,0,19011,19338,327
2022-10-13,70038,70046,Blue,1,41571,41932,361
2022-05-31,70048,70052,Blue,1,29162,29456,294
2022-09-20,70059,70055,Blue,0,81193,81330,137
2022-11-30,70040,70042,Blue,1,45933,45966,33
2022-06-17,70053,70045,Blue,0,75861,76272,411
2022-10-12,70053,70045,Blue,0,30421,30929,508
2022-08-30,70057,70041,Blue,0,23084,24014,930
2022-11-16,70051,70049,Blue,0,21161,21265,104
2022-02-19,70041,70039,Blue,0,42069,42102,33
2022-02-05,70048,70050,Blue,1,39330,39387,57
2022-02-24,70055,70053,Blue,0,71178,71236,58
2022-10-07,70052,70058,Blue,1,28548,28810,262
2022-02-16,70038,70056,Blue,1,55959,56989,1030
2022-02-03,70059,70047,Blue,0,23994,24593,599
2022-04-30,70054,70060,Blue,1,27953,28211,258
2022-06-18,70053,70049,Blue,0,55970,56175,205
2022-01-28,70038,70048,Blue,1,46517,46983,466
2022-01-02,70049,70045,Blue,0,63029,63230,201
2022-10-31,70044,70060,Blue,1,72941,73937,996
2022-08-25,70053,70047,Blue,0,35617,35916,299
2022-09-22,70057,70838,Blue,0,28119,29262,1143
2022-01-13,70040,70054,Blue,1,56559,57498,939
2022-01-21,70059,70055,Blue,0,77776,77919,143
2022-06-11,70044,70052,Blue,1,87518,88040,522
2022-08-25,70049,70045,Blue,0,72263,72451,188
2022-09-12,70055,70045,Blue,0,34520,35026,506
2022-12-20,70046,70060,Blue,1,62280,63068,788
2022-10-18,70044,70050,Blue,1,71818,72157,339
2022-06-22,70051,70047,Blue,0,65987,66183,196
2022-01-01,70045,70039,Blue,0,50297,50537,240
2022-11-10,70054,70056,Blue,1,35717,35763,46
2022-11-20,70053,70045,Blue,0,58451,58849,398
2022-04-17,70051,70043,Blue,0,59048,59552,504
2022-02-02,70055,70838,Blue,0,22656,23727,1071
2022-08-06,70047,70043,Blue,0,42278,42540,262
2022-06-24,70042,70046,Blue,1,29893,30092,199
2022-02-28,70055,70051,Blue,0,86467,86602,135
2022-09-11,70053,70039,Blue,0,84875,85575,700
2022-11-23,70046,70050,Blue,1,76199,76383,184
2022-10-19,70055,70053,Blue,0,24750,24797,47
2022-07-19,70049,70041,Blue,0,67049,67479,430
2022-12-26,70043,70838,Blue,0,81121,81295,174
2022-03-22,70057,70051,Blue,0,21207,21550,343
2022-05-24,70042,70050,Blue,1,60509,61102,593
2022-09-19,70050,70060,Blue,1,81418,81924,506
2022-06-24,70046,70054,Blue,1,69280,69804,524
2022-04-03,70052,70056,Blue,1,41748,41881,133
2022-12-03,70053,70049,Blue,0,65149,65348,199
2022-07-04,70038,70044,Blue,1,64649,64819,170
2022-05-23,70042,70046,Blue,1,71015,71220,205
2022-11-19,70046,70050,Blue,1,30034,30211,177
2022-11-21,70042,70052,Blue,1,81502,82030,528
2022-12-01,70053,70043,Blue,0,71573,72132,559
2022-03-10,70055,70041,Blue,0,21241,22055,814
2022-11-28,70046,70054,Blue,1,77125,77522,397
2022-08-30,70057,70838,Blue,0,69205,70165,960
2022-12-21,70040,70050,Blue,1,36451,36940,489
2022-03-28,70047,70043,Blue,0,88051,88286,235
2022-02-28,70053,70049,Blue,0,39562,39826,264
2022-06-24,70053,70045,Blue,0,58923,59357,434
2022-09-21,70040,70050,Blue,1,31693,32179,486
2022-07-29,70054,70058,Blue,1,76073,76235,162
2022-08-08,70040,70060,Blue,1,67510,68622,1112
2022-04-17,70042,70048,Blue,1,51183,51500,317
2022-08-04,70056,70060,Blue,1,76082,76253,171
2022-11-03,70053,70049,Blue,0,58895,59112,217
2022-03-17,70059,70838,Blue,0,29059,30241,1182
2022-03-16,70053,70051,Blue,0,30242,30301,59
2022-02-07,70054,70056,Blue,1,24003,24055,52
2022-11-20,70058,70060,Blue,1,75908,76037,129
2022-02-20,70053,70838,Blue,0,42442,43386,944
2022-04-22,70038,70044,Blue,1,64937,65126,189
2022-10-01,70053,70047,Blue,0,71071,71368,297
2022-12-29,70050,70054,Blue,1,22065,22264,199
2022-01-10,70049,70039,Blue,0,51686,52169,483
2022-10-13,70055,70838,Blue,0,31168,32127,959
2022-08-03,70057,70041,Blue,0,23094,24030,936
2022-02-23,70054,70058,Blue,1,58935,59259,324
2022-06-13,70048,70050,Blue,1,88207,88264,57
2022-12-28,70059,70055,Blue,0,52032,52180,148
2022-01-08,70046,70056,Blue,1,58800,59316,516
2022-06-17,70050,70052,Blue,1,76602,76723,121
2022-11-20,70051,70041,Blue,0,54794,55341,547
2022-08-07,70056,70060,Blue,1,58975,59159,184
2022-01-09,70040,70046,Blue,1,57037,57313,276
2022-07-09,70046,70048,Blue,1,31101,31187,86
2022-10-09,70055,70045,Blue,0,58877,59399,522
2022-07-08,70055,70043,Blue,0,54640,55315,675
2022-10-24,70059,70041,Blue,0,79815,80724,909
2022-07-12,70057,70051,Blue,0,39255,39510,255
2022-12-26,70045,70043,Blue,0,58363,58455,92
2022-08-14,70045,70039,Blue,0,65388,65660,272
2022-09-18,70044,70046,Blue,1,32564,32675,111
2022-01-06,70046,70056,Blue,1,29405,29921,516
2022-04-19,70043,70838,Blue,0,72486,72685,199
2022-09-21,70042,70044,Blue,1,56687,56717,30
2022-01-11,70043,70041,Blue,0,30066,30096,30
2022-07-29,70040,70050,Blue,1,81185,81901,716
2022-12-18,70048,70060,Blue,1,39596,40194,598
2022-07-02,70059,70057,Blue,0,60555,60590,35
2022-07-08,70046,70050,Blue,1,84196,84377,181
2022-04-03,70059,70043,Blue,0,86412,87210,798
2022-04-26,70053,70051,Blue,0,37215,37280,65
2022-10-28,70057,70049,Blue,0,25613,26034,421
2022-12-09,70047,70041,Blue,0,48933,49221,288
2022-04-05,70048,70052,Blue,1,33441,33661,220
2022-12-08,70051,70041,Blue,0,35584,36229,645
2022-12-06,70051,70041,Blue,0,48811,49390,579
2022-07-26,70052,70054,Blue,1,54566,54653,87
2022-11-18,70055,70039,Blue,0,69326,70228,902
2022-03-27,70045,70043,Blue,0,68652,68739,87
2022-04-09,70054,70058,Blue,1,52645,52805,160
2022-08-08,70042,70048,Blue,1,70165,70449,284
2022-09-27,70052,70060,Blue,1,62110,62529,419
2022-04-04,70047,70043,Blue,0,75495,75745,250
2022-01-21,70051,70045,Blue,0,54594,54949,355
2022-05-13,70057,70051,Blue,0,23074,23339,265
2022-05-26,70040,70050,Blue,1,87752,88322,570
2022-02-22,70048,70060,Blue,1,48665,49232,567
2022-04-15,70038,70058,Blue,1,58932,59919,987
2022-04-24,70044,70060,Blue,1,34119,34957,838
2022-03-10,70040,70048,Blue,1,68001,68414,413
2022-03-23,70046,70048,Blue,1,34524,34635,111
2022-11-14,70050,70052,Blue,1,59382,59508,126
2022-01-14,70038,70060,Blue,1,49755,50797,1042
2022-02-01,70059,70045,Blue,0,29657,30488,831
2022-07-18,70038,70058,Blue,1,25213,26138,925
2022-02-17,70040,70056,Blue,1,48756,49578,822
2022-03-02,70046,70054,Blue,1,20858,21333,475
2022-08-07,70053,70039,Blue,0,43713,44484,771
2022-03-11,70056,70060,Blue,1,34591,34854,263
2022-02-25,70042,70046,Blue,1,85099,85274,175
2022-07-29,70051,70838,Blue,0,47677,48466,789
2022-08-15,70039,70838,Blue,0,23290,23327,37
2022-08-01,70042,70054,Blue,1,87615,88253,638
2022-06-11,70054,70058,Blue,1,41394,41546,152
2022-08-02,70054,70060,Blue,1,70579,70896,317
2022-01-26,70058,70060,Blue,1,22666,22808,142
2022-07-31,70045,70039,Blue,0,39649,39918,269
2022-04-18,70048,70052,Blue,1,91487,91693,206
2022-02-20,70048,70060,Blue,1,83005,83651,646
2022-07-01,70038,70040,Blue,1,40272,40289,17
2022-10-29,70055,70053,Blue,0,34301,34346,45
2022-11-23,70057,70041,Blue,0,22189,23044,855
2022-10-05,70047,70838,Blue,0,44762,45266,504
2022-06-16,70044,70058,Blue,1,58974,60303,1329
2022-03-15,70052,70060,Blue,1,57888,58341,453
2022-09-20,70051,70049,Blue,0,24211,24311,100
2022-12-26,70057,70043,Blue,0,63094,63854,760
2022-05-18,70044,70046,Blue,1,71099,71235,136
2022-10-07,70043,70041,Blue,0,35927,35955,28
2022-03-26,70046,70058,Blue,1,34884,35525,641
2022-11-17,70044,70060,Blue,1,73822,74660,838
2022-09-17,70048,70052,Blue,1,59374,59590,216
2022-08-23,70050,70060,Blue,1,61802,62386,584
2022-11-30,70046,70050,Blue,1,27259,27438,179
2022-03-04,70040,70044,Blue,1,69018,69134,116
2022-03-10,70045,70043,Blue,0,65706,65795,89
2022-04-22,70056,70058,Blue,1,39605,39681,76
2022-04-06,70055,70053,Blue,0,66091,66147,56
2022-04-09,70042,70044,Blue,1,62216,62247,31
2022-09-30,70039,70838,Blue,0,66209,66244,35
2022-04-06,70059,70057,Blue,0,57678,57715,37
2022-03-07,70055,70039,Blue,0,53785,54568,783
2022-10-13,70040,70046,Blue,1,31613,31877,264
2022-12-27,70051,70047,Blue,0,47130,47322,192
2022-07-06,70056,70058,Blue,1,48711,48781,70
2022-02-08,70055,70045,Blue,0,31745,32349,604
2022-10-28,70038,70044,Blue,1,71594,71788,194
2022-06-13,70044,70050,Blue,1,37084,37457,373
2022-10-02,70041,70039,Blue,0,57014,57047,33
2022-03-31,70055,70045,Blue,0,66978,67475,497
2022-12-22,70059,70039,Blue,0,57198,58215,1017
2022-11-16,70045,70041,Blue,0,45458,45623,165
2022-01-07,70049,70045,Blue,0,25372,25647,275
2022-10-19,70059,70041,Blue,0,68188,69153,965
2022-07-07,70046,70058,Blue,1,87767,88452,685
2022-09-02,70042,70046,Blue,1,60830,61021,191
2022-05-27,70044,70052,Blue,1,72753,73495,742
2022-02-22,70059,70051,Blue,0,61097,61408,311
2022-01-04,70049,70047,Blue,0,44417,44476,59
2022-12-14,70049,70047,Blue,0,62967,63022,55
2022-03-08,70053,70041,Blue,0,59859,60492,633
2022-07-04,70041,70039,Blue,0,32959,32993,34
2022-01-25,70047,70041,Blue,0,33819,34159,340
2022-07-09,70048,70060,Blue,1,32868,33520,652
2022-03-17,70059,70041,Blue,0,48684,49656,972
2022-01-09,70045,70838,Blue,0,63232,63557,325
2022-09-19,70050,70054,Blue,1,33330,33544,214
2022-03-03,70059,70039,Blue,0,72026,73106,1080
2022-08-30,70051,70043,Blue,0,82535,82994,459
2022-02-26,70053,70041,Blue,0,71085,71727,642
2022-04-03,70055,70039,Blue,0,72380,73184,804
2022-08-14,70041,70838,Blue,0,39157,39284,127
2022-09-26,70057,70055,Blue,0,27699,27770,71
2022-06-19,70059,70055,Blue,0,75977,76121,144
2022-01-04,70059,70047,Blue,0,63194,63719,525
2022-06-29,70040,70048,Blue,1,51858,52280,422
2022-05-27,70042,70048,Blue,1,72044,72417,373
2022-03-13,70056,70058,Blue,1,62765,62836,71
2022-02-28,70051,70041,Blue,0,77555,78128,573
2022-06-14,70050,70054,Blue,1,85959,86214,255
2022-11-05,70048,70052,Blue,1,33774,33980,206
2022-04-13,70046,70052,Blue,1,51593,51932,339
2022-09-22,70057,70043,Blue,0,44845,45665,820
2022-02-12,70047,70045,Blue,0,53074,53164,90
2022-08-29,70046,70050,Blue,1,70869,71044,175
2022-03-09,70044,70056,Blue,1,26566,27250,684
2022-01-11,70040,70046,Blue,1,43106,43379,273
2022-02-23,70059,70047,Blue,0,55102,55720,618
2022-02-13,70052,70060,Blue,1,67447,67816,369
2022-02-22,70046,70050,Blue,1,51720,51924,204
2022-07-14,70055,70053,Blue,0,78725,78773,48
2022-11-24,70038,70060,Blue,1,34688,35856,1168
2022-01-15,70047,70838,Blue,0,24076,24560,484
2022-03-24,70042,70050,Blue,1,72132,72510,378
2022-03-16,70045,70043,Blue,0,66351,66442,91
2022-03-12,70052,70054,Blue,1,38036,38094,58
2022-03-29,70055,70041,Blue,0,28359,29134,775
2022-10-30,70049,70045,Blue,0,22117,22395,278
2022-06-15,70042,70058,Blue,1,57700,58646,946
2022-10-19,70040,70044,Blue,1,53101,53208,107
2022-05-20,70053,70041,Blue,0,84885,85721,836
2022-05-15,70059,70055,Blue,0,85219,85387,168
2022-04-03,70050,70058,Blue,1,47876,48305,429
2022-10-30,70049,70041,Blue,0,26019,26449,430
2022-08-07,70056,70058,Blue,1,83309,83378,69
2022-12-19,70056,70058,Blue,1,39466,39540,74
2022-10-21,70048,70058,Blue,1,21590,22122,532
2022-06-14,70040,70058,Blue,1,82706,83774,1068
2022-07-21,70038,70050,Blue,1,72216,73046,830
2022-11-11,70040,70046,Blue,1,58102,58374,272
2022-10-15,70051,70049,Blue,0,30173,30276,103
2022-02-10,70040,70052,Blue,1,72047,72697,650
2022-11-28,70057,70049,Blue,0,65074,65469,395
2022-08-01,70057,70043,Blue,0,69747,70531,784
2022-08-18,70047,70043,Blue,0,24662,24966,304
2022-04-11,70049,70041,Blue,0,82243,82658,415
2022-04-08,70057,70043,Blue,0,71609,72399,790
2022-02-07,70059,70051,Blue,0,55508,55852,344
2022-05-30,70042,70044,Blue,1,79134,79169,35
2022-03-20,70057,70051,Blue,0,82290,82531,241
2022-11-02,70038,70056,Blue,1,23181,24070,889
2022-03-02,70040,70048,Blue,1,54889,55315,426
2022-10-30,70042,70046,Blue,1,51219,51408,189
2022-10-13,70043,70838,Blue,0,31921,32127,206
2022-04-05,70059,70053,Blue,0,81735,81963,228
2022-10-29,70042,70044,Blue,1,40608,40642,34
2022-03-03,70038,70052,Blue,1,40910,41685,775
2022-06-16,70044,70046,Blue,1,67976,68101,125
2022-09-24,70040,70052,Blue,1,51356,51984,628
2022-08-22,70057,70055,Blue,0,82503,82574,71
2022-08-22,70045,70838,Blue,0,55270,55642,372
2022-10-29,70046,70058,Blue,1,30056,30687,631
2022-08-26,70045,70041,Blue,0,49639,49825,186
2022-02-18,70044,70050,Blue,1,63961,64323,362
2022-07-24,70047,70045,Blue,0,28310,28403,93
2022-08-23,70044,70046,Blue,1,71541,71652,111
2022-04-10,70040,70056,Blue,1,57556,58449,893
2022-02-10,70050,70052,Blue,1,67021,67130,109
2022-11-09,70044,70056,Blue,1,49134,49812,678
2022-04-11,70059,70039,Blue,0,25183,26236,1053
2022-09-03,70050,70052,Blue,1,21611,21721,110
2022-12-23,70040,70056,Blue,1,66062,66988,926
2022-10-16,70057,70039,Blue,0,65257,66175,918
2022-06-14,70038,70060,Blue,1,55926,57502,1576
2022-08-09,70038,70060,Blue,1,24119,25408,1289
2022-09-11,70038,70054,Blue,1,25621,26539,918
2022-02-18,70040,70042,Blue,1,29138,29170,32
2022-10-18,70038,70054,Blue,1,44622,45402,780
2022-11-27,70048,70054,Blue,1,46600,46878,278
2022-11-16,70040,70060,Blue,1,23244,24368,1124
2022-08-04,70038,70054,Blue,1,80703,81572,869
2022-03-25,70038,70048,Blue,1,38508,39023,515
2022-03-18,70057,70055,Blue,0,71070,71138,68
2022-11-25,70051,70838,Blue,0,69014,69746,732
2022-03-18,70040,70058,Blue,1,28588,29487,899
2022-12-26,70053,70041,Blue,0,47093,47753,660
2022-02-09,70049,70041,Blue,0,60712,61193,481
2022-11-19,70049,70043,Blue,0,69097,69427,330
2022-01-05,70055,70053,Blue,0,42858,42912,54
2022-11-24,70040,70044,Blue,1,55430,55544,114
2022-01-06,70059,70047,Blue,0,61693,62282,589
2022-09-23,70044,70048,Blue,1,24746,24969,223
2022-07-04,70038,70050,Blue,1,83414,84065,651
2022-06-22,70044,70058,Blue,1,63880,64783,903
2022-07-02,70044,70054,Blue,1,60670,61363,693
2022-09-07,70049,70045,Blue,0,54177,54416,239
2022-08-21,70040,70050,Blue,1,82430,82944,514
2022-01-04,70048,70050,Blue,1,30127,30182,55
2022-12-20,70040,70058,Blue,1,25696,26559,863
2022-01-01,70054,70058,Blue,1,84005,84172,167
2022-09-16,70052,70060,Blue,1,50955,51327,372
2022-06-30,70046,70058,Blue,1,74564,75209,645
2022-01-11,70046,70050,Blue,1,68979,69157,178
2022-02-06,70052,70054,Blue,1,69570,69614,44
2022-02-11,70044,70060,Blue,1,71333,72203,870
2022-04-28,70050,70058,Blue,1,60224,60672,448
2022-03-15,70055,70043,Blue,0,29540,30361,821
2022-11-22,70045,70838,Blue,0,26219,26594,375
2022-06-21,70046,70056,Blue,1,55253,55800,547
2022-09-19,70055,70045,Blue,0,66203,66712,509
2022-01-22,70044,70054,Blue,1,61832,62472,640
2022-12-20,70057,70039,Blue,0,81276,82221,945
2022-12-21,70047,70039,Blue,0,24179,24573,394
2022-12-10,70042,70052,Blue,1,76772,77367,595
2022-06-22,70048,70060,Blue,1,53277,53915,638
2022-06-22,70038,70050,Blue,1,85582,86170,588
2022-07-11,70046,70054,Blue,1,66279,66713,434
2022-02-10,70038,70046,Blue,1,58685,59032,347
2022-01-03,70059,70039,Blue,0,74024,75031,1007
2022-09-02,70045,70838,Blue,0,83303,83657,354
2022-02-03,70044,70052,Blue,1,33800,34304,504
2022-03-09,70059,70039,Blue,0,68468,69463,995
2022-05-20,70042,70052,Blue,1,78456,79089,633
2022-03-29,70051,70049,Blue,0,32476,32585,109
2022-12-30,70059,70838,Blue,0,59719,60833,1114
2022-09-27,70042,70060,Blue,1,35778,36704,926
2022-06-07,70047,70838,Blue,0,27599,28156,557
2022-01-16,70059,70045,Blue,0,45361,46133,772
2022-08-08,70044,70060,Blue,1,26278,27220,942
2022-02-07,70052,70056,Blue,1,53243,53376,133
2022-02-22,70059,70051,Blue,0,28156,28480,324
2022-07-14,70053,70049,Blue,0,51310,51517,207
2022-04-02,70044,70050,Blue,1,61767,62100,333
2022-07-23,70049,70838,Blue,0,47036,47643,607
2022-01-07,70057,70049,Blue,0,62681,63116,435
2022-02-01,70043,70041,Blue,0,31316,31348,32
2022-01-13,70051,70043,Blue,0,71924,72434,510
2022-02-22,70048,70056,Blue,1,60395,60788,393
2022-01-13,70038,70044,Blue,1,29112,29274,162
2022-05-27,70043,70041,Blue,0,88333,88361,28
2022-12-13,70048,70052,Blue,1,42629,42890,261
2022-11-11,70054,70056,Blue,1,37972,38020,48
2022-05-24,70042,70048,Blue,1,83580,83944,364
2022-05-31,70049,70838,Blue,0,43418,44077,659
2022-01-22,70042,70044,Blue,1,74706,74735,29
2022-08-03,70055,70043,Blue,0,53709,54371,662
2022-08-02,70044,70046,Blue,1,48897,49001,104
2022-01-31,70038,70052,Blue,1,30733,31607,874
2022-03-15,70046,70058,Blue,1,60850,61598,748
2022-11-07,70057,70045,Blue,0,63854,64537,683
2022-04-19,70059,70047,Blue,0,53597,54163,566
2022-02-11,70051,70043,Blue,0,56419,56948,529
2022-08-03,70050,70060,Blue,1,65036,65564,528
2022-12-19,70050,70056,Blue,1,32132,32498,366
2022-04-24,70054,70056,Blue,1,75617,75665,48
2022-10-12,70059,70039,Blue,0,36527,37551,1024
2022-07-29,70051,70047,Blue,0,24229,24417,188
2022-01-02,70057,70055,Blue,0,43537,43606,69
2022-12-11,70044,70050,Blue,1,37904,38245,341
2022-10-12,70046,70056,Blue,1,69351,69843,492
2022-12-28,70052,70054,Blue,1,76552,76600,48
2022-07-25,70047,70039,Blue,0,62457,62886,429
2022-12-02,70048,70060,Blue,1,74656,75253,597
2022-09-12,70057,70041,Blue,0,27698,28564,866
2022-04-02,70040,70056,Blue,1,25698,26545,847
2022-12-19,70047,70045,Blue,0,36394,36491,97
2022-10-04,70057,70043,Blue,0,66639,67424,785
2022-09-04,70051,70043,Blue,0,54022,54535,513
2022-08-08,70048,70058,Blue,1,29464,29980,516
2022-10-19,70055,70047,Blue,0,49587,49956,369
2022-09-10,70059,70041,Blue,0,22147,23026,879
2022-03-08,70053,70045,Blue,0,76319,76762,443
2022-03-07,70053,70041,Blue,0,36172,36868,696
2022-08-17,70043,70041,Blue,0,46954,46985,31
2022-04-05,70049,70041,Blue,0,23558,24003,445
2022-03-03,70044,70056,Blue,1,44489,45203,714
2022-02-08,70055,70053,Blue,0,65602,65672,70
2022-08-03,70046,70058,Blue,1,81831,82436,605
2022-11-08,70048,70050,Blue,1,28352,28409,57
2022-08-06,70057,70043,Blue,0,52533,53297,764
2022-11-23,70043,70039,Blue,0,30173,30286,113
2022-12-08,70038,70048,Blue,1,71595,72049,454
2022-02-20,70057,70041,Blue,0,59851,60729,878
2022-01-31,70055,70049,Blue,0,72266,72600,334
2022-11-14,70059,70039,Blue,0,35241,36305,1064
2022-10-17,70052,70054,Blue,1,38030,38088,58
2022-01-05,70057,70039,Blue,0,88175,89277,1102
2022-12-21,70051,70047,Blue,0,69335,69523,188
2022-10-31,70046,70050,Blue,1,37098,37266,168
2022-03-21,70059,70043,Blue,0,27264,28209,945
2022-07-28,70047,70838,Blue,0,62440,62957,517
2022-06-23,70044,70056,Blue,1,28014,28825,811
2022-06-09,70051,70838,Blue,0,82119,82959,840
2022-03-03,70058,70060,Blue,1,68350,68475,125
2022-06-17,70044,70058,Blue,1,25953,26776,823
2022-08-23,70057,70039,Blue,0,75514,76383,869
2022-11-03,70048,70060,Blue,1,52840,53457,617
2022-02-22,70053,70049,Blue,0,43020,43249,229
2022-04-05,70038,70048,Blue,1,24856,25325,469
2022-07-26,70048,70056,Blue,1,62883,63309,426
2022-10-14,70042,70046,Blue,1,21508,21696,188
2022-06-30,70038,70058,Blue,1,64075,65192,1117
2022-06-27,70057,70053,Blue,0,62255,62409,154
2022-02-21,70045,70039,Blue,0,80670,80940,270
2022-08-11,70044,70052,Blue,1,72854,73340,486
2022-04-26,70059,70057,Blue,0,33084,33119,35
2022-08-11,70053,70049,Blue,0,79523,79712,189
2022-09-27,70057,70049,Blue,0,39767,40264,497
2022-12-03,70053,70047,Blue,0,82608,82910,302
2022-06-27,70057,70838,Blue,0,35321,36439,1118
2022-05-18,70040,70054,Blue,1,33610,34526,916
2022-06-15,70056,70060,Blue,1,47379,47561,182
2022-06-19,70051,70039,Blue,0,62724,63416,692
2022-02-21,70042,70060,Blue,1,22503,23494,991
2022-08-08,70054,70058,Blue,1,40455,40620,165
2022-04-01,70046,70060,Blue,1,68417,69272,855
2022-12-06,70057,70053,Blue,0,70802,70952,150
2022-07-22,70055,70053,Blue,0,66839,66885,46
2022-12-16,70052,70060,Blue,1,35838,36191,353
2022-04-23,70059,70055,Blue,0,46545,46697,152
2022-07-27,70044,70052,Blue,1,67248,67756,508
2022-08-05,70040,70042,Blue,1,62688,62717,29
2022-12-30,70055,70039,Blue,0,57808,58623,815
2022-06-28,70055,70049,Blue,0,70487,70774,287
2022-09-06,70051,70039,Blue,0,23405,24085,680
2022-12-26,70042,70044,Blue,1,32485,32515,30
2022-07-01,70045,70043,Blue,0,40978,41079,101
2022-09-30,70042,70058,Blue,1,86710,87584,874
2022-08-23,70045,70039,Blue,0,28313,28587,274
2022-02-07,70043,70039,Blue,0,53930,54039,109
2022-12-17,70053,70039,Blue,0,47341,48124,783
2022-09-11,70050,70056,Blue,1,49458,49751,293
2022-09-08,70040,70060,Blue,1,21879,22893,1014
2022-12-22,70048,70058,Blue,1,52218,52713,495
2022-08-29,70044,70050,Blue,1,21450,21807,357
2022-07-25,70058,70060,Blue,1,72186,72253,67
2022-09-26,70040,70048,Blue,1,33257,33668,411
2022-12-15,70050,70052,Blue,1,33026,33144,118
2022-04-14,70049,70041,Blue,0,82839,83236,397
2022-11-23,70057,70039,Blue,0,54680,55595,915
2022-11-03,70059,70055,Blue,0,62673,62819,146
2022-01-27,70050,70056,Blue,1,35119,35483,364
2022-10-24,70038,70050,Blue,1,47112,47649,537
2022-03-30,70055,70043,Blue,0,57074,57745,671
2022-12-03,70038,70046,Blue,1,67452,67756,304
2022-09-23,70043,70041,Blue,0,20912,20942,30
2022-02-04,70054,70056,Blue,1,30313,30363,50
2022-12-01,70048,70058,Blue,1,47226,47732,506
2022-10-20,70055,70049,Blue,0,78850,79126,276
2022-01-28,70038,70056,Blue,1,73507,74346,839
2022-10-01,70049,70045,Blue,0,31911,32098,187
2022-03-24,70038,70040,Blue,1,46940,46960,20
2022-04-07,70048,70056,Blue,1,31976,32409,433
2022-04-24,70049,70041,Blue,0,48947,49383,436
2022-07-04,70040,70056,Blue,1,81974,82814,840
2022-02-08,70042,70050,Blue,1,20961,21353,392
2022-04-29,70057,70055,Blue,0,58176,58245,69
2022-08-02,70055,70053,Blue,0,61045,61090,45
2022-02-19,70049,70838,Blue,0,35792,36413,621
2022-05-29,70040,70046,Blue,1,39971,40284,313
2022-09-26,70048,70056,Blue,1,28779,29175,396
2022-07-14,70052,70060,Blue,1,47443,47829,386
2022-03-15,70056,70058,Blue,1,31364,31440,76
2022-08-15,70051,70049,Blue,0,45704,45817,113
2022-10-19,70038,70056,Blue,1,59909,60791,882
2022-09-14,70038,70048,Blue,1,66077,66570,493
2022-05-04,70055,70053,Blue,0,53656,53702,46
2022-08-01,70059,70051,Blue,0,54617,54924,307
2022-10-10,70050,70056,Blue,1,73404,73710,306
2022-10-16,70057,70055,Blue,0,72265,72332,67
2022-09-08,70050,70054,Blue,1,40186,40406,220
2022-07-03,70049,70039,Blue,0,61920,62444,524
2022-02-15,70055,70838,Blue,0,29183,30199,1016
2022-07-01,70055,70047,Blue,0,35074,35534,460
2022-02-01,70038,70058,Blue,1,36733,37760,1027
2022-11-13,70048,70054,Blue,1,34368,34660,292
2022-09-27,70050,70056,Blue,1,27171,27489,318
2022-01-23,70049,70041,Blue,0,26929,27378,449
2022-09-19,70049,70041,Blue,0,29151,29704,553
2022-07-14,70047,70043,Blue,0,55428,55737,309
2022-11-20,70042,70054,Blue,1,37833,38480,647
2022-04-10,70046,70058,Blue,1,72947,73543,596
2022-02-14,70055,70838,Blue,0,49974,51060,1086
2022-07-07,70059,70055,Blue,0,36374,36520,146
2022-08-17,70049,70041,Blue,0,66494,66937,443
2022-09-30,70045,70039,Blue,0,73628,73937,309
2022-05-20,70048,70060,Blue,1,54266,55243,977
2022-05-05,70058,70060,Blue,1,25944,26009,65
2022-01-10,70040,70048,Blue,1,60207,60662,455
2022-12-25,70042,70046,Blue,1,50065,50246,181
2022-08-28,70059,70055,Blue,0,72735,72882,147
2022-12-20,70057,70041,Blue,0,37842,38845,1003
2022-03-09,70044,70056,Blue,1,82279,83027,748
2022-12-27,70038,70052,Blue,1,58486,59220,734
2022-10-05,70051,70041,Blue,0,24882,25480,598
2022-12-11,70057,70039,Blue,0,52284,53179,895
2022-09-29,70053,70039,Blue,0,74642,75548,906
2022-04-13,70049,70838,Blue,0,72056,72639,583
2022-01-17,70046,70050,Blue,1,79659,79839,180
2022-03-06,70040,70054,Blue,1,32459,33293,834
2022-09-10,70049,70041,Blue,0,46484,46926,442
2022-03-22,70048,70050,Blue,1,38053,38115,62
2022-10-17,70044,70060,Blue,1,47317,48176,859
2022-08-16,70059,70057,Blue,0,19935,19970,35
2022-12-03,70059,70838,Blue,0,44923,46067,1144
2022-03-02,70044,70056,Blue,1,79519,80278,759
2022-10-22,70038,70050,Blue,1,65831,66402,571
2022-01-08,70059,70055,Blue,0,35172,35316,144
2022-12-08,70042,70056,Blue,1,53646,54439,793
2022-01-17,70049,70043,Blue,0,28717,29106,389
2022-09-16,70038,70060,Blue,1,21401,22572,1171
2022-02-24,70059,70838,Blue,0,69497,70712,1215
2022-04-04,70045,70039,Blue,0,49434,49680,246
2022-12-08,70048,70056,Blue,1,52328,52716,388
2022-02-15,70059,70043,Blue,0,20960,21976,1016
2022-02-22,70055,70043,Blue,0,71707,72467,760
2022-07-04,70055,70043,Blue,0,49491,50233,742
2022-06-11,70046,70050,Blue,1,58275,58459,184
2022-10-14,70042,70060,Blue,1,80787,81765,978
2022-09-29,70049,70041,Blue,0,37522,38017,495
2022-07-01,70054,70056,Blue,1,33911,33958,47
2022-08-29,70053,70838,Blue,0,79270,80119,849
2022-10-05,70038,70048,Blue,1,69603,70109,506
2022-03-02,70040,70050,Blue,1,50861,51399,538
2022-01-26,70054,70056,Blue,1,82846,82892,46
2022-12-07,70056,70060,Blue,1,57598,57849,251
2022-11-04,70059,70055,Blue,0,28675,28821,146
2022-08-10,70055,70041,Blue,0,25305,26121,816
2022-10-07,70056,70060,Blue,1,67162,67339,177
2022-06-23,70053,70039,Blue,0,39040,39972,932
2022-02-23,70041,70838,Blue,0,23232,23369,137
2022-03-03,70042,70046,Blue,1,87866,88039,173
2022-03-16,70047,70045,Blue,0,34848,34959,111
2022-03-10,70059,70051,Blue,0,58395,58705,310
2022-10-21,70056,70058,Blue,1,40118,40188,70
2022-05-08,70057,70055,Blue,0,85995,86073,78
2022-02-20,70053,70049,Blue,0,84038,84246,208
2022-03-26,70053,70838,Blue,0,32204,33078,874
2022-12-17,70057,70838,Blue,0,65500,66552,1052
2022-12-21,70051,70838,Blue,0,74172,74880,708
2022-02-21,70047,70041,Blue,0,45045,45444,399
2022-06-28,70042,70050,Blue,1,26209,26657,448
2022-09-16,70040,70058,Blue,1,53130,54142,1012
2022-04-10,70042,70058,Blue,1,66333,67244,911
2022-01-04,70048,70052,Blue,1,30457,30668,211
2022-12-21,70053,70045,Blue,0,60355,60783,428
2022-10-08,70043,70838,Blue,0,32328,32532,204
2022-12-25,70048,70056,Blue,1,74781,75195,414
2022-11-18,70059,70043,Blue,0,59603,60897,1294
2022-07-26,70055,70053,Blue,0,31634,31686,52
2022-03-31,70047,70045,Blue,0,54796,54901,105
2022-09-26,70046,70060,Blue,1,49070,49805,735
2022-06-26,70045,70041,Blue,0,37700,37895,195
2022-10-12,70042,70048,Blue,1,86657,86950,293
2022-06-18,70058,70060,Blue,1,51331,51409,78
2022-05-08,70053,70047,Blue,0,68689,69089,400
2022-11-13,70057,70045,Blue,0,38257,38863,606
2022-05-20,70059,70057,Blue,0,76044,76079,35
2022-02-14,70039,70838,Blue,0,28937,28978,41
2022-11-18,70051,70039,Blue,0,33375,34009,634
2022-06-29,70057,70039,Blue,0,55592,56560,968
2022-03-09,70059,70838,Blue,0,19513,20796,1283
2022-10-24,70055,70049,Blue,0,42812,43126,314
2022-03-07,70038,70048,Blue,1,33547,33980,433
2022-09-11,70044,70060,Blue,1,88430,89264,834
2022-09-14,70048,70052,Blue,1,28424,28680,256
2022-10-29,70038,70044,Blue,1,59892,60075,183
2022-12-05,70047,70838,Blue,0,62173,62698,525
2022-03-10,70057,70047,Blue,0,41626,42093,467
2022-12-28,70058,70060,Blue,1,21527,21645,118
2022-03-10,70044,70060,Blue,1,26653,27562,909
2022-12-03,70055,70047,Blue,0,39152,39563,411
2022-09-30,70041,70039,Blue,0,35604,35641,37
2022-09-30,70042,70044,Blue,1,59265,59293,28
2022-09-20,70038,70040,Blue,1,81338,81354,16
2022-06-10,70056,70060,Blue,1,40599,40916,317
2022-10-25,70049,70043,Blue,0,83430,83777,347
2022-02-11,70057,70043,Blue,0,26157,26988,831
2022-10-09,70049,70047,Blue,0,38709,38762,53
2022-07-12,70044,70048,Blue,1,22240,22522,282
2022-05-03,70056,70060,Blue,1,63551,63727,176
2022-07-21,70059,70055,Blue,0,87005,87195,190
2022-07-22,70051,70043,Blue,0,83883,84390,507
2022-05-18,70040,70054,Blue,1,73831,74621,790
2022-11-17,70038,70054,Blue,1,27190,28013,823
2022-06-28,70042,70058,Blue,1,75547,76534,987
2022-09-13,70042,70050,Blue,1,69144,69540,396
2022-04-01,70047,70838,Blue,0,67192,67686,494
2022-08-03,70040,70050,Blue,1,49359,49896,537
2022-11-14,70052,70058,Blue,1,45418,45676,258
2022-03-02,70045,70043,Blue,0,73414,73508,94
2022-08-24,70040,70056,Blue,1,80041,80935,894
2022-08-24,70042,70048,Blue,1,25038,25338,300
2022-01-27,70053,70051,Blue,0,46389,46452,63
2022-05-23,70047,70041,Blue,0,32516,32970,454
2022-08-13,70038,70044,Blue,1,84679,84903,224
2022-12-30,70040,70048,Blue,1,54681,55077,396
2022-03-24,70051,70039,Blue,0,50107,50752,645
2022-01-03,70045,70041,Blue,0,38961,39121,160
2022-03-09,70050,70060,Blue,1,86673,87220,547
2022-05-24,70042,70050,Blue,1,56169,56639,470
2022-05-13,70057,70051,Blue,0,72014,72266,252
2022-11-21,70051,70838,Blue,0,27078,27939,861
2022-08-05,70042,70048,Blue,1,22375,22680,305
2022-04-10,70059,70045,Blue,0,48979,49745,766
2022-04-06,70054,70060,Blue,1,65152,65519,367
2022-05-25,70045,70039,Blue,0,37051,37353,302
2022-06-22,70055,70049,Blue,0,87605,87869,264
2022-07-26,70047,70838,Blue,0,24812,25429,617
2022-02-21,70059,70043,Blue,0,28161,29065,904
2022-03-17,70057,70055,Blue,0,32734,32803,69
2022-05-29,70038,70050,Blue,1,75315,75976,661
2022-09-09,70040,70054,Blue,1,21528,22367,839
2022-03-07,70040,70056,Blue,1,79299,80139,840
2022-01-13,70051,70049,Blue,0,88501,88605,104
2022-11-11,70040,70060,Blue,1,21848,22906,1058
2022-07-03,70057,70045,Blue,0,86493,87338,845
2022-03-10,70038,70040,Blue,1,28781,28797,16
2022-08-19,70055,70041,Blue,0,48688,49474,786
2022-08-06,70046,70056,Blue,1,45172,45669,497
2022-08-03,70040,70058,Blue,1,35535,36484,949
2022-04-08,70052,70060,Blue,1,36280,36733,453
2022-06-24,70040,70048,Blue,1,43204,43658,454
2022-08-03,70040,70052,Blue,1,32091,32814,723
2022-07-23,70050,70058,Blue,1,71030,71454,424
2022-02-07,70040,70058,Blue,1,68294,69218,924
2022-12-18,70057,70045,Blue,0,85612,86245,633
2022-09-29,70054,70056,Blue,1,49198,49246,48
2022-02-08,70042,70060,Blue,1,68814,69785,971
2022-04-19,70042,70056,Blue,1,54953,55747,794
2022-05-20,70059,70051,Blue,0,63199,63510,311
2022-09-10,70042,70058,Blue,1,27074,27863,789
2022-01-26,70044,70048,Blue,1,20998,21266,268
2022-03-16,70059,70051,Blue,0,59306,59633,327
2022-02-04,70040,70044,Blue,1,70758,70883,125
2022-04-24,70040,70060,Blue,1,63003,64119,1116
2022-08-19,70048,70058,Blue,1,69017,69637,620
2022-02-02,70059,70057,Blue,0,75491,75526,35
2022-05-21,70042,70052,Blue,1,35248,35842,594
2022-06-09,70057,70053,Blue,0,33652,33827,175
2022-07-07,70050,70060,Blue,1,36526,37073,547
2022-06-13,70042,70054,Blue,1,53876,54561,685
2022-12-21,70057,70055,Blue,0,70331,70400,69
2022-02-09,70047,70039,Blue,0,47202,47602,400
2022-12-25,70047,70838,Blue,0,69050,69524,474
2022-08-25,70040,70044,Blue,1,25765,25871,106
2022-04-19,70040,70046,Blue,1,56290,56550,260
2022-07-26,70053,70043,Blue,0,52361,52994,633
2022-09-17,70039,70838,Blue,0,33531,33567,36
2022-12-18,70050,70060,Blue,1,57521,58022,501
2022-01-24,70057,70039,Blue,0,64164,65137,973
2022-07-17,70052,70058,Blue,1,37751,37996,245
2022-03-16,70046,70058,Blue,1,37768,38447,679
2022-02-21,70052,70054,Blue,1,24391,24447,56
2022-03-13,70044,70056,Blue,1,28651,29289,638
2022-03-26,70059,70838,Blue,0,80569,81664,1095
2022-08-13,70052,70054,Blue,1,37504,37568,64
2022-01-23,70057,70051,Blue,0,60461,60719,258
2022-03-04,70049,70041,Blue,0,62549,63047,498
2022-09-01,70038,70050,Blue,1,64281,64877,596
2022-01-18,70053,70039,Blue,0,82710,83400,690
2022-07-10,70051,70041,Blue,0,66055,66631,576
2022-03-21,70051,70039,Blue,0,42424,43088,664
2022-11-26,70040,70054,Blue,1,76698,77448,750
2022-07-18,70056,70058,Blue,1,68750,68871,121
2022-02-12,70049,70039,Blue,0,82117,82655,538
2022-09-24,70053,70045,Blue,0,85117,85553,436
2022-01-03,70055,70039,Blue,0,76795,77626,831
2022-04-09,70042,70044,Blue,1,88356,88381,25
2022-04-25,70050,70060,Blue,1,48255,48741,486
2022-01-28,70038,70058,Blue,1,63732,64711,979
2022-09-25,70049,70045,Blue,0,45663,45876,213
2022-11-30,70053,70047,Blue,0,68400,68698,298
2022-03-29,70045,70043,Blue,0,19826,19913,87
2022-08-09,70044,70060,Blue,1,86845,87777,932
2022-11-04,70048,70056,Blue,1,48067,48475,408
2022-06-12,70050,70052,Blue,1,85238,85352,114
2022-03-08,70056,70058,Blue,1,43836,43910,74
2022-04-13,70051,70838,Blue,0,74694,75448,754
2022-06-18,70048,70052,Blue,1,70126,70329,203
2022-11-04,70049,70045,Blue,0,33542,33750,208
2022-10-17,70050,70060,Blue,1,33827,34407,580
2022-09-07,70051,70039,Blue,0,54010,54754,744
2022-09-12,70054,70060,Blue,1,44425,44683,258
2022-09-01,70043,70838,Blue,0,20917,21133,216
2022-03-12,70047,70838,Blue,0,62747,63209,462
2022-12-13,70055,70053,Blue,0,27281,27327,46
2022-08-31,70040,70042,Blue,1,38107,38137,30
2022-11-01,70054,70060,Blue,1,52268,52550,282
2022-07-13,70057,70049,Blue,0,47252,47648,396
2022-09-28,70054,70056,Blue,1,49130,49178,48
2022-06-09,70042,70050,Blue,1,78853,79322,469
2022-07-06,70051,70838,Blue,0,30142,30975,833
2022-11-16,70057,70049,Blue,0,30934,31317,383
2022-11-18,70055,70045,Blue,0,65494,66056,562
2022-06-15,70042,70060,Blue,1,32203,33264,1061
2022-10-15,70042,70052,Blue,1,38415,38985,570
2022-08-09,70038,70040,Blue,1,27424,27441,17
2022-10-31,70042,70056,Blue,1,76899,77674,775
2022-10-15,70057,70045,Blue,0,46109,46721,612
2022-03-01,70056,70060,Blue,1,35528,35724,196
2022-12-14,70046,70060,Blue,1,70847,71525,678
2022-12-28,70038,70050,Blue,1,85224,85799,575
2022-03-24,70055,70041,Blue,0,57973,58685,712
2022-05-07,70058,70060,Blue,1,26851,26910,59
2022-05-05,70057,70051,Blue,0,48386,48629,243
2022-10-04,70045,70043,Blue,0,84509,84597,88
2022-02-07,70059,70053,Blue,0,29060,29323,263
2022-09-07,70053,70047,Blue,0,65266,65561,295
2022-09-01,70046,70052,Blue,1,74651,74994,343
2022-09-08,70050,70060,Blue,1,87932,88424,492
2022-07-16,70042,70060,Blue,1,25124,26007,883
2022-05-19,70053,70838,Blue,0,41296,42404,1108
2022-10-25,70057,70051,Blue,0,80036,80285,249
2022-01-01,70045,70043,Blue,0,67603,67693,90
2022-04-12,70052,70058,Blue,1,82819,83062,243
2022-12-04,70052,70054,Blue,1,83719,83766,47
2022-01-13,70042,70046,Blue,1,75937,76122,185
2022-12-27,70059,70055,Blue,0,44172,44315,143
2022-08-31,70045,70043,Blue,0,52256,52349,93
2022-06-16,70040,70044,Blue,1,58799,58926,127
2022-02-02,70042,70058,Blue,1,66393,67432,1039
2022-02-16,70053,70047,Blue,0,64392,64688,296
2022-11-30,70047,70838,Blue,0,68165,68631,466
2022-01-07,70057,70043,Blue,0,85235,86058,823
2022-05-20,70045,70039,Blue,0,68722,68996,274
2022-12-03,70048,70060,Blue,1,31715,32288,573
2022-05-26,70038,70052,Blue,1,28637,29488,851
2022-02-24,70042,70056,Blue,1,26797,27570,773
2022-04-09,70055,70049,Blue,0,32656,32930,274
2022-01-28,70057,70049,Blue,0,43903,44356,453
2022-11-07,70048,70060,Blue,1,21608,22279,671
2022-09-27,70038,70058,Blue,1,83635,84697,1062
2022-01-20,70045,70838,Blue,0,56192,56633,441
2022-01-05,70042,70050,Blue,1,75330,75738,408
2022-04-20,70040,70044,Blue,1,65928,66047,119
2022-02-14,70040,70056,Blue,1,62884,63750,866
2022-05-21,70056,70060,Blue,1,36065,36239,174
2022-09-03,70045,70838,Blue,0,78535,78898,363
2022-05-27,70049,70041,Blue,0,28514,29017,503
2022-07-05,70042,70046,Blue,1,49357,49539,182
2022-11-18,70048,70058,Blue,1,26564,27063,499
2022-10-01,70049,70045,Blue,0,86193,86392,199
2022-01-02,70042,70056,Blue,1,72199,72878,679
2022-05-17,70050,70058,Blue,1,59812,60268,456
2022-07-01,70038,70046,Blue,1,26653,27010,357
2022-02-05,70058,70060,Blue,1,67972,68047,75
2022-08-28,70051,70045,Blue,0,52055,52374,319
2022-10-18,70056,70060,Blue,1,86649,86831,182
2022-10-29,70038,70060,Blue,1,24972,26066,1094
2022-08-29,70048,70050,Blue,1,30083,30142,59
2022-11-25,70038,70050,Blue,1,47681,48223,542
2022-01-07,70040,70046,Blue,1,62321,62596,275
2022-07-10,70049,70041,Blue,0,65319,65810,491
2022-04-19,70057,70051,Blue,0,36508,36752,244
2022-02-20,70057,70838,Blue,0,59851,60888,1037
2022-06-03,70045,70043,Blue,0,50252,50380,128
2022-10-29,70057,70055,Blue,0,74671,74739,68
2022-10-15,70047,70838,Blue,0,40652,41174,522
2022-12-31,70057,70043,Blue,0,63933,64745,812
2022-04-09,70050,70058,Blue,1,56728,57131,403
2022-01-16,70053,70838,Blue,0,66006,66866,860
2022-07-25,70044,70052,Blue,1,91185,91689,504
2022-07-20,70040,70060,Blue,1,24584,25715,1131
2022-10-08,70052,70060,Blue,1,30873,31214,341
2022-08-17,70042,70054,Blue,1,57222,57922,700
2022-04-06,70047,70838,Blue,0,21275,21798,523
2022-04-11,70050,70054,Blue,1,25186,25398,212
2022-04-04,70050,70060,Blue,1,21414,22001,587
2022-06-08,70049,70838,Blue,0,82327,82972,645
2022-08-06,70044,70058,Blue,1,32565,33495,930
2022-09-27,70051,70838,Blue,0,76862,77576,714
2022-01-19,70046,70060,Blue,1,25308,26140,832
2022-04-22,70041,70039,Blue,0,26357,26400,43
2022-09-19,70051,70049,Blue,0,69686,69785,99
2022-08-10,70042,70052,Blue,1,89239,89759,520
2022-04-11,70048,70058,Blue,1,62484,62990,506
2022-10-22,70052,70060,Blue,1,66584,66923,339
2022-11-29,70053,70838,Blue,0,27784,28689,905
2022-06-14,70040,70058,Blue,1,63810,64826,1016
2022-11-08,70055,70838,Blue,0,20538,21414,876
2022-06-15,70043,70039,Blue,0,65039,65156,117
2022-08-11,70047,70045,Blue,0,77549,77637,88
2022-10-19,70038,70056,Blue,1,37353,38330,977
2022-01-27,70049,70045,Blue,0,72051,72252,201
2022-02-26,70051,70838,Blue,0,72821,73508,687
2022-09-11,70038,70058,Blue,1,80356,81429,1073
2022-09-30,70059,70043,Blue,0,31399,32288,889
2022-04-21,70040,70058,Blue,1,65624,66621,997
2022-05-21,70049,70039,Blue,0,43781,44438,657
2022-05-02,70052,70058,Blue,1,37005,37278,273
2022-11-22,70059,70047,Blue,0,56922,57443,521
2022-09-11,70051,70045,Blue,0,60172,60497,325
2022-03-03,70040,70050,Blue,1,73045,73637,592
2022-01-14,70056,70058,Blue,1,63502,63577,75
2022-08-14,70045,70838,Blue,0,49741,50096,355
2022-04-20,70059,70057,Blue,0,21672,21707,35
2022-03-11,70040,70054,Blue,1,52808,53502,694
2022-01-21,70059,70055,Blue,0,62417,62560,143
2022-02-17,70059,70057,Blue,0,31152,31189,37
2022-01-31,70038,70050,Blue,1,52570,53195,625
2022-02-01,70048,70050,Blue,1,27850,27913,63
2022-07-28,70038,70042,Blue,1,56203,56334,131
2022-08-23,70042,70044,Blue,1,53839,53868,29
2022-03-25,70053,70039,Blue,0,48941,49670,729
2022-01-15,70046,70058,Blue,1,86021,86676,655
2022-05-12,70056,70058,Blue,1,47229,47299,70
2022-03-04,70040,70054,Blue,1,60494,61211,717
2022-11-16,70050,70054,Blue,1,46127,46332,205
2022-10-18,70053,70045,Blue,0,54187,54689,502
2022-01-30,70041,70838,Blue,0,86146,86294,148
2022-07-08,70053,70049,Blue,0,86920,87109,189
2022-07-09,70051,70838,Blue,0,74434,75170,736
2022-06-24,70038,70044,Blue,1,51384,51596,212
2022-02-09,70046,70052,Blue,1,61705,62022,317
2022-11-19,70050,70060,Blue,1,28669,29228,559
2022-12-12,70047,70041,Blue,0,29910,30238,328
2022-09-14,70053,70051,Blue,0,56946,57006,60
2022-01-24,70054,70056,Blue,1,28863,28910,47
2022-07-10,70055,70041,Blue,0,42411,43153,742
2022-06-25,70049,70047,Blue,0,87037,87090,53
2022-09-12,70056,70058,Blue,1,44514,44585,71
2022-11-20,70057,70055,Blue,0,25425,25496,71
2022-01-13,70055,70043,Blue,0,55280,55932,652
2022-09-27,70042,70046,Blue,1,40637,40830,193
2022-10-11,70047,70041,Blue,0,79825,80128,303
2022-04-05,70052,70054,Blue,1,74804,74863,59
2022-04-22,70055,70049,Blue,0,54070,54342,272
2022-04-02,70046,70048,Blue,1,40356,40444,88
2022-01-06,70042,70056,Blue,1,25031,25786,755
2022-02-12,70050,70060,Blue,1,29150,29648,498
2022-04-23,70042,70052,Blue,1,51980,52591,611
2022-12-08,70042,70052,Blue,1,62553,63206,653
2022-12-07,70049,70041,Blue,0,82602,83008,406
2022-07-03,70043,70041,Blue,0,31003,31031,28
2022-09-12,70038,70050,Blue,1,57734,58352,618
2022-05-17,70059,70053,Blue,0,27613,27843,230
2022-01-07,70054,70060,Blue,1,61300,61764,464
2022-01-05,70059,70047,Blue,0,63498,64115,617
2022-02-24,70050,70054,Blue,1,49316,49556,240
2022-03-09,70055,70039,Blue,0,79077,79923,846
2022-06-17,70038,70040,Blue,1,70619,70634,15
2022-12-13,70045,70039,Blue,0,80766,81003,237
2022-01-28,70041,70039,Blue,0,62047,62083,36
2022-03-12,70052,70058,Blue,1,59579,59826,247
2022-11-22,70040,70044,Blue,1,50868,50995,127
2022-02-25,70053,70045,Blue,0,28172,28645,473
2022-03-07,70054,70058,Blue,1,45464,45619,155
2022-08-19,70042,70054,Blue,1,49425,50476,1051
2022-09-16,70050,70058,Blue,1,37085,37547,462
2022-01-27,70055,70838,Blue,0,60072,61039,967
2022-12-15,70039,70838,Blue,0,26608,26649,41
2022-06-13,70038,70060,Blue,1,43820,45020,1200
2022-09-15,70053,70045,Blue,0,73819,74610,791
2022-02-14,70042,70046,Blue,1,43713,43905,192
2022-03-18,70053,70838,Blue,0,86547,87305,758
2022-10-26,70052,70058,Blue,1,47378,47613,235
2022-04-18,70055,70045,Blue,0,63975,64484,509
2022-08-03,70055,70051,Blue,0,62588,62726,138
2022-08-02,70046,70056,Blue,1,49739,50331,592
2022-12-28,70053,70041,Blue,0,32131,32747,616
2022-05-10,70056,70058,Blue,1,31326,31403,77
2022-11-21,70055,70053,Blue,0,52163,52208,45
2022-11-05,70043,70041,Blue,0,26328,26356,28
2022-02-09,70040,70048,Blue,1,31955,32410,455
2022-12-10,70046,70060,Blue,1,71060,71761,701
2022-12-16,70040,70058,Blue,1,50825,51751,926
2022-07-26,70051,70049,Blue,0,23084,23201,117
2022-12-07,70059,70045,Blue,0,51015,51801,786
2022-02-25,70046,70054,Blue,1,59959,60421,462
2022-10-11,70046,70052,Blue,1,70891,71200,309
2022-08-20,70040,70044,Blue,1,23833,23941,108
2022-10-27,70040,70060,Blue,1,78988,80116,1128
2022-08-17,70044,70060,Blue,1,29795,30756,961
2022-04-06,70046,70052,Blue,1,21300,21639,339
2022-06-24,70051,70043,Blue,0,60698,61187,489
2022-11-13,70059,70043,Blue,0,83778,84600,822
2022-09-22,70057,70055,Blue,0,58832,58900,68
2022-03-04,70059,70057,Blue,0,54194,54229,35
2022-07-12,70042,70044,Blue,1,31520,31551,31
2022-12-30,70053,70045,Blue,0,31025,31418,393
2022-10-31,70055,70049,Blue,0,84566,84853,287
2022-04-20,70052,70054,Blue,1,43136,43199,63
2022-07-29,70044,70046,Blue,1,88604,88710,106
2022-03-07,70057,70053,Blue,0,52167,52328,161
2022-10-26,70042,70048,Blue,1,32650,32940,290
2022-12-19,70048,70060,Blue,1,28030,28903,873
2022-08-05,70040,70048,Blue,1,30831,31206,375
2022-12-22,70049,70039,Blue,0,51107,51597,490
2022-10-01,70052,70056,Blue,1,87267,87412,145
2022-06-27,70042,70050,Blue,1,50172,50624,452
2022-02-28,70055,70047,Blue,0,52280,52647,367
2022-03-04,70042,70048,Blue,1,54744,55085,341
2022-09-14,70059,70039,Blue,0,29720,30917,1197
2022-10-29,70045,70039,Blue,0,22957,23215,258
2022-02-01,70041,70838,Blue,0,56666,56796,130
2022-09-08,70059,70057,Blue,0,36648,36687,39
2022-09-11,70038,70054,Blue,1,73687,74502,815
2022-10-08,70055,70051,Blue,0,78617,78752,135
2022-03-17,70045,70041,Blue,0,57690,57885,195
2022-10-13,70038,70042,Blue,1,51327,51420,93
2022-07-30,70044,70054,Blue,1,80823,81449,626
2022-10-06,70042,70060,Blue,1,73780,74699,919
2022-01-04,70044,70054,Blue,1,25664,26238,574
2022-04-07,70057,70043,Blue,0,65368,66112,744
2022-11-09,70040,70060,Blue,1,37470,38560,1090
2022-10-13,70040,70060,Blue,1,78429,79477,1048
2022-01-15,70048,70054,Blue,1,63545,63846,301
2022-03-02,70040,70050,Blue,1,82159,82669,510
2022-09-22,70040,70048,Blue,1,51718,52077,359
2022-12-05,70038,70042,Blue,1,73168,73266,98
2022-10-16,70054,70058,Blue,1,77022,77180,158
2022-04-19,70040,70044,Blue,1,35484,35619,135
2022-09-11,70053,70045,Blue,0,32687,33122,435
2022-10-21,70049,70045,Blue,0,66070,66287,217
2022-01-21,70051,70049,Blue,0,19571,19681,110
2022-01-07,70038,70040,Blue,1,33864,33881,17
2022-07-05,70042,70044,Blue,1,70157,70184,27
2022-07-17,70040,70056,Blue,1,73243,74323,1080
2022-03-21,70055,70051,Blue,0,65168,65307,139
2022-11-18,70057,70838,Blue,0,63750,64910,1160
2022-10-29,70046,70050,Blue,1,74299,74479,180
2022-03-11,70046,70056,Blue,1,63540,64072,532
2022-06-14,70055,70053,Blue,0,80253,80307,54
2022-04-06,70057,70049,Blue,0,32645,33047,402
2022-01-18,70046,70050,Blue,1,88813,89040,227
2022-06-14,70051,70049,Blue,0,71333,71433,100
2022-09-01,70050,70052,Blue,1,41612,41896,284
2022-09-25,70051,70838,Blue,0,54217,54944,727
2022-06-21,70044,70046,Blue,1,54762,54906,144
2022-07-01,70038,70056,Blue,1,25511,26616,1105
2022-08-09,70041,70838,Blue,0,33687,33821,134
2022-02-19,70050,70054,Blue,1,49233,49438,205
2022-08-05,70047,70045,Blue,0,59878,59986,108
2022-06-17,70059,70043,Blue,0,53113,53977,864
2022-10-21,70040,70044,Blue,1,29381,29527,146
2022-12-20,70053,70043,Blue,0,29598,30218,620
2022-10-23,70040,70056,Blue,1,38402,39268,866
2022-06-12,70051,70041,Blue,0,54197,54780,583
2022-12-15,70048,70056,Blue,1,56600,57008,408
2022-07-16,70038,70054,Blue,1,22987,23803,816
2022-03-21,70053,70051,Blue,0,19450,19520,70
2022-04-10,70057,70049,Blue,0,23911,24289,378
2022-12-20,70052,70054,Blue,1,52906,52967,61
2022-08-22,70044,70058,Blue,1,42250,43119,869
2022-11-29,70044,70060,Blue,1,64086,65002,916
2022-03-15,70038,70044,Blue,1,62827,63010,183
2022-01-06,70042,70050,Blue,1,21927,22326,399
2022-11-09,70042,70052,Blue,1,41048,41614,566
2022-09-08,70038,70060,Blue,1,60140,61782,1642
2022-01-07,70042,70060,Blue,1,58109,59236,1127
2022-12-02,70055,70045,Blue,0,53717,54212,495
2022-07-07,70040,70042,Blue,1,45829,45860,31
2022-10-01,70057,70041,Blue,0,59556,60395,839
2022-05-15,70059,70047,Blue,0,76825,77516,691
2022-10-22,70042,70060,Blue,1,36849,37738,889
2022-08-20,70059,70049,Blue,0,50835,51315,480
2022-05-31,70040,70046,Blue,1,83501,83801,300
2022-08-03,70050,70058,Blue,1,50951,51437,486
2022-07-04,70055,70838,Blue,0,53224,54171,947
2022-01-06,70045,70043,Blue,0,26257,26346,89
2022-01-05,70040,70052,Blue,1,36261,36917,656
2022-07-11,70051,70838,Blue,0,30524,31334,810
2022-10-20,70043,70041,Blue,0,39438,39466,28
2022-02-10,70055,70838,Blue,0,68645,69526,881
2022-07-16,70049,70838,Blue,0,37929,38541,612
2022-11-20,70042,70052,Blue,1,86528,87046,518
2022-09-25,70049,70838,Blue,0,62983,63589,606
2022-03-28,70042,70056,Blue,1,51341,52107,766
2022-07-22,70057,70039,Blue,0,70324,71315,991
2022-11-24,70057,70053,Blue,0,33284,33436,152
2022-01-05,70054,70056,Blue,1,68838,68885,47
2022-04-02,70053,70047,Blue,0,38136,38422,286
2022-01-22,70054,70060,Blue,1,22414,22664,250
2022-06-24,70050,70056,Blue,1,20763,21093,330
2022-08-20,70042,70044,Blue,1,63823,63859,36
2022-02-28,70051,70047,Blue,0,31616,31812,196
2022-09-12,70043,70039,Blue,0,66946,67065,119
2022-07-28,70059,70041,Blue,0,72801,73720,919
2022-08-03,70041,70039,Blue,0,53550,53581,31
2022-06-14,70052,70056,Blue,1,49818,49955,137
2022-11-09,70047,70043,Blue,0,67701,67943,242
2022-12-15,70038,70044,Blue,1,45282,45472,190
2022-06-14,70038,70060,Blue,1,54552,56109,1557
2022-10-25,70050,70052,Blue,1,84875,84984,109
2022-12-02,70044,70046,Blue,1,31546,31660,114
2022-08-13,70059,70838,Blue,0,67057,68208,1151
2022-06-30,70051,70039,Blue,0,53339,54034,695
2022-04-01,70057,70043,Blue,0,33027,33814,787
2022-11-03,70050,70052,Blue,1,29493,29607,114
2022-07-08,70040,70050,Blue,1,22031,22587,556
2022-11-30,70040,70042,Blue,1,59255,59284,29
2022-02-25,70046,70058,Blue,1,49038,49681,643
2022-06-14,70046,70050,Blue,1,45854,46049,195
2022-01-18,70050,70054,Blue,1,68315,68588,273
2022-02-05,70053,70838,Blue,0,49063,49953,890
2022-10-30,70049,70041,Blue,0,52720,53133,413
2022-04-17,70055,70053,Blue,0,65399,65444,45
2022-12-26,70055,70039,Blue,0,61580,62434,854
2022-11-30,70042,70050,Blue,1,81547,82001,454
2022-05-03,70050,70052,Blue,1,23590,23711,121
2022-02-01,70038,70060,Blue,1,51367,52585,1218
2022-02-04,70055,70049,Blue,0,75683,76020,337
2022-12-13,70051,70045,Blue,0,31229,31580,351
2022-02-07,70053,70838,Blue,0,61120,62028,908
2022-12-15,70051,70043,Blue,0,62275,62784,509
2022-03-18,70059,70049,Blue,0,59896,60360,464
2022-09-07,70044,70052,Blue,1,36649,37187,538
2022-01-05,70053,70838,Blue,0,75187,76013,826
2022-09-05,70040,70056,Blue,1,53262,54105,843
2022-11-29,70038,70060,Blue,1,42971,44089,1118
2022-06-10,70055,70053,Blue,0,81923,81973,50
2022-08-21,70054,70056,Blue,1,42648,42695,47
2022-11-04,70050,70058,Blue,1,22554,23026,472
2022-11-22,70044,70048,Blue,1,50484,50718,234
2022-02-10,70055,70049,Blue,0,20081,20372,291
2022-12-11,70043,70039,Blue,0,68737,68831,94
2022-04-07,70040,70042,Blue,1,46446,46477,31
2022-09-17,70042,70044,Blue,1,49264,49291,27
2022-07-30,70054,70060,Blue,1,67831,68100,269
2022-12-07,70049,70047,Blue,0,27353,27414,61
2022-08-03,70044,70054,Blue,1,81678,82247,569
2022-11-15,70049,70039,Blue,0,63619,64155,536
2022-12-06,70059,70039,Blue,0,70719,71691,972
2022-09-18,70053,70051,Blue,0,54124,54187,63
2022-04-10,70055,70041,Blue,0,50768,51498,730
2022-03-14,70056,70058,Blue,1,46697,46770,73
2022-01-25,70049,70047,Blue,0,49716,49775,59
2022-03-05,70038,70048,Blue,1,43153,43591,438
2022-07-13,70053,70045,Blue,0,46905,47356,451
2022-08-07,70047,70041,Blue,0,51747,52088,341
2022-04-01,70056,70058,Blue,1,61048,61119,71
2022-08-24,70043,70838,Blue,0,42074,42285,211
2022-02-03,70047,70043,Blue,0,23474,23747,273
2022-02-11,70044,70052,Blue,1,28103,28615,512
2022-04-19,70038,70042,Blue,1,25459,25558,99
2022-04-09,70057,70045,Blue,0,65493,66108,615
2022-06-30,70051,70039,Blue,0,26294,26979,685
2022-01-29,70052,70058,Blue,1,80392,80728,336
2022-02-10,70040,70060,Blue,1,40780,41906,1126
2022-07-03,70046,70048,Blue,1,26495,26587,92
2022-10-31,70053,70043,Blue,0,86024,86572,548
2022-07-23,70039,70838,Blue,0,35671,35709,38
2022-10-24,70043,70838,Blue,0,66934,67122,188
2022-11-21,70038,70060,Blue,1,28168,29329,1161
2022-12-17,70057,70039,Blue,0,66034,66993,959
2022-09-28,70059,70047,Blue,0,50954,51563,609
2022-10-25,70055,70047,Blue,0,53733,54120,387
2022-01-18,70055,70047,Blue,0,60074,60480,406
2022-07-16,70038,70054,Blue,1,70685,71488,803
2022-03-03,70044,70052,Blue,1,88586,89153,567
2022-03-30,70059,70057,Blue,0,77772,77807,35
2022-11-05,70046,70050,Blue,1,27877,28067,190
2022-02-28,70059,70051,Blue,0,34353,34747,394
2022-02-12,70051,70047,Blue,0,76906,77115,209
2022-01-10,70047,70041,Blue,0,49296,49596,300
2022-03-21,70050,70056,Blue,1,48657,48941,284
2022-12-27,70040,70060,Blue,1,68735,69815,1080
2022-12-14,70042,70044,Blue,1,22181,22210,29
2022-10-03,70047,70838,Blue,0,21501,22040,539
2022-06-09,70044,70054,Blue,1,23271,24118,847
2022-09-26,70038,70056,Blue,1,63814,64765,951
2022-12-13,70059,70053,Blue,0,56241,56469,228
2022-07-23,70050,70052,Blue,1,39987,40093,106
2022-02-21,70059,70053,Blue,0,45445,45709,264
2022-02-22,70059,70041,Blue,0,22292,23352,1060
2022-08-01,70048,70060,Blue,1,32819,33468,649
2022-09-03,70049,70043,Blue,0,67517,67855,338
2022-03-14,70050,70054,Blue,1,25146,25351,205
2022-05-19,70052,70056,Blue,1,37639,37795,156
2022-04-22,70058,70060,Blue,1,54063,54272,209
2022-01-06,70058,70060,Blue,1,27097,27180,83
2022-12-31,70059,70051,Blue,0,87852,88174,322
2022-07-09,70055,70049,Blue,0,40799,41080,281
2022-11-16,70038,70058,Blue,1,69646,70724,1078
2022-03-26,70051,70838,Blue,0,39858,40601,743
2022-10-31,70059,70043,Blue,0,73861,74684,823
2022-03-31,70043,70838,Blue,0,24896,25100,204
2022-07-28,70048,70054,Blue,1,30167,30491,324
2022-03-29,70043,70838,Blue,0,83352,83555,203
2022-03-15,70059,70047,Blue,0,58086,58678,592
2022-05-20,70051,70045,Blue,0,57561,57995,434
2022-07-13,70057,70041,Blue,0,50347,51245,898
2022-01-05,70045,70838,Blue,0,20685,21047,362
2022-03-14,70048,70056,Blue,1,75390,75854,464
2022-04-13,70057,70049,Blue,0,26753,27204,451
2022-04-07,70053,70045,Blue,0,39516,40089,573
2022-04-06,70044,70054,Blue,1,42272,42883,611
2022-11-19,70053,70041,Blue,0,81803,82473,670
2022-12-28,70049,70041,Blue,0,65484,65895,411
2022-01-24,70043,70838,Blue,0,71402,71580,178
2022-12-14,70048,70054,Blue,1,88679,88980,301
2022-09-16,70057,70039,Blue,0,61528,62435,907
2022-02-09,70059,70049,Blue,0,64089,64548,459
2022-04-04,70042,70048,Blue,1,59976,60282,306
2022-02-02,70049,70047,Blue,0,35734,35796,62
2022-04-09,70042,70060,Blue,1,52486,53389,903
2022-10-03,70042,70056,Blue,1,45770,46513,743
2022-12-13,70053,70045,Blue,0,52262,52721,459
2022-07-20,70041,70838,Blue,0,45776,45904,128
2022-12-29,70048,70054,Blue,1,84385,84684,299
2022-06-21,70056,70060,Blue,1,71051,71251,200
2022-02-18,70048,70054,Blue,1,62463,62754,291
2022-08-15,70059,70045,Blue,0,88688,89374,686
2022-11-19,70046,70050,Blue,1,85898,86086,188
2022-12-13,70047,70043,Blue,0,65069,65307,238
2022-11-07,70038,70046,Blue,1,68467,68791,324
2022-03-22,70059,70039,Blue,0,21347,22686,1339
2022-07-28,70044,70048,Blue,1,53118,53358,240
2022-04-11,70046,70052,Blue,1,26416,26755,339
2022-09-30,70053,70838,Blue,0,33349,34211,862
2022-12-16,70038,70060,Blue,1,30692,31822,1130
2022-04-12,70055,70041,Blue,0,50398,51103,705
2022-12-06,70049,70047,Blue,0,53673,53730,57
2022-04-02,70059,70055,Blue,0,74050,74193,143
2022-03-29,70055,70045,Blue,0,23823,24326,503
2022-08-05,70049,70043,Blue,0,40521,40871,350
2022-09-01,70046,70056,Blue,1,48576,49134,558
2022-09-08,70040,70046,Blue,1,44258,44530,272
2022-06-18,70051,70043,Blue,0,62600,63152,552
2022-07-02,70040,70060,Blue,1,55111,56188,1077
2022-02-22,70051,70043,Blue,0,58491,59061,570
2022-10-26,70040,70046,Blue,1,30503,30757,254
2022-07-09,70044,70050,Blue,1,69307,69685,378
2022-01-14,70042,70054,Blue,1,74256,74994,738
2022-07-31,70042,70046,Blue,1,77650,77824,174
2022-03-02,70044,70060,Blue,1,39855,40816,961
2022-03-03,70053,70049,Blue,0,40110,40367,257
2022-04-08,70040,70052,Blue,1,65903,66509,606
2022-01-05,70048,70060,Blue,1,77328,77902,574
2022-04-11,70051,70047,Blue,0,71917,72116,199
2022-07-24,70053,70047,Blue,0,61118,61397,279
2022-01-13,70054,70058,Blue,1,84096,84256,160
2022-06-15,70040,70044,Blue,1,43589,43707,118
2022-09-13,70057,70053,Blue,0,24632,24782,150
2022-07-19,70052,70054,Blue,1,45425,45481,56
2022-09-08,70040,70050,Blue,1,71680,72176,496
2022-02-06,70038,70046,Blue,1,26413,26734,321
2022-12-28,70038,70058,Blue,1,89227,90207,980
2022-03-11,70038,70052,Blue,1,37867,38620,753
2022-12-06,70056,70058,Blue,1,86730,86803,73
2022-01-11,70049,70838,Blue,0,53330,53973,643
2022-03-08,70040,70042,Blue,1,64088,64124,36
2022-07-29,70044,70054,Blue,1,52640,53277,637
2022-04-19,70051,70045,Blue,0,37481,37904,423
2022-12-13,70059,70047,Blue,0,77625,78182,557
2022-12-21,70038,70042,Blue,1,30982,31084,102
2022-07-19,70048,70050,Blue,1,74117,74176,59
2022-09-02,70044,70050,Blue,1,24147,24466,319
2022-04-18,70059,70055,Blue,0,44354,44496,142
2022-01-20,70044,70054,Blue,1,88589,89260,671
2022-01-18,70039,70838,Blue,0,74526,74562,36
2022-04-26,70052,70054,Blue,1,80955,81007,52
2022-09-24,70047,70041,Blue,0,68765,69079,314
2022-11-17,70053,70049,Blue,0,46440,46680,240
2022-06-15,70059,70041,Blue,0,74895,75841,946
2022-06-29,70046,70054,Blue,1,23561,24001,440
2022-04-14,70046,70050,Blue,1,51171,51375,204
2022-04-20,70042,70050,Blue,1,21320,21761,441
2022-02-07,70044,70048,Blue,1,45812,46044,232
2022-09-28,70047,70045,Blue,0,68253,68350,97
2022-09-02,70057,70047,Blue,0,26849,27324,475
2022-06-29,70038,70044,Blue,1,84309,84494,185
2022-02-14,70042,70054,Blue,1,22313,22985,672
2022-01-21,70059,70045,Blue,0,67154,67839,685
2022-06-27,70059,70057,Blue,0,56846,56881,35
2022-01-15,70039,70838,Blue,0,21242,21281,39
2022-07-06,70058,70060,Blue,1,53262,53357,95
2022-11-08,70047,70838,Blue,0,50552,51036,484
2022-05-26,70045,70039,Blue,0,83178,83464,286
2022-07-04,70044,70060,Blue,1,77908,78891,983
2022-03-18,70052,70058,Blue,1,61862,62116,254
2022-07-12,70047,70043,Blue,0,19068,19332,264
2022-04-06,70059,70039,Blue,0,32961,34114,1153
2022-10-08,70057,70041,Blue,0,87440,88249,809
2022-06-17,70040,70058,Blue,1,84321,85287,966
2022-10-09,70053,70047,Blue,0,46562,46843,281
2022-11-14,70059,70053,Blue,0,53061,53299,238
2022-11-28,70059,70049,Blue,0,56655,57119,464
2022-04-07,70040,70050,Blue,1,27304,27786,482
2022-11-16,70044,70056,Blue,1,39561,40178,617
2022-07-21,70040,70046,Blue,1,30404,30659,255
2022-06-21,70038,70048,Blue,1,82542,83196,654
2022-04-25,70059,70051,Blue,0,26775,27091,316
2022-07-16,70057,70045,Blue,0,49344,49953,609
2022-06-05,70045,70041,Blue,0,57861,58067,206
2022-07-27,70049,70047,Blue,0,27287,27346,59
2022-07-28,70043,70838,Blue,0,41560,41774,214
2022-10-15,70057,70039,Blue,0,44990,46029,1039
2022-04-21,70056,70058,Blue,1,69568,69715,147
2022-01-30,70038,70054,Blue,1,84110,85207,1097
2022-11-02,70047,70039,Blue,0,31542,31949,407
2022-02-01,70038,70046,Blue,1,75893,76251,358
2022-12-20,70057,70041,Blue,0,72235,73189,954
2022-08-07,70057,70039,Blue,0,73363,74291,928
2022-08-01,70038,70058,Blue,1,52876,53992,1116
2022-04-04,70038,70048,Blue,1,37867,38320,453
2022-11-14,70042,70052,Blue,1,62237,62885,648
2022-02-18,70044,70060,Blue,1,71243,72265,1022
2022-02-07,70044,70058,Blue,1,30526,31395,869
2022-02-18,70040,70054,Blue,1,32516,33306,790
2022-03-06,70053,70838,Blue,0,56257,57098,841
2022-06-25,70047,70045,Blue,0,43393,43503,110
2022-07-07,70045,70041,Blue,0,25106,25293,187
2022-12-13,70043,70838,Blue,0,63802,64002,200
2022-08-22,70050,70056,Blue,1,53023,53327,304
2022-09-17,70057,70043,Blue,0,45038,45878,840
2022-09-22,70049,70838,Blue,0,83921,84482,561
2022-07-10,70054,70056,Blue,1,31679,31725,46
2022-11-23,70053,70039,Blue,0,74073,74759,686
2022-10-13,70045,70043,Blue,0,57251,57344,93
2022-10-10,70038,70050,Blue,1,63355,63932,577
2022-01-31,70045,70043,Blue,0,65818,65959,141
2022-09-27,70046,70054,Blue,1,45731,46182,451
2022-05-28,70047,70041,Blue,0,70055,70418,363
2022-02-14,70044,70050,Blue,1,25672,26012,340
2022-08-29,70052,70058,Blue,1,81940,82204,264
2022-07-07,70046,70050,Blue,1,65036,65226,190
2022-06-11,70046,70058,Blue,1,52185,52835,650
2022-02-16,70038,70044,Blue,1,48689,48866,177
2022-04-11,70053,70039,Blue,0,61391,62118,727
2022-06-21,70057,70043,Blue,0,34607,35528,921
2022-11-07,70055,70051,Blue,0,26670,26824,154
2022-06-26,70048,70058,Blue,1,82958,83491,533
2022-02-22,70057,70043,Blue,0,34238,35240,1002
2022-05-31,70042,70048,Blue,1,35114,35506,392
2022-04-03,70048,70058,Blue,1,74773,75283,510
2022-04-13,70038,70050,Blue,1,54552,55108,556
2022-07-06,70048,70058,Blue,1,87894,88413,519
2022-10-08,70040,70048,Blue,1,42665,43052,387
2022-01-21,70059,70045,Blue,0,24253,24920,667
2022-02-21,70043,70838,Blue,0,70114,70286,172
2022-09-11,70050,70056,Blue,1,61315,61602,287
2022-02-09,70055,70041,Blue,0,60365,61193,828
2022-02-02,70059,70045,Blue,0,79455,80093,638
2022-04-17,70047,70041,Blue,0,36137,36437,300
2022-09-03,70043,70041,Blue,0,59846,59876,30
2022-04-08,70040,70048,Blue,1,70597,70981,384
2022-05-20,70044,70058,Blue,1,62153,63078,925
2022-05-28,70040,70052,Blue,1,45512,46356,844
2022-08-10,70046,70052,Blue,1,38926,39291,365
2022-01-17,70059,70051,Blue,0,23512,23884,372
2022-12-03,70040,70056,Blue,1,32949,33756,807
2022-10-03,70038,70046,Blue,1,28576,28889,313
2022-09-01,70057,70045,Blue,0,40985,42707,1722
2022-02-03,70039,70838,Blue,0,46644,46679,35
2022-12-31,70055,70043,Blue,0,41964,42625,661
2022-07-13,70038,70054,Blue,1,29640,30460,820
2022-12-08,70055,70045,Blue,0,58395,58956,561
2022-02-07,70044,70058,Blue,1,27178,27964,786
2022-08-18,70051,70039,Blue,0,30151,30899,748
2022-01-17,70053,70045,Blue,0,74324,74745,421
2022-10-13,70046,70056,Blue,1,53988,54475,487
2022-07-31,70047,70039,Blue,0,63085,63478,393
2022-12-07,70044,70056,Blue,1,22401,23068,667
2022-07-25,70038,70046,Blue,1,78313,78631,318
2022-08-13,70053,70047,Blue,0,73793,74100,307
2022-09-18,70053,70838,Blue,0,43063,43978,915
2022-10-21,70051,70043,Blue,0,67922,68394,472
2022-02-10,70054,70060,Blue,1,64346,64725,379
2022-12-29,70046,70056,Blue,1,59356,59902,546
2022-12-14,70057,70041,Blue,0,84380,85264,884
2022-06-10,70045,70041,Blue,0,34428,34597,169
2022-05-25,70049,70838,Blue,0,31265,31923,658
2022-09-20,70044,70060,Blue,1,86751,87611,860
2022-09-01,70049,70043,Blue,0,58733,59103,370
2022-01-21,70059,70043,Blue,0,23427,24439,1012
2022-07-04,70059,70051,Blue,0,63496,63823,327
2022-11-29,70041,70039,Blue,0,51381,51413,32
2022-06-26,70051,70047,Blue,0,47726,47919,193
2022-09-14,70042,70060,Blue,1,31723,32692,969
2022-09-14,70053,70047,Blue,0,75935,76214,279
2022-11-17,70038,70042,Blue,1,52068,52149,81
2022-08-26,70053,70041,Blue,0,27243,27938,695
2022-07-10,70044,70060,Blue,1,28653,29512,859
2022-04-08,70043,70041,Blue,0,29713,29743,30
2022-10-09,70054,70060,Blue,1,56741,56988,247
2022-07-04,70051,70047,Blue,0,38342,38538,196
2022-12-18,70042,70046,Blue,1,46849,47017,168
2022-07-12,70050,70056,Blue,1,23573,23856,283
2022-03-09,70040,70052,Blue,1,23119,23780,661
2022-10-13,70052,70058,Blue,1,59153,59437,284
2022-06-12,70042,70050,Blue,1,30144,30533,389
2022-09-15,70055,70051,Blue,0,28673,28826,153
2022-02-09,70040,70046,Blue,1,54634,54903,269
2022-04-08,70042,70060,Blue,1,31597,32676,1079
2022-07-14,70044,70054,Blue,1,55179,55816,637
2022-07-13,70051,70047,Blue,0,57214,57417,203
2022-12-15,70057,70047,Blue,0,21868,22517,649
2022-02-18,70053,70043,Blue,0,51455,52020,565
2022-09-08,70044,70048,Blue,1,67440,67670,230
2022-02-26,70058,70060,Blue,1,84822,84883,61
2022-12-20,70047,70043,Blue,0,88027,88260,233
2022-04-10,70051,70049,Blue,0,87678,87781,103
2022-05-20,70051,70041,Blue,0,63569,64265,696
2022-12-07,70038,70054,Blue,1,42967,43799,832
2022-02-27,70038,70054,Blue,1,61270,62110,840
2022-02-23,70059,70039,Blue,0,54318,55309,991
2022-06-20,70059,70051,Blue,0,71250,71613,363
2022-05-06,70050,70056,Blue,1,57410,57700,290
2022-07-23,70039,70838,Blue,0,32004,32041,37
2022-07-11,70042,70054,Blue,1,29999,30708,709
2022-09-09,70040,70060,Blue,1,63325,64934,1609
2022-04-07,70057,70049,Blue,0,25535,25940,405
2022-08-17,70045,70838,Blue,0,54615,54986,371
2022-02-25,70040,70060,Blue,1,68152,69542,1390
2022-02-18,70045,70041,Blue,0,46930,47162,232
2022-02-17,70040,70054,Blue,1,80383,81124,741
2022-09-19,70055,70041,Blue,0,30944,31930,986
2022-04-15,70045,70041,Blue,0,33174,33337,163
2022-06-29,70051,70838,Blue,0,43635,44466,831
2022-04-14,70049,70041,Blue,0,33476,34112,636
2022-04-12,70059,70049,Blue,0,56295,56772,477
2022-03-26,70043,70838,Blue,0,21723,21926,203
2022-01-05,70048,70058,Blue,1,40054,40648,594
2022-01-27,70044,70058,Blue,1,74344,75199,855
2022-01-09,70048,70058,Blue,1,53129,53615,486
2022-09-06,70059,70047,Blue,0,57768,58357,589
2022-07-16,70055,70049,Blue,0,58176,58465,289
2022-01-09,70045,70043,Blue,0,52475,52564,89
2022-01-11,70053,70041,Blue,0,64999,65645,646
2022-10-21,70052,70054,Blue,1,52921,52977,56
2022-07-13,70038,70040,Blue,1,76342,76360,18
2022-04-20,70055,70045,Blue,0,64277,64821,544
2022-01-27,70042,70044,Blue,1,59713,59741,28
2022-02-21,70043,70039,Blue,0,82469,82578,109
2022-02-12,70059,70057,Blue,0,27609,27646,37
2022-07-16,70040,70050,Blue,1,72374,72886,512
2022-03-02,70051,70045,Blue,0,83206,83522,316
2022-03-09,70057,70043,Blue,0,31249,32077,828
2022-07-04,70053,70041,Blue,0,46818,47511,693
2022-01-03,70054,70056,Blue,1,62574,62621,47
2022-11-09,70043,70838,Blue,0,42526,42753,227
2022-01-27,70038,70044,Blue,1,42498,42667,169
2022-05-20,70053,70041,Blue,0,48935,49813,878
2022-12-21,70040,70044,Blue,1,54534,54644,110
2022-03-09,70040,70058,Blue,1,62014,63007,993
2022-12-02,70044,70050,Blue,1,57859,58219,360
2022-02-28,70038,70044,Blue,1,61626,61800,174
2022-06-18,70056,70058,Blue,1,43079,43156,77
2022-02-01,70057,70055,Blue,0,86383,86454,71
2022-06-20,70047,70838,Blue,0,67086,67736,650
2022-11-14,70046,70050,Blue,1,68654,68856,202
2022-04-07,70055,70047,Blue,0,76248,76666,418
2022-01-20,70042,70052,Blue,1,53855,54417,562
2022-08-02,70045,70043,Blue,0,52270,52360,90
2022-03-28,70043,70041,Blue,0,64304,64332,28
2022-04-18,70052,70056,Blue,1,57304,57449,145
2022-09-20,70059,70039,Blue,0,57727,58742,1015
2022-06-10,70040,70046,Blue,1,64078,64348,270
2022-08-25,70051,70043,Blue,0,29240,29767,527
2022-09-24,70040,70044,Blue,1,53506,53642,136
2022-09-01,70039,70838,Blue,0,44088,44128,40
2022-10-28,70049,70047,Blue,0,62056,62108,52
2022-03-13,70042,70054,Blue,1,69521,70197,676
2022-01-29,70044,70048,Blue,1,20334,20630,296
2022-07-24,70057,70049,Blue,0,61577,61970,393
2022-02-14,70047,70045,Blue,0,83431,83522,91
2022-05-20,70059,70041,Blue,0,77181,78249,1068
2022-02-23,70055,70838,Blue,0,49940,50980,1040
2022-04-13,70057,70043,Blue,0,65368,66146,778
2022-06-14,70042,70058,Blue,1,56060,57218,1158
2022-03-21,70049,70039,Blue,0,75985,76448,463
2022-06-29,70053,70047,Blue,0,23268,23582,314
2022-01-13,70051,70047,Blue,0,72980,73172,192
2022-06-22,70038,70060,Blue,1,50947,52147,1200
2022-11-11,70043,70041,Blue,0,34354,34382,28
2022-03-25,70053,70045,Blue,0,47417,47859,442
2022-10-23,70055,70041,Blue,0,33373,34094,721
2022-12-30,70038,70050,Blue,1,63983,64581,598
2022-07-17,70055,70041,Blue,0,41663,42452,789
2022-05-19,70059,70049,Blue,0,32073,32546,473
2022-01-25,70038,70042,Blue,1,70516,70606,90
2022-08-30,70055,70053,Blue,0,38653,38826,173
2022-01-25,70042,70048,Blue,1,63895,64198,303
2022-01-20,70044,70048,Blue,1,59173,59417,244
2022-10-24,70039,70838,Blue,0,71762,71802,40
2022-09-11,70057,70049,Blue,0,34833,35209,376
2022-10-05,70040,70052,Blue,1,35846,36485,639
2022-12-02,70038,70040,Blue,1,34872,34888,16
2022-07-24,70043,70039,Blue,0,83889,83994,105
2022-11-14,70052,70056,Blue,1,50044,50183,139
2022-12-30,70059,70053,Blue,0,25147,25380,233
2022-09-04,70054,70058,Blue,1,74549,74715,166
2022-12-10,70048,70058,Blue,1,30796,31305,509
2022-08-15,70044,70048,Blue,1,37629,37858,229
2022-07-11,70055,70053,Blue,0,25726,25775,49
2022-04-08,70052,70056,Blue,1,24858,24994,136
2022-09-26,70055,70045,Blue,0,62055,62566,511
2022-07-11,70041,70039,Blue,0,89693,89733,40
2022-07-29,70054,70056,Blue,1,79076,79124,48
2022-07-29,70049,70039,Blue,0,21965,22530,565
2022-04-04,70046,70058,Blue,1,25303,25968,665
2022-03-11,70045,70838,Blue,0,64490,64843,353
2022-03-28,70057,70045,Blue,0,32446,33174,728
2022-10-15,70042,70046,Blue,1,32079,32270,191
2022-03-10,70044,70048,Blue,1,22089,22337,248
2022-06-20,70042,70058,Blue,1,48811,49734,923
2022-12-03,70059,70047,Blue,0,77776,78336,560
2022-01-27,70049,70045,Blue,0,61331,61555,224
2022-08-09,70046,70052,Blue,1,56485,56821,336
2022-01-13,70048,70054,Blue,1,41483,41799,316
2022-12-17,70044,70050,Blue,1,35994,36323,329
2022-02-03,70047,70039,Blue,0,76069,76434,365
2022-05-20,70053,70838,Blue,0,78735,79760,1025
2022-10-05,70053,70838,Blue,0,72039,72868,829
2022-04-14,70053,70047,Blue,0,32648,32989,341
2022-05-28,70040,70044,Blue,1,21309,21408,99
2022-05-18,70050,70054,Blue,1,51484,51718,234
2022-04-21,70050,70058,Blue,1,62549,62971,422
2022-03-14,70045,70838,Blue,0,59781,60126,345
2022-10-10,70044,70046,Blue,1,38029,38127,98
2022-01-08,70059,70039,Blue,0,64336,65347,1011
2022-07-11,70048,70056,Blue,1,47166,47585,419
2022-02-21,70038,70048,Blue,1,49124,49609,485
2022-03-04,70055,70041,Blue,0,34326,35135,809
2022-11-24,70057,70047,Blue,0,52836,53314,478
2022-12-11,70046,70048,Blue,1,65989,66057,68
2022-03-17,70040,70042,Blue,1,46460,46491,31
2022-07-15,70038,70040,Blue,1,45565,45584,19
2022-10-24,70042,70052,Blue,1,47821,48384,563
2022-07-06,70046,70058,Blue,1,68868,69612,744
2022-04-05,70043,70041,Blue,0,80426,80460,34
2022-08-29,70039,70838,Blue,0,76389,76419,30
2022-08-03,70042,70046,Blue,1,26614,26791,177
2022-08-15,70039,70838,Blue,0,61933,61968,35
2022-08-08,70045,70043,Blue,0,35924,36027,103
2022-12-13,70048,70060,Blue,1,76628,77248,620
2022-08-01,70046,70052,Blue,1,52428,52795,367
2022-02-26,70043,70041,Blue,0,82550,82580,30
2022-02-28,70056,70058,Blue,1,77910,77981,71
2022-04-23,70047,70041,Blue,0,20140,20476,336
2022-02-07,70038,70056,Blue,1,89166,90030,864
2022-03-22,70041,70838,Blue,0,59186,59371,185
2022-04-20,70044,70048,Blue,1,77163,77428,265
2022-07-28,70046,70058,Blue,1,38199,38822,623
2022-03-20,70057,70039,Blue,0,56157,57137,980
2022-02-01,70052,70058,Blue,1,65406,65643,237
2022-10-08,70059,70057,Blue,0,57859,57895,36
2022-12-22,70042,70060,Blue,1,69349,70408,1059
2022-04-14,70053,70838,Blue,0,29054,30040,986
2022-11-29,70050,70060,Blue,1,45118,45613,495
2022-03-29,70057,70049,Blue,0,64466,64835,369
2022-11-08,70044,70046,Blue,1,59883,59983,100
2022-03-05,70051,70041,Blue,0,73891,74453,562
2022-01-20,70050,70052,Blue,1,55366,55487,121
2022-09-13,70038,70052,Blue,1,82008,82778,770
2022-12-15,70038,70040,Blue,1,57589,57605,16
2022-04-05,70052,70058,Blue,1,55300,55569,269
2022-09-29,70045,70041,Blue,0,76782,76995,213
2022-06-15,70042,70048,Blue,1,65367,65766,399
2022-01-03,70038,70044,Blue,1,29346,29494,148
2022-08-21,70040,70060,Blue,1,74842,75879,1037
2022-12-14,70042,70046,Blue,1,81614,81798,184
2022-08-28,70057,70055,Blue,0,25469,25538,69
2022-06-24,70043,70039,Blue,0,42003,42124,121
2022-07-15,70046,70054,Blue,1,33019,33509,490
2022-05-09,70050,70052,Blue,1,39347,39482,135
2022-03-31,70051,70047,Blue,0,41939,42132,193
2022-03-16,70043,70838,Blue,0,25034,25267,233
2022-09-08,70039,70838,Blue,0,59599,59636,37
2022-03-03,70057,70047,Blue,0,47702,48195,493
2022-06-28,70059,70049,Blue,0,46821,47273,452
2022-01-18,70040,70060,Blue,1,80469,81623,1154
2022-02-25,70038,70050,Blue,1,52753,53373,620
2022-09-19,70040,70048,Blue,1,40498,40913,415
2022-09-23,70053,70838,Blue,0,66814,67657,843
2022-09-08,70038,70042,Blue,1,46718,46827,109
2022-10-04,70038,70040,Blue,1,42183,42196,13
2022-01-21,70044,70054,Blue,1,25671,26446,775
2022-11-03,70057,70838,Blue,0,50490,51846,1356
2022-10-25,70059,70055,Blue,0,40578,40727,149
2022-05-20,70044,70048,Blue,1,71276,71531,255
2022-12-02,70042,70054,Blue,1,31635,32330,695
2022-12-19,70057,70039,Blue,0,32787,34335,1548
2022-01-26,70038,70048,Blue,1,65234,65722,488
2022-11-03,70053,70838,Blue,0,69946,70790,844
2022-03-10,70049,70047,Blue,0,76513,76572,59
2022-08-08,70057,70838,Blue,0,42238,43711,1473
2022-06-22,70059,70039,Blue,0,51978,52985,1007
2022-11-15,70047,70838,Blue,0,70052,70496,444
2022-12-26,70053,70047,Blue,0,33479,33770,291
2022-02-28,70057,70055,Blue,0,37089,37159,70
2022-10-29,70040,70048,Blue,1,48068,48481,413
2022-03-06,70050,70056,Blue,1,27468,27746,278
2022-07-22,70053,70043,Blue,0,51241,51843,602
2022-09-06,70057,70055,Blue,0,61952,62021,69
2022-07-17,70048,70060,Blue,1,39535,40131,596
2022-06-29,70050,70058,Blue,1,67729,68258,529
2022-12-23,70049,70047,Blue,0,40453,40526,73
2022-12-26,70055,70045,Blue,0,45508,46044,536
2022-10-05,70045,70043,Blue,0,40217,40315,98
2022-06-28,70059,70051,Blue,0,20834,21152,318
2022-10-09,70038,70050,Blue,1,79096,79911,815
2022-03-31,70045,70039,Blue,0,63930,64173,243
2022-04-19,70040,70058,Blue,1,78758,79830,1072
2022-02-01,70046,70060,Blue,1,21107,22392,1285
2022-02-03,70046,70060,Blue,1,30010,30921,911
2022-10-03,70045,70838,Blue,0,70368,70707,339
2022-01-13,70051,70045,Blue,0,59956,60279,323
2022-02-14,70043,70041,Blue,0,66205,66233,28
2022-01-09,70043,70041,Blue,0,38426,38457,31
2022-07-27,70052,70058,Blue,1,22945,23211,266
2022-01-02,70038,70046,Blue,1,61280,61636,356
2022-02-02,70059,70045,Blue,0,58417,59208,791
2022-12-24,70057,70047,Blue,0,58476,58955,479
2022-01-24,70046,70048,Blue,1,45790,45864,74
2022-04-09,70044,70060,Blue,1,67659,68545,886
2022-02-18,70042,70054,Blue,1,26520,27221,701
2022-11-28,70040,70044,Blue,1,87455,87564,109
2022-02-26,70057,70838,Blue,0,23555,24682,1127
2022-06-24,70056,70060,Blue,1,31072,31267,195
2022-12-19,70048,70054,Blue,1,70970,71291,321
2022-09-09,70051,70039,Blue,0,44787,45477,690
2022-02-10,70049,70047,Blue,0,22976,23041,65
2022-04-29,70053,70049,Blue,0,27898,28101,203
2022-07-09,70042,70052,Blue,1,85702,86436,734
2022-06-06,70045,70039,Blue,0,21072,21371,299
2022-05-14,70056,70060,Blue,1,57816,58018,202
2022-05-31,70043,70039,Blue,0,22149,22261,112
2022-08-20,70038,70046,Blue,1,60433,60790,357
2022-12-09,70040,70060,Blue,1,54833,55951,1118
2022-07-23,70038,70048,Blue,1,81784,82268,484
2022-12-31,70043,70039,Blue,0,38842,38947,105
2022-05-17,70059,70047,Blue,0,64238,64976,738
2022-08-21,70052,70060,Blue,1,54510,54901,391
2022-03-05,70044,70060,Blue,1,89401,90327,926
2022-04-21,70056,70058,Blue,1,48609,48683,74
2022-09-25,70038,70048,Blue,1,85573,86059,486
2022-03-28,70049,70838,Blue,0,61328,61923,595
2022-11-08,70043,70041,Blue,0,82113,82142,29
2022-03-24,70040,70054,Blue,1,38546,39324,778
2022-07-27,70050,70058,Blue,1,86427,86966,539
2022-10-30,70057,70041,Blue,0,42208,43066,858
2022-09-13,70038,70042,Blue,1,79074,79173,99
2022-12-25,70051,70041,Blue,0,23655,24553,898
2022-04-15,70049,70047,Blue,0,29079,29144,65
2022-10-26,70043,70838,Blue,0,86647,86845,198
2022-07-04,70038,70054,Blue,1,58067,59028,961
2022-08-23,70040,70052,Blue,1,78402,79007,605
2022-05-29,70042,70052,Blue,1,58062,58768,706
2022-03-26,70046,70058,Blue,1,50041,50739,698
2022-08-23,70042,70058,Blue,1,35648,36665,1017
2022-03-12,70051,70039,Blue,0,60422,61065,643
2022-03-17,70051,70045,Blue,0,27362,27717,355
2022-11-04,70042,70056,Blue,1,67907,68827,920
2022-02-28,70059,70055,Blue,0,85752,85896,144
2022-02-09,70050,70052,Blue,1,66821,66939,118
2022-08-15,70048,70056,Blue,1,37915,38362,447
2022-04-08,70057,70045,Blue,0,62663,63257,594
2022-03-21,70050,70054,Blue,1,53310,53538,228
2022-06-05,70044,70048,Blue,1,73715,74008,293
2022-05-11,70054,70060,Blue,1,27708,27986,278
2022-07-26,70050,70054,Blue,1,56256,56483,227
2022-03-25,70054,70058,Blue,1,68901,69064,163
2022-02-13,70059,70043,Blue,0,49515,50413,898
2022-05-09,70050,70056,Blue,1,47615,47906,291
2022-07-30,70038,70060,Blue,1,62592,63824,1232
2022-12-20,70052,70058,Blue,1,64280,64547,267
2022-11-29,70044,70052,Blue,1,60461,60961,500
2022-07-27,70042,70050,Blue,1,37972,38383,411
2022-08-10,70051,70838,Blue,0,25500,26307,807
2022-12-20,70053,70047,Blue,0,20313,20623,310
2022-06-09,70040,70042,Blue,1,65216,65254,38
2022-12-22,70059,70051,Blue,0,79870,80195,325
2022-12-26,70040,70048,Blue,1,88279,88677,398
2022-02-05,70059,70055,Blue,0,68658,68804,146
2022-02-17,70049,70045,Blue,0,57153,57369,216
2022-09-28,70038,70044,Blue,1,50280,50479,199
2022-01-18,70059,70053,Blue,0,25759,26059,300
2022-10-18,70046,70050,Blue,1,60325,60489,164
2022-11-04,70041,70838,Blue,0,58898,59008,110
2022-02-23,70044,70058,Blue,1,64271,65110,839
2022-08-03,70055,70041,Blue,0,38253,39100,847
2022-04-14,70051,70047,Blue,0,65346,65534,188
2022-11-10,70047,70045,Blue,0,30333,30427,94
2022-02-14,70049,70047,Blue,0,22983,23049,66
2022-02-26,70042,70048,Blue,1,35750,36093,343
2022-04-07,70048,70058,Blue,1,42990,43545,555
2022-11-04,70046,70050,Blue,1,43329,43496,167
2022-11-24,70044,70056,Blue,1,88401,89223,822
2022-02-28,70053,70838,Blue,0,32648,33536,888
2022-01-21,70038,70050,Blue,1,83707,84353,646
2022-03-05,70055,70049,Blue,0,37533,37824,291
2022-07-08,70055,70049,Blue,0,67278,67564,286
2022-03-17,70054,70058,Blue,1,61921,62087,166
2022-03-24,70052,70060,Blue,1,52523,52885,362
2022-11-30,70053,70049,Blue,0,27404,27637,233
2022-12-08,70052,70054,Blue,1,77340,77387,47
2022-11-30,70043,70041,Blue,0,57242,57269,27
2022-04-11,70055,70049,Blue,0,53292,53565,273
2022-05-13,70052,70060,Blue,1,83444,83821,377
2022-11-27,70053,70041,Blue,0,54111,54818,707
2022-11-29,70039,70838,Blue,0,24915,24951,36
2022-06-28,70050,70054,Blue,1,89664,89865,201
2022-07-18,70046,70060,Blue,1,64632,65576,944
2022-05-02,70050,70054,Blue,1,62968,63204,236
2022-03-21,70044,70054,Blue,1,78234,78964,730
2022-03-02,70047,70838,Blue,0,57537,58102,565
2022-03-05,70059,70057,Blue,0,71366,71402,36
2022-03-06,70051,70049,Blue,0,73102,73205,103
2022-12-10,70042,70056,Blue,1,78792,79566,774
2022-02-05,70046,70058,Blue,1,71620,72253,633
2022-04-01,70047,70838,Blue,0,85728,86190,462
2022-04-24,70057,70053,Blue,0,58771,58931,160
2022-12-08,70051,70039,Blue,0,41010,41686,676
2022-12-31,70043,70041,Blue,0,49638,49667,29
2022-07-13,70046,70054,Blue,1,63399,63890,491
2022-08-16,70038,70042,Blue,1,50361,50477,116
2022-03-01,70059,70039,Blue,0,33862,34980,1118
2022-06-17,70043,70041,Blue,0,66521,66549,28
2022-12-23,70040,70056,Blue,1,62116,63044,928
2022-01-28,70055,70047,Blue,0,52293,52669,376
2022-07-30,70059,70041,Blue,0,43291,44266,975
2022-04-16,70051,70041,Blue,0,70661,71264,603
2022-05-09,70057,70049,Blue,0,79887,80291,404
2022-08-26,70048,70056,Blue,1,27361,27720,359
2022-08-08,70038,70042,Blue,1,61693,61811,118
2022-09-05,70049,70041,Blue,0,52780,53231,451
2022-01-18,70047,70838,Blue,0,29663,30476,813
2022-06-10,70054,70056,Blue,1,64917,64974,57
2022-04-05,70046,70048,Blue,1,27093,27170,77
2022-10-20,70040,70042,Blue,1,20068,20106,38
2022-08-20,70053,70041,Blue,0,70587,71239,652
2022-04-04,70038,70046,Blue,1,47544,47893,349
2022-04-24,70058,70060,Blue,1,80103,80164,61
2022-11-09,70048,70052,Blue,1,79350,79558,208
2022-10-26,70048,70058,Blue,1,69442,69944,502
2022-09-07,70038,70044,Blue,1,53775,53964,189
2022-08-09,70044,70052,Blue,1,77673,78242,569
2022-03-31,70047,70043,Blue,0,84624,84870,246
2022-11-05,70052,70056,Blue,1,39678,39828,150
2022-12-11,70041,70039,Blue,0,68800,68831,31
2022-10-07,70040,70054,Blue,1,22282,22999,717
2022-08-15,70049,70047,Blue,0,41634,41689,55
2022-07-10,70038,70048,Blue,1,23087,23532,445
2022-09-02,70051,70838,Blue,0,41961,42702,741
2022-08-11,70051,70838,Blue,0,46109,46884,775
2022-03-06,70059,70039,Blue,0,63015,64025,1010
2022-11-14,70049,70039,Blue,0,22418,22964,546
2022-04-06,70057,70053,Blue,0,32785,32938,153
2022-12-12,70044,70048,Blue,1,65588,65820,232
2022-03-28,70057,70041,Blue,0,72143,72935,792
2022-02-03,70040,70060,Blue,1,40207,41295,1088
2022-04-11,70057,70041,Blue,0,67249,68054,805
2022-08-29,70052,70056,Blue,1,86639,86794,155
2022-06-19,70059,70055,Blue,0,58695,58845,150
2022-06-23,70054,70058,Blue,1,38322,38517,195
2022-02-14,70045,70041,Blue,0,53966,54193,227
2022-05-12,70050,70058,Blue,1,66898,67311,413
2022-11-13,70051,70045,Blue,0,52043,52372,329
2022-05-20,70047,70041,Blue,0,43353,43826,473
2022-04-13,70051,70041,Blue,0,22829,23505,676
2022-03-02,70048,70054,Blue,1,75723,76053,330
2022-06-29,70043,70041,Blue,0,72097,72125,28
2022-07-10,70049,70045,Blue,0,69474,69684,210
2022-10-01,70059,70057,Blue,0,23483,23520,37
2022-08-15,70038,70054,Blue,1,73638,74451,813
2022-10-30,70047,70039,Blue,0,62544,62948,404
2022-10-25,70057,70053,Blue,0,70290,70437,147
2022-01-23,70046,70048,Blue,1,66517,66600,83
2022-07-24,70053,70051,Blue,0,49775,49824,49
2022-08-05,70051,70045,Blue,0,73695,74029,334
2022-05-20,70052,70058,Blue,1,68577,68860,283
2022-07-13,70051,70045,Blue,0,72015,72429,414
2022-01-22,70049,70041,Blue,0,20755,21145,390
2022-11-10,70044,70054,Blue,1,65662,66281,619
2022-10-12,70042,70058,Blue,1,54700,55599,899
2022-09-03,70048,70060,Blue,1,70671,71295,624
2022-07-05,70038,70054,Blue,1,79913,80749,836
2022-08-14,70051,70039,Blue,0,25756,26414,658
2022-06-24,70051,70041,Blue,0,77915,78476,561
2022-06-10,70055,70049,Blue,0,28675,29567,892
2022-04-20,70053,70049,Blue,0,81476,81675,199
2022-11-30,70055,70051,Blue,0,32720,32855,135
2022-09-27,70051,70047,Blue,0,29714,29961,247
2022-02-28,70040,70058,Blue,1,87194,88119,925
2022-06-14,70044,70046,Blue,1,74278,74392,114
2022-04-15,70046,70060,Blue,1,75062,75769,707
2022-06-21,70043,70039,Blue,0,78560,78674,114
2022-01-17,70038,70042,Blue,1,72949,73052,103
2022-06-10,70040,70048,Blue,1,66863,67311,448
2022-06-25,70044,70046,Blue,1,28822,28948,126
2022-10-17,70050,70058,Blue,1,26548,26947,399
2022-07-29,70053,70043,Blue,0,50774,51347,573
2022-07-26,70047,70039,Blue,0,87090,87498,408
2022-02-17,70051,70039,Blue,0,50189,50925,736
2022-04-15,70043,70838,Blue,0,62876,63094,218
2022-10-07,70055,70051,Blue,0,42329,42480,151
2022-03-09,70059,70051,Blue,0,32371,32747,376
2022-02-26,70051,70047,Blue,0,40916,41112,196
2022-01-17,70059,70838,Blue,0,26672,27928,1256
2022-12-21,70054,70058,Blue,1,36258,36408,150
2022-04-20,70051,70838,Blue,0,56967,57730,763
2022-07-10,70049,70039,Blue,0,60825,61393,568
2022-07-05,70053,70838,Blue,0,53444,54336,892
2022-03-11,70041,70039,Blue,0,54839,54872,33
2022-04-20,70042,70044,Blue,1,88513,88544,31
2022-09-03,70059,70043,Blue,0,71896,72729,833
2022-02-28,70053,70041,Blue,0,58382,59087,705
2022-03-14,70040,70058,Blue,1,61719,62717,998
2022-09-16,70057,70053,Blue,0,75996,76153,157
2022-11-30,70045,70039,Blue,0,20704,21005,301
2022-12-25,70049,70047,Blue,0,46805,46859,54
2022-08-22,70040,70060,Blue,1,85016,86103,1087
2022-06-29,70038,70058,Blue,1,56894,58106,1212
2022-01-18,70059,70045,Blue,0,52514,53213,699
2022-12-28,70043,70838,Blue,0,24980,25176,196
2022-07-01,70041,70838,Blue,0,51301,51425,124
2022-09-01,70048,70060,Blue,1,25818,26402,584
2022-02-07,70051,70043,Blue,0,58143,58670,527
2022-02-09,70049,70045,Blue,0,24147,24339,192
2022-08-30,70042,70048,Blue,1,57648,57989,341
2022-09-14,70038,70058,Blue,1,32379,33396,1017
2022-01-20,70059,70049,Blue,0,61396,61893,497
2022-03-29,70042,70060,Blue,1,32233,33209,976
2022-02-13,70055,70043,Blue,0,25093,25833,740
2022-10-13,70042,70046,Blue,1,61522,61701,179
2022-11-02,70059,70045,Blue,0,53535,54222,687
2022-02-27,70057,70045,Blue,0,78750,79378,628
2022-12-06,70039,70838,Blue,0,25082,25119,37
2022-10-10,70044,70050,Blue,1,23144,23498,354
2022-03-30,70055,70051,Blue,0,38845,38998,153
2022-09-28,70042,70054,Blue,1,59012,59740,728
2022-11-08,70059,70049,Blue,0,65051,65531,480
2022-09-07,70055,70053,Blue,0,60985,61030,45
2022-01-26,70055,70041,Blue,0,73397,74307,910
2022-01-27,70044,70050,Blue,1,56531,56930,399
2022-01-24,70038,70040,Blue,1,60441,60456,15
2022-08-23,70047,70041,Blue,0,23677,24061,384
2022-07-12,70057,70053,Blue,0,47368,47517,149
2022-06-12,70046,70048,Blue,1,51431,51524,93
2022-03-28,70052,70054,Blue,1,30577,30626,49
2022-06-09,70047,70838,Blue,0,28498,29015,517
2022-10-23,70044,70056,Blue,1,27895,28508,613
2022-08-20,70042,70046,Blue,1,47125,47302,177
2022-06-14,70052,70054,Blue,1,50521,50570,49
2022-02-26,70040,70052,Blue,1,65900,66547,647
2022-12-26,70048,70050,Blue,1,80218,80277,59
2022-07-28,70056,70058,Blue,1,32562,32635,73
2022-02-28,70054,70060,Blue,1,87367,87631,264
2022-01-21,70046,70058,Blue,1,80661,81280,619
2022-01-11,70058,70060,Blue,1,24460,24643,183
2022-03-19,70038,70060,Blue,1,56656,57799,1143
2022-01-23,70057,70051,Blue,0,42877,43163,286
2022-07-09,70052,70060,Blue,1,49895,50269,374
2022-07-19,70057,70053,Blue,0,82718,82919,201
2022-05-25,70048,70050,Blue,1,52233,52287,54
2022-06-10,70059,70057,Blue,0,43429,43471,42
2022-10-25,70057,70045,Blue,0,28127,28787,660
2022-06-21,70054,70058,Blue,1,45997,46155,158
2022-03-30,70055,70039,Blue,0,36050,36934,884
2022-06-09,70049,70043,Blue,0,44477,44852,375
2022-02-02,70038,70048,Blue,1,66256,66751,495
2022-02-01,70045,70041,Blue,0,49668,49841,173
2022-06-15,70050,70056,Blue,1,64448,64757,309
2022-08-03,70054,70058,Blue,1,75653,75815,162
2022-03-30,70052,70054,Blue,1,82824,82873,49
2022-05-02,70055,70049,Blue,0,23603,23899,296
2022-06-30,70042,70058,Blue,1,21262,22191,929
2022-10-12,70044,70050,Blue,1,26764,27114,350
2022-01-12,70046,70060,Blue,1,35637,36529,892
2022-09-14,70046,70060,Blue,1,62660,63443,783
2022-07-11,70038,70052,Blue,1,64095,64798,703
2022-08-26,70055,70838,Blue,0,60714,61689,975
2022-03-04,70051,70039,Blue,0,45332,45972,640
2022-10-10,70047,70838,Blue,0,51591,52095,504
2022-03-04,70038,70040,Blue,1,28158,28185,27
2022-10-03,70056,70060,Blue,1,64516,64705,189
2022-02-07,70059,70838,Blue,0,76033,77168,1135
2022-06-10,70046,70050,Blue,1,25315,25520,205
2022-01-07,70052,70060,Blue,1,67600,68169,569
2022-11-06,70059,70057,Blue,0,73818,73852,34
2022-09-03,70042,70044,Blue,1,80084,80115,31
2022-09-12,70056,70058,Blue,1,79281,79362,81
2022-06-12,70051,70838,Blue,0,50417,51121,704
2022-05-19,70040,70058,Blue,1,42694,43803,1109
2022-06-20,70051,70039,Blue,0,63175,63918,743
2022-09-08,70051,70045,Blue,0,81628,81971,343
2022-12-03,70053,70039,Blue,0,72188,72986,798
2022-05-04,70055,70047,Blue,0,80591,80968,377
2022-11-21,70038,70040,Blue,1,28575,28591,16
2022-02-17,70051,70043,Blue,0,60923,61456,533
2022-03-28,70054,70056,Blue,1,66063,66109,46
2022-10-27,70040,70044,Blue,1,42105,42219,114
2022-08-03,70040,70052,Blue,1,33789,34486,697
2022-07-26,70040,70048,Blue,1,53805,54225,420
2022-05-30,70039,70838,Blue,0,82016,82050,34
2022-01-07,70038,70044,Blue,1,28460,28643,183
2022-10-04,70057,70039,Blue,0,21452,22444,992
2022-01-28,70055,70045,Blue,0,66673,67226,553
2022-03-30,70059,70838,Blue,0,67167,68320,1153
2022-12-23,70046,70052,Blue,1,29998,30343,345
2022-10-31,70047,70039,Blue,0,34121,34553,432
2022-12-31,70038,70054,Blue,1,35073,35836,763
2022-08-22,70055,70047,Blue,0,75706,76079,373
2022-09-01,70042,70052,Blue,1,33422,33985,563
2022-08-03,70057,70053,Blue,0,30641,30794,153
2022-01-08,70056,70058,Blue,1,38287,38358,71
2022-02-25,70044,70054,Blue,1,83435,84054,619
2022-02-23,70057,70041,Blue,0,30646,31614,968
2022-12-13,70051,70047,Blue,0,75273,75511,238
2022-10-20,70044,70058,Blue,1,25398,26134,736
2022-01-17,70055,70051,Blue,0,34873,35085,212
2022-07-06,70055,70045,Blue,0,80035,80551,516
2022-04-03,70045,70043,Blue,0,26176,26258,82
2022-12-14,70059,70053,Blue,0,20423,20657,234
2022-04-15,70041,70039,Blue,0,64457,64494,37
2022-08-31,70055,70049,Blue,0,19737,20045,308
2022-02-14,70051,70043,Blue,0,78194,78702,508
2022-02-19,70040,70054,Blue,1,23064,23850,786
2022-11-29,70038,70044,Blue,1,87371,87527,156
2022-07-25,70053,70045,Blue,0,36682,37182,500
2022-03-20,70057,70045,Blue,0,76618,77252,634
2022-08-19,70054,70056,Blue,1,39761,39810,49
2022-08-05,70049,70043,Blue,0,25328,25656,328
2022-06-17,70053,70047,Blue,0,51027,51334,307
2022-01-06,70047,70043,Blue,0,85781,86007,226
2022-05-06,70051,70047,Blue,0,28455,28685,230
2022-09-27,70042,70048,Blue,1,71327,71652,325
2022-05-15,70050,70054,Blue,1,40520,40760,240
2022-08-03,70049,70043,Blue,0,30281,30686,405
2022-07-05,70057,70053,Blue,0,43361,43518,157
2022-12-26,70047,70043,Blue,0,29126,29362,236
2022-02-28,70049,70041,Blue,0,28215,28685,470
2022-06-15,70059,70055,Blue,0,85156,85312,156
2022-12-06,70053,70049,Blue,0,69418,69604,186
2022-11-03,70051,70045,Blue,0,86888,87228,340
2022-11-20,70051,70838,Blue,0,52053,52776,723
2022-10-03,70054,70060,Blue,1,34682,34961,279
2022-09-20,70057,70041,Blue,0,28002,28907,905
2022-10-07,70038,70042,Blue,1,78877,78979,102
2022-03-16,70038,70042,Blue,1,82008,82112,104
2022-04-19,70051,70039,Blue,0,40861,41726,865
2022-04-01,70051,70043,Blue,0,55781,56298,517
2022-08-22,70043,70039,Blue,0,84514,84614,100
2022-06-29,70048,70054,Blue,1,78395,78712,317
2022-09-09,70050,70060,Blue,1,58293,58841,548
2022-01-06,70047,70838,Blue,0,70685,71147,462
2022-03-07,70044,70058,Blue,1,82216,83043,827
2022-11-13,70044,70052,Blue,1,69030,69497,467
2022-06-21,70055,70051,Blue,0,27768,27930,162
2022-02-06,70038,70056,Blue,1,69373,70312,939
2022-02-18,70056,70058,Blue,1,23022,23175,153
2022-08-10,70059,70041,Blue,0,61876,62865,989
2022-12-29,70038,70048,Blue,1,22804,23262,458
2022-03-29,70044,70060,Blue,1,56164,57121,957
2022-10-12,70049,70047,Blue,0,37041,37095,54
2022-01-05,70057,70047,Blue,0,65380,65909,529
2022-01-07,70057,70043,Blue,0,54583,55365,782
2022-04-01,70039,70838,Blue,0,54911,54945,34
2022-05-13,70054,70060,Blue,1,82929,83213,284
2022-08-30,70040,70060,Blue,1,76823,77875,1052
2022-12-19,70053,70039,Blue,0,80982,81693,711
2022-11-02,70053,70047,Blue,0,37396,37797,401
2022-07-20,70059,70047,Blue,0,59034,59591,557
2022-10-11,70038,70040,Blue,1,59046,59059,13
2022-01-12,70040,70048,Blue,1,79154,79548,394
2022-12-17,70045,70838,Blue,0,74280,74619,339
2022-08-01,70053,70041,Blue,0,43972,44682,710
2022-01-14,70057,70047,Blue,0,31831,32293,462
2022-03-15,70053,70049,Blue,0,80860,81061,201
2022-04-20,70038,70060,Blue,1,58957,60155,1198
2022-10-16,70050,70054,Blue,1,44253,44454,201
2022-04-15,70051,70041,Blue,0,32748,33337,589
2022-02-22,70053,70838,Blue,0,31121,31991,870
2022-10-24,70042,70050,Blue,1,25056,25481,425
2022-02-28,70040,70048,Blue,1,74111,74502,391
2022-09-22,70059,70049,Blue,0,52510,53002,492
2022-09-28,70049,70041,Blue,0,68635,69045,410
2022-11-20,70059,70043,Blue,0,42022,42870,848
2022-06-26,70040,70058,Blue,1,34099,35070,971
2022-03-08,70055,70049,Blue,0,49955,50293,338
2022-09-22,70043,70041,Blue,0,51231,51258,27
2022-06-14,70044,70048,Blue,1,51039,51336,297
2022-10-10,70045,70039,Blue,0,86610,86845,235
2022-02-20,70048,70058,Blue,1,44238,44753,515
2022-10-24,70043,70838,Blue,0,41029,41258,229
2022-01-06,70047,70039,Blue,0,49986,50536,550
2022-04-14,70046,70048,Blue,1,86986,87072,86
2022-10-02,70047,70041,Blue,0,82357,82679,322
2022-02-14,70053,70051,Blue,0,41266,41326,60
2022-09-07,70040,70044,Blue,1,69025,69135,110
2022-01-25,70044,70050,Blue,1,31829,32188,359
2022-08-11,70049,70039,Blue,0,83968,84458,490
2022-10-10,70057,70041,Blue,0,74975,75878,903
2022-10-03,70048,70056,Blue,1,87322,87747,425
2022-07-04,70051,70045,Blue,0,39313,39649,336
2022-04-01,70048,70052,Blue,1,34109,34313,204
2022-01-04,70053,70051,Blue,0,60204,60266,62
2022-06-20,70042,70044,Blue,1,80090,80119,29
2022-12-29,70052,70060,Blue,1,72180,72498,318
2022-10-25,70040,70048,Blue,1,63939,64433,494
2022-07-17,70053,70838,Blue,0,39761,40610,849
2022-07-21,70057,70838,Blue,0,63768,64791,1023
2022-03-03,70050,70054,Blue,1,46763,46963,200
2022-01-27,70047,70838,Blue,0,47707,48176,469
2022-07-09,70055,70053,Blue,0,62366,62412,46
2022-12-30,70057,70045,Blue,0,53355,53941,586
2022-12-12,70043,70041,Blue,0,25220,25249,29
2022-09-03,70057,70053,Blue,0,46058,46215,157
2022-12-18,70053,70039,Blue,0,60216,60975,759
2022-04-05,70043,70838,Blue,0,46498,46696,198
2022-05-12,70059,70057,Blue,0,43525,43562,37
2022-11-30,70040,70054,Blue,1,58421,59266,845
2022-06-16,70042,70052,Blue,1,27118,27741,623
2022-02-12,70045,70838,Blue,0,62933,63287,354
2022-04-18,70054,70056,Blue,1,68218,68265,47
2022-05-15,70050,70060,Blue,1,28501,29027,526
2022-04-20,70053,70043,Blue,0,67414,68001,587
2022-05-20,70055,70051,Blue,0,70701,70838,137
2022-09-06,70053,70838,Blue,0,36265,37294,1029
2022-02-17,70042,70058,Blue,1,66611,67431,820
2022-10-06,70055,70053,Blue,0,23264,23316,52
2022-05-29,70040,70050,Blue,1,23189,23749,560
2022-02-09,70049,70039,Blue,0,45442,45955,513
2022-10-26,70049,70041,Blue,0,66077,66518,441
2022-03-25,70040,70050,Blue,1,70996,71485,489
2022-02-15,70043,70838,Blue,0,42963,43157,194
2022-09-02,70048,70050,Blue,1,63914,63971,57
2022-12-15,70038,70040,Blue,1,86534,86547,13
2022-11-21,70044,70054,Blue,1,30051,30699,648
2022-01-01,70059,70039,Blue,0,44657,45701,1044
2022-11-04,70053,70051,Blue,0,60753,60805,52
2022-03-24,70046,70054,Blue,1,23740,24228,488
2022-07-03,70052,70056,Blue,1,76631,76782,151
2022-07-02,70043,70039,Blue,0,72802,72917,115
2022-11-29,70057,70045,Blue,0,72325,72905,580
2022-02-15,70038,70046,Blue,1,67035,67356,321
2022-11-02,70042,70046,Blue,1,80841,81016,175
2022-12-09,70042,70046,Blue,1,52501,52716,215
2022-03-05,70049,70047,Blue,0,75117,75169,52
2022-01-09,70040,70056,Blue,1,44372,45209,837
2022-08-31,70042,70056,Blue,1,55650,56421,771
2022-06-23,70057,70053,Blue,0,47674,47828,154
2022-04-17,70053,70039,Blue,0,22534,23256,722
2022-01-24,70055,70041,Blue,0,31769,32651,882
2022-02-08,70057,70838,Blue,0,50318,51324,1006
2022-09-08,70051,70838,Blue,0,25194,25961,767
2022-12-22,70044,70054,Blue,1,27381,27951,570
2022-05-15,70057,70053,Blue,0,62491,62642,151
2022-03-29,70040,70052,Blue,1,28540,29220,680
2022-09-23,70057,70045,Blue,0,40664,41346,682
2022-09-09,70059,70057,Blue,0,59799,59836,37
2022-02-08,70056,70058,Blue,1,88095,88184,89
2022-09-14,70051,70045,Blue,0,52314,52645,331
2022-10-19,70052,70060,Blue,1,61970,62331,361
2022-07-26,70053,70045,Blue,0,66191,66644,453
2022-10-16,70040,70054,Blue,1,29287,30039,752
2022-04-15,70046,70058,Blue,1,72338,72940,602
2022-04-08,70059,70055,Blue,0,54200,54344,144
2022-01-07,70050,70060,Blue,1,78753,79305,552
2022-07-12,70046,70056,Blue,1,65641,66147,506
2022-06-14,70047,70838,Blue,0,80724,81323,599
2022-07-01,70041,70838,Blue,0,65811,65932,121
2022-11-04,70038,70052,Blue,1,57900,58674,774
2022-11-19,70047,70039,Blue,0,41764,42150,386
2022-07-29,70050,70060,Blue,1,51893,52472,579
2022-08-23,70045,70039,Blue,0,67623,67886,263
2022-09-02,70044,70058,Blue,1,71570,72377,807
2022-01-07,70053,70045,Blue,0,29440,29971,531
2022-01-03,70049,70045,Blue,0,43716,43902,186
2022-04-13,70059,70045,Blue,0,48192,48951,759
2022-04-09,70046,70060,Blue,1,30561,31255,694
2022-07-14,70055,70047,Blue,0,87595,87963,368
2022-05-15,70053,70051,Blue,0,54908,54969,61
2022-02-14,70054,70058,Blue,1,58882,59105,223
2022-03-29,70040,70048,Blue,1,45539,45937,398
2022-07-09,70042,70060,Blue,1,60619,61642,1023
2022-09-23,70053,70039,Blue,0,25034,25848,814
2022-11-17,70052,70056,Blue,1,41199,41353,154
2022-06-15,70052,70054,Blue,1,88520,88582,62
2022-06-30,70048,70050,Blue,1,70097,70159,62
2022-06-14,70040,70058,Blue,1,65597,66664,1067
2022-07-02,70048,70060,Blue,1,22195,22817,622
2022-11-16,70050,70060,Blue,1,44137,44662,525
2022-09-12,70059,70055,Blue,0,25113,25258,145
2022-04-23,70052,70060,Blue,1,52103,52470,367
2022-02-22,70054,70060,Blue,1,33532,33801,269
2022-03-01,70055,70051,Blue,0,58472,58622,150
2022-10-07,70059,70049,Blue,0,31402,31896,494
2022-06-11,70045,70838,Blue,0,79434,79800,366
2022-08-16,70057,70045,Blue,0,46348,47016,668
2022-10-17,70046,70060,Blue,1,30070,30952,882
2022-08-09,70055,70041,Blue,0,65517,66295,778
2022-05-18,70047,70045,Blue,0,62961,63122,161
2022-10-28,70055,70049,Blue,0,32418,32698,280
2022-01-26,70059,70045,Blue,0,35233,35986,753
2022-09-23,70059,70049,Blue,0,64765,65223,458
2022-05-28,70044,70046,Blue,1,24520,24644,124
2022-10-16,70040,70042,Blue,1,81096,81125,29
2022-02-10,70057,70838,Blue,0,88185,89623,1438
2022-07-09,70051,70041,Blue,0,39333,40061,728
2022-03-01,70040,70044,Blue,1,33939,34051,112
2022-11-04,70059,70051,Blue,0,31814,32138,324
2022-07-26,70051,70838,Blue,0,72157,72862,705
2022-04-23,70042,70054,Blue,1,31606,32313,707
2022-03-05,70045,70039,Blue,0,74769,74998,229
2022-08-14,70046,70060,Blue,1,64464,65191,727
2022-07-18,70048,70054,Blue,1,80172,80467,295
2022-11-05,70049,70838,Blue,0,48113,48709,596
2022-08-10,70053,70039,Blue,0,84733,85435,702
2022-02-19,70059,70838,Blue,0,43812,44934,1122
2022-07-06,70053,70039,Blue,0,59315,60027,712
2022-06-14,70059,70053,Blue,0,19877,20268,391
2022-08-22,70049,70047,Blue,0,74743,74815,72
2022-08-17,70038,70042,Blue,1,26388,26486,98
2022-08-07,70051,70049,Blue,0,32769,32872,103
2022-12-27,70057,70045,Blue,0,37839,38427,588
2022-07-21,70049,70838,Blue,0,67604,68224,620
2022-11-12,70053,70049,Blue,0,58137,58343,206
2022-07-31,70040,70058,Blue,1,52692,53655,963
2022-05-23,70038,70040,Blue,1,80407,80422,15
2022-03-07,70055,70039,Blue,0,31038,31966,928
2022-10-15,70038,70060,Blue,1,46418,47653,1235
2022-09-03,70040,70042,Blue,1,24416,24449,33
2022-07-03,70053,70043,Blue,0,47615,48214,599
2022-06-22,70053,70045,Blue,0,56726,57200,474
2022-03-29,70052,70060,Blue,1,62952,63416,464
2022-11-24,70049,70041,Blue,0,50537,50978,441
2022-01-14,70047,70041,Blue,0,27601,27976,375
2022-09-20,70055,70049,Blue,0,82221,82479,258
2022-05-21,70040,70048,Blue,1,27349,27850,501
2022-03-23,70049,70039,Blue,0,80005,80575,570
2022-07-06,70059,70043,Blue,0,56955,57845,890
2022-04-04,70052,70058,Blue,1,38139,38447,308
2022-02-28,70051,70047,Blue,0,67153,67348,195
2022-11-24,70054,70060,Blue,1,73946,74211,265
2022-12-23,70049,70838,Blue,0,19785,20483,698
2022-10-18,70042,70054,Blue,1,68659,69315,656
2022-01-10,70044,70048,Blue,1,57953,58254,301
2022-03-01,70047,70039,Blue,0,55429,55875,446
2022-07-12,70046,70048,Blue,1,76734,76815,81
2022-05-30,70038,70040,Blue,1,22883,22899,16
2022-06-14,70057,70045,Blue,0,63273,63892,619
2022-10-05,70049,70045,Blue,0,87091,87294,203
2022-09-21,70053,70049,Blue,0,38361,38569,208
2022-10-15,70046,70058,Blue,1,33404,33979,575
2022-04-12,70049,70041,Blue,0,65476,65864,388
2022-02-14,70054,70060,Blue,1,26040,26380,340
2022-09-27,70056,70060,Blue,1,26937,27107,170
2022-03-29,70048,70056,Blue,1,53525,53894,369
2022-12-02,70057,70049,Blue,0,33446,33830,384
2022-12-02,70059,70041,Blue,0,30136,31021,885
2022-04-12,70057,70039,Blue,0,79544,80562,1018
2022-07-18,70038,70060,Blue,1,58717,60096,1379
2022-01-17,70057,70053,Blue,0,78518,78689,171
2022-01-15,70046,70054,Blue,1,34940,35378,438
2022-09-22,70039,70838,Blue,0,60425,60461,36
2022-11-13,70057,70041,Blue,0,51771,52598,827
2022-02-12,70057,70045,Blue,0,28760,29406,646
2022-08-07,70054,70060,Blue,1,71351,71616,265
2022-01-18,70044,70046,Blue,1,74987,75100,113
2022-01-08,70054,70060,Blue,1,32088,32388,300
2022-06-19,70038,70048,Blue,1,63795,64322,527
2022-10-06,70059,70053,Blue,0,67093,67321,228
2022-08-12,70048,70060,Blue,1,39625,40309,684
2022-12-09,70046,70056,Blue,1,80984,81493,509
2022-11-08,70042,70052,Blue,1,30899,31498,599
2022-02-20,70042,70056,Blue,1,72212,72907,695
2022-10-19,70045,70039,Blue,0,52319,52577,258
2022-07-29,70040,70060,Blue,1,76434,77445,1011
2022-10-13,70042,70044,Blue,1,48818,48846,28
2022-04-08,70059,70055,Blue,0,49754,49897,143
2022-11-28,70055,70049,Blue,0,39234,39535,301
2022-12-26,70051,70047,Blue,0,49319,49509,190
2022-06-13,70040,70048,Blue,1,59606,60106,500
2022-04-19,70046,70052,Blue,1,51586,51919,333
2022-02-08,70044,70046,Blue,1,51032,51138,106
2022-12-05,70057,70049,Blue,0,40678,41092,414
2022-02-06,70059,70041,Blue,0,58693,59620,927
2022-03-05,70044,70048,Blue,1,64996,65241,245
2022-03-08,70049,70047,Blue,0,40369,40438,69
2022-12-10,70053,70049,Blue,0,37673,37869,196
2022-08-24,70059,70057,Blue,0,24255,24289,34
2022-07-14,70057,70045,Blue,0,55325,55949,624
2022-10-18,70054,70058,Blue,1,24582,24737,155
2022-07-26,70049,70045,Blue,0,41257,41704,447
2022-03-17,70048,70058,Blue,1,62163,62806,643
2022-09-09,70051,70045,Blue,0,28444,28813,369
2022-04-20,70038,70060,Blue,1,26418,27697,1279
2022-07-25,70054,70056,Blue,1,69038,69086,48
2022-02-03,70058,70060,Blue,1,26078,26289,211
2022-04-18,70042,70054,Blue,1,39808,40475,667
2022-04-18,70039,70838,Blue,0,43842,43878,36
2022-12-31,70054,70058,Blue,1,49392,49544,152
2022-03-26,70057,70838,Blue,0,39041,40140,1099
2022-10-12,70040,70046,Blue,1,77886,78138,252
2022-01-24,70051,70047,Blue,0,35699,35903,204
2022-03-21,70050,70058,Blue,1,40184,40584,400
2022-03-09,70038,70056,Blue,1,28764,29656,892
2022-09-28,70054,70060,Blue,1,32101,32365,264
2022-11-23,70055,70039,Blue,0,52170,53022,852
2022-07-21,70046,70058,Blue,1,73599,74380,781
2022-02-15,70038,70058,Blue,1,36734,37704,970
2022-01-10,70054,70056,Blue,1,23914,23970,56
2022-04-28,70051,70049,Blue,0,30106,30208,102
2022-06-29,70045,70041,Blue,0,60509,60698,189
2022-02-11,70040,70054,Blue,1,65125,65892,767
2022-08-03,70046,70048,Blue,1,51094,51173,79
2022-01-06,70049,70045,Blue,0,46417,46682,265
2022-11-12,70044,70052,Blue,1,35279,35808,529
2022-10-15,70044,70052,Blue,1,52008,52514,506
2022-08-17,70057,70045,Blue,0,38555,39212,657
2022-01-18,70051,70043,Blue,0,50789,51343,554
2022-10-21,70055,70041,Blue,0,37341,38256,915
2022-03-24,70059,70049,Blue,0,86298,86834,536
2022-07-13,70047,70043,Blue,0,42339,42745,406
2022-02-18,70040,70046,Blue,1,82917,83192,275
2022-10-06,70042,70054,Blue,1,80497,81199,702
2022-11-03,70045,70043,Blue,0,52785,52894,109
2022-08-11,70055,70041,Blue,0,22756,23569,813
2022-01-20,70040,70054,Blue,1,24016,24778,762
2022-01-01,70059,70039,Blue,0,53834,54866,1032
2022-12-01,70053,70039,Blue,0,56953,57725,772
2022-08-30,70040,70056,Blue,1,22458,23262,804
2022-01-13,70054,70056,Blue,1,52501,52548,47
2022-09-26,70042,70048,Blue,1,72209,72514,305
2022-12-16,70044,70060,Blue,1,57335,58251,916
2022-06-17,70046,70054,Blue,1,83183,83630,447
2022-06-30,70038,70056,Blue,1,40904,41991,1087
2022-09-22,70042,70054,Blue,1,56633,57274,641
2022-08-16,70057,70053,Blue,0,75450,75609,159
2022-03-31,70048,70058,Blue,1,20907,21463,556
2022-06-20,70049,70047,Blue,0,57298,57354,56
2022-07-09,70045,70838,Blue,0,45174,45570,396
2022-12-26,70053,70045,Blue,0,25674,26109,435
2022-11-13,70038,70052,Blue,1,40990,41714,724
2022-02-01,70039,70838,Blue,0,20811,20849,38
2022-09-27,70048,70060,Blue,1,63910,64524,614
2022-06-09,70040,70052,Blue,1,68079,68771,692
2022-03-18,70038,70044,Blue,1,86029,86208,179
2022-02-15,70038,70060,Blue,1,64332,65530,1198
2022-08-18,70044,70058,Blue,1,78469,79242,773
2022-03-06,70038,70046,Blue,1,24553,24874,321
2022-08-19,70042,70054,Blue,1,63101,63843,742
2022-11-25,70056,70060,Blue,1,65290,65461,171
2022-12-19,70040,70048,Blue,1,59608,60066,458
2022-06-29,70040,70042,Blue,1,53277,53312,35
2022-08-25,70047,70039,Blue,0,58403,58871,468
2022-02-25,70055,70047,Blue,0,25964,26426,462
2022-04-16,70051,70043,Blue,0,35033,35595,562
2022-07-12,70042,70048,Blue,1,30820,31154,334
2022-08-03,70051,70047,Blue,0,70632,70843,211
2022-04-01,70042,70048,Blue,1,82730,83035,305
2022-01-07,70042,70058,Blue,1,30390,31383,993
2022-05-06,70059,70051,Blue,0,36333,36677,344
2022-10-17,70055,70049,Blue,0,49030,49313,283
2022-11-19,70055,70051,Blue,0,85027,85162,135
2022-05-27,70047,70838,Blue,0,40769,41365,596
2022-02-05,70050,70056,Blue,1,33461,33786,325
2022-06-13,70056,70058,Blue,1,73878,73947,69
2022-06-22,70049,70047,Blue,0,52461,52520,59
2022-06-30,70038,70044,Blue,1,43653,43881,228
2022-09-18,70047,70838,Blue,0,39530,40075,545
2022-05-06,70050,70054,Blue,1,58314,58524,210
2022-08-27,70042,70058,Blue,1,76781,77690,909
2022-06-20,70041,70039,Blue,0,53944,53977,33
2022-03-18,70050,70060,Blue,1,53633,54409,776
2022-11-07,70038,70058,Blue,1,59477,60739,1262
2022-11-10,70040,70044,Blue,1,46152,46265,113
2022-06-28,70053,70039,Blue,0,34706,35495,789
2022-01-26,70040,70056,Blue,1,49340,50416,1076
2022-03-21,70049,70039,Blue,0,22275,22805,530
2022-06-15,70043,70041,Blue,0,34608,34638,30
2022-07-21,70057,70047,Blue,0,46415,46910,495
2022-01-26,70046,70052,Blue,1,50193,50537,344
2022-03-21,70047,70838,Blue,0,33583,34119,536
2022-08-10,70044,70046,Blue,1,46393,46495,102
2022-11-01,70042,70046,Blue,1,58250,58496,246
2022-01-21,70059,70041,Blue,0,56591,57525,934
2022-01-07,70048,70052,Blue,1,50812,51110,298
2022-07-08,70059,70049,Blue,0,58971,59450,479
2022-03-31,70044,70056,Blue,1,77735,78533,798
2022-02-20,70042,70054,Blue,1,54404,55028,624
2022-07-28,70055,70049,Blue,0,34128,34428,300
2022-07-31,70040,70046,Blue,1,49450,49707,257
2022-09-09,70041,70838,Blue,0,64140,64275,135
2022-12-28,70051,70043,Blue,0,39697,40254,557
2022-10-13,70038,70042,Blue,1,68958,69061,103
2022-08-06,70038,70058,Blue,1,19816,20790,974
2022-04-23,70059,70051,Blue,0,44353,44670,317
2022-04-08,70059,70053,Blue,0,84012,84229,217
2022-02-06,70050,70058,Blue,1,67236,67794,558
2022-01-29,70038,70042,Blue,1,32348,32439,91
2022-01-03,70059,70838,Blue,0,24874,25916,1042
2022-11-28,70038,70052,Blue,1,61796,62562,766
2022-06-23,70055,70053,Blue,0,24024,24094,70
2022-01-26,70038,70042,Blue,1,62835,62927,92
2022-02-18,70040,70058,Blue,1,88395,89617,1222
2022-03-14,70046,70054,Blue,1,23991,24442,451
2022-02-14,70053,70047,Blue,0,67456,67739,283
2022-12-23,70053,70039,Blue,0,57503,58249,746
2022-04-21,70038,70054,Blue,1,29046,29814,768
2022-12-02,70038,70054,Blue,1,24815,25563,748
2022-03-11,70049,70838,Blue,0,24473,25067,594
2022-10-05,70040,70056,Blue,1,61214,62050,836
2022-02-01,70046,70050,Blue,1,82970,83157,187
2022-01-14,70038,70050,Blue,1,64949,65550,601
2022-09-09,70057,70053,Blue,0,25318,25469,151
2022-09-21,70053,70838,Blue,0,67845,68660,815
2022-08-10,70053,70043,Blue,0,24941,25549,608
2022-02-12,70048,70054,Blue,1,66978,67290,312
2022-01-16,70045,70838,Blue,0,55697,56072,375
2022-08-08,70052,70054,Blue,1,38099,38166,67
2022-10-09,70049,70043,Blue,0,42626,43020,394
2022-10-17,70040,70050,Blue,1,57375,57865,490
2022-01-25,70055,70041,Blue,0,32493,33336,843
2022-06-24,70059,70041,Blue,0,53978,54955,977
2022-03-19,70046,70048,Blue,1,54342,54442,100
2022-04-18,70056,70058,Blue,1,37762,37835,73
2022-05-27,70048,70052,Blue,1,63800,64083,283
2022-03-29,70059,70047,Blue,0,80052,80579,527
2022-08-21,70051,70047,Blue,0,71475,71672,197
2022-06-29,70059,70051,Blue,0,77355,77686,331
2022-02-17,70059,70043,Blue,0,57799,58646,847
2022-07-08,70047,70043,Blue,0,73980,74233,253
2022-09-27,70041,70838,Blue,0,33818,33943,125
2022-11-30,70053,70049,Blue,0,35080,35334,254
2022-07-06,70059,70049,Blue,0,48373,48818,445
2022-11-24,70042,70046,Blue,1,73284,73453,169
2022-04-04,70048,70052,Blue,1,54524,54727,203
2022-01-08,70048,70056,Blue,1,41528,41940,412
2022-10-14,70049,70045,Blue,0,34049,34254,205
2022-07-03,70054,70056,Blue,1,57388,57435,47
2022-10-22,70051,70043,Blue,0,19895,20405,510
2022-10-07,70050,70060,Blue,1,71360,71876,516
2022-04-13,70038,70048,Blue,1,29950,30449,499
2022-12-31,70053,70043,Blue,0,80724,81258,534
2022-07-11,70059,70047,Blue,0,80505,81036,531
2022-08-18,70045,70838,Blue,0,69027,69361,334
2022-06-22,70044,70050,Blue,1,61695,62115,420
2022-03-02,70053,70045,Blue,0,58965,59362,397
2022-09-23,70038,70048,Blue,1,48317,48795,478
2022-06-19,70046,70056,Blue,1,65229,65763,534
2022-03-16,70048,70054,Blue,1,66660,66957,297
2022-03-21,70043,70838,Blue,0,54791,55000,209
2022-06-19,70057,70039,Blue,0,24980,25959,979
2022-09-30,70046,70056,Blue,1,52780,53287,507
2022-06-14,70052,70054,Blue,1,61561,61621,60
2022-04-08,70046,70060,Blue,1,75201,75947,746
2022-09-03,70057,70039,Blue,0,46586,47591,1005
2022-11-21,70053,70051,Blue,0,65792,65841,49
2022-07-22,70052,70058,Blue,1,27063,27346,283
2022-10-05,70053,70045,Blue,0,40855,41297,442
2022-01-02,70045,70041,Blue,0,69714,69871,157
2022-06-28,70055,70053,Blue,0,69993,70042,49
2022-06-13,70052,70058,Blue,1,47161,47400,239
2022-12-16,70038,70044,Blue,1,45652,45815,163
2022-03-17,70040,70060,Blue,1,81020,82195,1175
2022-05-05,70058,70060,Blue,1,42209,42281,72
2022-12-07,70038,70060,Blue,1,29451,30624,1173
2022-07-17,70059,70047,Blue,0,32425,32967,542
2022-06-24,70040,70046,Blue,1,38171,38517,346
2022-09-15,70053,70051,Blue,0,63430,63486,56
2022-05-09,70050,70058,Blue,1,21529,22032,503
2022-08-19,70042,70058,Blue,1,29210,30125,915
2022-08-27,70050,70052,Blue,1,54561,54677,116
2022-09-22,70053,70838,Blue,0,32997,33984,987
2022-08-07,70050,70058,Blue,1,82546,82972,426
2022-03-26,70053,70838,Blue,0,30585,31413,828
2022-10-08,70043,70838,Blue,0,64703,64917,214
2022-07-27,70038,70040,Blue,1,61273,61288,15
2022-06-27,70053,70045,Blue,0,20338,20786,448
2022-11-24,70053,70041,Blue,0,64364,64992,628
2022-05-13,70059,70049,Blue,0,32235,32681,446
2022-01-24,70049,70039,Blue,0,50313,50867,554
2022-02-01,70053,70039,Blue,0,41811,42623,812
2022-09-25,70038,70056,Blue,1,79688,80605,917
2022-07-23,70044,70050,Blue,1,76350,76711,361
2022-03-16,70056,70060,Blue,1,38372,38564,192
2022-06-29,70057,70047,Blue,0,44254,44725,471
2022-09-02,70059,70053,Blue,0,39007,39324,317
2022-09-14,70050,70052,Blue,1,84914,85024,110
2022-09-23,70042,70048,Blue,1,28475,28810,335
2022-10-19,70046,70060,Blue,1,69578,70399,821
2022-08-23,70051,70043,Blue,0,20885,21428,543
2022-09-22,70051,70049,Blue,0,46689,46798,109
2022-06-18,70059,70041,Blue,0,72976,73999,1023
2022-07-19,70050,70052,Blue,1,31615,31758,143
2022-12-20,70055,70051,Blue,0,75746,75893,147
2022-06-13,70055,70041,Blue,0,57980,58724,744
2022-06-09,70043,70838,Blue,0,55512,55714,202
2022-08-11,70055,70041,Blue,0,75082,75758,676
2022-03-18,70056,70058,Blue,1,58092,58168,76
2022-07-01,70059,70051,Blue,0,38727,39110,383
2022-01-24,70038,70048,Blue,1,63132,63611,479
2022-11-15,70046,70060,Blue,1,43907,44650,743
2022-10-10,70040,70046,Blue,1,31575,31869,294
2022-12-16,70042,70048,Blue,1,62433,62758,325
2022-06-22,70040,70050,Blue,1,25602,26221,619
2022-12-02,70045,70041,Blue,0,49640,49819,179
2022-06-11,70040,70056,Blue,1,49745,50675,930
2022-12-09,70052,70058,Blue,1,55131,55377,246
2022-12-07,70053,70041,Blue,0,81441,82131,690
2022-07-11,70042,70054,Blue,1,35103,35852,749
2022-06-11,70051,70049,Blue,0,25220,25323,103
2022-10-27,70046,70050,Blue,1,61143,61326,183
2022-03-26,70042,70048,Blue,1,29241,29535,294
2022-01-11,70052,70054,Blue,1,52973,53023,50
2022-01-27,70043,70039,Blue,0,66686,66795,109
2022-01-10,70038,70040,Blue,1,88364,88379,15
2022-09-14,70045,70838,Blue,0,38211,38561,350
2022-07-07,70050,70054,Blue,1,21920,22155,235
2022-06-27,70053,70049,Blue,0,49186,49417,231
2022-05-07,70059,70057,Blue,0,85222,85258,36
2022-01-02,70042,70054,Blue,1,61418,62110,692
2022-10-13,70051,70049,Blue,0,87687,87797,110
2022-06-09,70044,70054,Blue,1,64443,65088,645
2022-08-16,70055,70045,Blue,0,67457,67978,521
2022-08-24,70042,70058,Blue,1,45333,46271,938
2022-06-11,70050,70052,Blue,1,84500,84612,112
2022-10-22,70038,70050,Blue,1,29654,30192,538
2022-04-12,70055,70051,Blue,0,66687,66834,147
2022-04-11,70046,70052,Blue,1,54112,54445,333
2022-09-17,70041,70838,Blue,0,53042,53185,143
2022-03-24,70059,70049,Blue,0,50239,50717,478
2022-07-07,70046,70054,Blue,1,29387,29844,457
2022-02-23,70059,70057,Blue,0,32079,32113,34
2022-10-26,70052,70058,Blue,1,82991,83240,249
2022-05-19,70046,70048,Blue,1,53502,53607,105
2022-03-12,70043,70838,Blue,0,38726,38911,185
2022-10-19,70053,70045,Blue,0,87580,88030,450
2022-10-03,70044,70048,Blue,1,45441,45673,232
2022-10-03,70051,70047,Blue,0,66814,67007,193
2022-01-12,70042,70048,Blue,1,63578,63881,303
2022-09-12,70047,70838,Blue,0,52938,53419,481
2022-11-13,70053,70838,Blue,0,50848,51643,795
2022-01-08,70048,70054,Blue,1,64716,65028,312
2022-10-18,70047,70043,Blue,0,47464,47709,245
2022-04-24,70038,70058,Blue,1,47769,48775,1006
2022-10-13,70051,70043,Blue,0,44270,44773,503
2022-07-23,70042,70056,Blue,1,61669,62441,772
2022-06-29,70051,70838,Blue,0,24200,25131,931
2022-09-03,70049,70041,Blue,0,34050,34504,454
2022-06-10,70057,70838,Blue,0,29976,31134,1158
2022-09-11,70045,70039,Blue,0,74552,74793,241
2022-03-14,70056,70060,Blue,1,59930,60145,215
2022-10-15,70038,70042,Blue,1,48548,48646,98
2022-11-15,70051,70047,Blue,0,57127,57326,199
2022-12-01,70044,70046,Blue,1,47936,48043,107
2022-04-15,70047,70041,Blue,0,59281,59635,354
2022-12-28,70051,70043,Blue,0,32953,33445,492
2022-03-21,70040,70046,Blue,1,26421,26684,263
2022-01-23,70040,70058,Blue,1,72662,73554,892
2022-04-18,70056,70060,Blue,1,90131,90296,165
2022-11-25,70042,70044,Blue,1,21550,21582,32
2022-07-06,70044,70046,Blue,1,61019,61136,117
2022-11-02,70054,70058,Blue,1,71320,71473,153
2022-11-22,70042,70048,Blue,1,54709,55036,327
2022-07-29,70048,70054,Blue,1,65885,66239,354
2022-02-09,70053,70051,Blue,0,33293,33355,62
2022-10-07,70059,70047,Blue,0,57557,58123,566
2022-01-05,70044,70060,Blue,1,78319,79315,996
2022-06-24,70059,70049,Blue,0,52521,52990,469
2022-07-04,70038,70058,Blue,1,59530,60563,1033
2022-08-19,70042,70060,Blue,1,46499,47466,967
2022-07-04,70052,70054,Blue,1,70999,71077,78
2022-10-05,70038,70042,Blue,1,42031,42138,107
2022-12-19,70051,70045,Blue,0,88453,88821,368
2022-08-20,70047,70039,Blue,0,67095,67551,456
2022-09-08,70046,70052,Blue,1,33784,34126,342
2022-02-26,70055,70045,Blue,0,88547,89273,726
2022-09-15,70047,70045,Blue,0,69690,69777,87
2022-07-06,70057,70838,Blue,0,37300,38610,1310
2022-05-21,70057,70041,Blue,0,67218,68372,1154
2022-06-09,70051,70043,Blue,0,67167,67670,503
2022-02-08,70038,70048,Blue,1,25205,25636,431
2022-04-28,70050,70052,Blue,1,49997,50123,126
2022-10-30,70053,70039,Blue,0,75719,76452,733
2022-10-14,70059,70039,Blue,0,88163,89976,1813
2022-02-05,70038,70042,Blue,1,21099,21195,96
2022-08-01,70045,70838,Blue,0,51179,51527,348
2022-07-14,70055,70838,Blue,0,58152,59092,940
2022-02-20,70038,70040,Blue,1,36253,36271,18
2022-08-19,70038,70042,Blue,1,21918,22035,117
2022-04-12,70055,70053,Blue,0,42266,42319,53
2022-03-05,70049,70039,Blue,0,67561,68063,502
2022-11-05,70038,70050,Blue,1,59358,59967,609
2022-04-18,70042,70056,Blue,1,46523,47224,701
2022-08-11,70040,70044,Blue,1,28640,28742,102
2022-01-27,70059,70045,Blue,0,68469,69134,665
2022-11-07,70047,70045,Blue,0,84856,84951,95
2022-10-07,70059,70053,Blue,0,42622,42847,225
2022-12-05,70055,70043,Blue,0,81457,82128,671
2022-04-04,70052,70060,Blue,1,79899,80253,354
2022-03-04,70040,70050,Blue,1,33612,34121,509
2022-12-17,70053,70041,Blue,0,27363,28055,692
2022-06-19,70049,70045,Blue,0,68894,69091,197
2022-11-29,70038,70056,Blue,1,41516,42464,948
2022-06-21,70047,70043,Blue,0,62589,62870,281
2022-01-28,70038,70058,Blue,1,45252,46225,973
2022-04-05,70049,70041,Blue,0,33459,33880,421
2022-10-14,70046,70058,Blue,1,66738,67362,624
2022-01-10,70057,70051,Blue,0,77251,77503,252
2022-06-17,70056,70060,Blue,1,73573,73790,217
2022-12-04,70040,70052,Blue,1,57021,57744,723
2022-01-04,70046,70054,Blue,1,25481,25867,386
2022-07-15,70042,70054,Blue,1,76478,77515,1037
2022-08-14,70050,70060,Blue,1,53286,53831,545
2022-12-18,70059,70051,Blue,0,42145,42457,312
2022-03-14,70053,70051,Blue,0,84886,84949,63
2022-10-13,70039,70838,Blue,0,41646,41678,32
2022-07-20,70045,70043,Blue,0,22444,22579,135
2022-10-19,70055,70051,Blue,0,76097,76239,142
2022-02-10,70047,70045,Blue,0,87558,87662,104
2022-10-11,70051,70041,Blue,0,62758,63302,544
2022-07-26,70046,70054,Blue,1,40203,40664,461
2022-02-04,70057,70838,Blue,0,25790,26952,1162
2022-10-21,70059,70838,Blue,0,57730,58789,1059
2022-04-16,70057,70039,Blue,0,87453,88355,902
2022-07-05,70042,70048,Blue,1,41044,41429,385
2022-05-19,70044,70058,Blue,1,29117,30029,912
2022-06-15,70040,70042,Blue,1,40233,40269,36
2022-07-27,70038,70044,Blue,1,87374,87534,160
2022-11-04,70057,70045,Blue,0,33710,34428,718
2022-03-23,70049,70039,Blue,0,43247,43898,651
2022-03-08,70048,70056,Blue,1,81318,81716,398
2022-06-18,70049,70045,Blue,0,41194,41451,257
2022-10-03,70050,70060,Blue,1,51437,51948,511
2022-02-07,70051,70039,Blue,0,18744,19602,858
2022-12-13,70052,70054,Blue,1,54489,54591,102
2022-07-20,70038,70056,Blue,1,72055,73556,1501
2022-01-26,70055,70047,Blue,0,80259,80676,417
2022-04-03,70040,70044,Blue,1,53792,53916,124
2022-05-10,70050,70056,Blue,1,85631,85978,347
2022-04-17,70051,70041,Blue,0,72584,73201,617
2022-10-15,70057,70049,Blue,0,64408,64811,403
2022-05-27,70049,70039,Blue,0,54929,55527,598
2022-11-30,70042,70052,Blue,1,72276,72852,576
2022-02-18,70038,70052,Blue,1,86555,87305,750
2022-02-03,70056,70060,Blue,1,50218,50397,179
2022-07-15,70038,70060,Blue,1,24029,25221,1192
2022-07-10,70054,70056,Blue,1,60705,60752,47
2022-11-16,70045,70039,Blue,0,20417,20696,279
2022-08-12,70040,70060,Blue,1,74340,75427,1087
2022-01-22,70040,70056,Blue,1,58387,59264,877
2022-09-27,70042,70050,Blue,1,62901,63328,427
2022-11-21,70046,70060,Blue,1,28098,28826,728
2022-08-07,70047,70041,Blue,0,73910,74216,306
2022-03-21,70043,70041,Blue,0,24610,24638,28
2022-08-18,70040,70060,Blue,1,68803,69869,1066
2022-07-01,70041,70838,Blue,0,51704,51915,211
2022-07-17,70046,70054,Blue,1,69439,69890,451
2022-05-20,70059,70055,Blue,0,46102,46245,143
2022-04-04,70042,70048,Blue,1,60901,61227,326
2022-08-31,70045,70039,Blue,0,58956,59211,255
2022-03-29,70051,70045,Blue,0,54552,54892,340
2022-06-20,70045,70838,Blue,0,72024,72367,343
2022-04-23,70044,70058,Blue,1,48816,49646,830
2022-04-12,70056,70058,Blue,1,86261,86329,68
2022-06-11,70051,70047,Blue,0,23200,23392,192
2022-12-12,70056,70060,Blue,1,89153,89330,177
2022-08-23,70055,70043,Blue,0,70112,70796,684
2022-04-04,70047,70045,Blue,0,67090,67184,94
2022-03-15,70040,70060,Blue,1,60497,61759,1262
2022-02-16,70050,70052,Blue,1,45205,45322,117
2022-02-16,70040,70044,Blue,1,35123,35254,131
2022-12-22,70043,70838,Blue,0,24565,24755,190
2022-03-11,70055,70053,Blue,0,59717,59763,46
2022-08-27,70047,70043,Blue,0,22744,23006,262
2022-08-25,70041,70838,Blue,0,46036,46170,134
2022-07-30,70055,70049,Blue,0,65048,65324,276
2022-07-22,70045,70041,Blue,0,84290,84475,185
2022-11-28,70053,70043,Blue,0,52257,52817,560
2022-07-22,70046,70058,Blue,1,35007,35687,680
2022-06-18,70042,70046,Blue,1,51549,51743,194
2022-04-22,70040,70042,Blue,1,21662,21694,32
2022-10-25,70038,70054,Blue,1,48676,49597,921
2022-11-26,70051,70047,Blue,0,56605,56803,198
2022-08-25,70052,70058,Blue,1,73988,74265,277
2022-04-30,70057,70049,Blue,0,37916,38360,444
2022-04-01,70058,70060,Blue,1,64780,65110,330
2022-01-28,70044,70046,Blue,1,31675,31789,114
2022-06-23,70059,70045,Blue,0,28205,28965,760
2022-07-01,70051,70049,Blue,0,40552,40655,103
2022-01-25,70059,70039,Blue,0,68473,69463,990
2022-06-24,70055,70049,Blue,0,88334,88643,309
2022-03-07,70053,70039,Blue,0,25439,26206,767
2022-09-25,70038,70056,Blue,1,78549,79424,875
2022-09-11,70055,70051,Blue,0,87503,87643,140
2022-01-13,70048,70054,Blue,1,82598,82918,320
2022-11-04,70051,70041,Blue,0,24537,25221,684
2022-04-17,70055,70838,Blue,0,77797,78728,931
2022-03-18,70052,70056,Blue,1,58559,58706,147
2022-01-07,70059,70041,Blue,0,39287,40275,988
2022-09-27,70044,70046,Blue,1,31346,31458,112
2022-03-28,70055,70053,Blue,0,69268,69315,47
2022-02-14,70038,70056,Blue,1,57741,58677,936
2022-06-24,70047,70045,Blue,0,67519,67611,92
2022-09-04,70040,70056,Blue,1,76477,77283,806
2022-03-21,70055,70039,Blue,0,88305,89273,968
2022-07-31,70044,70052,Blue,1,48568,49089,521
2022-01-19,70042,70058,Blue,1,62436,63396,960
2022-12-11,70046,70060,Blue,1,47582,48275,693
2022-11-20,70042,70048,Blue,1,40497,40799,302
2022-04-06,70050,70054,Blue,1,65530,65740,210
2022-07-28,70047,70838,Blue,0,68830,69366,536
2022-04-12,70059,70045,Blue,0,21320,22079,759
2022-05-26,70040,70042,Blue,1,73303,73338,35
2022-11-30,70040,70046,Blue,1,45933,46177,244
2022-11-11,70057,70055,Blue,0,72875,72946,71
2022-11-13,70059,70047,Blue,0,66255,66838,583
2022-01-28,70051,70049,Blue,0,71447,71607,160
2022-09-11,70045,70838,Blue,0,29274,29615,341
2022-02-11,70048,70052,Blue,1,84247,84455,208
2022-11-27,70049,70045,Blue,0,62444,62670,226
2022-08-03,70055,70045,Blue,0,31152,31707,555
2022-07-29,70049,70039,Blue,0,32758,33382,624
2022-11-26,70046,70054,Blue,1,59703,60097,394
2022-05-24,70049,70041,Blue,0,75316,75866,550
2022-01-31,70038,70040,Blue,1,87751,87767,16
2022-02-17,70044,70050,Blue,1,84454,84781,327
2022-10-01,70049,70041,Blue,0,75085,75497,412
2022-07-26,70051,70039,Blue,0,88633,89700,1067
2022-10-22,70052,70056,Blue,1,60088,60220,132
2022-09-25,70051,70045,Blue,0,22623,22982,359
2022-01-15,70052,70058,Blue,1,38545,38776,231
2022-03-15,70050,70052,Blue,1,88632,88750,118
2022-01-13,70053,70041,Blue,0,33595,34366,771
2022-10-24,70051,70047,Blue,0,46624,46820,196
2022-11-25,70048,70052,Blue,1,49156,49372,216
2022-11-26,70042,70046,Blue,1,40591,40777,186
2022-12-22,70055,70051,Blue,0,85656,85803,147
2022-07-10,70038,70054,Blue,1,33907,34751,844
2022-07-12,70046,70054,Blue,1,84531,84953,422
2022-08-24,70040,70042,Blue,1,86692,86726,34
2022-06-19,70040,70048,Blue,1,31701,32133,432
2022-05-30,70040,70050,Blue,1,87377,87939,562
2022-04-07,70051,70041,Blue,0,20610,21199,589
2022-09-10,70055,70045,Blue,0,82536,83063,527
2022-09-26,70038,70048,Blue,1,30406,30851,445
2022-05-31,70044,70046,Blue,1,68240,68362,122
2022-07-09,70043,70838,Blue,0,86564,86753,189
2022-06-29,70053,70039,Blue,0,24516,25321,805
2022-12-14,70059,70053,Blue,0,51497,51729,232
2022-11-13,70051,70045,Blue,0,65558,65912,354
2022-03-25,70044,70052,Blue,1,87339,87819,480
2022-03-13,70040,70054,Blue,1,75922,76635,713
2022-02-28,70045,70043,Blue,0,51738,51844,106
2022-01-02,70038,70050,Blue,1,30013,30556,543
2022-05-16,70054,70056,Blue,1,65729,65777,48
2022-02-04,70049,70041,Blue,0,79441,79871,430
2022-11-30,70055,70047,Blue,0,56493,56890,397
2022-10-19,70042,70058,Blue,1,70639,71591,952
2022-01-20,70059,70039,Blue,0,88127,89558,1431
2022-07-28,70057,70053,Blue,0,54525,54695,170
2022-03-14,70051,70047,Blue,0,28555,28774,219
2022-04-05,70055,70049,Blue,0,19711,20002,291
2022-09-07,70057,70043,Blue,0,69755,70572,817
2022-06-30,70038,70052,Blue,1,77301,78087,786
2022-09-22,70044,70056,Blue,1,22411,23071,660
2022-11-11,70048,70060,Blue,1,33144,33760,616
2022-08-10,70053,70043,Blue,0,63716,64315,599
2022-06-14,70043,70041,Blue,0,55397,55425,28
2022-03-09,70042,70060,Blue,1,45989,46991,1002
2022-12-05,70057,70041,Blue,0,60400,61264,864
2022-02-03,70041,70838,Blue,0,71545,71652,107
2022-10-23,70055,70047,Blue,0,44300,44672,372
2022-04-09,70048,70050,Blue,1,63087,63142,55
2022-04-19,70056,70058,Blue,1,91681,91753,72
2022-12-18,70049,70045,Blue,0,30598,30797,199
2022-05-28,70038,70046,Blue,1,61460,61826,366
2022-06-30,70050,70060,Blue,1,38053,38789,736
2022-06-13,70046,70056,Blue,1,59999,60575,576
2022-04-01,70040,70048,Blue,1,63802,64227,425
2022-12-20,70048,70060,Blue,1,64303,65041,738
2022-11-17,70044,70060,Blue,1,71329,72255,926
2022-08-30,70054,70058,Blue,1,46449,46606,157
2022-07-04,70055,70047,Blue,0,42378,42752,374
2022-10-11,70038,70060,Blue,1,67951,69087,1136
2022-08-26,70056,70058,Blue,1,34326,34397,71
2022-01-07,70052,70058,Blue,1,60348,60613,265
2022-09-18,70044,70052,Blue,1,62948,63443,495
2022-10-10,70038,70054,Blue,1,74721,75513,792
2022-10-29,70042,70058,Blue,1,21818,22672,854
2022-03-22,70052,70056,Blue,1,78518,78681,163
2022-08-01,70055,70043,Blue,0,76690,77357,667
2022-12-20,70052,70058,Blue,1,55431,55672,241
2022-08-04,70057,70041,Blue,0,58581,59467,886
2022-10-27,70042,70048,Blue,1,66613,67027,414
2022-08-20,70054,70058,Blue,1,36994,37150,156
2022-02-01,70041,70838,Blue,0,78068,78172,104
2022-03-02,70042,70054,Blue,1,32247,32929,682
2022-12-23,70053,70043,Blue,0,30096,30725,629
2022-10-22,70042,70060,Blue,1,29259,30233,974
2022-02-16,70040,70050,Blue,1,65310,65802,492
2022-11-25,70047,70039,Blue,0,34976,35358,382
2022-11-02,70039,70838,Blue,0,60349,60383,34
2022-12-17,70054,70060,Blue,1,51079,51359,280
2022-03-07,70043,70838,Blue,0,71385,71561,176
2022-07-20,70048,70056,Blue,1,26255,26655,400
2022-06-22,70047,70041,Blue,0,49488,49821,333
2022-08-10,70052,70056,Blue,1,71824,71993,169
2022-11-02,70038,70054,Blue,1,48381,49152,771
2022-03-25,70048,70058,Blue,1,69914,70594,680
2022-07-24,70051,70838,Blue,0,64764,65525,761
2022-08-07,70055,70045,Blue,0,38361,38879,518
2022-06-14,70049,70047,Blue,0,57413,57469,56
2022-02-28,70040,70044,Blue,1,35880,36001,121
2022-08-23,70045,70039,Blue,0,70326,70560,234
2022-03-17,70055,70039,Blue,0,58570,59366,796
2022-03-27,70057,70049,Blue,0,51219,51597,378
2022-11-07,70040,70056,Blue,1,59397,60483,1086
2022-01-28,70042,70058,Blue,1,60263,61139,876
2022-12-21,70038,70054,Blue,1,30155,30971,816
2022-12-08,70043,70039,Blue,0,89375,89809,434
2022-08-18,70040,70044,Blue,1,44190,44316,126
2022-11-29,70042,70054,Blue,1,45253,45918,665
2022-06-27,70050,70054,Blue,1,58019,58267,248
2022-06-25,70051,70047,Blue,0,48561,48763,202
2022-12-23,70044,70048,Blue,1,66212,66444,232
2022-03-29,70038,70042,Blue,1,72434,72524,90
2022-12-25,70059,70045,Blue,0,36198,36915,717
2022-07-04,70050,70058,Blue,1,67689,68098,409
2022-01-07,70055,70045,Blue,0,64612,65217,605
2022-09-22,70055,70039,Blue,0,83605,84402,797
2022-07-21,70046,70050,Blue,1,23240,23451,211
2022-11-22,70038,70048,Blue,1,30683,31169,486
2022-09-27,70059,70055,Blue,0,63449,63590,141
2022-06-10,70059,70055,Blue,0,38129,38284,155
2022-02-05,70059,70049,Blue,0,44353,44793,440
2022-03-08,70041,70838,Blue,0,65486,65612,126
2022-04-12,70053,70838,Blue,0,47956,48850,894
2022-09-28,70053,70838,Blue,0,20681,21554,873
2022-12-24,70057,70049,Blue,0,82407,82781,374
2022-03-18,70047,70043,Blue,0,59893,60166,273
2022-07-04,70053,70043,Blue,0,49112,49738,626
2022-09-24,70048,70060,Blue,1,71193,71799,606
2022-10-25,70044,70052,Blue,1,29611,30106,495
2022-12-20,70050,70060,Blue,1,65464,65987,523
2022-08-27,70053,70039,Blue,0,86792,88315,1523
2022-04-12,70045,70039,Blue,0,21073,21323,250
2022-09-16,70046,70054,Blue,1,41875,42345,470
2022-10-15,70049,70043,Blue,0,32389,32743,354
2022-10-30,70057,70039,Blue,0,67932,68853,921
2022-01-04,70050,70060,Blue,1,91309,91795,486
2022-09-18,70040,70050,Blue,1,86465,86929,464
2022-12-13,70038,70056,Blue,1,79542,80381,839
2022-08-11,70038,70054,Blue,1,72634,73453,819
2022-12-03,70044,70048,Blue,1,68217,68460,243
2022-01-16,70051,70047,Blue,0,52174,52371,197
2022-07-21,70050,70060,Blue,1,65198,65709,511
2022-10-21,70046,70058,Blue,1,40475,41148,673
2022-07-10,70043,70041,Blue,0,70426,70460,34
2022-07-11,70038,70044,Blue,1,33201,33380,179
2022-08-02,70053,70045,Blue,0,24552,24985,433
2022-01-21,70038,70050,Blue,1,70973,71536,563
2022-10-30,70038,70046,Blue,1,59654,60035,381
2022-07-07,70043,70838,Blue,0,73846,74025,179
2022-03-24,70042,70052,Blue,1,86130,86672,542
2022-02-08,70053,70047,Blue,0,59290,59626,336
2022-05-20,70046,70054,Blue,1,69416,69959,543
2022-03-12,70056,70060,Blue,1,62537,62729,192
2022-02-18,70055,70045,Blue,0,24738,25312,574
2022-01-19,70040,70052,Blue,1,61091,61760,669
2022-01-13,70049,70838,Blue,0,67663,68260,597
2022-02-20,70044,70050,Blue,1,70668,71029,361
2022-08-20,70056,70058,Blue,1,52205,52303,98
2022-03-30,70042,70060,Blue,1,50941,51952,1011
2022-11-23,70059,70049,Blue,0,77493,77956,463
2022-09-28,70038,70060,Blue,1,80622,81759,1137
2022-01-02,70051,70043,Blue,0,75274,75743,469
2022-07-25,70057,70039,Blue,0,79337,80275,938
2022-08-28,70040,70056,Blue,1,83049,83885,836
2022-10-01,70059,70051,Blue,0,77113,77410,297
2022-09-20,70038,70042,Blue,1,81338,81448,110
2022-09-03,70049,70838,Blue,0,76963,77569,606
2022-07-23,70053,70041,Blue,0,37614,38370,756
2022-02-11,70053,70838,Blue,0,68195,69095,900
2022-03-17,70038,70044,Blue,1,69943,70120,177
2022-04-15,70038,70058,Blue,1,72425,73438,1013
2022-04-17,70040,70052,Blue,1,44968,45695,727
2022-01-19,70051,70838,Blue,0,32223,33213,990
2022-03-06,70040,70052,Blue,1,75919,76519,600
2022-06-06,70049,70043,Blue,0,61183,61589,406
2022-02-10,70050,70060,Blue,1,73027,73717,690
2022-06-13,70038,70040,Blue,1,25750,25763,13
2022-04-17,70057,70043,Blue,0,73355,74150,795
2022-10-07,70059,70049,Blue,0,28061,28573,512
2022-01-31,70051,70045,Blue,0,41094,41462,368
2022-06-24,70047,70045,Blue,0,69335,69436,101
2022-03-28,70050,70056,Blue,1,54357,54663,306
2022-07-07,70046,70048,Blue,1,51305,51404,99
2022-08-19,70054,70060,Blue,1,34475,34729,254
2022-02-24,70046,70048,Blue,1,60826,60931,105
2022-08-22,70052,70056,Blue,1,58376,58537,161
2022-01-21,70041,70039,Blue,0,57357,57410,53
2022-01-20,70055,70049,Blue,0,23270,23643,373
2022-04-02,70049,70047,Blue,0,18923,18975,52
2022-07-14,70040,70058,Blue,1,60949,61939,990
2022-02-22,70040,70042,Blue,1,56961,57004,43
2022-03-17,70048,70056,Blue,1,46253,46636,383
2022-02-23,70042,70058,Blue,1,21996,22873,877
2022-09-28,70053,70039,Blue,0,79085,79766,681
2022-04-12,70050,70054,Blue,1,85042,85253,211
2022-04-19,70040,70060,Blue,1,49283,50310,1027
2022-01-11,70059,70057,Blue,0,61394,61430,36
2022-12-27,70058,70060,Blue,1,21723,21970,247
2022-10-04,70042,70050,Blue,1,20009,20428,419
2022-07-08,70041,70838,Blue,0,67762,67931,169
2022-02-04,70052,70058,Blue,1,60079,60385,306
2022-06-09,70052,70058,Blue,1,34486,34782,296
2022-11-17,70044,70054,Blue,1,48437,49034,597
2022-01-12,70044,70046,Blue,1,75403,75513,110
2022-08-13,70038,70048,Blue,1,32922,33376,454
2022-07-02,70044,70048,Blue,1,69312,69586,274
2022-10-26,70044,70058,Blue,1,75498,76346,848
2022-03-24,70059,70051,Blue,0,22034,22355,321
2022-08-05,70054,70056,Blue,1,90265,90311,46
2022-12-02,70047,70838,Blue,0,71844,72331,487
2022-10-27,70049,70043,Blue,0,70701,71038,337
2022-11-08,70059,70051,Blue,0,58306,58622,316
2022-03-02,70055,70838,Blue,0,72815,73745,930
2022-07-23,70044,70056,Blue,1,87993,88867,874
2022-11-09,70056,70058,Blue,1,51701,51771,70
2022-06-13,70057,70039,Blue,0,86376,87273,897
2022-03-30,70053,70045,Blue,0,71243,71732,489
2022-07-15,70050,70054,Blue,1,75550,75761,211
2022-03-30,70059,70055,Blue,0,31453,31600,147
2022-06-14,70050,70054,Blue,1,61406,61621,215
2022-02-18,70038,70054,Blue,1,67084,67955,871
2022-09-08,70051,70045,Blue,0,49794,50130,336
2022-01-10,70045,70039,Blue,0,37239,37550,311
2022-07-18,70051,70049,Blue,0,76809,76910,101
2022-02-08,70038,70058,Blue,1,33555,34509,954
2022-10-27,70046,70052,Blue,1,30216,30583,367
2022-11-29,70038,70058,Blue,1,38418,39470,1052
2022-11-13,70053,70045,Blue,0,50848,51266,418
2022-11-30,70050,70052,Blue,1,71067,71176,109
2022-02-10,70045,70039,Blue,0,86497,86751,254
2022-06-17,70040,70058,Blue,1,33618,34718,1100
2022-04-05,70051,70041,Blue,0,88442,88970,528
2022-05-10,70057,70055,Blue,0,38793,38864,71
2022-07-25,70051,70041,Blue,0,33505,34115,610
2022-12-27,70044,70054,Blue,1,22039,22667,628
2022-03-08,70059,70053,Blue,0,21697,21971,274
2022-09-02,70058,70060,Blue,1,49919,49984,65
2022-10-21,70052,70054,Blue,1,66650,66702,52
2022-10-14,70051,70838,Blue,0,71050,71775,725
2022-07-08,70040,70052,Blue,1,43202,43904,702
2022-01-20,70044,70052,Blue,1,64294,64798,504
2022-03-17,70053,70838,Blue,0,75150,75982,832
2022-02-03,70042,70048,Blue,1,22379,22703,324
2022-11-21,70059,70055,Blue,0,69756,69893,137
2022-02-10,70050,70056,Blue,1,35694,36171,477
2022-03-09,70052,70058,Blue,1,56063,56350,287
2022-10-05,70038,70050,Blue,1,31560,32109,549
2022-02-01,70053,70047,Blue,0,27544,27842,298
2022-03-01,70050,70056,Blue,1,55149,55541,392
2022-12-28,70057,70047,Blue,0,87531,88007,476
2022-07-23,70053,70041,Blue,0,30584,31265,681
2022-03-06,70048,70056,Blue,1,65647,66063,416
2022-02-28,70040,70046,Blue,1,65300,65557,257
2022-06-28,70049,70838,Blue,0,60142,60740,598
2022-06-22,70040,70058,Blue,1,54978,56003,1025
2022-12-07,70054,70058,Blue,1,76714,76891,177
2022-03-04,70041,70838,Blue,0,51414,51542,128
2022-04-15,70038,70042,Blue,1,83751,83837,86
2022-03-27,70038,70042,Blue,1,49932,50034,102
2022-03-04,70044,70058,Blue,1,87941,88741,800
2022-06-29,70043,70041,Blue,0,66357,66384,27
2022-11-26,70052,70060,Blue,1,41944,42292,348
2022-12-21,70051,70041,Blue,0,80288,81301,1013
2022-10-25,70044,70048,Blue,1,46529,46803,274
2022-01-27,70040,70054,Blue,1,54966,55684,718
2022-03-07,70049,70043,Blue,0,63139,63505,366
2022-10-04,70057,70055,Blue,0,60392,60462,70
2022-12-16,70040,70058,Blue,1,38087,39007,920
2022-08-22,70057,70045,Blue,0,20494,21144,650
2022-10-07,70051,70043,Blue,0,54421,54883,462
2022-12-31,70047,70838,Blue,0,75839,76293,454
2022-12-04,70057,70838,Blue,0,54631,56707,2076
2022-10-04,70047,70039,Blue,0,86357,86723,366
2022-06-14,70059,70043,Blue,0,33583,34598,1015
2022-08-01,70057,70043,Blue,0,58297,59073,776
2022-12-19,70038,70056,Blue,1,33080,34663,1583
2022-07-04,70045,70043,Blue,0,66651,66765,114
2022-11-27,70038,70046,Blue,1,87331,87650,319
2022-02-28,70055,70043,Blue,0,87667,88315,648
2022-12-21,70044,70060,Blue,1,37622,38655,1033
2022-09-27,70047,70039,Blue,0,43570,44029,459
2022-06-14,70044,70052,Blue,1,77065,77559,494
2022-12-27,70059,70045,Blue,0,74430,75123,693
2022-12-17,70038,70050,Blue,1,59347,59896,549
2022-09-23,70038,70042,Blue,1,19950,20048,98
2022-01-24,70047,70039,Blue,0,21278,21778,500
2022-10-28,70045,70043,Blue,0,21574,21693,119
2022-09-13,70051,70043,Blue,0,49878,50355,477
2022-12-27,70050,70060,Blue,1,36589,37105,516
2022-09-14,70056,70060,Blue,1,67063,67252,189
2022-07-20,70051,70041,Blue,0,64696,65269,573
2022-03-02,70038,70060,Blue,1,53059,54410,1351
2022-08-27,70042,70056,Blue,1,67067,67852,785
2022-09-16,70046,70048,Blue,1,50932,51013,81
2022-01-13,70055,70039,Blue,0,47909,48850,941
2022-04-05,70059,70047,Blue,0,58697,59277,580
2022-04-01,70051,70041,Blue,0,29161,29754,593
2022-07-25,70048,70050,Blue,1,82458,82516,58
2022-04-27,70054,70058,Blue,1,44044,44198,154
2022-10-24,70057,70045,Blue,0,41401,42070,669
2022-08-02,70059,70053,Blue,0,70700,70984,284
2022-02-11,70059,70055,Blue,0,23354,23502,148
2022-01-25,70041,70039,Blue,0,55939,55980,41
2022-04-14,70038,70050,Blue,1,47072,47673,601
2022-05-20,70038,70040,Blue,1,73640,73656,16
2022-04-05,70051,70838,Blue,0,62068,62862,794
2022-06-16,70042,70052,Blue,1,85074,85668,594
2022-04-05,70056,70060,Blue,1,49031,49199,168
2022-03-27,70044,70060,Blue,1,65269,66166,897
2022-01-21,70040,70056,Blue,1,31521,32514,993
2022-09-29,70044,70050,Blue,1,34386,34728,342
2022-10-21,70046,70052,Blue,1,86139,86481,342
2022-08-24,70049,70047,Blue,0,77709,77762,53
2022-12-28,70059,70051,Blue,0,52516,52835,319
2022-07-17,70059,70039,Blue,0,73826,74894,1068
2022-11-11,70040,70044,Blue,1,31990,32097,107
2022-07-20,70045,70043,Blue,0,29255,29353,98
2022-08-07,70056,70058,Blue,1,81488,81559,71
2022-08-23,70059,70043,Blue,0,51827,52747,920
2022-11-03,70051,70838,Blue,0,24766,25588,822
2022-06-17,70044,70052,Blue,1,32876,33427,551
2022-04-11,70044,70048,Blue,1,59154,59395,241
2022-09-02,70054,70058,Blue,1,57912,58070,158
2022-04-13,70051,70049,Blue,0,67527,67638,111
2022-11-27,70051,70041,Blue,0,68241,68816,575
2022-08-13,70053,70051,Blue,0,74305,74362,57
2022-03-19,70057,70045,Blue,0,27692,28296,604
2022-11-20,70047,70045,Blue,0,28301,28396,95
2022-04-04,70058,70060,Blue,1,87559,87623,64
2022-09-07,70049,70047,Blue,0,28147,28206,59
2022-03-25,70042,70056,Blue,1,21683,22492,809
2022-02-26,70059,70041,Blue,0,42181,43134,953
2022-06-10,70048,70060,Blue,1,61470,62496,1026
2022-04-23,70047,70043,Blue,0,60091,60320,229
2022-04-16,70039,70838,Blue,0,27074,27107,33
2022-03-25,70038,70048,Blue,1,58349,58932,583
2022-06-12,70057,70049,Blue,0,63091,63469,378
2022-12-20,70053,70049,Blue,0,63128,63348,220
2022-10-16,70044,70054,Blue,1,70643,71198,555
2022-11-02,70057,70055,Blue,0,63520,63587,67
2022-03-01,70038,70046,Blue,1,39606,39907,301
2022-05-18,70043,70041,Blue,0,61340,61367,27
2022-07-11,70048,70050,Blue,1,60136,60192,56
2022-09-21,70054,70056,Blue,1,82814,82861,47
2022-09-06,70057,70053,Blue,0,48566,48719,153
2022-05-21,70040,70052,Blue,1,67027,67749,722
2022-04-16,70050,70058,Blue,1,62708,63116,408
2022-01-16,70038,70050,Blue,1,36348,36969,621
2022-08-15,70044,70048,Blue,1,23817,24061,244
2022-04-07,70047,70043,Blue,0,37012,37273,261
2022-01-22,70057,70049,Blue,0,73113,73507,394
2022-11-06,70053,70051,Blue,0,88502,88555,53
2022-01-26,70051,70039,Blue,0,78740,79454,714
2022-02-09,70042,70056,Blue,1,66897,67670,773
2022-10-19,70050,70054,Blue,1,40216,40433,217
2022-04-17,70053,70043,Blue,0,21784,22424,640
2022-04-13,70057,70039,Blue,0,44438,45385,947
2022-08-07,70044,70050,Blue,1,23966,24292,326
2022-02-16,70050,70060,Blue,1,30845,31495,650
2022-08-18,70059,70057,Blue,0,23012,23048,36
2022-11-04,70051,70045,Blue,0,58980,59369,389
2022-06-22,70040,70042,Blue,1,69112,69147,35
2022-09-26,70043,70041,Blue,0,23768,23798,30
2022-10-14,70052,70060,Blue,1,51022,51354,332
2022-05-15,70055,70053,Blue,0,29008,29059,51
2022-11-12,70038,70056,Blue,1,56107,57045,938
2022-03-24,70049,70043,Blue,0,33456,33822,366
2022-03-14,70055,70049,Blue,0,62809,63086,277
2022-06-27,70040,70042,Blue,1,28214,28249,35
2022-05-04,70059,70051,Blue,0,64178,64476,298
2022-12-30,70045,70838,Blue,0,86222,86528,306
2022-10-31,70049,70838,Blue,0,59408,60019,611
2022-10-13,70051,70047,Blue,0,28015,28207,192
2022-03-22,70046,70056,Blue,1,71797,72326,529
2022-03-15,70040,70058,Blue,1,25309,26288,979
2022-06-05,70040,70048,Blue,1,33982,34454,472
2022-12-31,70048,70054,Blue,1,48053,48348,295
2022-12-07,70055,70045,Blue,0,64607,65093,486
2022-12-14,70047,70043,Blue,0,64107,64339,232
2022-08-16,70048,70050,Blue,1,37815,37872,57
2022-07-07,70050,70060,Blue,1,58487,59030,543
2022-10-10,70043,70039,Blue,0,82111,82219,108
2022-01-31,70050,70052,Blue,1,60508,60645,137
2022-06-20,70045,70838,Blue,0,35895,36252,357
2022-09-21,70059,70838,Blue,0,30986,32213,1227
2022-09-19,70050,70054,Blue,1,73828,74045,217
2022-07-18,70057,70047,Blue,0,47914,48400,486
2022-11-25,70044,70060,Blue,1,58310,59225,915
2022-10-25,70059,70051,Blue,0,21747,22107,360
2022-10-26,70048,70060,Blue,1,35483,36297,814
2022-12-06,70040,70050,Blue,1,28262,28760,498
2022-12-13,70054,70060,Blue,1,63183,63453,270
2022-01-28,70051,70041,Blue,0,72963,73523,560
2022-11-03,70048,70058,Blue,1,76779,77282,503
2022-10-20,70039,70838,Blue,0,71366,71401,35
2022-04-14,70051,70049,Blue,0,76439,76583,144
2022-06-21,70059,70053,Blue,0,57781,58019,238
2022-07-29,70057,70049,Blue,0,84442,84868,426
2022-09-04,70051,70045,Blue,0,38616,39044,428
2022-09-20,70047,70838,Blue,0,59362,59855,493
2022-09-03,70057,70043,Blue,0,20914,21743,829
2022-06-22,70050,70058,Blue,1,82401,82845,444
2022-09-23,70056,70058,Blue,1,57599,57669,70
2022-10-24,70038,70058,Blue,1,77889,78889,1000
2022-10-05,70057,70055,Blue,0,52606,52675,69
2022-08-05,70057,70041,Blue,0,40657,41569,912
2022-06-10,70042,70046,Blue,1,79995,80201,206
2022-01-01,70043,70041,Blue,0,78502,78530,28
2022-07-16,70053,70041,Blue,0,22424,23092,668
2022-07-24,70042,70054,Blue,1,31711,32366,655
2022-06-09,70054,70058,Blue,1,47968,48137,169
2022-10-14,70049,70047,Blue,0,63398,63471,73
2022-12-30,70055,70047,Blue,0,29215,29582,367
2022-08-24,70044,70056,Blue,1,42294,43006,712
2022-02-06,70055,70041,Blue,0,31814,32552,738
2022-01-27,70053,70047,Blue,0,59854,60132,278
2022-12-29,70045,70041,Blue,0,72845,73006,161
2022-03-31,70049,70043,Blue,0,43695,44045,350
2022-07-20,70050,70060,Blue,1,27076,27762,686
2022-11-23,70053,70051,Blue,0,37590,37652,62
2022-08-03,70041,70039,Blue,0,85080,85112,32
2022-06-13,70042,70054,Blue,1,32485,33142,657
2022-11-12,70040,70042,Blue,1,71366,71401,35
2022-12-10,70042,70054,Blue,1,23827,24485,658
2022-12-31,70052,70058,Blue,1,26394,26641,247
2022-10-05,70040,70048,Blue,1,65428,65835,407
2022-03-08,70046,70058,Blue,1,68332,68987,655
2022-08-31,70049,70045,Blue,0,71733,71930,197
2022-02-21,70057,70838,Blue,0,79954,81021,1067
2022-02-13,70040,70048,Blue,1,84652,85056,404
2022-09-27,70040,70054,Blue,1,36054,36810,756
2022-01-03,70057,70053,Blue,0,63758,63942,184
2022-06-27,70047,70039,Blue,0,60016,60431,415
2022-03-23,70041,70838,Blue,0,31240,31407,167
2022-12-16,70040,70048,Blue,1,45707,46080,373
2022-09-30,70049,70039,Blue,0,18999,19533,534
2022-06-21,70059,70041,Blue,0,23843,24793,950
2022-02-05,70049,70041,Blue,0,63765,64191,426
2022-11-07,70044,70052,Blue,1,79392,79891,499
2022-01-24,70038,70050,Blue,1,86084,86662,578
2022-11-04,70045,70043,Blue,0,38366,38481,115
2022-11-21,70059,70053,Blue,0,30448,30686,238
2022-09-15,70057,70053,Blue,0,74551,74702,151
2022-07-08,70043,70039,Blue,0,60254,60359,105
2022-09-19,70059,70039,Blue,0,37975,39195,1220
2022-09-15,70059,70049,Blue,0,56897,57462,565
2022-03-27,70051,70838,Blue,0,44981,45665,684
2022-05-26,70038,70040,Blue,1,82811,82824,13
2022-03-01,70046,70052,Blue,1,58600,58964,364
2022-02-17,70055,70041,Blue,0,61565,62388,823
2022-11-05,70045,70041,Blue,0,25615,25786,171
2022-10-05,70053,70045,Blue,0,67360,67779,419
2022-10-11,70054,70058,Blue,1,89986,90144,158
2022-12-28,70055,70049,Blue,0,29418,29697,279
2022-02-05,70047,70039,Blue,0,57964,58394,430
2022-02-01,70042,70060,Blue,1,29199,30202,1003
2022-03-21,70042,70050,Blue,1,72121,72538,417
2022-01-21,70050,70058,Blue,1,29630,30195,565
2022-01-15,70050,70058,Blue,1,56006,56423,417
2022-11-11,70048,70056,Blue,1,37621,38020,399
2022-07-16,70042,70044,Blue,1,49807,49845,38
2022-01-11,70049,70045,Blue,0,70537,70743,206
2022-02-04,70055,70838,Blue,0,41730,42786,1056
2022-11-12,70042,70054,Blue,1,50331,51017,686
2022-04-04,70040,70044,Blue,1,64108,64213,105
2022-12-23,70057,70039,Blue,0,45579,46599,1020
2022-11-15,70044,70046,Blue,1,51011,51112,101
2022-02-21,70049,70838,Blue,0,67754,68425,671
2022-04-20,70055,70053,Blue,0,23931,23977,46
2022-09-06,70038,70050,Blue,1,63606,64197,591
2022-12-25,70051,70838,Blue,0,56969,57704,735
2022-04-19,70053,70045,Blue,0,34446,34975,529
2022-08-08,70057,70053,Blue,0,79076,79226,150
2022-09-23,70040,70048,Blue,1,79755,80145,390
2022-12-06,70057,70838,Blue,0,72871,73890,1019
2022-03-03,70055,70045,Blue,0,64261,64740,479
2022-10-01,70045,70043,Blue,0,60223,60315,92
2022-10-16,70055,70049,Blue,0,56724,57004,280
2022-03-23,70048,70054,Blue,1,35973,36395,422
2022-06-05,70041,70039,Blue,0,68740,68777,37
2022-01-06,70044,70046,Blue,1,52470,52577,107
2022-12-18,70038,70046,Blue,1,89114,89439,325
2022-01-26,70043,70039,Blue,0,59791,59905,114
2022-12-28,70042,70044,Blue,1,60902,60930,28
2022-09-12,70059,70049,Blue,0,73355,73822,467
2022-10-13,70043,70041,Blue,0,85959,85994,35
2022-03-13,70055,70051,Blue,0,73456,73595,139
2022-03-02,70046,70050,Blue,1,47335,47526,191
2022-10-04,70047,70043,Blue,0,51169,51405,236
2022-03-26,70056,70058,Blue,1,49557,49626,69
2022-12-13,70050,70052,Blue,1,42773,42890,117
2022-04-26,70059,70049,Blue,0,78905,79417,512
2022-04-04,70038,70040,Blue,1,79723,79740,17
2022-10-29,70056,70058,Blue,1,43019,43092,73
2022-09-20,70040,70054,Blue,1,58107,58869,762
2022-01-13,70044,70048,Blue,1,48335,48605,270
2022-02-21,70038,70052,Blue,1,37215,37903,688
2022-10-28,70042,70056,Blue,1,54050,54862,812
2022-04-12,70038,70056,Blue,1,40159,41045,886
2022-09-15,70059,70049,Blue,0,86529,86999,470
2022-10-17,70049,70838,Blue,0,68619,69185,566
2022-02-09,70044,70054,Blue,1,57373,57956,583
2022-02-17,70055,70051,Blue,0,66067,66209,142
2022-02-15,70045,70041,Blue,0,34389,34573,184
2022-02-03,70044,70060,Blue,1,24279,25317,1038
2022-12-06,70045,70043,Blue,0,59233,59329,96
2022-09-16,70042,70046,Blue,1,21536,21713,177
2022-08-27,70040,70044,Blue,1,43750,43850,100
2022-01-24,70040,70058,Blue,1,31516,32590,1074
2022-10-31,70044,70048,Blue,1,81264,81491,227
2022-12-21,70056,70060,Blue,1,79234,79414,180
2022-09-26,70038,70054,Blue,1,44752,45571,819
2022-01-11,70059,70053,Blue,0,54492,54728,236
2022-04-14,70057,70838,Blue,0,30326,31504,1178
2022-12-16,70045,70838,Blue,0,40850,41188,338
2022-09-27,70042,70048,Blue,1,56974,57279,305
2022-11-11,70049,70043,Blue,0,67084,67422,338
2022-10-30,70040,70056,Blue,1,72672,73522,850
2022-06-27,70042,70058,Blue,1,31269,32230,961
2022-11-27,70048,70056,Blue,1,77436,77844,408
2022-02-08,70042,70058,Blue,1,85017,85877,860
2022-10-14,70052,70060,Blue,1,63689,64081,392
2022-10-27,70038,70060,Blue,1,57446,58837,1391
2022-03-20,70044,70048,Blue,1,54151,54420,269
2022-04-12,70043,70039,Blue,0,24907,25018,111
2022-12-24,70046,70058,Blue,1,64579,65308,729
2022-02-15,70038,70056,Blue,1,36734,37596,862
2022-10-08,70040,70044,Blue,1,47001,47111,110
2022-07-17,70057,70045,Blue,0,30927,31519,592
2022-08-09,70046,70060,Blue,1,35306,36057,751
2022-12-23,70059,70838,Blue,0,70474,71673,1199
2022-03-19,70051,70049,Blue,0,47428,47531,103
2022-06-23,70052,70060,Blue,1,82649,83154,505
2022-09-01,70047,70043,Blue,0,51586,51879,293
2022-03-04,70041,70838,Blue,0,54619,54844,225
2022-08-15,70041,70838,Blue,0,67239,67353,114
2022-01-18,70044,70054,Blue,1,76210,76871,661
2022-06-17,70038,70046,Blue,1,80348,80733,385
2022-11-01,70047,70039,Blue,0,44327,44748,421
2022-12-20,70043,70838,Blue,0,63059,63256,197
2022-07-20,70053,70043,Blue,0,72025,72931,906
2022-11-27,70045,70041,Blue,0,72960,73114,154
2022-08-18,70046,70058,Blue,1,58804,59438,634
2022-10-08,70059,70045,Blue,0,86538,87249,711
2022-03-29,70038,70058,Blue,1,54546,55575,1029
2022-04-12,70043,70039,Blue,0,51076,51175,99
2022-03-19,70042,70046,Blue,1,60040,60227,187
2022-04-17,70046,70056,Blue,1,79472,80089,617
2022-04-21,70059,70055,Blue,0,85159,85320,161
2022-03-31,70051,70047,Blue,0,58779,58970,191
2022-03-15,70038,70060,Blue,1,54306,55505,1199
2022-10-23,70059,70043,Blue,0,54370,55238,868
2022-09-27,70047,70838,Blue,0,52876,53472,596
2022-10-25,70040,70060,Blue,1,40995,42037,1042
2022-01-06,70059,70041,Blue,0,63197,64083,886
2022-06-26,70052,70060,Blue,1,90065,90473,408
2022-07-20,70040,70056,Blue,1,56915,57898,983
2022-09-27,70056,70058,Blue,1,61615,61684,69
2022-06-13,70046,70056,Blue,1,55431,56025,594
2022-12-05,70044,70054,Blue,1,41066,41627,561
2022-10-11,70045,70838,Blue,0,69895,70212,317
2022-06-15,70040,70044,Blue,1,28806,28908,102
2022-05-18,70044,70056,Blue,1,44986,45885,899
2022-08-04,70046,70050,Blue,1,59044,59238,194
2022-09-29,70038,70042,Blue,1,61403,61514,111
2022-11-17,70040,70046,Blue,1,23616,23898,282
2022-03-29,70055,70041,Blue,0,38839,39658,819
2022-12-21,70055,70043,Blue,0,80109,81229,1120
2022-11-29,70059,70039,Blue,0,49938,50948,1010
2022-11-08,70040,70054,Blue,1,82811,83612,801
2022-03-02,70057,70045,Blue,0,69569,70199,630
2022-03-17,70038,70044,Blue,1,57135,57302,167
2022-11-01,70050,70052,Blue,1,76863,76994,131
2022-10-27,70043,70039,Blue,0,80106,80214,108
2022-08-08,70038,70040,Blue,1,60315,60334,19
2022-01-09,70042,70048,Blue,1,60327,60647,320
2022-06-14,70040,70060,Blue,1,53825,54874,1049
2022-11-07,70059,70053,Blue,0,54635,54851,216
2022-12-20,70059,70041,Blue,0,68595,69405,810
2022-10-10,70053,70045,Blue,0,53801,54237,436
2022-10-24,70042,70058,Blue,1,50944,51831,887
2022-03-10,70043,70838,Blue,0,21187,21417,230
2022-12-12,70057,70039,Blue,0,43291,44294,1003
2022-12-28,70048,70052,Blue,1,24024,24243,219
2022-08-24,70052,70058,Blue,1,84221,84503,282
2022-03-01,70054,70056,Blue,1,65111,65159,48
2022-11-12,70059,70045,Blue,0,57317,58060,743
2022-02-03,70056,70060,Blue,1,53400,53579,179
2022-09-29,70046,70052,Blue,1,79410,79728,318
2022-12-27,70044,70058,Blue,1,36882,37647,765
2022-02-17,70042,70044,Blue,1,38845,38880,35
2022-02-10,70047,70838,Blue,0,41100,41671,571
2022-12-23,70050,70058,Blue,1,56169,56672,503
2022-09-24,70038,70048,Blue,1,55586,56060,474
2022-08-13,70047,70838,Blue,0,20105,20790,685
2022-09-09,70044,70058,Blue,1,66002,66997,995
2022-02-06,70050,70052,Blue,1,80325,80443,118
2022-01-29,70052,70058,Blue,1,27644,28171,527
2022-12-28,70057,70838,Blue,0,45632,46655,1023
2022-02-15,70056,70058,Blue,1,78460,78540,80
2022-06-16,70059,70053,Blue,0,68153,68383,230
2022-11-04,70055,70045,Blue,0,41263,41773,510
2022-01-18,70042,70052,Blue,1,31283,31917,634
2022-03-18,70046,70052,Blue,1,32230,32577,347
2022-05-30,70045,70043,Blue,0,31257,31384,127
2022-03-20,70038,70040,Blue,1,68357,68373,16
2022-08-17,70038,70056,Blue,1,34224,35158,934
2022-09-07,70049,70047,Blue,0,23099,23149,50
2022-07-15,70042,70058,Blue,1,48923,49860,937
2022-12-11,70059,70838,Blue,0,66255,67434,1179
2022-06-16,70040,70044,Blue,1,70407,70604,197
2022-09-29,70044,70060,Blue,1,64625,65515,890
2022-06-09,70057,70049,Blue,0,31549,31935,386
2022-08-06,70059,70047,Blue,0,50835,51411,576
2022-05-23,70047,70043,Blue,0,84212,84569,357
2022-04-12,70057,70045,Blue,0,50298,50883,585
2022-05-19,70059,70049,Blue,0,21317,21827,510
2022-01-22,70044,70050,Blue,1,25252,25563,311
2022-01-09,70038,70046,Blue,1,46768,47095,327
2022-03-19,70038,70048,Blue,1,38836,39309,473
2022-12-17,70059,70055,Blue,0,22815,22961,146
2022-09-19,70044,70050,Blue,1,42903,43291,388
2022-03-07,70056,70060,Blue,1,57227,57570,343
2022-06-11,70043,70039,Blue,0,78234,78350,116
2022-07-09,70040,70048,Blue,1,41053,41483,430
2022-01-31,70055,70047,Blue,0,41660,42125,465
2022-07-14,70042,70046,Blue,1,71542,71774,232
2022-10-21,70049,70041,Blue,0,88612,89083,471
2022-02-03,70039,70838,Blue,0,50372,50407,35
2022-01-13,70059,70049,Blue,0,77776,78251,475
2022-10-19,70038,70042,Blue,1,46741,46828,87
2022-11-09,70042,70058,Blue,1,24309,25209,900
2022-09-28,70059,70041,Blue,0,49941,50911,970
2022-07-23,70044,70060,Blue,1,89526,90659,1133
2022-12-27,70040,70054,Blue,1,87794,88503,709
2022-09-10,70052,70058,Blue,1,28337,28581,244
2022-04-16,70054,70058,Blue,1,64538,64697,159
2022-03-09,70051,70838,Blue,0,71888,72611,723
2022-10-12,70053,70838,Blue,0,24368,25381,1013
2022-11-20,70042,70048,Blue,1,71699,72009,310
2022-04-15,70047,70045,Blue,0,38337,38447,110
2022-06-27,70042,70058,Blue,1,42393,43370,977
2022-07-30,70040,70042,Blue,1,75083,75116,33
2022-04-17,70038,70056,Blue,1,70986,71896,910
2022-01-02,70042,70060,Blue,1,51293,52340,1047
2022-10-08,70040,70050,Blue,1,32984,33491,507
2022-07-01,70055,70049,Blue,0,79794,80130,336
2022-08-25,70048,70060,Blue,1,56658,57274,616
2022-12-19,70055,70051,Blue,0,28511,28649,138
2022-09-28,70049,70838,Blue,0,56363,57082,719
2022-03-12,70046,70050,Blue,1,38170,38392,222
2022-08-10,70059,70043,Blue,0,28881,29771,890
2022-02-20,70038,70052,Blue,1,66167,66994,827
2022-08-22,70054,70056,Blue,1,84630,84678,48
2022-12-13,70040,70052,Blue,1,49992,50668,676
2022-11-15,70059,70047,Blue,0,35250,35827,577
2022-12-13,70049,70043,Blue,0,53706,54064,358
2022-08-28,70055,70047,Blue,0,50241,50599,358
2022-07-22,70039,70838,Blue,0,64885,64920,35
2022-01-08,70045,70838,Blue,0,51181,51562,381
2022-03-07,70057,70041,Blue,0,57243,58034,791
2022-05-02,70054,70060,Blue,1,25494,25750,256
2022-08-16,70038,70048,Blue,1,90169,91418,1249
2022-02-08,70059,70051,Blue,0,51558,51908,350
2022-06-18,70048,70060,Blue,1,51353,52024,671
2022-06-17,70040,70044,Blue,1,55134,55283,149
2022-06-02,70049,70045,Blue,0,61100,61304,204
2022-10-05,70051,70043,Blue,0,44523,45015,492
2022-08-07,70046,70060,Blue,1,24118,24861,743
2022-11-22,70038,70058,Blue,1,54999,56118,1119
2022-07-27,70049,70041,Blue,0,23110,23595,485
2022-03-31,70056,70058,Blue,1,68314,68398,84
2022-12-28,70051,70049,Blue,0,30430,30534,104
2022-11-10,70051,70041,Blue,0,51870,52414,544
2022-12-21,70044,70054,Blue,1,24473,25047,574
2022-06-04,70049,70043,Blue,0,70002,70405,403
2022-03-11,70059,70041,Blue,0,26953,27896,943
2022-10-06,70046,70052,Blue,1,41214,41584,370
2022-01-12,70038,70048,Blue,1,39065,39501,436
2022-11-07,70051,70043,Blue,0,66094,66591,497
2022-08-19,70053,70838,Blue,0,22425,23292,867
2022-09-22,70055,70053,Blue,0,55274,55321,47
2022-06-13,70045,70041,Blue,0,66333,66550,217
2022-04-12,70042,70060,Blue,1,55492,56598,1106
2022-03-05,70055,70051,Blue,0,70461,70648,187
2022-01-16,70046,70060,Blue,1,28823,29469,646
2022-08-09,70042,70058,Blue,1,33820,34720,900
2022-03-17,70050,70060,Blue,1,32080,32683,603
2022-03-03,70040,70056,Blue,1,67991,68934,943
2022-03-07,70053,70039,Blue,0,87742,88410,668
2022-05-23,70038,70044,Blue,1,76215,76416,201
2022-02-20,70054,70058,Blue,1,45219,45379,160
2022-01-27,70059,70041,Blue,0,23760,24857,1097
2022-04-27,70052,70056,Blue,1,89528,89682,154
2022-02-01,70050,70056,Blue,1,25450,25765,315
2022-07-18,70040,70046,Blue,1,59030,59297,267
2022-03-10,70040,70058,Blue,1,61179,62196,1017
2022-10-09,70055,70047,Blue,0,72982,73356,374
2022-11-29,70052,70054,Blue,1,49470,49530,60
2022-07-23,70047,70045,Blue,0,35773,35895,122
2022-03-14,70052,70058,Blue,1,33006,33240,234
2022-03-29,70057,70838,Blue,0,81270,82278,1008
2022-03-11,70055,70051,Blue,0,75074,75226,152
2022-08-02,70044,70046,Blue,1,57182,57284,102
2022-02-28,70038,70042,Blue,1,21866,21964,98
2022-12-09,70038,70056,Blue,1,55903,57028,1125
2022-06-20,70038,70056,Blue,1,39519,40454,935
2022-08-29,70047,70041,Blue,0,79917,80215,298
2022-02-22,70051,70039,Blue,0,72461,73097,636
2022-03-03,70040,70046,Blue,1,39265,39532,267
2022-06-24,70044,70048,Blue,1,35152,35488,336
2022-01-21,70053,70838,Blue,0,63245,64072,827
2022-07-31,70059,70053,Blue,0,55456,55689,233
2022-10-28,70038,70054,Blue,1,22820,23622,802
2022-04-15,70049,70045,Blue,0,53830,54048,218
2022-08-04,70058,70060,Blue,1,27253,27336,83
2022-07-18,70055,70047,Blue,0,82520,82915,395
2022-05-19,70053,70051,Blue,0,28785,28858,73
2022-02-25,70039,70838,Blue,0,73807,73843,36
2022-02-02,70047,70045,Blue,0,53967,54057,90
2022-09-01,70042,70046,Blue,1,32499,32672,173
2022-01-18,70046,70058,Blue,1,73867,74505,638
2022-03-09,70038,70044,Blue,1,54889,55053,164
2022-02-04,70046,70052,Blue,1,76350,76762,412
2022-04-11,70048,70060,Blue,1,60793,61479,686
2022-12-31,70046,70050,Blue,1,74915,75106,191
2022-06-11,70059,70045,Blue,0,87667,88403,736
2022-11-26,70049,70039,Blue,0,50804,51361,557
2022-07-30,70040,70050,Blue,1,63233,63788,555
2022-06-16,70042,70048,Blue,1,62789,63214,425
2022-03-10,70047,70838,Blue,0,34287,34871,584
2022-01-01,70049,70045,Blue,0,66715,66892,177
2022-12-20,70044,70058,Blue,1,42779,43634,855
2022-02-08,70038,70050,Blue,1,67932,68512,580
2022-06-20,70038,70046,Blue,1,41105,41466,361
2022-08-26,70057,70045,Blue,0,87443,88244,801
2022-11-12,70054,70056,Blue,1,84860,84907,47
2022-08-03,70038,70056,Blue,1,65492,66382,890
2022-03-10,70059,70838,Blue,0,68467,69500,1033
2022-10-03,70052,70054,Blue,1,67242,67297,55
2022-03-15,70040,70052,Blue,1,59897,60501,604
2022-12-28,70043,70838,Blue,0,64796,65142,346
2022-12-30,70053,70041,Blue,0,78449,79103,654
2022-04-14,70040,70048,Blue,1,62333,62739,406
2022-08-28,70043,70838,Blue,0,52577,52761,184
2022-05-02,70050,70054,Blue,1,31937,32137,200
2022-08-18,70059,70057,Blue,0,71952,71987,35
2022-06-18,70038,70052,Blue,1,26293,27176,883
2022-01-19,70059,70051,Blue,0,38479,38921,442
2022-12-23,70042,70046,Blue,1,52054,52235,181
2022-04-01,70040,70042,Blue,1,82033,82065,32
2022-02-16,70051,70047,Blue,0,27935,28142,207
2022-10-05,70057,70051,Blue,0,50016,50265,249
2022-01-18,70045,70039,Blue,0,68272,68569,297
2022-04-23,70052,70056,Blue,1,20581,20723,142
2022-12-06,70042,70058,Blue,1,42682,43601,919
2022-07-31,70059,70051,Blue,0,75439,75781,342
2022-06-26,70055,70047,Blue,0,70240,70613,373
2022-11-01,70045,70838,Blue,0,72951,73288,337
2022-12-28,70038,70044,Blue,1,58274,58492,218
2022-01-28,70051,70045,Blue,0,36873,37215,342
2022-02-25,70058,70060,Blue,1,65131,65223,92
2022-07-16,70048,70056,Blue,1,32299,32764,465
2022-02-17,70051,70838,Blue,0,57602,58457,855
2022-08-07,70047,70043,Blue,0,45275,45544,269
2022-02-21,70038,70050,Blue,1,52337,52937,600
2022-07-04,70051,70043,Blue,0,76350,76859,509
2022-09-16,70046,70058,Blue,1,32370,33048,678
2022-12-20,70038,70056,Blue,1,88455,89348,893
2022-09-21,70051,70045,Blue,0,73747,74069,322
2022-06-19,70049,70043,Blue,0,55109,55461,352
2022-09-10,70043,70041,Blue,0,31775,31807,32
2022-05-19,70051,70041,Blue,0,30953,31638,685
2022-04-21,70057,70053,Blue,0,25832,25982,150
2022-05-23,70044,70050,Blue,1,74656,75133,477
2022-01-06,70048,70052,Blue,1,35751,36176,425
2022-02-28,70038,70054,Blue,1,78631,79511,880
2022-10-29,70057,70838,Blue,0,35830,36933,1103
2022-06-06,70042,70046,Blue,1,60060,60294,234
2022-07-09,70040,70042,Blue,1,73447,73477,30
2022-01-13,70059,70053,Blue,0,21315,21562,247
2022-03-15,70051,70039,Blue,0,33064,34108,1044
2022-04-03,70059,70055,Blue,0,38180,38323,143
2022-04-23,70041,70039,Blue,0,64215,64246,31
2022-01-15,70059,70053,Blue,0,54082,54330,248
2022-12-19,70051,70049,Blue,0,27680,27780,100
2022-10-06,70051,70049,Blue,0,57015,57116,101
2022-03-29,70038,70044,Blue,1,89704,91126,1422
2022-10-22,70053,70043,Blue,0,34921,35546,625
2022-10-20,70040,70046,Blue,1,51446,51728,282
2022-01-25,70048,70050,Blue,1,27472,27533,61
2022-11-05,70042,70044,Blue,1,28198,28227,29
2022-02-17,70054,70058,Blue,1,30564,30718,154
2022-10-31,70057,70053,Blue,0,65605,65766,161
2022-06-14,70046,70060,Blue,1,47378,48164,786
2022-06-16,70045,70838,Blue,0,80783,81104,321
2022-07-11,70059,70053,Blue,0,63018,63242,224
2022-07-31,70059,70045,Blue,0,57073,57769,696
2022-07-31,70057,70053,Blue,0,72812,72962,150
2022-12-22,70049,70045,Blue,0,76679,76881,202
2022-08-17,70045,70041,Blue,0,57089,57327,238
2022-03-22,70041,70039,Blue,0,26760,26800,40
2022-07-10,70057,70049,Blue,0,29370,29750,380
2022-08-13,70055,70051,Blue,0,55335,55466,131
2022-04-05,70059,70057,Blue,0,30253,30289,36
2022-04-21,70042,70060,Blue,1,46529,47452,923
2022-03-12,70047,70045,Blue,0,45554,45652,98
2022-09-27,70046,70054,Blue,1,46113,46571,458
2022-05-03,70057,70051,Blue,0,75089,75337,248
2022-07-26,70045,70043,Blue,0,61163,61256,93
2022-05-21,70040,70050,Blue,1,48618,49185,567
2022-08-25,70050,70054,Blue,1,38053,38295,242
2022-06-11,70045,70838,Blue,0,44584,45103,519
2022-03-22,70056,70058,Blue,1,56707,56764,57
2022-07-30,70049,70041,Blue,0,25325,25808,483
2022-10-19,70038,70052,Blue,1,56799,57533,734
2022-09-14,70040,70050,Blue,1,65920,66417,497
2022-12-02,70038,70056,Blue,1,73632,74496,864
2022-02-13,70054,70058,Blue,1,64913,65104,191
2022-10-02,70052,70054,Blue,1,78209,78283,74
2022-09-10,70042,70046,Blue,1,22645,22834,189
2022-09-24,70055,70049,Blue,0,60200,60473,273
2022-12-22,70043,70838,Blue,0,67472,67678,206
2022-02-09,70044,70048,Blue,1,83956,84184,228
2022-10-30,70054,70060,Blue,1,72938,73191,253
2022-09-26,70046,70054,Blue,1,48674,49107,433
2022-01-18,70038,70046,Blue,1,65236,65553,317
2022-07-06,70051,70045,Blue,0,42583,42981,398
2022-06-09,70059,70053,Blue,0,43828,44114,286
2022-11-17,70057,70838,Blue,0,39098,40230,1132
2022-03-25,70040,70052,Blue,1,79808,80463,655
2022-01-03,70050,70060,Blue,1,68461,68961,500
2022-10-19,70059,70055,Blue,0,34879,35036,157
2022-12-12,70042,70054,Blue,1,48854,49561,707
2022-06-20,70051,70039,Blue,0,55091,55769,678
2022-02-19,70057,70053,Blue,0,48753,48916,163
2022-01-19,70041,70838,Blue,0,62355,62479,124
2022-07-01,70059,70838,Blue,0,32657,33805,1148
2022-06-28,70040,70048,Blue,1,35848,36249,401
2022-12-29,70046,70056,Blue,1,68801,69289,488
2022-04-13,70050,70052,Blue,1,35333,35480,147
2022-03-14,70046,70048,Blue,1,56100,56178,78
2022-02-07,70045,70043,Blue,0,22491,22617,126
2022-03-14,70040,70056,Blue,1,33314,34125,811
2022-11-18,70044,70056,Blue,1,56024,56771,747
2022-01-28,70050,70058,Blue,1,31504,32009,505
2022-09-24,70049,70838,Blue,0,68249,68828,579
2022-10-24,70054,70058,Blue,1,34083,34252,169
2022-01-13,70059,70045,Blue,0,68467,69164,697
2022-10-18,70050,70052,Blue,1,35490,35609,119
2022-06-28,70055,70838,Blue,0,80543,81476,933
2022-06-29,70040,70044,Blue,1,44840,44960,120
2022-10-28,70038,70056,Blue,1,85825,86871,1046
2022-12-29,70040,70046,Blue,1,54855,55113,258
2022-10-24,70055,70049,Blue,0,49578,49892,314
2022-03-07,70049,70045,Blue,0,58806,59016,210
2022-07-29,70059,70049,Blue,0,25521,25992,471
2022-01-27,70051,70039,Blue,0,47475,48095,620
2022-02-23,70041,70039,Blue,0,58214,58252,38
2022-04-24,70045,70039,Blue,0,48170,48422,252
2022-02-15,70049,70041,Blue,0,55582,56045,463
2022-06-14,70050,70054,Blue,1,52603,52821,218
2022-07-11,70038,70050,Blue,1,84967,85552,585
2022-04-04,70051,70838,Blue,0,52120,52903,783
2022-04-01,70043,70838,Blue,0,25495,25702,207
2022-09-26,70045,70838,Blue,0,38229,38577,348
2022-02-11,70059,70051,Blue,0,21681,22042,361
2022-04-19,70053,70043,Blue,0,69368,70003,635
2022-06-15,70050,70052,Blue,1,25815,25929,114
2022-03-05,70056,70060,Blue,1,63465,63643,178
2022-06-30,70053,70838,Blue,0,49478,50490,1012
2022-08-01,70057,70053,Blue,0,20503,20658,155
2022-08-30,70044,70048,Blue,1,41819,42129,310
2022-07-11,70049,70838,Blue,0,54136,54826,690
2022-01-14,70048,70050,Blue,1,48148,48204,56
2022-04-06,70057,70049,Blue,0,19243,19650,407
2022-05-11,70056,70058,Blue,1,58499,58570,71
2022-11-22,70038,70044,Blue,1,65861,66055,194
2022-02-16,70054,70058,Blue,1,80699,80861,162
2022-07-28,70046,70060,Blue,1,30678,31434,756
2022-03-04,70038,70042,Blue,1,48674,48770,96
2022-04-15,70044,70048,Blue,1,53320,53541,221
2022-07-21,70038,70046,Blue,1,54522,54892,370
2022-08-22,70042,70060,Blue,1,85959,86910,951
2022-11-06,70055,70838,Blue,0,64271,65154,883
2022-04-01,70038,70058,Blue,1,25750,26705,955
2022-12-03,70053,70041,Blue,0,50082,50820,738
2022-10-22,70038,70050,Blue,1,64214,64823,609
2022-10-01,70042,70048,Blue,1,40628,40932,304
2022-04-04,70042,70046,Blue,1,24530,24721,191
2022-03-19,70038,70044,Blue,1,63668,63867,199
2022-05-21,70038,70056,Blue,1,37218,38131,913
2022-07-03,70054,70060,Blue,1,42532,42777,245
2022-12-19,70045,70041,Blue,0,68038,68204,166
2022-06-15,70048,70052,Blue,1,60693,60924,231
2022-03-15,70050,70060,Blue,1,65581,66262,681
2022-07-05,70046,70058,Blue,1,23807,24496,689
2022-09-25,70038,70056,Blue,1,44364,45366,1002
2022-06-07,70041,70838,Blue,0,37269,37413,144
2022-12-12,70047,70043,Blue,0,26573,26823,250
2022-03-28,70048,70056,Blue,1,65433,65794,361
2022-07-21,70057,70049,Blue,0,54695,55078,383
2022-03-05,70055,70838,Blue,0,85864,86722,858
2022-01-17,70055,70049,Blue,0,80845,81133,288
2022-05-20,70048,70056,Blue,1,65240,65650,410
2022-02-11,70055,70041,Blue,0,74544,75293,749
2022-03-29,70048,70050,Blue,1,32230,32289,59
2022-09-24,70040,70056,Blue,1,47085,47964,879
2022-04-04,70041,70838,Blue,0,27675,27836,161
2022-03-31,70047,70039,Blue,0,72147,72566,419
2022-12-20,70053,70039,Blue,0,68002,68712,710
2022-12-29,70038,70060,Blue,1,43507,45056,1549
2022-06-19,70040,70042,Blue,1,64590,64622,32
2022-02-19,70055,70045,Blue,0,58044,58550,506
2022-04-22,70040,70046,Blue,1,59003,59277,274
2022-03-13,70055,70043,Blue,0,51858,52575,717
2022-10-06,70042,70052,Blue,1,43322,43938,616
2022-08-22,70047,70045,Blue,0,21438,21540,102
2022-10-01,70057,70051,Blue,0,42275,42523,248
2022-04-04,70050,70058,Blue,1,26645,27041,396
2022-03-25,70049,70045,Blue,0,32257,32461,204
2022-12-20,70049,70838,Blue,0,19745,20336,591
2022-12-28,70048,70060,Blue,1,47441,48070,629
2022-09-21,70044,70050,Blue,1,31588,31944,356
2022-07-04,70052,70060,Blue,1,78429,78891,462
2022-05-30,70044,70048,Blue,1,31150,31449,299
2022-07-05,70044,70056,Blue,1,76504,77170,666
2022-09-12,70040,70060,Blue,1,70566,71587,1021
2022-06-14,70040,70056,Blue,1,71481,72391,910
2022-11-19,70042,70058,Blue,1,55762,56646,884
2022-05-19,70040,70050,Blue,1,57682,58278,596
2022-03-23,70040,70050,Blue,1,22201,22658,457
2022-03-04,70046,70058,Blue,1,31241,31938,697
2022-10-17,70055,70049,Blue,0,71428,71725,297
2022-04-06,70059,70838,Blue,0,87494,88546,1052
2022-04-03,70043,70039,Blue,0,63889,63998,109
2022-02-28,70046,70052,Blue,1,47294,47606,312
2022-04-15,70042,70050,Blue,1,83887,84306,419
2022-11-01,70051,70043,Blue,0,84319,84793,474
2022-09-15,70044,70056,Blue,1,63515,64220,705
2022-11-02,70040,70044,Blue,1,24088,24196,108
2022-04-20,70053,70039,Blue,0,34211,35124,913
2022-08-16,70051,70043,Blue,0,56214,56702,488
2022-07-27,70055,70838,Blue,0,32016,32939,923
2022-12-27,70040,70044,Blue,1,69917,70021,104
2022-11-27,70040,70058,Blue,1,58161,59190,1029
2022-08-01,70041,70838,Blue,0,57891,58066,175
2022-03-06,70048,70050,Blue,1,67159,67217,58
2022-01-08,70057,70041,Blue,0,55769,56657,888
2022-07-19,70051,70047,Blue,0,84717,84907,190
2022-02-13,70055,70051,Blue,0,57800,57930,130
2022-11-09,70045,70043,Blue,0,42382,42474,92
2022-09-10,70043,70041,Blue,0,63633,63660,27
2022-04-08,70052,70056,Blue,1,43177,43338,161
2022-02-04,70055,70049,Blue,0,32282,32570,288
2022-02-04,70043,70041,Blue,0,48666,48698,32
2022-04-19,70059,70049,Blue,0,52514,53046,532
2022-03-14,70049,70838,Blue,0,69582,70152,570
2022-10-04,70051,70047,Blue,0,64815,65007,192
2022-07-20,70059,70043,Blue,0,29718,30670,952
2022-01-11,70052,70058,Blue,1,44263,44527,264
2022-09-21,70039,70838,Blue,0,34632,34663,31
2022-05-27,70040,70044,Blue,1,38090,38208,118
2022-11-02,70057,70041,Blue,0,25625,26593,968
2022-03-01,70044,70050,Blue,1,81921,82331,410
2022-06-14,70051,70838,Blue,0,59068,59879,811
2022-03-11,70057,70043,Blue,0,45567,46380,813
2022-11-22,70048,70052,Blue,1,36266,36503,237
2022-03-28,70047,70838,Blue,0,65042,65510,468
2022-07-20,70053,70838,Blue,0,23731,24687,956
2022-04-26,70059,70051,Blue,0,28899,29232,333
2022-11-27,70053,70041,Blue,0,43612,44279,667
2022-05-20,70042,70056,Blue,1,65438,66261,823
2022-11-01,70055,70838,Blue,0,57394,58339,945
2022-08-19,70038,70042,Blue,1,49967,50068,101
2022-03-22,70038,70052,Blue,1,57424,58238,814
2022-11-16,70055,70043,Blue,0,61135,61796,661
2022-02-07,70053,70045,Blue,0,25138,25555,417
2022-12-17,70048,70056,Blue,1,58777,59175,398
2022-10-27,70057,70051,Blue,0,37002,37294,292
2022-12-10,70059,70045,Blue,0,36384,37110,726
2022-04-28,70050,70054,Blue,1,31834,32045,211
2022-11-30,70040,70046,Blue,1,29894,30140,246
2022-12-05,70057,70838,Blue,0,31411,32520,1109
2022-09-21,70053,70838,Blue,0,85230,86111,881
2022-10-30,70047,70039,Blue,0,51722,52108,386
2022-10-25,70057,70043,Blue,0,75983,76721,738
2022-10-27,70046,70054,Blue,1,89516,89969,453
2022-08-30,70044,70046,Blue,1,21358,21465,107
2022-01-25,70042,70050,Blue,1,87862,88324,462
2022-03-08,70053,70043,Blue,0,82046,82640,594
2022-12-21,70052,70054,Blue,1,52420,52466,46
2022-01-09,70052,70060,Blue,1,69075,69445,370
2022-04-07,70059,70049,Blue,0,36977,37480,503
2022-04-12,70059,70053,Blue,0,45497,45732,235
2022-06-11,70049,70043,Blue,0,82891,83250,359
2022-08-03,70047,70043,Blue,0,32056,32305,249
2022-11-30,70045,70838,Blue,0,27159,27559,400
2022-04-06,70053,70043,Blue,0,55877,56473,596
2022-03-27,70046,70054,Blue,1,73539,73980,441
2022-03-13,70041,70838,Blue,0,48992,49134,142
2022-02-15,70048,70056,Blue,1,78010,78421,411
2022-07-12,70043,70838,Blue,0,52512,52723,211
2022-02-13,70041,70838,Blue,0,34277,34389,112
2022-10-09,70054,70060,Blue,1,76142,76390,248
2022-09-02,70052,70056,Blue,1,84258,84404,146
2022-12-01,70041,70039,Blue,0,75378,75408,30
2022-04-13,70057,70043,Blue,0,62387,63244,857
2022-03-19,70039,70838,Blue,0,19505,19540,35
2022-12-08,70045,70041,Blue,0,77177,77350,173
2022-10-10,70038,70040,Blue,1,24429,24448,19
2022-03-18,70059,70053,Blue,0,65899,66137,238
2022-08-29,70045,70039,Blue,0,30078,30356,278
2022-02-12,70057,70051,Blue,0,45503,45771,268
2022-02-08,70046,70056,Blue,1,56885,57455,570
2022-03-14,70055,70043,Blue,0,82514,83150,636
2022-08-31,70059,70053,Blue,0,34396,34614,218
2022-10-02,70043,70041,Blue,0,52615,52644,29
2022-10-14,70051,70043,Blue,0,39923,40391,468
2022-03-06,70048,70054,Blue,1,51518,51798,280
2022-08-20,70053,70838,Blue,0,56530,57426,896
2022-06-29,70050,70052,Blue,1,91635,91746,111
2022-06-13,70055,70049,Blue,0,69708,69977,269
2022-08-04,70044,70054,Blue,1,55395,55985,590
2022-09-02,70049,70043,Blue,0,76017,76387,370
2022-05-31,70040,70050,Blue,1,21972,22500,528
2022-10-20,70059,70049,Blue,0,61875,62326,451
2022-03-27,70049,70047,Blue,0,46801,46855,54
2022-09-23,70053,70051,Blue,0,54390,54449,59
2022-01-07,70044,70060,Blue,1,61247,62243,996
2022-02-19,70047,70039,Blue,0,82928,83328,400
2022-01-18,70053,70041,Blue,0,20859,21498,639
2022-05-21,70059,70838,Blue,0,53535,54709,1174
2022-02-13,70038,70040,Blue,1,73158,73182,24
2022-09-13,70042,70044,Blue,1,48386,48415,29
2022-07-25,70059,70055,Blue,0,62444,62588,144
2022-06-10,70048,70058,Blue,1,64755,65477,722
2022-10-17,70038,70042,Blue,1,34592,34690,98
2022-12-06,70045,70043,Blue,0,23064,23152,88
2022-08-01,70057,70838,Blue,0,25187,26237,1050
2022-09-18,70039,70838,Blue,0,71669,71702,33
2022-08-09,70046,70052,Blue,1,51058,51428,370
2022-04-14,70047,70043,Blue,0,51678,51979,301
2022-08-09,70059,70838,Blue,0,58575,59715,1140
2022-09-23,70053,70041,Blue,0,27909,28690,781
2022-04-02,70047,70045,Blue,0,80493,80592,99
2022-11-06,70042,70044,Blue,1,27798,27824,26
2022-08-30,70048,70058,Blue,1,21871,22380,509
2022-02-16,70049,70043,Blue,0,39146,39513,367
2022-04-21,70050,70054,Blue,1,35044,35290,246
2022-03-15,70052,70060,Blue,1,57310,57720,410
2022-11-02,70048,70054,Blue,1,27531,27839,308
2022-09-16,70040,70046,Blue,1,23085,23347,262
2022-08-04,70054,70056,Blue,1,50221,50269,48
2022-12-04,70040,70052,Blue,1,73228,73879,651
2022-10-19,70044,70052,Blue,1,35719,36211,492
2022-02-08,70047,70041,Blue,0,38785,39197,412
2022-03-23,70045,70043,Blue,0,50482,50577,95
2022-07-15,70057,70049,Blue,0,54166,54556,390
2022-02-13,70055,70039,Blue,0,49162,50016,854
2022-06-24,70041,70039,Blue,0,36482,36535,53
2022-11-19,70054,70058,Blue,1,83003,83161,158
2022-04-20,70049,70838,Blue,0,39800,40474,674
2022-12-27,70046,70056,Blue,1,78026,78540,514
2022-02-16,70045,70039,Blue,0,25113,25380,267
2022-02-02,70046,70050,Blue,1,54187,54494,307
2022-03-12,70045,70838,Blue,0,64562,64906,344
2022-10-19,70042,70050,Blue,1,75350,75752,402
2022-01-08,70045,70039,Blue,0,86477,86699,222
2022-03-02,70048,70052,Blue,1,57618,57823,205
2022-03-25,70043,70838,Blue,0,66273,66488,215
2022-09-13,70051,70047,Blue,0,61218,61410,192
2022-07-27,70055,70053,Blue,0,28260,28308,48
2022-10-30,70053,70051,Blue,0,41751,41812,61
2022-12-29,70051,70045,Blue,0,80524,80875,351
2022-03-23,70047,70838,Blue,0,24030,24603,573
2022-09-19,70059,70055,Blue,0,66750,66895,145
2022-08-31,70057,70043,Blue,0,43861,44646,785
2022-04-23,70047,70043,Blue,0,75277,75540,263
2022-11-22,70053,70043,Blue,0,67836,68422,586
2022-07-17,70044,70050,Blue,1,45815,46137,322
2022-01-03,70055,70049,Blue,0,36554,36882,328
2022-03-04,70050,70058,Blue,1,84956,85374,418
2022-04-11,70047,70838,Blue,0,73835,74294,459
2022-01-25,70048,70060,Blue,1,64557,65198,641
2022-01-05,70049,70041,Blue,0,73134,73541,407
2022-02-12,70047,70045,Blue,0,22799,22913,114
2022-03-21,70052,70056,Blue,1,30795,30946,151
2022-09-13,70056,70058,Blue,1,71494,71563,69
2022-10-04,70059,70039,Blue,0,31827,32956,1129
2022-07-18,70055,70051,Blue,0,82520,82700,180
2022-09-25,70057,70045,Blue,0,41550,42182,632
2022-05-13,70059,70051,Blue,0,64860,65200,340
2022-02-21,70038,70056,Blue,1,66945,67916,971
2022-03-21,70048,70054,Blue,1,64661,65096,435
2022-11-09,70038,70058,Blue,1,31449,32440,991
2022-03-27,70044,70052,Blue,1,79998,80504,506
2022-09-06,70048,70058,Blue,1,67383,67974,591
2022-01-11,70054,70058,Blue,1,64039,64204,165
2022-03-22,70055,70043,Blue,0,75675,76300,625
2022-03-23,70050,70056,Blue,1,61364,61658,294
2022-03-28,70044,70050,Blue,1,83365,83709,344
2022-11-17,70054,70056,Blue,1,55398,55446,48
2022-07-02,70044,70058,Blue,1,38511,39328,817
2022-09-23,70059,70041,Blue,0,55635,56598,963
2022-03-01,70043,70039,Blue,0,23101,23203,102
2022-03-28,70038,70042,Blue,1,23994,24106,112
2022-03-18,70040,70050,Blue,1,75288,75807,519
2022-10-02,70051,70049,Blue,0,84989,85121,132
2022-06-15,70051,70045,Blue,0,47042,47375,333
2022-03-26,70053,70039,Blue,0,25721,26501,780
2022-03-15,70049,70043,Blue,0,20015,20434,419
2022-04-20,70052,70060,Blue,1,33623,34248,625
2022-12-18,70042,70052,Blue,1,80485,81027,542
2022-08-21,70057,70049,Blue,0,74994,75374,380
2022-04-04,70044,70054,Blue,1,48958,49551,593
2022-01-05,70059,70055,Blue,0,60192,60336,144
2022-06-24,70053,70045,Blue,0,75220,75624,404
2022-01-07,70051,70049,Blue,0,23830,23953,123
2022-02-08,70049,70043,Blue,0,58905,59276,371
2022-06-21,70054,70056,Blue,1,68719,68768,49
2022-07-28,70057,70053,Blue,0,27698,27854,156
2022-01-10,70044,70048,Blue,1,84499,84800,301
2022-07-19,70042,70056,Blue,1,48458,49244,786
2022-04-21,70053,70039,Blue,0,57880,58950,1070
2022-02-20,70042,70052,Blue,1,64121,64712,591
2022-05-26,70040,70042,Blue,1,87752,87788,36
2022-03-22,70048,70052,Blue,1,68737,69172,435
2022-04-13,70041,70838,Blue,0,45349,45473,124
2022-10-27,70040,70048,Blue,1,31456,31861,405
2022-04-09,70050,70052,Blue,1,37822,37937,115
2022-07-25,70038,70046,Blue,1,50775,51141,366
2022-09-12,70051,70838,Blue,0,60860,61569,709
2022-12-23,70049,70838,Blue,0,52458,53205,747
2022-01-14,70043,70838,Blue,0,55978,56171,193
2022-12-13,70038,70056,Blue,1,77336,78244,908
2022-03-03,70053,70043,Blue,0,26342,27020,678
2022-10-04,70047,70043,Blue,0,72409,72654,245
2022-04-16,70057,70045,Blue,0,87453,88083,630
2022-06-13,70049,70047,Blue,0,30795,30862,67
2022-03-12,70048,70050,Blue,1,39303,39359,56
2022-10-01,70059,70055,Blue,0,50295,50449,154
2022-01-23,70058,70060,Blue,1,87536,87612,76
2022-12-08,70044,70056,Blue,1,31358,32059,701
2022-03-26,70058,70060,Blue,1,77127,77193,66
2022-07-23,70051,70049,Blue,0,30680,30782,102
2022-11-02,70050,70052,Blue,1,86386,86503,117
2022-09-28,70052,70056,Blue,1,82721,82855,134
2022-02-25,70042,70060,Blue,1,55482,56538,1056
2022-08-10,70042,70060,Blue,1,29549,30483,934
2022-06-26,70038,70048,Blue,1,83764,84345,581
2022-06-09,70055,70049,Blue,0,24164,24492,328
2022-03-02,70059,70838,Blue,0,24597,25811,1214
2022-02-02,70057,70047,Blue,0,65057,65551,494
2022-01-12,70044,70046,Blue,1,38267,38442,175
2022-06-11,70053,70039,Blue,0,59802,60546,744
2022-08-29,70053,70043,Blue,0,59570,60207,637
2022-06-11,70059,70055,Blue,0,51383,51537,154
2022-05-28,70038,70046,Blue,1,24861,25221,360
2022-12-03,70055,70051,Blue,0,51561,51703,142
2022-03-08,70053,70043,Blue,0,64733,65365,632
2022-04-18,70046,70056,Blue,1,31230,31760,530
2022-04-23,70051,70045,Blue,0,28017,28437,420
2022-03-14,70044,70052,Blue,1,70117,70617,500
2022-04-16,70055,70838,Blue,0,59649,60652,1003
2022-08-19,70059,70057,Blue,0,39780,39816,36
2022-11-13,70052,70054,Blue,1,52796,52850,54
2022-04-03,70051,70049,Blue,0,50957,51058,101
2022-01-19,70042,70044,Blue,1,84989,85022,33
2022-08-09,70046,70052,Blue,1,71451,71778,327
2022-02-21,70051,70041,Blue,0,81925,82501,576
2022-10-04,70055,70039,Blue,0,71439,72237,798
2022-03-22,70051,70049,Blue,0,28563,28666,103
2022-04-04,70052,70054,Blue,1,25200,25256,56
2022-02-28,70055,70838,Blue,0,31633,32581,948
2022-02-21,70053,70838,Blue,0,34959,35886,927
2022-02-07,70059,70838,Blue,0,79453,80629,1176
2022-07-06,70044,70052,Blue,1,41410,41933,523
2022-05-03,70057,70047,Blue,0,32306,32766,460
2022-06-19,70057,70047,Blue,0,54705,55160,455
2022-03-08,70042,70050,Blue,1,52933,53415,482
2022-07-06,70043,70039,Blue,0,60481,60636,155
2022-02-24,70057,70043,Blue,0,54709,55508,799
2022-12-19,70057,70039,Blue,0,19237,20362,1125
2022-03-31,70046,70060,Blue,1,22214,23112,898
2022-11-24,70043,70039,Blue,0,48791,48917,126
2022-07-11,70044,70050,Blue,1,28789,29144,355
2022-03-25,70042,70048,Blue,1,61775,62070,295
2022-12-12,70052,70056,Blue,1,45907,46087,180
2022-01-14,70047,70043,Blue,0,38878,39112,234
2022-09-22,70040,70060,Blue,1,51407,52471,1064
2022-10-04,70041,70039,Blue,0,74263,74293,30
2022-11-22,70059,70051,Blue,0,28757,29089,332
2022-12-04,70049,70041,Blue,0,78767,79177,410
2022-11-17,70038,70040,Blue,1,35025,35039,14
2022-03-20,70046,70048,Blue,1,84074,84160,86
2022-03-29,70052,70060,Blue,1,29856,30218,362
2022-06-15,70051,70045,Blue,0,43133,43498,365
2022-01-24,70053,70045,Blue,0,21231,21638,407
2022-09-09,70038,70060,Blue,1,87375,88686,1311
2022-05-28,70038,70050,Blue,1,54859,55508,649
2022-09-21,70057,70838,Blue,0,24604,25725,1121
2022-09-14,70054,70056,Blue,1,42916,42964,48
2022-02-14,70042,70060,Blue,1,23198,24354,1156
2022-05-10,70059,70053,Blue,0,69450,69674,224
2022-08-11,70059,70051,Blue,0,36946,37288,342
2022-09-08,70050,70054,Blue,1,57099,57311,212
2022-06-27,70051,70047,Blue,0,77661,77850,189
2022-06-22,70051,70039,Blue,0,55036,55688,652
2022-02-25,70040,70050,Blue,1,83797,84269,472
2022-01-05,70046,70056,Blue,1,56592,57096,504
2022-03-29,70057,70838,Blue,0,65067,66042,975
2022-12-10,70044,70048,Blue,1,62790,63005,215
2022-03-15,70043,70039,Blue,0,64978,65114,136
2022-01-14,70038,70054,Blue,1,34158,35056,898
2022-08-23,70038,70060,Blue,1,30736,31868,1132
2022-09-03,70048,70058,Blue,1,53894,54389,495
2022-03-23,70041,70039,Blue,0,59348,59384,36
2022-06-13,70048,70052,Blue,1,27780,27994,214
2022-08-12,70059,70057,Blue,0,30142,30177,35
2022-03-07,70038,70048,Blue,1,25459,25927,468
2022-10-11,70057,70053,Blue,0,20919,21083,164
2022-11-23,70059,70053,Blue,0,61219,61454,235
2022-02-08,70050,70056,Blue,1,23983,24296,313
2022-06-18,70042,70058,Blue,1,28291,29223,932
2022-04-15,70047,70041,Blue,0,57836,58179,343
2022-06-10,70055,70049,Blue,0,49411,49705,294
2022-03-06,70059,70039,Blue,0,22273,23329,1056
2022-09-24,70038,70040,Blue,1,51284,51302,18
2022-12-29,70047,70043,Blue,0,60244,60488,244
2022-08-15,70041,70039,Blue,0,25533,25573,40
2022-12-14,70042,70052,Blue,1,76057,76653,596
2022-01-19,70046,70054,Blue,1,23521,24003,482
2022-10-27,70040,70058,Blue,1,61922,62939,1017
2022-04-10,70047,70838,Blue,0,77095,77579,484
2022-10-20,70046,70054,Blue,1,55915,56342,427
2022-02-07,70055,70039,Blue,0,32843,33729,886
2022-01-21,70042,70052,Blue,1,44833,45437,604
2022-01-26,70050,70056,Blue,1,23716,24008,292
2022-07-27,70052,70058,Blue,1,69201,69485,284
2022-04-19,70045,70041,Blue,0,40655,40838,183
2022-08-03,70043,70039,Blue,0,52436,52563,127
2022-12-16,70050,70052,Blue,1,59712,59824,112
2022-10-30,70048,70052,Blue,1,28149,28348,199
2022-08-05,70049,70045,Blue,0,59777,59986,209
2022-10-26,70057,70043,Blue,0,61411,62157,746
2022-03-30,70043,70041,Blue,0,57790,57822,32
2022-10-26,70052,70056,Blue,1,47117,47252,135
2022-02-11,70055,70838,Blue,0,81920,82870,950
2022-11-06,70059,70041,Blue,0,36863,37818,955
2022-03-21,70042,70046,Blue,1,83275,83485,210
2022-09-20,70059,70053,Blue,0,83463,83691,228
2022-06-13,70057,70053,Blue,0,56362,56513,151
2022-11-22,70051,70047,Blue,0,46589,46790,201
2022-02-11,70056,70060,Blue,1,20812,20990,178
2022-12-05,70042,70056,Blue,1,20123,20929,806
2022-04-15,70059,70049,Blue,0,88117,88562,445
2022-10-24,70057,70051,Blue,0,76002,76369,367
2022-12-24,70054,70056,Blue,1,62965,63011,46
2022-08-06,70048,70058,Blue,1,40466,40964,498
2022-03-20,70045,70041,Blue,0,54299,54471,172
2022-12-01,70046,70054,Blue,1,33572,34026,454
2022-12-28,70051,70049,Blue,0,20405,20506,101
2022-01-28,70048,70060,Blue,1,73504,74105,601
2022-04-15,70038,70042,Blue,1,34273,34375,102
2022-09-12,70040,70058,Blue,1,47175,48099,924
2022-09-14,70044,70058,Blue,1,78101,78897,796
2022-02-04,70042,70060,Blue,1,83897,84885,988
2022-03-28,70038,70044,Blue,1,62242,62445,203
2022-02-03,70059,70041,Blue,0,27647,28652,1005
2022-11-09,70057,70051,Blue,0,86605,86831,226
2022-08-24,70053,70041,Blue,0,32932,33666,734
2022-04-05,70056,70060,Blue,1,37388,37570,182
2022-12-05,70053,70838,Blue,0,25382,26219,837
2022-09-27,70055,70041,Blue,0,26794,27745,951
2022-04-01,70040,70054,Blue,1,87252,87990,738
2022-08-18,70049,70043,Blue,0,86321,86627,306
2022-02-01,70046,70056,Blue,1,71061,71570,509
2022-08-09,70059,70053,Blue,0,76453,76659,206
2022-08-26,70044,70060,Blue,1,49089,50000,911
2022-02-18,70048,70052,Blue,1,68111,68301,190
2022-01-20,70050,70058,Blue,1,83997,84413,416
2022-03-25,70059,70053,Blue,0,68473,68699,226
2022-06-11,70047,70045,Blue,0,55290,55393,103
2022-10-30,70042,70044,Blue,1,63593,63625,32
2022-06-20,70043,70838,Blue,0,24501,24693,192
2022-06-21,70038,70060,Blue,1,44126,45477,1351
2022-03-02,70048,70052,Blue,1,40642,40848,206
2022-02-14,70059,70043,Blue,0,64987,65814,827
2022-12-04,70057,70049,Blue,0,54631,56008,1377
2022-07-09,70048,70056,Blue,1,22174,22560,386
2022-08-10,70050,70058,Blue,1,47468,47909,441
2022-04-21,70044,70046,Blue,1,46003,46111,108
2022-09-16,70038,70044,Blue,1,28611,28783,172
2022-02-25,70042,70060,Blue,1,31448,33086,1638
2022-10-07,70038,70042,Blue,1,50248,50353,105
2022-12-12,70059,70838,Blue,0,30168,31491,1323
2022-02-24,70057,70041,Blue,0,71607,72499,892
2022-11-04,70041,70039,Blue,0,55047,55077,30
2022-07-26,70043,70838,Blue,0,68504,68688,184
2022-02-12,70059,70045,Blue,0,56776,57515,739
2022-10-03,70050,70058,Blue,1,51093,51488,395
2022-03-30,70059,70041,Blue,0,77176,78171,995
2022-07-22,70040,70054,Blue,1,22321,23312,991
2022-02-18,70058,70060,Blue,1,23862,23933,71
2022-08-26,70041,70838,Blue,0,24703,24830,127
2022-11-25,70059,70039,Blue,0,31393,32370,977
2022-02-23,70055,70041,Blue,0,83676,84563,887
2022-02-12,70047,70838,Blue,0,61188,61703,515
2022-03-21,70051,70838,Blue,0,84337,85028,691
2022-12-14,70046,70060,Blue,1,63190,64006,816
2022-02-10,70059,70039,Blue,0,73753,74790,1037
2022-02-14,70050,70054,Blue,1,56539,56741,202
2022-02-17,70040,70060,Blue,1,61131,62251,1120
2022-02-19,70047,70039,Blue,0,28214,28628,414
2022-03-20,70046,70048,Blue,1,62696,62764,68
2022-08-09,70040,70046,Blue,1,36617,36897,280
2022-02-23,70058,70060,Blue,1,70055,70123,68
2022-03-31,70051,70045,Blue,0,63842,64196,354
2022-12-31,70052,70058,Blue,1,31453,31711,258
2022-11-23,70046,70056,Blue,1,70451,70964,513
2022-05-29,70047,70043,Blue,0,66604,66896,292
2022-03-27,70050,70060,Blue,1,44923,45437,514
2022-03-10,70053,70047,Blue,0,25180,25539,359
2022-01-25,70044,70056,Blue,1,37632,38391,759
2022-01-13,70055,70053,Blue,0,57074,57134,60
2022-01-18,70038,70054,Blue,1,65537,66424,887
2022-09-08,70057,70043,Blue,0,24329,25139,810
2022-02-28,70044,70052,Blue,1,49970,50436,466
2022-11-23,70038,70048,Blue,1,46744,47209,465
2022-08-26,70046,70048,Blue,1,64111,64212,101
2022-04-05,70058,70060,Blue,1,49797,49872,75
2022-07-05,70053,70051,Blue,0,28203,28261,58
2022-03-15,70041,70039,Blue,0,60644,60676,32
2022-03-08,70046,70052,Blue,1,84617,84948,331
2022-09-16,70040,70046,Blue,1,52591,52871,280
2022-02-01,70055,70051,Blue,0,20443,20611,168
2022-06-04,70041,70039,Blue,0,38700,38732,32
2022-12-07,70057,70041,Blue,0,41190,42077,887
2022-08-29,70050,70058,Blue,1,58701,59109,408
2022-07-12,70044,70058,Blue,1,63268,64123,855
2022-10-31,70043,70838,Blue,0,44633,44831,198
2022-12-03,70055,70838,Blue,0,66130,66994,864
2022-06-20,70046,70056,Blue,1,87753,88266,513
2022-03-08,70046,70058,Blue,1,23109,23738,629
2022-12-09,70040,70060,Blue,1,26535,27608,1073
2022-03-28,70057,70049,Blue,0,22843,23263,420
2022-06-09,70055,70047,Blue,0,20438,20874,436
2022-09-03,70042,70050,Blue,1,88343,88747,404
2022-03-29,70038,70056,Blue,1,67337,68376,1039
2022-02-21,70057,70045,Blue,0,39044,39985,941
2022-03-11,70047,70045,Blue,0,74346,74449,103
2022-10-12,70040,70050,Blue,1,64350,64923,573
2022-07-11,70044,70050,Blue,1,27520,27873,353
2022-03-03,70049,70047,Blue,0,64964,65037,73
2022-04-18,70044,70060,Blue,1,84594,85558,964
2022-07-08,70042,70050,Blue,1,61808,62285,477
2022-07-22,70059,70838,Blue,0,20836,22021,1185
2022-10-04,70051,70039,Blue,0,75713,76329,616
2022-10-12,70047,70039,Blue,0,46865,47294,429
2022-07-18,70054,70056,Blue,1,34132,34178,46
2022-06-10,70042,70060,Blue,1,71417,72422,1005
2022-05-03,70057,70049,Blue,0,27318,27717,399
2022-12-10,70040,70044,Blue,1,39431,39585,154
2022-12-13,70059,70051,Blue,0,51599,51928,329
2022-12-04,70040,70046,Blue,1,68356,68649,293
2022-01-12,70055,70041,Blue,0,84799,85664,865
2022-02-28,70054,70058,Blue,1,63734,63897,163
2022-07-23,70042,70052,Blue,1,89439,90249,810
2022-01-02,70054,70056,Blue,1,43754,43800,46
2022-02-12,70040,70050,Blue,1,78761,79256,495
2022-06-13,70053,70039,Blue,0,63169,63953,784
2022-09-27,70048,70056,Blue,1,64471,64860,389
2022-07-04,70041,70838,Blue,0,63530,63676,146
2022-06-27,70040,70054,Blue,1,59020,59776,756
2022-02-19,70044,70054,Blue,1,61211,61825,614
2022-09-05,70050,70058,Blue,1,81197,81609,412
2022-12-09,70044,70056,Blue,1,31093,31924,831
2022-02-05,70057,70055,Blue,0,32025,32093,68
2022-01-01,70051,70047,Blue,0,69414,69651,237
2022-08-30,70039,70838,Blue,0,28738,28770,32
2022-02-26,70059,70053,Blue,0,44901,45149,248
2022-02-09,70057,70047,Blue,0,69619,70084,465
2022-09-05,70048,70058,Blue,1,33646,34127,481
2022-06-25,70059,70055,Blue,0,53127,53269,142
2022-04-22,70051,70049,Blue,0,62359,62462,103
2022-11-11,70049,70039,Blue,0,41579,42099,520
2022-01-20,70042,70046,Blue,1,20801,20997,196
2022-11-28,70055,70041,Blue,0,41457,42216,759
2022-06-01,70047,70045,Blue,0,54496,54599,103
2022-01-09,70055,70051,Blue,0,75699,75851,152
2022-02-19,70038,70060,Blue,1,34128,35274,1146
2022-06-28,70038,70060,Blue,1,54989,56314,1325
2022-03-23,70057,70055,Blue,0,80669,80738,69
2022-10-19,70048,70060,Blue,1,71560,72189,629
2022-06-21,70057,70039,Blue,0,61285,62285,1000
2022-12-22,70056,70060,Blue,1,34584,34756,172
2022-12-26,70044,70052,Blue,1,46369,46846,477
2022-11-08,70044,70058,Blue,1,86743,87524,781
2022-11-06,70040,70060,Blue,1,72179,73307,1128
2022-09-07,70042,70054,Blue,1,85082,85720,638
2022-07-16,70049,70041,Blue,0,24652,25071,419
2022-11-29,70038,70058,Blue,1,78310,79318,1008
2022-03-15,70038,70052,Blue,1,27537,28342,805
2022-04-29,70055,70053,Blue,0,51976,52025,49
2022-01-10,70053,70051,Blue,0,24532,24582,50
2022-07-12,70038,70046,Blue,1,48670,49012,342
2022-01-17,70059,70838,Blue,0,22157,23340,1183
2022-06-21,70057,70043,Blue,0,65032,65832,800
2022-02-15,70038,70052,Blue,1,43107,43780,673
2022-01-24,70057,70045,Blue,0,28232,28954,722
2022-11-24,70048,70050,Blue,1,79578,79636,58
2022-07-08,70047,70043,Blue,0,77554,77800,246
2022-05-20,70041,70039,Blue,0,54204,54240,36
2022-10-02,70050,70058,Blue,1,51052,51456,404
2022-09-23,70051,70047,Blue,0,80234,80430,196
2022-10-25,70057,70043,Blue,0,23103,24088,985
2022-01-22,70052,70058,Blue,1,27033,27289,256
2022-11-01,70054,70058,Blue,1,60487,60647,160
2022-10-21,70052,70060,Blue,1,72914,73295,381
2022-11-02,70038,70046,Blue,1,28997,29296,299
2022-12-19,70041,70039,Blue,0,22421,22455,34
2022-12-06,70053,70049,Blue,0,25164,25403,239
2022-12-18,70044,70060,Blue,1,82543,83459,916
2022-11-04,70049,70045,Blue,0,22701,22963,262
2022-01-08,70057,70047,Blue,0,73596,74091,495
2022-02-19,70042,70052,Blue,1,63315,63887,572
2022-08-23,70049,70039,Blue,0,74514,75015,501
2022-07-13,70044,70048,Blue,1,84188,84457,269
2022-12-21,70038,70040,Blue,1,64122,64136,14
2022-10-26,70043,70039,Blue,0,45167,45272,105
2022-03-29,70055,70043,Blue,0,45681,46412,731
2022-08-11,70055,70053,Blue,0,60209,60256,47
2022-03-20,70038,70056,Blue,1,79800,80704,904
2022-09-19,70055,70045,Blue,0,27950,28564,614
2022-02-19,70057,70045,Blue,0,75868,76474,606
2022-05-07,70050,70056,Blue,1,30659,30947,288
2022-01-24,70059,70053,Blue,0,67150,67384,234
2022-11-10,70055,70047,Blue,0,58389,58757,368
2022-03-29,70055,70053,Blue,0,77370,77421,51
2022-10-10,70040,70044,Blue,1,67506,67666,160
2022-12-12,70051,70049,Blue,0,60732,60836,104
2022-08-17,70046,70056,Blue,1,69917,70456,539
2022-02-28,70040,70050,Blue,1,56310,56788,478
2022-09-25,70042,70050,Blue,1,76532,76960,428
2022-09-14,70048,70060,Blue,1,40197,40843,646
2022-06-13,70038,70040,Blue,1,32132,32147,15
2022-03-19,70059,70055,Blue,0,63795,63939,144
2022-04-11,70048,70050,Blue,1,60793,60860,67
2022-03-28,70059,70047,Blue,0,85155,85709,554
2022-06-14,70053,70045,Blue,0,51821,52264,443
2022-11-06,70055,70045,Blue,0,58887,59434,547
2022-12-04,70059,70051,Blue,0,86427,86728,301
2022-02-27,70039,70838,Blue,0,24835,24870,35
2022-07-10,70038,70042,Blue,1,55866,55979,113
2022-11-02,70044,70046,Blue,1,68124,68229,105
2022-09-17,70049,70838,Blue,0,71330,72033,703
2022-02-23,70059,70049,Blue,0,29959,30475,516
2022-12-21,70044,70054,Blue,1,61324,61908,584
2022-03-07,70046,70058,Blue,1,85861,86463,602
2022-07-15,70049,70041,Blue,0,83942,84366,424
2022-08-03,70048,70050,Blue,1,31750,31806,56
2022-12-21,70049,70838,Blue,0,20281,20883,602
2022-01-14,70053,70045,Blue,0,84890,85330,440
2022-06-29,70045,70043,Blue,0,28396,28505,109
2022-04-12,70038,70046,Blue,1,21547,21835,288
2022-12-22,70059,70045,Blue,0,65417,66165,748
2022-10-18,70053,70045,Blue,0,39832,40247,415
2022-04-19,70052,70058,Blue,1,25490,25750,260
2022-10-21,70057,70838,Blue,0,26851,27916,1065
2022-09-26,70043,70039,Blue,0,61791,61904,113
2022-09-15,70047,70039,Blue,0,67118,67555,437
2022-05-09,70049,70047,Blue,0,28108,28168,60
2022-06-08,70038,70040,Blue,1,89187,89201,14
2022-03-08,70057,70049,Blue,0,57271,57673,402
2022-02-03,70055,70043,Blue,0,26284,27098,814
2022-10-16,70042,70048,Blue,1,52756,53072,316
2022-11-28,70056,70060,Blue,1,24033,24303,270
2022-01-15,70057,70041,Blue,0,83346,84240,894
2022-05-06,70058,70060,Blue,1,70514,70581,67
2022-10-22,70038,70060,Blue,1,51260,52410,1150
2022-07-24,70050,70052,Blue,1,61345,61455,110
2022-09-26,70053,70047,Blue,0,51263,51575,312
2022-11-13,70044,70058,Blue,1,30998,31738,740
2022-09-25,70048,70056,Blue,1,75276,75697,421
2022-01-18,70053,70047,Blue,0,58702,59037,335
2022-07-16,70059,70838,Blue,0,25452,26529,1077
2022-10-21,70048,70058,Blue,1,32813,33295,482
2022-10-05,70043,70039,Blue,0,56002,56118,116
2022-03-21,70048,70054,Blue,1,23659,24033,374
2022-02-18,70057,70047,Blue,0,62094,62640,546
2022-09-04,70057,70838,Blue,0,46353,47372,1019
2022-06-16,70040,70044,Blue,1,55779,55887,108
2022-09-14,70048,70052,Blue,1,57545,57771,226
2022-08-08,70038,70058,Blue,1,62901,63932,1031
2022-02-03,70042,70056,Blue,1,86716,87463,747
2022-09-03,70059,70049,Blue,0,81590,82049,459
2022-08-07,70055,70041,Blue,0,31092,31849,757
2022-05-26,70038,70050,Blue,1,81613,82224,611
2022-04-10,70051,70043,Blue,0,27319,27812,493
2022-06-14,70048,70058,Blue,1,28711,29224,513
2022-01-11,70040,70042,Blue,1,52273,52305,32
2022-12-26,70042,70050,Blue,1,50596,50965,369
2022-02-05,70053,70838,Blue,0,70566,71365,799
2022-07-31,70050,70052,Blue,1,44895,45008,113
2022-04-20,70049,70045,Blue,0,63488,63735,247
2022-07-01,70059,70051,Blue,0,40152,40508,356
2022-01-22,70059,70039,Blue,0,44354,45264,910
2022-01-31,70044,70052,Blue,1,46656,47168,512
2022-04-20,70047,70041,Blue,0,24559,24883,324
2022-05-21,70051,70039,Blue,0,63323,64036,713
2022-12-15,70049,70045,Blue,0,68113,68306,193
2022-08-02,70054,70060,Blue,1,29906,30174,268
2022-01-25,70056,70060,Blue,1,31325,31496,171
2022-02-14,70040,70056,Blue,1,61710,62524,814
2022-02-03,70040,70042,Blue,1,53782,53812,30
2022-08-20,70045,70043,Blue,0,75909,76023,114
2022-07-26,70057,70043,Blue,0,72336,73086,750
2022-05-16,70050,70060,Blue,1,49191,49687,496
2022-02-24,70042,70060,Blue,1,67827,68914,1087
2022-03-24,70046,70060,Blue,1,73972,74649,677
2022-05-27,70047,70838,Blue,0,74610,75241,631
2022-07-28,70040,70050,Blue,1,24453,24899,446
2022-02-05,70046,70048,Blue,1,55472,55545,73
2022-01-04,70057,70043,Blue,0,24363,25104,741
2022-10-14,70042,70046,Blue,1,89268,89479,211
2022-10-24,70044,70056,Blue,1,39968,40667,699
2022-10-14,70046,70050,Blue,1,48601,48782,181
2022-02-09,70038,70058,Blue,1,68654,69626,972
2022-09-24,70052,70060,Blue,1,83718,84079,361
2022-06-11,70057,70043,Blue,0,45512,46324,812
2022-06-21,70048,70060,Blue,1,67211,67950,739
2022-05-24,70049,70039,Blue,0,22248,23048,800
2022-07-11,70053,70041,Blue,0,32516,33204,688
2022-10-04,70042,70048,Blue,1,48877,49171,294
2022-02-03,70038,70048,Blue,1,53407,53904,497
2022-07-24,70046,70060,Blue,1,71914,72738,824
2022-12-16,70057,70055,Blue,0,62976,63045,69
2022-11-11,70043,70838,Blue,0,61809,61997,188
2022-11-15,70040,70054,Blue,1,53564,54372,808
2022-03-13,70042,70050,Blue,1,67896,68325,429
2022-11-16,70050,70052,Blue,1,45684,45792,108
2022-06-04,70038,70048,Blue,1,38060,38605,545
2022-10-27,70056,70058,Blue,1,24560,24636,76
2022-01-13,70053,70047,Blue,0,61977,62275,298
2022-07-22,70042,70046,Blue,1,89380,89667,287
2022-05-18,70055,70047,Blue,0,59768,60131,363
2022-03-24,70038,70054,Blue,1,34750,35584,834
2022-04-12,70040,70060,Blue,1,46443,47451,1008
2022-06-09,70038,70052,Blue,1,76386,77162,776
2022-12-15,70057,70041,Blue,0,46917,47938,1021
2022-08-24,70042,70060,Blue,1,29562,30574,1012
2022-04-08,70040,70056,Blue,1,53112,53964,852
2022-06-29,70049,70039,Blue,0,22216,22821,605
2022-06-29,70042,70058,Blue,1,30449,31398,949
2022-12-27,70042,70048,Blue,1,39305,39588,283
2022-01-20,70047,70045,Blue,0,50434,50531,97
2022-07-23,70046,70050,Blue,1,50164,50353,189
2022-02-22,70038,70040,Blue,1,51307,51329,22
2022-09-22,70052,70056,Blue,1,80782,80912,130
2022-06-10,70059,70057,Blue,0,24260,24296,36
2022-08-28,70046,70048,Blue,1,29650,29729,79
2022-02-18,70038,70044,Blue,1,31980,32157,177
2022-01-23,70051,70049,Blue,0,25931,26035,104
2022-08-11,70042,70050,Blue,1,30114,30536,422
2022-11-07,70046,70052,Blue,1,31819,32167,348
2022-12-04,70059,70051,Blue,0,78261,78575,314
2022-04-24,70045,70041,Blue,0,57313,57478,165
2022-01-03,70043,70041,Blue,0,89093,89123,30
2022-07-08,70040,70060,Blue,1,55583,56752,1169
2022-04-29,70058,70060,Blue,1,65213,65313,100
2022-01-24,70059,70838,Blue,0,61999,63162,1163
2022-10-03,70055,70039,Blue,0,70869,71652,783
2022-08-16,70053,70047,Blue,0,80817,81117,300
2022-08-31,70043,70041,Blue,0,28393,28423,30
2022-08-11,70044,70046,Blue,1,57426,57530,104
2022-02-23,70053,70043,Blue,0,19865,20566,701
2022-02-02,70059,70047,Blue,0,58417,59051,634
2022-09-08,70042,70056,Blue,1,34234,35113,879
2022-01-20,70047,70838,Blue,0,47223,47696,473
2022-06-20,70038,70046,Blue,1,26977,27301,324
2022-05-21,70042,70052,Blue,1,57432,58078,646
2022-10-08,70044,70052,Blue,1,21356,21856,500
2022-07-03,70059,70051,Blue,0,27730,28079,349
2022-07-29,70050,70052,Blue,1,72781,72897,116
2022-12-28,70053,70051,Blue,0,84666,84721,55
2022-03-10,70051,70039,Blue,0,76378,77038,660
2022-08-03,70053,70838,Blue,0,72091,72869,778
2022-10-28,70040,70060,Blue,1,62005,63167,1162
2022-09-25,70047,70039,Blue,0,59764,60237,473
2022-03-10,70053,70043,Blue,0,49488,50111,623
2022-02-28,70048,70054,Blue,1,65211,65518,307
2022-12-28,70042,70050,Blue,1,42673,43144,471
2022-07-29,70057,70045,Blue,0,56393,57067,674
2022-08-06,70044,70052,Blue,1,72009,72503,494
2022-12-29,70048,70050,Blue,1,28479,28538,59
2022-08-30,70042,70054,Blue,1,46331,47024,693
2022-03-02,70057,70051,Blue,0,26141,26431,290
2022-12-31,70038,70050,Blue,1,91708,92271,563
2022-01-14,70040,70060,Blue,1,28845,29963,1118
2022-06-23,70038,70058,Blue,1,66486,67637,1151
2022-07-07,70042,70054,Blue,1,61369,62127,758
2022-03-21,70038,70048,Blue,1,69907,70344,437
2022-07-04,70057,70041,Blue,0,52293,53276,983
2022-08-21,70057,70041,Blue,0,73350,74196,846
2022-10-04,70040,70058,Blue,1,36894,37956,1062
2022-08-07,70048,70052,Blue,1,67697,67898,201
2022-02-11,70051,70043,Blue,0,25847,26381,534
2022-05-20,70048,70060,Blue,1,23315,23926,611
2022-12-23,70059,70039,Blue,0,25828,27026,1198
2022-11-28,70059,70049,Blue,0,39019,39535,516
2022-02-16,70043,70838,Blue,0,65874,66102,228
2022-04-04,70048,70058,Blue,1,63689,64261,572
2022-12-03,70052,70060,Blue,1,51997,52369,372
2022-02-16,70040,70044,Blue,1,48142,48247,105
2022-03-22,70042,70054,Blue,1,56097,56816,719
2022-12-28,70046,70054,Blue,1,45426,45856,430
2022-05-19,70048,70054,Blue,1,33466,33830,364
2022-06-22,70055,70043,Blue,0,43593,44371,778
2022-10-12,70038,70044,Blue,1,37963,38122,159
2022-01-28,70038,70044,Blue,1,68955,69125,170
2022-09-19,70042,70048,Blue,1,29914,30245,331
2022-10-08,70053,70045,Blue,0,47316,47760,444
2022-09-26,70055,70045,Blue,0,78519,79238,719
2022-10-29,70059,70053,Blue,0,73516,73756,240
2022-10-17,70058,70060,Blue,1,74263,74337,74
2022-07-10,70043,70039,Blue,0,76383,76499,116
2022-04-12,70038,70044,Blue,1,20904,21079,175
2022-11-26,70051,70049,Blue,0,69544,69646,102
2022-06-23,70042,70048,Blue,1,59673,60012,339
2022-04-06,70046,70052,Blue,1,22225,22577,352
2022-08-22,70040,70056,Blue,1,52795,53717,922
2022-03-15,70044,70056,Blue,1,23718,24432,714
2022-11-18,70045,70041,Blue,0,22283,22454,171
2022-12-31,70048,70058,Blue,1,61912,62426,514
2022-02-03,70057,70039,Blue,0,19961,21009,1048
2022-04-09,70059,70838,Blue,0,47596,48726,1130
2022-11-18,70045,70838,Blue,0,48761,49138,377
2022-09-25,70055,70053,Blue,0,81738,81784,46
2022-10-07,70053,70838,Blue,0,69599,70432,833
2022-10-25,70052,70056,Blue,1,25008,25211,203
2022-05-16,70054,70060,Blue,1,54358,54636,278
2022-07-25,70042,70052,Blue,1,25342,25873,531
2022-10-20,70049,70838,Blue,0,20433,21097,664
2022-10-06,70057,70051,Blue,0,51923,52202,279
2022-06-20,70038,70058,Blue,1,67499,68643,1144
2022-11-04,70038,70044,Blue,1,57459,57683,224
2022-11-21,70050,70056,Blue,1,62944,63235,291
2022-08-06,70038,70046,Blue,1,75044,75402,358
2022-07-30,70048,70052,Blue,1,62599,62815,216
2022-10-25,70059,70057,Blue,0,34975,35010,35
2022-09-23,70055,70051,Blue,0,43370,43532,162
2022-07-19,70038,70060,Blue,1,84325,85408,1083
2022-08-26,70048,70052,Blue,1,61432,61632,200
2022-03-08,70054,70058,Blue,1,79361,79516,155
2022-11-11,70055,70838,Blue,0,69329,70264,935
2022-04-21,70059,70838,Blue,0,60798,61902,1104
2022-04-23,70042,70056,Blue,1,46011,46738,727
2022-04-08,70057,70043,Blue,0,75566,76295,729
2022-01-01,70048,70050,Blue,1,82837,82896,59
2022-01-28,70053,70041,Blue,0,36259,37018,759
2022-06-30,70051,70049,Blue,0,47079,47245,166
2022-05-20,70040,70054,Blue,1,49357,50135,778
2022-05-11,70055,70051,Blue,0,44289,44424,135
2022-09-23,70051,70838,Blue,0,52364,53049,685
2022-11-06,70059,70055,Blue,0,46302,46448,146
2022-04-13,70042,70054,Blue,1,42401,43203,802
2022-09-22,70053,70039,Blue,0,43975,44758,783
2022-07-15,70055,70043,Blue,0,49136,50015,879
2022-11-09,70038,70040,Blue,1,58890,58904,14
2022-11-26,70047,70838,Blue,0,43596,44127,531
2022-05-24,70046,70052,Blue,1,45635,46194,559
2022-11-21,70057,70051,Blue,0,53615,53871,256
2022-07-25,70059,70838,Blue,0,30554,31663,1109
2022-03-26,70048,70060,Blue,1,57775,58688,913
2022-06-09,70052,70058,Blue,1,62026,62279,253
2022-12-15,70040,70054,Blue,1,25810,26570,760
2022-04-13,70050,70054,Blue,1,56094,56311,217
2022-08-04,70046,70050,Blue,1,55553,55737,184
2022-01-24,70055,70043,Blue,0,37711,38454,743
2022-05-18,70058,70060,Blue,1,79922,79994,72
2022-06-12,70038,70046,Blue,1,51542,51850,308
2022-07-04,70046,70060,Blue,1,69372,70157,785
2022-11-17,70039,70838,Blue,0,19675,19713,38
2022-03-21,70049,70043,Blue,0,62847,63251,404
2022-07-26,70040,70056,Blue,1,65070,65949,879
2022-10-08,70057,70041,Blue,0,26773,27627,854
2022-07-22,70055,70045,Blue,0,32864,33475,611
2022-08-29,70059,70043,Blue,0,68660,69473,813
2022-12-13,70055,70049,Blue,0,32292,32594,302
2022-11-07,70050,70060,Blue,1,63532,64058,526
2022-04-28,70055,70051,Blue,0,79151,79309,158
2022-11-10,70045,70039,Blue,0,62839,63088,249
2022-11-01,70047,70041,Blue,0,54155,54482,327
2022-07-16,70059,70051,Blue,0,65955,66279,324
2022-08-31,70045,70043,Blue,0,68866,68954,88
2022-03-23,70040,70044,Blue,1,41288,41391,103
2022-12-09,70040,70050,Blue,1,56989,57536,547
2022-12-19,70038,70056,Blue,1,52693,53631,938
2022-06-09,70053,70838,Blue,0,81460,82297,837
2022-11-05,70042,70056,Blue,1,46024,46717,693
2022-07-03,70054,70060,Blue,1,72960,73230,270
2022-11-07,70052,70060,Blue,1,80485,80821,336
2022-07-03,70044,70046,Blue,1,25540,25672,132
2022-03-01,70038,70056,Blue,1,29346,30170,824
2022-02-17,70054,70058,Blue,1,79561,79719,158
2022-08-30,70057,70049,Blue,0,80550,80958,408
2022-12-09,70059,70053,Blue,0,77468,77706,238
2022-07-05,70059,70047,Blue,0,33499,34130,631
2022-08-08,70053,70045,Blue,0,68384,68805,421
2022-06-24,70059,70057,Blue,0,28974,29016,42
2022-12-12,70050,70060,Blue,1,30261,30801,540
2022-06-01,70049,70039,Blue,0,38599,39184,585
2022-04-21,70047,70045,Blue,0,36447,36542,95
2022-09-14,70055,70049,Blue,0,50593,50897,304
2022-12-08,70044,70060,Blue,1,27570,28532,962
2022-03-09,70048,70060,Blue,1,29558,30243,685
2022-01-20,70046,70052,Blue,1,55368,55718,350
2022-04-19,70048,70056,Blue,1,63352,63720,368
2022-02-23,70051,70043,Blue,0,62097,62608,511
2022-01-15,70048,70060,Blue,1,87808,88395,587
2022-03-14,70059,70057,Blue,0,26670,26708,38
2022-12-01,70048,70052,Blue,1,43670,43872,202
2022-12-31,70040,70048,Blue,1,70115,70503,388
2022-10-18,70056,70058,Blue,1,65499,65598,99
2022-12-09,70044,70052,Blue,1,84742,85293,551
2022-10-21,70038,70052,Blue,1,45553,46247,694
2022-06-24,70040,70050,Blue,1,63679,64283,604
2022-02-22,70057,70049,Blue,0,37658,38163,505
2022-04-05,70038,70044,Blue,1,31215,31402,187
2022-12-24,70055,70053,Blue,0,59126,59172,46
2022-01-21,70055,70051,Blue,0,69283,69437,154
2022-06-28,70059,70049,Blue,0,58082,58517,435
2022-12-13,70055,70043,Blue,0,79555,80192,637
2022-11-12,70053,70045,Blue,0,57025,57429,404
2022-10-17,70052,70060,Blue,1,30708,31178,470
2022-10-25,70038,70048,Blue,1,82078,82567,489
2022-08-25,70054,70058,Blue,1,76016,76170,154
2022-06-26,70057,70045,Blue,0,23910,24554,644
2022-08-09,70059,70043,Blue,0,79263,80151,888
2022-09-13,70042,70058,Blue,1,34484,35384,900
2022-08-13,70059,70039,Blue,0,35172,36401,1229
2022-12-07,70038,70050,Blue,1,43511,44123,612
2022-11-30,70044,70050,Blue,1,73515,73852,337
2022-03-28,70050,70056,Blue,1,64974,65267,293
2022-05-24,70041,70039,Blue,0,68906,68941,35
2022-09-23,70038,70052,Blue,1,49106,49900,794
2022-01-16,70053,70045,Blue,0,25722,26145,423
2022-06-12,70038,70060,Blue,1,71528,72784,1256
2022-08-05,70038,70042,Blue,1,85399,85518,119
2022-01-26,70040,70060,Blue,1,68116,69351,1235
2022-08-25,70048,70052,Blue,1,58603,58803,200
2022-11-23,70051,70045,Blue,0,47939,48274,335
2022-05-05,70057,70055,Blue,0,70292,70361,69
2022-03-08,70052,70056,Blue,1,32250,32403,153
2022-09-19,70055,70838,Blue,0,58523,59466,943
2022-08-24,70042,70046,Blue,1,74427,74602,175
2022-02-06,70046,70056,Blue,1,71361,71836,475
2022-04-03,70047,70039,Blue,0,38769,39183,414
2022-03-24,70048,70050,Blue,1,68168,68231,63
2022-04-10,70049,70041,Blue,0,68895,69317,422
2022-01-09,70053,70039,Blue,0,87606,88330,724
2022-06-22,70059,70049,Blue,0,51978,52426,448
2022-08-17,70059,70039,Blue,0,58216,59232,1016
2022-01-11,70042,70058,Blue,1,29536,30613,1077
2022-01-29,70042,70058,Blue,1,86576,88159,1583
2022-01-15,70046,70052,Blue,1,33275,33625,350
2022-03-18,70053,70838,Blue,0,50507,51379,872
2022-11-08,70054,70058,Blue,1,36644,36801,157
2022-12-09,70045,70041,Blue,0,21152,21310,158
2022-10-28,70059,70047,Blue,0,38123,38727,604
2022-02-02,70043,70041,Blue,0,75385,75414,29
2022-06-14,70038,70060,Blue,1,27915,29243,1328
2022-12-11,70043,70838,Blue,0,87272,87439,167
2022-03-31,70044,70052,Blue,1,55840,56365,525
2022-07-15,70047,70039,Blue,0,68312,68707,395
2022-08-26,70047,70043,Blue,0,73097,73366,269
2022-08-29,70038,70042,Blue,1,29096,29191,95
2022-07-08,70053,70051,Blue,0,49110,49161,51
2022-01-15,70044,70054,Blue,1,71879,72573,694
2022-10-17,70051,70045,Blue,0,32133,32493,360
2022-09-07,70057,70055,Blue,0,32734,32802,68
2022-01-09,70057,70039,Blue,0,75029,75975,946
2022-11-02,70050,70060,Blue,1,81284,81771,487
2022-09-02,70040,70060,Blue,1,64326,65393,1067
2022-03-21,70057,70043,Blue,0,67975,68721,746
2022-12-01,70046,70052,Blue,1,60720,61182,462
2022-08-04,70057,70045,Blue,0,58581,59207,626
2022-01-22,70047,70039,Blue,0,37487,37915,428
2022-05-28,70038,70046,Blue,1,20653,20995,342
2022-07-26,70042,70052,Blue,1,48121,48728,607
2022-07-15,70044,70048,Blue,1,29717,29967,250
2022-04-06,70047,70039,Blue,0,53706,54100,394
2022-11-12,70057,70049,Blue,0,33102,33541,439
2022-01-14,70038,70044,Blue,1,84335,84516,181
2022-02-06,70051,70039,Blue,0,25358,26028,670
2022-12-23,70038,70060,Blue,1,83408,84643,1235
2022-03-22,70053,70045,Blue,0,64850,65307,457
2022-12-24,70059,70045,Blue,0,25209,26170,961
2022-02-23,70059,70057,Blue,0,22398,22434,36
2022-08-02,70051,70045,Blue,0,71115,71437,322
2022-06-12,70048,70050,Blue,1,87838,87895,57
2022-11-30,70041,70039,Blue,0,62328,62365,37
2022-05-31,70040,70046,Blue,1,39781,40078,297
2022-10-11,70038,70048,Blue,1,61780,62331,551
2022-11-23,70059,70838,Blue,0,74895,75966,1071
2022-12-20,70049,70043,Blue,0,79860,80191,331
2022-07-10,70045,70043,Blue,0,69741,69847,106
2022-07-29,70044,70058,Blue,1,54674,55620,946
2022-03-29,70059,70057,Blue,0,82886,82925,39
2022-10-07,70049,70039,Blue,0,80981,81480,499
2022-09-30,70043,70039,Blue,0,43110,43219,109
2022-02-28,70057,70045,Blue,0,27329,27942,613
2022-01-08,70059,70045,Blue,0,82336,83026,690
2022-12-13,70042,70052,Blue,1,62440,63034,594
2022-06-19,70044,70046,Blue,1,59369,59492,123
2022-03-16,70041,70039,Blue,0,29581,29615,34
2022-03-30,70054,70058,Blue,1,60266,60419,153
2022-02-13,70059,70055,Blue,0,68417,68566,149
2022-11-16,70052,70056,Blue,1,28943,29095,152
2022-05-18,70048,70054,Blue,1,75420,75730,310
2022-04-06,70057,70055,Blue,0,27327,27396,69
2022-08-10,70038,70054,Blue,1,41742,42573,831
2022-09-20,70048,70060,Blue,1,80701,81279,578
2022-12-13,70048,70052,Blue,1,72153,72363,210
2022-03-05,70047,70838,Blue,0,29298,29794,496
2022-03-18,70038,70052,Blue,1,60754,61542,788
2022-12-21,70046,70058,Blue,1,73126,73753,627
2022-06-09,70054,70056,Blue,1,65691,65767,76
2022-08-23,70049,70045,Blue,0,52367,52561,194
2022-04-04,70042,70046,Blue,1,21207,21384,177
2022-06-26,70039,70838,Blue,0,40569,40602,33
2022-07-24,70057,70041,Blue,0,30154,31041,887
2022-06-11,70059,70057,Blue,0,68116,68152,36
2022-04-05,70054,70060,Blue,1,85652,85908,256
2022-10-05,70043,70039,Blue,0,60180,60288,108
2022-03-20,70046,70054,Blue,1,30355,30754,399
2022-06-14,70038,70054,Blue,1,43131,44066,935
2022-02-11,70038,70044,Blue,1,36728,36901,173
2022-09-05,70040,70056,Blue,1,83065,83842,777
2022-10-13,70044,70050,Blue,1,52008,52348,340
2022-06-24,70038,70054,Blue,1,60842,61779,937
2022-09-30,70038,70056,Blue,1,27764,28660,896
2022-05-02,70059,70057,Blue,0,72765,72805,40
2022-08-27,70055,70051,Blue,0,44537,44679,142
2022-03-14,70052,70060,Blue,1,40975,41352,377
2022-11-07,70059,70043,Blue,0,66326,67170,844
2022-04-07,70055,70838,Blue,0,45139,46071,932
2022-09-19,70042,70054,Blue,1,48702,49401,699
2022-11-20,70043,70838,Blue,0,26262,26463,201
2022-09-16,70048,70060,Blue,1,42013,42650,637
2022-06-25,70053,70049,Blue,0,45736,45937,201
2022-09-06,70052,70058,Blue,1,53516,53787,271
2022-08-08,70042,70052,Blue,1,58783,59362,579
2022-08-20,70042,70050,Blue,1,24498,24902,404
2022-07-11,70040,70052,Blue,1,61055,61686,631
2022-12-30,70045,70043,Blue,0,21876,21969,93
2022-06-29,70038,70042,Blue,1,64071,64164,93
2022-04-01,70052,70058,Blue,1,68061,68593,532
2022-11-01,70053,70045,Blue,0,30414,30878,464
2022-01-21,70038,70056,Blue,1,31155,32040,885
2022-02-16,70050,70052,Blue,1,64965,65079,114
2022-05-07,70059,70057,Blue,0,69015,69050,35
2022-10-19,70045,70838,Blue,0,45627,45981,354
2022-09-11,70059,70051,Blue,0,51129,51441,312
2022-08-07,70045,70039,Blue,0,56811,57084,273
2022-08-02,70054,70060,Blue,1,28609,28924,315
2022-12-22,70044,70050,Blue,1,76551,76910,359
2022-03-17,70055,70053,Blue,0,32840,32886,46
2022-01-12,70055,70045,Blue,0,53322,53914,592
2022-03-26,70059,70053,Blue,0,34096,34319,223
2022-01-14,70050,70052,Blue,1,59545,59655,110
2022-07-24,70044,70054,Blue,1,51822,52437,615
2022-02-17,70055,70039,Blue,0,61565,62469,904
2022-10-21,70038,70056,Blue,1,52490,53462,972
2022-07-02,70050,70056,Blue,1,41049,41339,290
2022-07-29,70042,70044,Blue,1,63922,63950,28
2022-07-20,70057,70041,Blue,0,35969,36953,984
2022-01-20,70043,70039,Blue,0,42616,42723,107
2022-08-22,70057,70041,Blue,0,52172,53088,916
2022-07-07,70052,70054,Blue,1,30626,30689,63
2022-06-26,70040,70056,Blue,1,34840,35694,854
2022-09-22,70059,70057,Blue,0,87347,87382,35
2022-12-29,70048,70060,Blue,1,82470,83056,586
2022-10-05,70046,70060,Blue,1,62710,63455,745
2022-11-09,70045,70043,Blue,0,41818,41899,81
2022-06-06,70040,70050,Blue,1,62380,63042,662
2022-10-29,70044,70056,Blue,1,25175,25847,672
2022-11-07,70049,70045,Blue,0,60493,60692,199
2022-10-13,70038,70048,Blue,1,50580,50994,414
2022-03-18,70038,70048,Blue,1,23488,23976,488
2022-11-03,70043,70041,Blue,0,66913,66941,28
2022-09-24,70043,70041,Blue,0,29065,29093,28
2022-10-03,70041,70039,Blue,0,54557,54590,33
2022-06-05,70038,70048,Blue,1,25596,26077,481
2022-01-06,70057,70838,Blue,0,28241,29357,1116
2022-12-02,70053,70041,Blue,0,47620,48265,645
2022-04-04,70040,70058,Blue,1,66211,67172,961
2022-03-08,70045,70043,Blue,0,24752,24857,105
2022-04-19,70051,70045,Blue,0,54587,54927,340
2022-03-30,70042,70048,Blue,1,38008,38325,317
2022-07-25,70056,70060,Blue,1,52695,52890,195
2022-05-21,70042,70054,Blue,1,30872,31592,720
2022-06-28,70059,70055,Blue,0,27616,27759,143
2022-02-17,70042,70046,Blue,1,35656,35850,194
2022-01-20,70057,70039,Blue,0,73826,74796,970
2022-05-02,70050,70060,Blue,1,67679,68183,504
2022-02-22,70055,70049,Blue,0,55571,55887,316
2022-04-20,70048,70056,Blue,1,79146,79541,395
2022-12-27,70045,70041,Blue,0,33929,34095,166
2022-12-28,70040,70054,Blue,1,20674,21399,725
2022-04-23,70042,70052,Blue,1,57943,58562,619
2022-01-03,70045,70039,Blue,0,33675,33891,216
2022-04-07,70038,70046,Blue,1,29060,29378,318
2022-10-17,70042,70056,Blue,1,37039,37846,807
2022-09-12,70047,70838,Blue,0,61476,61961,485
2022-09-23,70057,70045,Blue,0,27701,28423,722
2022-11-12,70044,70060,Blue,1,64971,65883,912
2022-01-27,70053,70047,Blue,0,40831,41169,338
2022-04-22,70059,70838,Blue,0,22034,23211,1177
2022-04-19,70049,70039,Blue,0,22581,23203,622
2022-12-18,70048,70056,Blue,1,59676,60231,555
2022-12-18,70057,70045,Blue,0,52291,52917,626
2022-08-11,70039,70838,Blue,0,27906,27939,33
2022-10-15,70040,70042,Blue,1,48612,48646,34
2022-07-04,70042,70060,Blue,1,86246,87390,1144
2022-12-14,70045,70838,Blue,0,42991,43342,351
2022-03-12,70053,70049,Blue,0,38701,38908,207
2022-11-28,70055,70051,Blue,0,52693,52828,135
2022-08-03,70044,70048,Blue,1,67768,68027,259
2022-04-03,70042,70058,Blue,1,60919,61776,857
2022-10-05,70057,70055,Blue,0,52047,52115,68
2022-01-19,70046,70056,Blue,1,55729,56270,541
2022-03-02,70041,70838,Blue,0,32719,32967,248
2022-02-13,70043,70039,Blue,0,65168,65280,112
2022-03-31,70038,70046,Blue,1,41437,41803,366
2022-07-05,70044,70046,Blue,1,51140,51257,117
2022-01-18,70057,70039,Blue,0,39391,40384,993
2022-08-25,70057,70039,Blue,0,46210,47330,1120
2022-10-14,70042,70052,Blue,1,48373,48932,559
2022-03-24,70051,70039,Blue,0,21340,22034,694
2022-09-12,70044,70052,Blue,1,61512,62015,503
2022-11-03,70038,70050,Blue,1,29831,30437,606
2022-03-06,70047,70039,Blue,0,34581,34983,402
2022-04-22,70057,70055,Blue,0,59384,59454,70
2022-08-08,70055,70047,Blue,0,26133,26522,389
2022-06-14,70049,70041,Blue,0,60387,60826,439
2022-10-13,70055,70041,Blue,0,54818,55542,724
2022-07-14,70038,70040,Blue,1,47109,47126,17
2022-02-26,70053,70047,Blue,0,37075,37479,404
2022-09-20,70051,70838,Blue,0,27580,28389,809
2022-12-06,70057,70838,Blue,0,45343,46444,1101
2022-03-28,70047,70045,Blue,0,59346,59467,121
2022-11-25,70038,70052,Blue,1,44020,44762,742
2022-11-25,70059,70838,Blue,0,23413,24579,1166
2022-11-02,70048,70060,Blue,1,23834,24648,814
2022-03-22,70055,70043,Blue,0,56647,57320,673
2022-11-27,70057,70047,Blue,0,26223,26704,481
2022-08-05,70053,70838,Blue,0,83991,84926,935
2022-12-17,70055,70045,Blue,0,29969,30511,542
2022-09-07,70038,70056,Blue,1,64260,65196,936
2022-11-23,70051,70045,Blue,0,59120,59483,363
2022-04-13,70057,70838,Blue,0,69425,70622,1197
2022-10-18,70044,70046,Blue,1,24743,24847,104
2022-04-08,70038,70060,Blue,1,46387,47464,1077
2022-01-31,70042,70054,Blue,1,56654,57401,747
2022-10-07,70039,70838,Blue,0,51443,51509,66
2022-10-07,70040,70060,Blue,1,73240,74319,1079
2022-07-08,70042,70056,Blue,1,54304,55096,792
2022-03-29,70038,70040,Blue,1,69907,69922,15
2022-12-25,70048,70056,Blue,1,62864,63243,379
2022-07-12,70053,70838,Blue,0,67340,68336,996
2022-10-19,70042,70052,Blue,1,33037,33646,609
2022-05-17,70055,70047,Blue,0,22752,23131,379
2022-03-20,70048,70056,Blue,1,86010,86398,388
2022-04-18,70057,70039,Blue,0,62496,63567,1071
2022-03-10,70040,70046,Blue,1,25521,25817,296
2022-02-06,70049,70043,Blue,0,52292,52801,509
2022-03-02,70054,70058,Blue,1,25238,25407,169
2022-07-29,70059,70039,Blue,0,39155,40285,1130
2022-12-29,70051,70047,Blue,0,83990,84182,192
2022-01-01,70043,70039,Blue,0,30184,30304,120
2022-04-23,70046,70050,Blue,1,63545,63736,191
2022-05-02,70052,70056,Blue,1,25402,25541,139
2022-12-15,70044,70050,Blue,1,69748,70109,361
2022-01-25,70059,70838,Blue,0,45494,46612,1118
2022-12-03,70043,70039,Blue,0,76717,76830,113
2022-09-28,70049,70047,Blue,0,51508,51563,55
2022-05-20,70042,70054,Blue,1,33391,34182,791
2022-02-24,70059,70043,Blue,0,29059,30015,956
2022-08-01,70057,70055,Blue,0,59380,59448,68
2022-02-12,70038,70052,Blue,1,68536,69229,693
2022-10-30,70038,70052,Blue,1,75849,76534,685
2022-07-20,70052,70054,Blue,1,87226,87278,52
2022-06-12,70045,70041,Blue,0,70781,70984,203
2022-01-14,70038,70056,Blue,1,64332,65264,932
2022-10-11,70059,70049,Blue,0,85756,86263,507
2022-01-16,70053,70041,Blue,0,76817,77503,686
2022-04-12,70040,70044,Blue,1,60498,60614,116
2022-01-07,70042,70050,Blue,1,62408,62863,455
2022-03-18,70038,70050,Blue,1,68957,69548,591
2022-07-07,70038,70052,Blue,1,41774,42601,827
2022-05-07,70058,70060,Blue,1,77637,77711,74
2022-11-03,70057,70045,Blue,0,86607,87228,621
2022-06-26,70038,70060,Blue,1,55843,57180,1337
2022-10-23,70038,70044,Blue,1,42968,43131,163
2022-03-02,70042,70060,Blue,1,47819,48837,1018
2022-08-07,70055,70039,Blue,0,61771,62694,923
2022-03-08,70053,70049,Blue,0,29062,29255,193
2022-04-08,70048,70050,Blue,1,84241,84299,58
2022-09-29,70059,70055,Blue,0,63206,63338,132
2022-12-22,70058,70060,Blue,1,69591,69655,64
2022-10-28,70046,70052,Blue,1,32943,33276,333
2022-11-30,70045,70039,Blue,0,62126,62365,239
2022-08-13,70044,70046,Blue,1,64466,64570,104
2022-10-15,70044,70058,Blue,1,65553,66363,810
2022-11-22,70041,70838,Blue,0,47221,47346,125
2022-08-24,70038,70054,Blue,1,29842,30662,820
2022-04-22,70053,70043,Blue,0,20211,20848,637
2022-03-14,70052,70054,Blue,1,69324,69375,51
2022-09-06,70038,70058,Blue,1,51796,52824,1028
2022-02-14,70057,70041,Blue,0,49849,50894,1045
2022-12-10,70055,70053,Blue,0,46692,46739,47
2022-11-10,70040,70048,Blue,1,25995,26406,411
2022-11-22,70057,70043,Blue,0,20815,21671,856
2022-12-30,70053,70051,Blue,0,53788,53846,58
2022-03-13,70053,70043,Blue,0,35091,35708,617
2022-10-18,70040,70042,Blue,1,79532,79561,29
2022-06-15,70059,70055,Blue,0,62895,63049,154
2022-03-15,70053,70838,Blue,0,56556,57452,896
2022-05-16,70059,70053,Blue,0,51792,52017,225
2022-02-01,70046,70054,Blue,1,29437,29882,445
2022-08-04,70059,70041,Blue,0,52521,53495,974
2022-07-29,70051,70043,Blue,0,67694,68269,575
2022-09-24,70053,70045,Blue,0,45157,45588,431
2022-01-03,70051,70039,Blue,0,66267,67860,1593
2022-08-26,70054,70060,Blue,1,36317,36597,280
2022-07-06,70047,70838,Blue,0,88769,89743,974
2022-01-18,70044,70052,Blue,1,47162,47777,615
2022-08-28,70058,70060,Blue,1,39435,39498,63
2022-07-12,70042,70044,Blue,1,39625,39659,34
2022-05-20,70051,70041,Blue,0,79311,79980,669
2022-04-20,70043,70838,Blue,0,55716,55935,219
2022-01-01,70052,70056,Blue,1,36962,37095,133
2022-12-05,70051,70049,Blue,0,29544,29646,102
2022-10-11,70053,70047,Blue,0,81440,81784,344
2022-02-20,70053,70045,Blue,0,24108,24509,401
2022-10-30,70059,70838,Blue,0,24809,25887,1078
2022-07-26,70047,70838,Blue,0,25973,26559,586
2022-06-22,70059,70838,Blue,0,47318,48420,1102
2022-01-06,70052,70056,Blue,1,69737,69885,148
2022-04-05,70047,70838,Blue,0,67091,67557,466
2022-08-26,70051,70838,Blue,0,78857,79846,989
2022-03-21,70038,70040,Blue,1,78009,78024,15
2022-09-15,70051,70043,Blue,0,53893,54371,478
2022-07-02,70052,70058,Blue,1,23122,23389,267
2022-04-08,70057,70047,Blue,0,39866,40406,540
2022-06-29,70055,70041,Blue,0,66829,67591,762
2022-10-07,70040,70050,Blue,1,31185,31679,494
2022-09-17,70053,70049,Blue,0,77382,77571,189
2022-05-06,70054,70058,Blue,1,52526,52681,155
2022-02-01,70044,70058,Blue,1,62436,63302,866
2022-12-22,70059,70838,Blue,0,54495,55601,1106
2022-03-01,70053,70043,Blue,0,50496,51052,556
2022-08-20,70047,70043,Blue,0,75201,75454,253
2022-11-02,70049,70039,Blue,0,34893,35425,532
2022-11-24,70054,70058,Blue,1,82633,82813,180
2022-08-30,70057,70039,Blue,0,48938,49844,906
2022-01-29,70051,70041,Blue,0,27449,28078,629
2022-02-17,70057,70055,Blue,0,82951,83022,71
2022-12-31,70040,70048,Blue,1,76625,76994,369
2022-03-14,70049,70041,Blue,0,63413,63838,425
2022-09-17,70054,70056,Blue,1,78173,78220,47
2022-04-06,70043,70039,Blue,0,33620,33773,153
2022-11-01,70059,70043,Blue,0,68661,69511,850
2022-06-26,70039,70838,Blue,0,67865,67897,32
2022-08-02,70059,70047,Blue,0,61639,62270,631
2022-02-19,70050,70054,Blue,1,67477,67710,233
2022-07-27,70051,70045,Blue,0,38331,38661,330
2022-08-31,70050,70060,Blue,1,59225,59728,503
2022-11-14,70038,70058,Blue,1,74177,75218,1041
2022-08-08,70045,70041,Blue,0,23329,23502,173
2022-07-23,70059,70051,Blue,0,50859,51202,343
2022-03-22,70047,70041,Blue,0,47968,48296,328
2022-10-31,70044,70050,Blue,1,54702,55043,341
2022-07-29,70048,70054,Blue,1,70660,70986,326
2022-06-02,70049,70043,Blue,0,84282,84667,385
2022-02-12,70046,70056,Blue,1,21456,21946,490
2022-12-10,70059,70838,Blue,0,57336,58456,1120
2022-04-14,70050,70052,Blue,1,77446,77558,112
2022-11-03,70053,70049,Blue,0,68872,69075,203
2022-08-23,70049,70043,Blue,0,80340,80743,403
2022-02-04,70045,70039,Blue,0,26930,27235,305
2022-08-11,70044,70048,Blue,1,64903,65151,248
2022-03-05,70040,70054,Blue,1,54562,55267,705
2022-12-31,70057,70053,Blue,0,56916,57065,149
2022-06-09,70042,70048,Blue,1,38014,38374,360
2022-12-22,70057,70055,Blue,0,87522,87601,79
2022-01-05,70038,70058,Blue,1,27261,28312,1051
2022-12-28,70057,70047,Blue,0,24520,25052,532
2022-01-24,70046,70060,Blue,1,86442,87224,782
2022-10-31,70046,70052,Blue,1,47468,47798,330
2022-03-23,70042,70046,Blue,1,79350,79542,192
2022-04-19,70059,70057,Blue,0,54229,54263,34
2022-11-01,70041,70039,Blue,0,23815,23847,32
2022-12-13,70051,70047,Blue,0,65966,66182,216
2022-10-01,70038,70054,Blue,1,72339,73109,770
2022-05-21,70059,70057,Blue,0,54620,54657,37
2022-08-18,70048,70056,Blue,1,38882,39539,657
2022-10-17,70052,70054,Blue,1,22506,22567,61
2022-05-19,70057,70049,Blue,0,20807,21186,379
2022-08-22,70055,70039,Blue,0,20601,21471,870
2022-11-22,70055,70838,Blue,0,24348,25339,991
2022-07-14,70050,70060,Blue,1,37121,37847,726
2022-11-29,70042,70048,Blue,1,52468,52825,357
2022-09-29,70039,70838,Blue,0,67160,67199,39
2022-04-19,70059,70838,Blue,0,63742,64803,1061
2022-06-14,70054,70058,Blue,1,23959,24122,163
2022-12-15,70042,70052,Blue,1,35420,35960,540
2022-10-31,70049,70045,Blue,0,73625,73837,212
2022-10-18,70038,70060,Blue,1,65394,66607,1213
2022-08-04,70055,70049,Blue,0,53768,54052,284
2022-07-22,70053,70045,Blue,0,43965,44414,449
2022-03-03,70054,70058,Blue,1,71342,71498,156
2022-12-25,70048,70060,Blue,1,74185,74793,608
2022-05-05,70052,70058,Blue,1,85341,85598,257
2022-12-14,70051,70045,Blue,0,82507,82849,342
2022-06-11,70051,70838,Blue,0,80354,81109,755
2022-08-30,70051,70838,Blue,0,79183,79916,733
2022-12-02,70040,70042,Blue,1,72131,72164,33
2022-03-17,70044,70052,Blue,1,81187,81741,554
2022-10-27,70040,70050,Blue,1,34546,35039,493
2022-11-05,70045,70838,Blue,0,25615,25984,369
2022-08-28,70053,70041,Blue,0,46053,46690,637
2022-03-30,70042,70048,Blue,1,29781,30095,314
2022-07-17,70042,70050,Blue,1,71224,71631,407
2022-09-02,70057,70051,Blue,0,23920,24154,234
2022-10-18,70044,70050,Blue,1,24355,24712,357
2022-06-12,70052,70054,Blue,1,79914,79960,46
2022-02-22,70050,70058,Blue,1,24842,25256,414
2022-06-20,70040,70058,Blue,1,48286,49318,1032
2022-11-01,70057,70838,Blue,0,70316,71286,970
2022-12-26,70050,70052,Blue,1,54342,54459,117
2022-09-10,70050,70054,Blue,1,54671,54884,213
2022-06-17,70038,70046,Blue,1,75901,76311,410
2022-03-31,70038,70056,Blue,1,33965,34941,976
2022-11-15,70052,70056,Blue,1,34350,34487,137
2022-11-21,70043,70838,Blue,0,74371,74546,175
2022-09-19,70050,70060,Blue,1,27151,27678,527
2022-02-28,70052,70054,Blue,1,79939,79993,54
2022-09-09,70055,70043,Blue,0,22222,22945,723
2022-04-03,70057,70039,Blue,0,80362,81251,889
2022-10-12,70040,70046,Blue,1,20118,20434,316
2022-03-31,70050,70056,Blue,1,20459,20770,311
2022-02-27,70047,70045,Blue,0,59326,59420,94
2022-10-01,70046,70048,Blue,1,57170,57248,78
2022-02-17,70059,70045,Blue,0,77773,78444,671
2022-01-09,70038,70052,Blue,1,39675,40408,733
2022-04-24,70053,70039,Blue,0,34256,35042,786
2022-06-18,70055,70047,Blue,0,29048,29443,395
2022-07-26,70052,70054,Blue,1,36359,36445,86
2022-03-20,70046,70050,Blue,1,23344,23582,238
2022-08-06,70059,70049,Blue,0,65955,66409,454
2022-11-11,70055,70039,Blue,0,42336,43200,864
2022-05-21,70055,70051,Blue,0,46779,46942,163
2022-10-17,70040,70044,Blue,1,67476,67584,108
2022-12-02,70052,70060,Blue,1,62493,62994,501
2022-09-03,70047,70039,Blue,0,27153,27570,417
2022-10-25,70044,70056,Blue,1,76219,76928,709
2022-11-11,70044,70060,Blue,1,83297,84259,962
2022-08-15,70057,70051,Blue,0,64530,64770,240
2022-03-01,70044,70054,Blue,1,55578,56182,604
2022-12-03,70059,70039,Blue,0,37336,38374,1038
2022-01-27,70049,70039,Blue,0,73827,74378,551
2022-04-13,70040,70052,Blue,1,82095,83572,1477
2022-04-16,70046,70058,Blue,1,50574,51236,662
2022-07-22,70049,70043,Blue,0,63190,63546,356
2022-10-14,70059,70043,Blue,0,80470,81315,845
2022-09-21,70055,70047,Blue,0,68396,69199,803
2022-08-15,70045,70838,Blue,0,88435,88795,360
2022-03-07,70059,70838,Blue,0,69077,70161,1084
2022-02-18,70049,70838,Blue,0,54994,55594,600
2022-04-19,70048,70058,Blue,1,27496,27995,499
2022-04-17,70049,70039,Blue,0,84294,84822,528
2022-11-10,70053,70838,Blue,0,42345,43187,842
2022-08-06,70046,70060,Blue,1,71647,72386,739
2022-06-16,70054,70056,Blue,1,87032,87080,48
2022-11-23,70053,70039,Blue,0,76729,77461,732
2022-09-09,70054,70060,Blue,1,43004,43281,277
2022-11-14,70059,70039,Blue,0,64456,65434,978
2022-01-08,70040,70044,Blue,1,68608,68733,125
2022-07-17,70056,70060,Blue,1,47206,47394,188
2022-08-08,70059,70043,Blue,0,56235,57202,967
2022-09-08,70053,70045,Blue,0,63680,64128,448
2022-03-03,70057,70041,Blue,0,42836,43789,953
2022-03-20,70056,70060,Blue,1,70870,71058,188
2022-08-25,70057,70043,Blue,0,22655,23481,826
2022-12-26,70057,70041,Blue,0,77133,77960,827
2022-06-13,70053,70045,Blue,0,79185,79641,456
2022-11-28,70044,70056,Blue,1,80541,81229,688
2022-03-24,70048,70052,Blue,1,54324,54524,200
2022-07-19,70044,70058,Blue,1,29185,29964,779
2022-10-22,70046,70058,Blue,1,44720,45336,616
2022-09-24,70059,70051,Blue,0,43268,43579,311
2022-02-22,70046,70050,Blue,1,47346,47533,187
2022-05-10,70050,70056,Blue,1,80574,80893,319
2022-08-22,70038,70054,Blue,1,56796,57631,835
2022-02-13,70042,70052,Blue,1,78714,79309,595
2022-09-12,70057,70041,Blue,0,35004,35971,967
2022-12-20,70048,70052,Blue,1,41826,42043,217
2022-04-07,70059,70045,Blue,0,81734,82466,732
2022-11-26,70053,70047,Blue,0,80920,81210,290
2022-06-02,70044,70052,Blue,1,41725,42430,705
2022-10-25,70046,70056,Blue,1,73011,73517,506
2022-05-09,70055,70053,Blue,0,32021,32066,45
2022-04-02,70038,70060,Blue,1,54486,55625,1139
2022-09-01,70047,70041,Blue,0,52089,52402,313
2022-11-13,70057,70047,Blue,0,41570,42045,475
2022-09-29,70038,70046,Blue,1,28729,29052,323
2022-12-12,70057,70045,Blue,0,64539,65137,598
2022-10-08,70047,70041,Blue,0,23492,23849,357
2022-07-19,70054,70060,Blue,1,74078,74344,266
2022-10-08,70046,70056,Blue,1,62953,63471,518
2022-06-22,70055,70047,Blue,0,28482,28879,397
2022-03-02,70048,70054,Blue,1,36248,36625,377
2022-10-04,70053,70047,Blue,0,67947,68237,290
2022-02-12,70055,70043,Blue,0,49962,50681,719
2022-11-22,70056,70060,Blue,1,22711,22984,273
2022-01-20,70048,70050,Blue,1,63642,63700,58
2022-03-01,70048,70058,Blue,1,40073,40555,482
2022-04-14,70042,70054,Blue,1,55483,56144,661
2022-02-20,70046,70054,Blue,1,54108,54552,444
2022-08-01,70044,70056,Blue,1,27525,28249,724
2022-11-27,70047,70838,Blue,0,46735,47284,549
2022-12-13,70038,70054,Blue,1,85693,86575,882
2022-08-10,70050,70052,Blue,1,83459,83570,111
2022-08-17,70040,70042,Blue,1,63315,63347,32
2022-12-19,70038,70060,Blue,1,49459,50597,1138
2022-02-12,70041,70039,Blue,0,62136,62174,38
2022-02-07,70057,70051,Blue,0,21419,21707,288
2022-02-28,70038,70046,Blue,1,39096,39441,345
2022-06-03,70047,70045,Blue,0,31952,32062,110
2022-12-21,70040,70046,Blue,1,29518,29769,251
2022-09-05,70047,70838,Blue,0,86121,86580,459
2022-02-15,70053,70045,Blue,0,22709,23219,510
2022-07-31,70057,70045,Blue,0,76054,76670,616
2022-03-12,70054,70060,Blue,1,77483,77749,266
2022-11-20,70047,70039,Blue,0,65202,65558,356
2022-06-01,70047,70838,Blue,0,25520,26050,530
2022-01-12,70050,70052,Blue,1,85752,85886,134
2022-08-12,70056,70058,Blue,1,49742,49814,72
2022-11-19,70049,70838,Blue,0,57848,58479,631
2022-06-27,70055,70049,Blue,0,53730,54007,277
2022-01-06,70053,70041,Blue,0,80867,81490,623
2022-12-29,70050,70058,Blue,1,60185,60570,385
2022-10-01,70046,70048,Blue,1,67840,67921,81
2022-12-08,70055,70043,Blue,0,51705,52348,643
2022-05-18,70040,70054,Blue,1,21191,22118,927
2022-06-20,70048,70058,Blue,1,75298,75793,495
2022-11-22,70040,70042,Blue,1,74254,74285,31
2022-02-12,70057,70053,Blue,0,74691,74887,196
2022-12-19,70038,70042,Blue,1,65676,65781,105
2022-02-10,70041,70838,Blue,0,68469,68588,119
2022-02-12,70059,70041,Blue,0,32477,33479,1002
2022-10-18,70059,70051,Blue,0,28899,29265,366
2022-10-21,70042,70048,Blue,1,83487,83805,318
2022-01-15,70057,70039,Blue,0,57392,59156,1764
2022-06-26,70049,70041,Blue,0,80794,81261,467
2022-12-31,70059,70053,Blue,0,79213,79444,231
2022-08-30,70050,70052,Blue,1,49312,49469,157
2022-10-15,70047,70838,Blue,0,67656,68152,496
2022-08-06,70042,70046,Blue,1,76251,76439,188
2022-09-29,70038,70040,Blue,1,26896,26912,16
2022-08-02,70053,70051,Blue,0,64338,64399,61
2022-11-02,70049,70838,Blue,0,63955,64557,602
2022-03-11,70040,70048,Blue,1,44859,45323,464
2022-09-29,70047,70838,Blue,0,75981,76511,530
2022-12-13,70042,70060,Blue,1,80437,81409,972
2022-11-02,70059,70043,Blue,0,24920,25889,969
2022-06-09,70053,70051,Blue,0,55690,55750,60
2022-10-04,70040,70056,Blue,1,54081,54980,899
2022-04-22,70059,70043,Blue,0,47655,48507,852
2022-03-26,70053,70838,Blue,0,35455,36343,888
2022-02-07,70046,70056,Blue,1,40748,41416,668
2022-06-08,70046,70048,Blue,1,74185,74285,100
2022-08-14,70055,70043,Blue,0,48089,48791,702
2022-04-11,70049,70043,Blue,0,45443,45793,350
2022-02-18,70054,70060,Blue,1,52311,52560,249
2022-12-15,70040,70048,Blue,1,21852,22220,368
2022-03-07,70054,70058,Blue,1,57067,57345,278
2022-09-30,70042,70044,Blue,1,85144,85175,31
2022-12-15,70040,70048,Blue,1,76811,77192,381
2022-08-13,70057,70047,Blue,0,85764,86232,468
2022-09-06,70050,70052,Blue,1,67478,67589,111
2022-05-11,70058,70060,Blue,1,56517,56584,67
2022-07-02,70059,70838,Blue,0,73558,74716,1158
2022-04-22,70044,70054,Blue,1,26766,27472,706
2022-06-08,70040,70050,Blue,1,21021,21649,628
2022-04-13,70038,70060,Blue,1,71948,73151,1203
2022-11-15,70059,70047,Blue,0,66815,67385,570
2022-10-10,70056,70058,Blue,1,61089,61163,74
2022-06-23,70057,70041,Blue,0,78914,79755,841
2022-12-13,70050,70052,Blue,1,25106,25223,117
2022-10-18,70053,70047,Blue,0,54869,55158,289
2022-11-29,70049,70041,Blue,0,80944,81362,418
2022-09-13,70044,70060,Blue,1,27728,28609,881
2022-09-04,70042,70058,Blue,1,83125,84000,875
2022-04-23,70048,70050,Blue,1,27402,27457,55
2022-10-06,70042,70054,Blue,1,32736,33407,671
2022-05-20,70049,70838,Blue,0,24488,25221,733
2022-02-01,70059,70049,Blue,0,60194,60690,496
2022-03-26,70046,70056,Blue,1,70023,70546,523
2022-02-21,70059,70057,Blue,0,25455,25490,35
2022-04-01,70055,70049,Blue,0,19688,19959,271
2022-12-13,70057,70039,Blue,0,80582,81487,905
2022-09-20,70040,70050,Blue,1,25701,26175,474
2022-09-22,70040,70056,Blue,1,77349,78145,796
2022-03-18,70057,70047,Blue,0,58170,58659,489
2022-12-08,70044,70060,Blue,1,55810,56752,942
2022-11-27,70044,70056,Blue,1,70664,71361,697
2022-12-15,70055,70045,Blue,0,37110,37775,665
2022-09-01,70057,70053,Blue,0,33995,34145,150
2022-02-25,70053,70039,Blue,0,66489,67270,781
2022-06-24,70038,70054,Blue,1,70202,71090,888
2022-12-19,70044,70054,Blue,1,81579,82167,588
2022-12-07,70057,70055,Blue,0,33456,33525,69
2022-01-12,70052,70058,Blue,1,29836,30097,261
2022-05-26,70039,70838,Blue,0,27683,27716,33
2022-09-28,70044,70060,Blue,1,25046,26294,1248
2022-04-27,70059,70047,Blue,0,25101,25691,590
2022-12-18,70052,70058,Blue,1,88963,89233,270
2022-08-30,70051,70047,Blue,0,75660,75851,191
2022-04-03,70043,70041,Blue,0,47612,47638,26
2022-09-06,70042,70044,Blue,1,21530,21559,29
2022-11-07,70059,70043,Blue,0,87339,88175,836
2022-01-16,70038,70044,Blue,1,46842,47011,169
2022-03-05,70050,70056,Blue,1,35789,36087,298
2022-01-20,70045,70041,Blue,0,81984,82187,203
2022-02-19,70048,70054,Blue,1,70665,70965,300
2022-06-24,70048,70050,Blue,1,25930,25989,59
2022-01-16,70042,70060,Blue,1,40578,41683,1105
2022-02-17,70052,70054,Blue,1,73747,73803,56
2022-10-12,70042,70060,Blue,1,63983,65000,1017
2022-11-17,70056,70060,Blue,1,26300,26476,176
2022-02-11,70051,70047,Blue,0,50165,50357,192
2022-06-04,70038,70042,Blue,1,59055,59153,98
2022-06-23,70044,70060,Blue,1,30488,31599,1111
2022-07-13,70055,70047,Blue,0,50455,50835,380
2022-07-26,70046,70060,Blue,1,36118,37052,934
2022-07-06,70043,70039,Blue,0,79362,79465,103
2022-09-26,70042,70050,Blue,1,36545,36971,426
2022-01-06,70053,70838,Blue,0,29989,30857,868
2022-09-02,70044,70056,Blue,1,77601,78322,721
2022-03-04,70054,70056,Blue,1,37109,37157,48
2022-09-14,70044,70054,Blue,1,64756,65382,626
2022-11-23,70048,70054,Blue,1,55396,55735,339
2022-11-04,70038,70048,Blue,1,25272,25719,447
2022-08-13,70038,70060,Blue,1,58280,59464,1184
2022-02-18,70043,70041,Blue,0,51475,51504,29
2022-10-24,70059,70047,Blue,0,51500,52047,547
2022-03-23,70053,70049,Blue,0,81457,81650,193
2022-12-16,70049,70045,Blue,0,41122,41331,209
2022-09-09,70043,70041,Blue,0,61259,61290,31
2022-03-03,70053,70051,Blue,0,36227,36293,66
2022-03-01,70040,70054,Blue,1,35444,36244,800
2022-10-07,70040,70044,Blue,1,61469,61590,121
2022-03-02,70038,70048,Blue,1,78164,78721,557
2022-10-22,70045,70838,Blue,0,39712,40073,361
2022-04-26,70052,70056,Blue,1,31250,31386,136
2022-03-05,70051,70039,Blue,0,20742,21334,592
2022-03-20,70051,70047,Blue,0,79362,79552,190
2022-11-20,70059,70057,Blue,0,80238,80276,38
2022-12-17,70052,70054,Blue,1,45005,45060,55
2022-08-09,70048,70052,Blue,1,67803,68010,207
2022-02-08,70059,70049,Blue,0,60198,60677,479
2022-09-10,70059,70045,Blue,0,19518,20232,714
2022-06-17,70044,70048,Blue,1,25397,25671,274
2022-04-23,70040,70052,Blue,1,61580,62286,706
2022-10-09,70059,70045,Blue,0,21505,22237,732
2022-12-16,70040,70058,Blue,1,72175,73138,963
2022-05-20,70051,70049,Blue,0,77545,77651,106
2022-11-09,70038,70042,Blue,1,48897,49007,110
2022-05-20,70038,70042,Blue,1,22753,22840,87
2022-03-04,70053,70041,Blue,0,86566,87200,634
2022-08-30,70048,70050,Blue,1,69444,69500,56
2022-10-30,70059,70043,Blue,0,80240,81054,814
2022-09-27,70044,70046,Blue,1,52496,52602,106
2022-10-11,70057,70838,Blue,0,73888,74887,999
2022-03-17,70040,70052,Blue,1,65291,66126,835
2022-01-02,70059,70051,Blue,0,54980,55315,335
2022-10-18,70059,70043,Blue,0,77490,78394,904
2022-01-07,70052,70058,Blue,1,34986,35283,297
2022-07-10,70053,70039,Blue,0,73539,74338,799
2022-11-25,70052,70056,Blue,1,43214,43355,141
2022-03-25,70044,70050,Blue,1,52356,52746,390
2022-05-20,70038,70052,Blue,1,24598,25382,784
2022-03-31,70041,70838,Blue,0,56999,57121,122
2022-10-11,70046,70054,Blue,1,39990,40424,434
2022-02-14,70057,70047,Blue,0,19249,19841,592
2022-10-26,70052,70056,Blue,1,61057,61193,136
2022-06-30,70056,70060,Blue,1,45033,45238,205
2022-02-18,70043,70041,Blue,0,25558,25586,28
2022-04-23,70046,70060,Blue,1,66218,66948,730
2022-12-30,70051,70047,Blue,0,54394,54588,194
2022-12-06,70046,70054,Blue,1,53783,54221,438
2022-12-17,70059,70053,Blue,0,23486,23727,241
2022-12-01,70050,70058,Blue,1,40300,40752,452
2022-03-25,70046,70052,Blue,1,36572,37011,439
2022-04-22,70045,70041,Blue,0,63054,63258,204
2022-08-25,70059,70043,Blue,0,64455,65286,831
2022-03-19,70045,70043,Blue,0,46716,46808,92
2022-08-24,70044,70058,Blue,1,52589,53412,823
2022-12-05,70038,70046,Blue,1,75197,75510,313
2022-11-24,70048,70052,Blue,1,64478,64687,209
2022-10-31,70038,70048,Blue,1,57123,57621,498
2022-05-19,70057,70049,Blue,0,69658,70041,383
2022-12-02,70059,70051,Blue,0,53534,53851,317
2022-01-20,70040,70058,Blue,1,70999,71949,950
2022-01-25,70046,70052,Blue,1,32447,32805,358
2022-08-26,70059,70053,Blue,0,71494,71736,242
2022-12-05,70053,70049,Blue,0,25382,25586,204
2022-12-19,70057,70051,Blue,0,53663,54028,365
2022-08-26,70053,70043,Blue,0,47087,47713,626
2022-02-15,70054,70056,Blue,1,29571,29618,47
2022-12-02,70059,70041,Blue,0,30867,31780,913
2022-02-10,70056,70058,Blue,1,58932,59121,189
2022-10-16,70049,70039,Blue,0,41966,42476,510
2022-07-06,70038,70060,Blue,1,23235,24521,1286
2022-03-29,70046,70048,Blue,1,24905,24986,81
2022-02-11,70051,70041,Blue,0,41922,42517,595
2022-08-08,70046,70060,Blue,1,61693,62444,751
2022-08-03,70044,70054,Blue,1,61064,61665,601
2022-01-20,70048,70056,Blue,1,85465,85874,409
2022-02-13,70051,70838,Blue,0,70980,71791,811
2022-07-21,70046,70060,Blue,1,76016,76980,964
2022-06-24,70040,70054,Blue,1,28796,29707,911
2022-02-22,70050,70058,Blue,1,23395,23881,486
2022-03-13,70040,70042,Blue,1,57556,57593,37
2022-07-23,70059,70043,Blue,0,81100,82001,901
2022-05-19,70055,70039,Blue,0,51384,52449,1065
2022-01-14,70042,70054,Blue,1,53500,54167,667
2022-12-14,70053,70043,Blue,0,66522,67102,580
2022-09-15,70059,70045,Blue,0,30947,31643,696
2022-03-16,70047,70045,Blue,0,50348,50455,107
2022-10-19,70055,70049,Blue,0,19722,20022,300
2022-04-12,70038,70058,Blue,1,76896,77952,1056
2022-01-27,70049,70041,Blue,0,20126,20616,490
2022-08-26,70039,70838,Blue,0,68834,68865,31
2022-11-23,70045,70041,Blue,0,42917,43087,170
2022-11-06,70057,70838,Blue,0,21601,22914,1313
2022-05-04,70049,70047,Blue,0,50043,50100,57
2022-07-12,70050,70060,Blue,1,79450,80067,617
2022-03-02,70054,70060,Blue,1,25238,25530,292
2022-04-02,70040,70056,Blue,1,80640,81460,820
2022-07-29,70044,70054,Blue,1,46885,47460,575
2022-02-17,70040,70054,Blue,1,65601,66302,701
2022-09-29,70055,70047,Blue,0,62054,62446,392
2022-06-21,70048,70050,Blue,1,43239,43298,59
2022-03-12,70049,70043,Blue,0,51893,52276,383
2022-07-30,70059,70047,Blue,0,55696,56264,568
2022-12-23,70040,70056,Blue,1,39842,40815,973
2022-07-19,70038,70044,Blue,1,34239,34447,208
2022-12-01,70055,70039,Blue,0,77123,77938,815
2022-06-14,70055,70043,Blue,0,76220,76965,745
2022-10-14,70044,70054,Blue,1,68144,68711,567
2022-09-02,70053,70043,Blue,0,62718,63310,592
2022-05-18,70055,70051,Blue,0,29259,29404,145
2022-10-28,70043,70838,Blue,0,61470,61692,222
2022-04-19,70040,70058,Blue,1,24292,25349,1057
2022-03-13,70050,70054,Blue,1,59183,59408,225
2022-05-21,70038,70044,Blue,1,24313,24469,156
2022-06-10,70042,70054,Blue,1,73635,74366,731
2022-07-16,70042,70060,Blue,1,66005,66973,968
2022-12-12,70040,70052,Blue,1,56554,57220,666
2022-02-14,70051,70041,Blue,0,87257,87840,583
2022-03-25,70042,70058,Blue,1,32510,33771,1261
2022-06-16,70051,70039,Blue,0,29468,30147,679
2022-12-01,70048,70058,Blue,1,31696,32243,547
2022-12-30,70051,70838,Blue,0,80937,81620,683
2022-08-04,70044,70054,Blue,1,78049,78698,649
2022-03-18,70051,70039,Blue,0,51557,52218,661
2022-12-04,70038,70048,Blue,1,63437,63923,486
2022-08-07,70042,70060,Blue,1,61702,62730,1028
2022-09-08,70051,70043,Blue,0,20781,21260,479
2022-02-05,70045,70041,Blue,0,77912,78076,164
2022-02-23,70041,70838,Blue,0,57500,57622,122
2022-06-23,70046,70054,Blue,1,25695,26148,453
2022-05-11,70055,70053,Blue,0,57006,57051,45
2022-03-21,70059,70053,Blue,0,21343,21590,247
2022-07-24,70049,70043,Blue,0,77583,77954,371
2022-11-12,70054,70056,Blue,1,42862,42908,46
2022-05-25,70049,70039,Blue,0,30382,31007,625
2022-11-14,70045,70041,Blue,0,54287,54456,169
2022-08-07,70038,70054,Blue,1,67222,67985,763
2022-02-04,70057,70041,Blue,0,32245,33285,1040
2022-02-04,70042,70054,Blue,1,30671,31349,678
2022-10-13,70044,70046,Blue,1,52008,52111,103
2022-02-02,70049,70043,Blue,0,30304,30708,404
2022-01-20,70046,70052,Blue,1,72974,73299,325
2022-03-21,70043,70039,Blue,0,74663,74767,104
2022-08-02,70038,70040,Blue,1,31093,31107,14
2022-09-26,70054,70056,Blue,1,63099,63147,48
2022-10-14,70056,70060,Blue,1,40457,40658,201
2022-07-05,70057,70053,Blue,0,76536,76686,150
2022-02-18,70044,70050,Blue,1,61592,61964,372
2022-10-09,70059,70055,Blue,0,70054,70197,143
2022-06-20,70055,70043,Blue,0,27800,28496,696
2022-11-03,70049,70043,Blue,0,83173,83520,347
2022-07-18,70057,70051,Blue,0,35976,36240,264
2022-01-19,70040,70050,Blue,1,26198,26741,543
2022-01-19,70038,70060,Blue,1,46484,47679,1195
2022-08-05,70038,70048,Blue,1,42026,42519,493
2022-09-06,70046,70054,Blue,1,87717,88134,417
2022-03-22,70054,70056,Blue,1,67366,67412,46
2022-03-31,70040,70042,Blue,1,31211,31247,36
2022-11-19,70046,70060,Blue,1,30034,30747,713
2022-04-07,70044,70052,Blue,1,62206,62717,511
2022-07-09,70038,70052,Blue,1,27488,28166,678
2022-10-02,70040,70060,Blue,1,48433,49465,1032
2022-09-21,70039,70838,Blue,0,47960,47991,31
2022-03-08,70042,70056,Blue,1,32795,33554,759
2022-11-22,70057,70053,Blue,0,52597,52751,154
2022-04-15,70047,70041,Blue,0,60203,60537,334
2022-02-15,70054,70060,Blue,1,91279,91529,250
2022-05-21,70051,70045,Blue,0,23877,24302,425
2022-04-06,70059,70055,Blue,0,84007,84150,143
2022-03-06,70045,70039,Blue,0,40255,40533,278
2022-11-19,70057,70051,Blue,0,29873,30109,236
2022-05-27,70048,70052,Blue,1,61889,62161,272
2022-10-06,70045,70041,Blue,0,76724,76928,204
2022-10-18,70042,70046,Blue,1,76482,76666,184
2022-03-04,70040,70042,Blue,1,66289,66325,36
2022-03-01,70048,70050,Blue,1,26212,26266,54
2022-09-22,70043,70041,Blue,0,42139,42168,29
2022-01-19,70057,70053,Blue,0,75561,75719,158
2022-12-15,70057,70051,Blue,0,78199,78434,235
2022-09-11,70042,70056,Blue,1,70600,71346,746
2022-09-15,70055,70045,Blue,0,57085,57810,725
2022-12-31,70043,70039,Blue,0,59634,59751,117
2022-10-18,70055,70043,Blue,0,28671,29506,835
2022-10-20,70047,70039,Blue,0,62191,62616,425
2022-04-20,70045,70838,Blue,0,59824,60167,343
2022-03-26,70044,70056,Blue,1,34726,35417,691
2022-10-02,70051,70049,Blue,0,59589,59706,117
2022-01-28,70048,70054,Blue,1,35978,36281,303
2022-07-16,70054,70056,Blue,1,53883,53930,47
2022-01-22,70052,70058,Blue,1,35829,36077,248
2022-09-02,70040,70044,Blue,1,73122,73234,112
2022-11-15,70044,70058,Blue,1,21601,22481,880
2022-06-29,70040,70044,Blue,1,31914,32031,117
2022-12-30,70059,70053,Blue,0,61410,61653,243
2022-09-13,70042,70044,Blue,1,23222,23252,30
2022-03-25,70043,70039,Blue,0,31795,31923,128
2022-06-13,70049,70047,Blue,0,52051,52106,55
2022-01-12,70059,70045,Blue,0,22206,22968,762
2022-02-16,70038,70060,Blue,1,31763,33004,1241
2022-05-14,70056,70058,Blue,1,78304,78376,72
2022-09-28,70044,70046,Blue,1,62628,62733,105
2022-01-16,70046,70056,Blue,1,79022,79527,505
2022-03-30,70053,70043,Blue,0,43482,44037,555
2022-08-04,70053,70047,Blue,0,37459,37796,337
2022-10-01,70038,70046,Blue,1,77292,77646,354
2022-07-13,70047,70045,Blue,0,40739,40847,108
2022-09-13,70038,70054,Blue,1,75239,76061,822
2022-04-07,70047,70838,Blue,0,58716,59215,499
2022-06-11,70046,70058,Blue,1,44665,45298,633
2022-07-07,70044,70060,Blue,1,74886,75852,966
2022-07-06,70047,70838,Blue,0,64806,65288,482
2022-06-17,70053,70039,Blue,0,36186,37020,834
2022-01-06,70053,70047,Blue,0,35005,35361,356
2022-12-22,70042,70052,Blue,1,82777,83420,643
2022-03-23,70047,70043,Blue,0,33314,33578,264
2022-11-08,70059,70049,Blue,0,79383,79810,427
2022-10-14,70052,70054,Blue,1,57909,57962,53
2022-10-30,70046,70052,Blue,1,42033,42358,325
2022-01-10,70051,70039,Blue,0,33935,34870,935
2022-12-07,70053,70047,Blue,0,43346,43675,329
2022-05-18,70047,70039,Blue,0,20116,20747,631
2022-06-13,70046,70052,Blue,1,25944,26296,352
2022-01-08,70051,70039,Blue,0,50140,50837,697
2022-07-02,70050,70054,Blue,1,39394,39598,204
2022-09-01,70054,70056,Blue,1,58087,58134,47
2022-04-03,70038,70048,Blue,1,61275,61755,480
2022-11-30,70058,70060,Blue,1,25544,25622,78
2022-06-12,70042,70054,Blue,1,60896,61542,646
2022-01-03,70038,70052,Blue,1,30258,30960,702
2022-07-09,70042,70044,Blue,1,62222,62256,34
2022-11-24,70043,70041,Blue,0,68733,68760,27
2022-12-09,70043,70041,Blue,0,41676,41705,29
2022-02-24,70040,70042,Blue,1,89241,89275,34
2022-01-16,70056,70058,Blue,1,58530,58602,72
2022-09-29,70040,70046,Blue,1,72738,72998,260
2022-05-09,70051,70049,Blue,0,26754,26860,106
2022-01-15,70051,70049,Blue,0,70110,70212,102
2022-04-04,70059,70053,Blue,0,40399,40627,228
2022-05-03,70059,70053,Blue,0,31395,31625,230
2022-09-17,70047,70045,Blue,0,37891,37992,101
2022-10-11,70044,70054,Blue,1,67845,68432,587
2022-07-11,70042,70048,Blue,1,37423,37764,341
2022-12-11,70050,70060,Blue,1,29837,30367,530
2022-01-20,70053,70838,Blue,0,82034,82885,851
2022-02-20,70044,70046,Blue,1,48039,48143,104
2022-08-09,70049,70045,Blue,0,60292,60491,199
2022-01-11,70041,70039,Blue,0,19393,19425,32
2022-01-29,70050,70052,Blue,1,49215,49430,215
2022-10-26,70052,70058,Blue,1,73995,74252,257
2022-09-09,70054,70058,Blue,1,43981,44162,181
2022-09-30,70057,70838,Blue,0,38149,39272,1123
2022-04-14,70057,70039,Blue,0,70034,71000,966
2022-02-14,70050,70058,Blue,1,60409,60799,390
2022-02-03,70047,70039,Blue,0,58478,58923,445
2022-02-15,70050,70060,Blue,1,24683,25268,585
2022-09-14,70046,70050,Blue,1,81329,81511,182
2022-04-08,70044,70058,Blue,1,72656,73511,855
2022-02-07,70042,70054,Blue,1,89292,89936,644
2022-11-24,70043,70039,Blue,0,35677,35790,113
2022-03-10,70049,70838,Blue,0,50892,51722,830
2022-08-03,70042,70048,Blue,1,28804,29102,298
2022-01-07,70051,70039,Blue,0,56051,56789,738
2022-12-25,70046,70058,Blue,1,24376,25235,859
2022-12-14,70050,70058,Blue,1,32514,32943,429
2022-06-19,70038,70054,Blue,1,43720,44545,825
2022-08-06,70038,70046,Blue,1,33431,33721,290
2022-03-11,70051,70041,Blue,0,34315,35016,701
2022-12-18,70053,70838,Blue,0,31917,32766,849
2022-04-08,70038,70052,Blue,1,63749,64506,757
2022-03-06,70055,70049,Blue,0,71832,72131,299
2022-12-22,70059,70057,Blue,0,77357,77398,41
2022-01-18,70046,70060,Blue,1,76383,77185,802
2022-10-05,70051,70045,Blue,0,42523,42851,328
2022-03-23,70053,70051,Blue,0,46882,46936,54
2022-07-23,70042,70060,Blue,1,33567,34518,951
2022-02-27,70055,70838,Blue,0,65887,66785,898
2022-06-24,70040,70054,Blue,1,63086,64019,933
2022-08-11,70059,70055,Blue,0,24258,24406,148
2022-06-18,70046,70058,Blue,1,43655,44412,757
2022-11-13,70046,70050,Blue,1,70848,71027,179
2022-10-19,70053,70043,Blue,0,76178,76775,597
2022-01-15,70055,70049,Blue,0,21673,21940,267
2022-01-25,70057,70838,Blue,0,35263,36311,1048
2022-03-18,70043,70039,Blue,0,50672,50784,112
2022-03-19,70048,70056,Blue,1,27457,27821,364
2022-03-06,70053,70045,Blue,0,33455,33907,452
2022-08-29,70055,70043,Blue,0,39671,40345,674
2022-03-02,70041,70838,Blue,0,52535,52664,129
2022-12-26,70055,70049,Blue,0,79837,80123,286
2022-06-16,70048,70054,Blue,1,67997,68309,312
2022-07-07,70040,70060,Blue,1,60120,61335,1215
2022-10-03,70044,70054,Blue,1,88454,89030,576
2022-12-21,70055,70043,Blue,0,59908,60599,691
2022-01-25,70041,70838,Blue,0,71518,71645,127
2022-04-09,70038,70054,Blue,1,76568,77388,820
2022-03-03,70050,70054,Blue,1,21680,21895,215
2022-09-23,70046,70058,Blue,1,35464,36104,640
2022-11-28,70046,70050,Blue,1,42006,42463,457
2022-08-07,70051,70041,Blue,0,30454,30991,537
2022-09-03,70053,70051,Blue,0,71641,71705,64
2022-01-25,70056,70058,Blue,1,53829,53904,75
2022-12-25,70057,70049,Blue,0,83067,83440,373
2022-02-28,70051,70838,Blue,0,38769,39579,810
2022-11-27,70059,70057,Blue,0,67888,67923,35
2022-10-12,70042,70046,Blue,1,38558,38741,183
2022-07-15,70046,70060,Blue,1,57067,57879,812
2022-02-15,70041,70838,Blue,0,62817,62949,132
2022-08-01,70042,70048,Blue,1,21038,21316,278
2022-10-05,70041,70838,Blue,0,76843,76949,106
2022-04-23,70051,70043,Blue,0,54441,54998,557
2022-08-13,70058,70060,Blue,1,53960,54027,67
2022-11-04,70057,70039,Blue,0,58684,59726,1042
2022-06-19,70057,70049,Blue,0,87411,87785,374
2022-04-19,70049,70047,Blue,0,69604,69656,52
2022-10-26,70041,70838,Blue,0,49898,50016,118
2022-10-18,70044,70050,Blue,1,60939,61282,343
2022-01-07,70038,70040,Blue,1,32365,32381,16
2022-08-29,70044,70046,Blue,1,25145,25257,112
2022-01-24,70053,70838,Blue,0,20932,21869,937
2022-03-07,70055,70049,Blue,0,73929,74251,322
2022-08-08,70052,70056,Blue,1,65584,65727,143
2022-12-07,70040,70054,Blue,1,28640,29345,705
2022-06-11,70051,70047,Blue,0,57144,57347,203
2022-03-07,70038,70058,Blue,1,47580,48703,1123
2022-04-11,70050,70060,Blue,1,84278,84769,491
2022-02-12,70048,70056,Blue,1,67591,68000,409
2022-07-06,70051,70043,Blue,0,18802,19342,540
2022-08-21,70054,70056,Blue,1,71914,71961,47
2022-06-16,70038,70046,Blue,1,73139,73689,550
2022-11-21,70038,70050,Blue,1,79620,80148,528
2022-01-10,70052,70054,Blue,1,46487,46550,63
2022-10-05,70055,70045,Blue,0,32013,32551,538
2022-03-05,70049,70041,Blue,0,68638,69044,406
2022-03-29,70048,70056,Blue,1,23620,24018,398
2022-10-05,70051,70838,Blue,0,67452,68161,709
2022-09-06,70046,70050,Blue,1,76550,76737,187
2022-05-29,70047,70041,Blue,0,76072,76413,341
2022-07-13,70049,70039,Blue,0,28752,29319,567
2022-01-12,70044,70058,Blue,1,56501,57264,763
2022-12-11,70052,70058,Blue,1,64546,64858,312
2022-03-25,70057,70838,Blue,0,32735,33849,1114
2022-03-22,70038,70042,Blue,1,43512,43608,96
2022-10-13,70059,70045,Blue,0,76936,77608,672
2022-04-05,70048,70056,Blue,1,30489,30883,394
2022-06-04,70045,70043,Blue,0,85264,85400,136
2022-01-05,70059,70039,Blue,0,65599,66585,986
2022-12-29,70042,70048,Blue,1,85890,86217,327
2022-02-18,70038,70058,Blue,1,48672,49625,953
2022-09-13,70055,70045,Blue,0,77826,78397,571
2022-09-07,70055,70049,Blue,0,40402,40710,308
2022-01-07,70048,70052,Blue,1,71885,72081,196
2022-03-05,70059,70043,Blue,0,37362,38202,840
2022-08-11,70059,70041,Blue,0,56957,57886,929
2022-04-02,70050,70058,Blue,1,89681,90066,385
2022-08-04,70041,70039,Blue,0,53268,53299,31
2022-03-09,70057,70049,Blue,0,39333,39815,482
2022-04-16,70056,70058,Blue,1,89098,89169,71
2022-06-29,70048,70060,Blue,1,83194,83839,645
2022-08-29,70055,70041,Blue,0,69320,70020,700
2022-05-07,70050,70060,Blue,1,82111,82712,601
2022-09-30,70046,70054,Blue,1,27330,27755,425
2022-09-20,70051,70047,Blue,0,81550,81788,238
2022-01-25,70053,70045,Blue,0,54807,55270,463
2022-09-11,70044,70060,Blue,1,63097,63931,834
2022-09-12,70056,70058,Blue,1,51190,51267,77
2022-04-21,70044,70060,Blue,1,70726,71626,900
2022-09-08,70038,70056,Blue,1,73160,74027,867
2022-07-19,70057,70049,Blue,0,75450,75843,393
2022-06-22,70057,70049,Blue,0,27704,28089,385
2022-08-17,70052,70060,Blue,1,75700,76076,376
2022-03-14,70055,70043,Blue,0,59473,60129,656
2022-07-02,70046,70056,Blue,1,24028,24531,503
2022-03-16,70038,70042,Blue,1,53366,53510,144
2022-03-10,70051,70047,Blue,0,82693,82888,195
2022-09-14,70044,70046,Blue,1,30655,30765,110
2022-01-11,70045,70838,Blue,0,60297,60674,377
2022-03-28,70038,70060,Blue,1,26668,27868,1200
2022-08-04,70055,70041,Blue,0,60217,60996,779
2022-08-23,70051,70039,Blue,0,50304,51028,724
2022-10-03,70042,70048,Blue,1,21994,22288,294
2022-03-22,70045,70041,Blue,0,38886,39060,174
2022-01-02,70050,70052,Blue,1,71022,71135,113
2022-06-29,70042,70052,Blue,1,67670,68272,602
2022-06-21,70053,70838,Blue,0,63419,64316,897
2022-03-22,70049,70043,Blue,0,47858,48210,352
2022-03-24,70057,70053,Blue,0,30326,30478,152
2022-05-04,70050,70054,Blue,1,24833,25054,221
2022-02-12,70059,70051,Blue,0,84856,85219,363
2022-04-14,70044,70060,Blue,1,80530,81389,859
2022-06-06,70049,70047,Blue,0,38469,38543,74
2022-08-10,70054,70056,Blue,1,62157,62231,74
2022-09-20,70052,70058,Blue,1,58816,59069,253
2022-04-07,70044,70054,Blue,1,21796,22397,601
2022-04-04,70044,70060,Blue,1,46007,46880,873
2022-02-26,70040,70058,Blue,1,76717,77685,968
2022-01-18,70038,70060,Blue,1,41523,42821,1298
2022-07-15,70047,70838,Blue,0,62719,63220,501
2022-10-19,70058,70060,Blue,1,43173,43231,58
2022-02-22,70040,70052,Blue,1,73567,74184,617
2022-04-06,70059,70053,Blue,0,63136,63357,221
2022-01-11,70042,70050,Blue,1,74868,75330,462
2022-12-11,70057,70039,Blue,0,84946,85862,916
2022-02-17,70040,70048,Blue,1,44236,44673,437
2022-03-04,70053,70045,Blue,0,21259,21666,407
2022-04-24,70040,70042,Blue,1,55424,55456,32
2022-03-14,70048,70054,Blue,1,24136,24442,306
2022-07-13,70050,70058,Blue,1,58662,59078,416
2022-11-22,70046,70050,Blue,1,44949,45133,184
2022-08-08,70049,70838,Blue,0,55112,55703,591
2022-07-24,70051,70045,Blue,0,47694,48020,326
2022-11-01,70057,70055,Blue,0,26440,26513,73
2022-09-06,70042,70052,Blue,1,60858,61402,544
2022-01-09,70044,70058,Blue,1,73548,74414,866
2022-01-28,70042,70050,Blue,1,68098,68524,426
2022-10-07,70038,70050,Blue,1,61077,61680,603
2022-01-16,70056,70058,Blue,1,55785,55856,71
2022-08-19,70038,70046,Blue,1,65356,65704,348
2022-07-11,70050,70060,Blue,1,62019,62551,532
2022-09-01,70047,70838,Blue,0,23681,24239,558
2022-04-26,70059,70055,Blue,0,82526,82667,141
2022-09-19,70044,70046,Blue,1,58017,58108,91
2022-03-18,70048,70058,Blue,1,63969,64523,554
2022-03-08,70040,70058,Blue,1,68356,69420,1064
2022-12-03,70038,70056,Blue,1,49629,50630,1001
2022-09-12,70040,70052,Blue,1,68126,68828,702
2022-07-17,70042,70052,Blue,1,34839,35397,558
2022-05-31,70044,70052,Blue,1,52929,53590,661
2022-12-04,70040,70054,Blue,1,79162,79877,715
2022-12-25,70055,70049,Blue,0,70906,71208,302
2022-07-10,70059,70053,Blue,0,36195,36432,237
2022-03-31,70038,70050,Blue,1,32945,33478,533
2022-03-19,70047,70041,Blue,0,88052,88415,363
2022-12-19,70040,70042,Blue,1,35443,35480,37
2022-03-02,70059,70838,Blue,0,54801,55991,1190
2022-12-14,70053,70047,Blue,0,41896,42226,330
2022-04-14,70044,70056,Blue,1,33857,34586,729
2022-12-24,70059,70045,Blue,0,63257,63897,640
2022-01-07,70040,70042,Blue,1,83786,83818,32
2022-04-06,70059,70045,Blue,0,67513,68218,705
2022-03-31,70040,70048,Blue,1,59005,59431,426
2022-08-09,70057,70039,Blue,0,52808,53817,1009
2022-07-18,70045,70041,Blue,0,58288,58501,213
2022-03-10,70048,70058,Blue,1,41287,41824,537
2022-03-03,70052,70058,Blue,1,68791,69045,254
2022-06-11,70049,70045,Blue,0,67599,67803,204
2022-12-07,70038,70052,Blue,1,54500,55249,749
2022-08-30,70048,70050,Blue,1,44282,44337,55
2022-11-01,70059,70057,Blue,0,73814,73849,35
2022-04-30,70057,70047,Blue,0,20202,20699,497
2022-04-22,70046,70056,Blue,1,52819,53351,532
2022-07-11,70044,70048,Blue,1,78229,78480,251
2022-02-22,70057,70055,Blue,0,47722,47790,68
2022-11-18,70046,70052,Blue,1,69379,69926,547
2022-03-13,70059,70057,Blue,0,65188,65224,36
2022-06-02,70040,70046,Blue,1,72001,72322,321
2022-10-07,70042,70046,Blue,1,29386,29567,181
2022-04-07,70042,70052,Blue,1,78319,78926,607
2022-12-09,70048,70058,Blue,1,24954,25481,527
2022-10-14,70057,70055,Blue,0,77011,77080,69
2022-02-10,70042,70056,Blue,1,41608,42442,834
2022-08-26,70057,70055,Blue,0,66119,66187,68
2022-07-22,70051,70047,Blue,0,63770,63964,194
2022-06-16,70040,70056,Blue,1,33625,34581,956
2022-02-07,70045,70043,Blue,0,54411,54532,121
2022-11-30,70059,70045,Blue,0,45114,45894,780
2022-09-24,70052,70056,Blue,1,79966,80099,133
2022-11-23,70043,70039,Blue,0,43994,44104,110
2022-09-11,70042,70054,Blue,1,29368,30008,640
2022-10-27,70045,70838,Blue,0,23829,24173,344
2022-06-10,70051,70045,Blue,0,81540,81877,337
2022-06-09,70055,70051,Blue,0,48875,49027,152
2022-06-08,70038,70048,Blue,1,51074,51632,558
2022-09-21,70047,70043,Blue,0,49000,49236,236
2022-01-25,70047,70039,Blue,0,69727,70165,438
2022-06-23,70038,70056,Blue,1,65677,66682,1005
2022-08-22,70048,70054,Blue,1,53462,53807,345
2022-06-14,70038,70048,Blue,1,67341,67859,518
2022-02-25,70045,70043,Blue,0,27528,27636,108
2022-09-11,70051,70039,Blue,0,48255,48896,641
2022-12-13,70059,70057,Blue,0,27093,27127,34
2022-11-17,70057,70041,Blue,0,50512,51323,811
2022-01-31,70051,70838,Blue,0,31424,32347,923
2022-12-27,70055,70041,Blue,0,61162,61915,753
2022-03-20,70038,70046,Blue,1,50267,50575,308
2022-09-28,70049,70045,Blue,0,23298,23584,286
2022-11-03,70044,70052,Blue,1,22011,22503,492
2022-05-18,70042,70052,Blue,1,71028,71655,627
2022-10-07,70053,70047,Blue,0,45027,45340,313
2022-02-03,70053,70051,Blue,0,25446,25497,51
2022-11-30,70057,70045,Blue,0,81180,81789,609
2022-03-12,70045,70838,Blue,0,75445,75807,362
2022-11-11,70050,70054,Blue,1,53211,53421,210
2022-05-17,70052,70054,Blue,1,69476,69546,70
2022-07-02,70039,70838,Blue,0,44103,44152,49
2022-01-23,70053,70043,Blue,0,80547,81124,577
2022-10-30,70042,70058,Blue,1,49542,50338,796
2022-04-08,70053,70041,Blue,0,25460,26149,689
2022-03-25,70051,70043,Blue,0,84345,84804,459
2022-02-28,70051,70043,Blue,0,35633,36139,506
2022-06-15,70047,70041,Blue,0,42211,42575,364
2022-01-15,70046,70054,Blue,1,47841,48227,386
2022-10-05,70040,70060,Blue,1,63877,64892,1015
2022-01-22,70040,70056,Blue,1,69767,70602,835
2022-04-18,70047,70039,Blue,0,63274,63723,449
2022-02-24,70056,70060,Blue,1,86379,86611,232
2022-12-20,70038,70052,Blue,1,84613,85342,729
2022-12-11,70048,70054,Blue,1,38785,39156,371
2022-04-21,70055,70043,Blue,0,62181,62846,665
2022-12-21,70051,70039,Blue,0,58212,58846,634
2022-05-07,70059,70047,Blue,0,21495,22051,556
2022-07-13,70042,70056,Blue,1,41450,43001,1551
2022-02-10,70051,70049,Blue,0,85552,85657,105
2022-09-13,70043,70838,Blue,0,24069,24297,228
2022-10-01,70045,70041,Blue,0,68891,69067,176
2022-07-10,70049,70039,Blue,0,40663,41206,543
2022-01-19,70042,70060,Blue,1,81679,82750,1071
2022-07-02,70048,70060,Blue,1,75054,75694,640
2022-05-29,70042,70046,Blue,1,53875,54100,225
2022-12-08,70057,70055,Blue,0,44843,44914,71
2022-01-15,70059,70043,Blue,0,56237,57633,1396
2022-04-03,70049,70047,Blue,0,70520,70577,57
2022-12-16,70050,70052,Blue,1,31291,31411,120
2022-05-21,70048,70050,Blue,1,66694,66749,55
2022-03-21,70059,70838,Blue,0,60497,61863,1366
2022-06-30,70051,70838,Blue,0,33020,33780,760
2022-08-27,70040,70052,Blue,1,72943,73634,691
2022-12-08,70044,70050,Blue,1,24807,25143,336
2022-01-09,70049,70047,Blue,0,55971,56024,53
2022-01-14,70052,70058,Blue,1,79933,80177,244
2022-09-10,70051,70047,Blue,0,32853,33046,193
2022-01-06,70057,70041,Blue,0,49413,50446,1033
2022-11-15,70044,70054,Blue,1,58407,59053,646
2022-12-19,70038,70058,Blue,1,55569,56612,1043
2022-04-05,70038,70040,Blue,1,55653,55669,16
2022-08-22,70057,70838,Blue,0,43774,44866,1092
2022-03-25,70055,70838,Blue,0,53797,54741,944
2022-05-18,70057,70053,Blue,0,59376,59532,156
2022-08-29,70055,70049,Blue,0,67754,68023,269
2022-05-10,70057,70055,Blue,0,29374,29442,68
2022-10-10,70051,70838,Blue,0,21771,22550,779
2022-07-27,70050,70054,Blue,1,74235,74491,256
2022-01-26,70057,70047,Blue,0,31597,32166,569
2022-01-13,70046,70056,Blue,1,23774,24303,529
2022-08-22,70059,70049,Blue,0,56720,57184,464
2022-07-26,70057,70838,Blue,0,76529,77496,967
2022-08-12,70051,70047,Blue,0,65957,66154,197
2022-09-16,70047,70043,Blue,0,44312,44560,248
2022-04-12,70049,70045,Blue,0,30509,30737,228
2022-08-21,70050,70060,Blue,1,69988,70565,577
2022-12-16,70059,70838,Blue,0,52515,53604,1089
2022-09-11,70054,70056,Blue,1,62229,62275,46
2022-09-24,70042,70048,Blue,1,40590,40890,300
2022-06-01,70042,70044,Blue,1,50008,50035,27
2022-04-21,70050,70060,Blue,1,50313,50802,489
2022-03-01,70038,70060,Blue,1,76380,77527,1147
2022-07-12,70055,70045,Blue,0,29099,29668,569
2022-03-28,70043,70041,Blue,0,63445,63475,30
2022-10-21,70049,70838,Blue,0,62079,62689,610
2022-10-07,70057,70045,Blue,0,58291,58925,634
2022-10-06,70059,70838,Blue,0,51847,52999,1152
2022-04-29,70050,70056,Blue,1,25212,25508,296
2022-01-31,70049,70838,Blue,0,52343,53018,675
2022-04-28,70052,70058,Blue,1,61986,62231,245
2022-04-07,70057,70838,Blue,0,71609,72635,1026
2022-11-10,70055,70039,Blue,0,49102,49933,831
2022-11-16,70053,70047,Blue,0,30725,31039,314
2022-11-04,70038,70056,Blue,1,77833,78774,941
2022-03-13,70040,70058,Blue,1,33981,34972,991
2022-12-30,70049,70041,Blue,0,82880,83296,416
2022-07-21,70058,70060,Blue,1,85675,85745,70
2022-09-17,70042,70058,Blue,1,64398,65271,873
2022-01-10,70040,70044,Blue,1,52251,52360,109
2022-04-07,70044,70046,Blue,1,66052,66164,112
2022-04-13,70046,70058,Blue,1,50685,51349,664
2022-01-16,70050,70052,Blue,1,58666,58784,118
2022-12-01,70048,70054,Blue,1,47630,47927,297
2022-08-08,70047,70838,Blue,0,30763,31352,589
2022-05-19,70038,70056,Blue,1,74191,75211,1020
2022-09-04,70038,70054,Blue,1,67754,68566,812
2022-10-26,70059,70039,Blue,0,39784,40707,923
2022-09-30,70053,70047,Blue,0,56936,57265,329
2022-10-28,70052,70054,Blue,1,68771,68826,55
2022-02-20,70049,70047,Blue,0,74301,74354,53
2022-02-19,70059,70045,Blue,0,56808,57561,753
2022-04-03,70043,70838,Blue,0,44330,44507,177
2022-12-20,70044,70050,Blue,1,23624,23964,340
2022-09-19,70038,70058,Blue,1,25963,26923,960
2022-05-19,70057,70049,Blue,0,71606,71987,381
2022-10-04,70048,70050,Blue,1,85675,85735,60
2022-03-31,70048,70054,Blue,1,85966,86281,315
2022-10-09,70046,70058,Blue,1,43312,43949,637
2022-02-13,70059,70053,Blue,0,36197,36464,267
2022-09-12,70049,70043,Blue,0,70199,70565,366
2022-03-07,70044,70056,Blue,1,28765,29451,686
2022-02-10,70054,70060,Blue,1,77651,77896,245
2022-02-19,70059,70045,Blue,0,71905,72685,780
2022-04-12,70055,70043,Blue,0,42266,43005,739
2022-07-24,70057,70047,Blue,0,23912,24398,486
2022-06-14,70043,70039,Blue,0,86099,86202,103
2022-07-27,70045,70043,Blue,0,63374,63462,88
2022-04-24,70053,70838,Blue,0,66007,66841,834
2022-03-11,70057,70043,Blue,0,69146,69924,778
2022-09-28,70040,70048,Blue,1,19968,20385,417
2022-10-27,70044,70056,Blue,1,53805,54512,707
2022-01-19,70058,70060,Blue,1,88681,88751,70
2022-11-29,70042,70060,Blue,1,39753,40740,987
2022-03-15,70042,70052,Blue,1,68742,69328,586
2022-04-20,70051,70043,Blue,0,65068,65566,498
2022-10-26,70052,70056,Blue,1,22174,22317,143
2022-03-15,70042,70050,Blue,1,73138,73580,442
2022-04-20,70047,70838,Blue,0,23409,23917,508
2022-06-21,70038,70040,Blue,1,23953,23971,18
2022-06-25,70055,70049,Blue,0,65030,65312,282
2022-12-11,70045,70039,Blue,0,72413,72646,233
2022-08-16,70039,70838,Blue,0,41745,41782,37
2022-01-17,70038,70056,Blue,1,43204,44220,1016
2022-12-26,70057,70045,Blue,0,84732,85334,602
2022-03-15,70046,70050,Blue,1,46153,46337,184
2022-04-02,70050,70052,Blue,1,70212,70318,106
2022-01-08,70038,70056,Blue,1,33432,34284,852
2022-12-09,70052,70054,Blue,1,21946,21999,53
2022-10-19,70040,70048,Blue,1,74770,75141,371
2022-08-26,70058,70060,Blue,1,50305,50374,69
2022-05-29,70042,70044,Blue,1,86877,86907,30
2022-08-08,70059,70053,Blue,0,66567,66800,233
2022-08-07,70055,70043,Blue,0,72919,73588,669
2022-12-23,70040,70046,Blue,1,30434,30688,254
2022-01-20,70044,70050,Blue,1,67308,67665,357
2022-04-01,70055,70051,Blue,0,80230,80359,129
2022-11-15,70040,70052,Blue,1,29902,30612,710
2022-10-05,70045,70039,Blue,0,88882,89762,880
2022-10-12,70049,70041,Blue,0,51446,51880,434
2022-07-12,70050,70054,Blue,1,78108,78348,240
2022-09-16,70038,70040,Blue,1,55543,55560,17
2022-02-11,70047,70838,Blue,0,32945,33428,483
2022-02-09,70047,70838,Blue,0,84086,84591,505
2022-08-22,70052,70058,Blue,1,45896,46213,317
2022-04-05,70046,70054,Blue,1,61427,61935,508
2022-03-08,70048,70054,Blue,1,62451,62779,328
2022-11-11,70050,70058,Blue,1,55506,55952,446
2022-03-25,70055,70043,Blue,0,60670,61394,724
2022-02-19,70053,70039,Blue,0,52204,52997,793
2022-02-10,70040,70050,Blue,1,73121,73668,547
2022-12-26,70038,70054,Blue,1,58578,59504,926
2022-12-01,70059,70045,Blue,0,24259,24968,709
2022-06-22,70038,70046,Blue,1,24937,25302,365
2022-05-20,70059,70049,Blue,0,34698,35176,478
2022-12-30,70040,70046,Blue,1,82829,83276,447
2022-04-08,70057,70051,Blue,0,87558,87790,232
2022-02-21,70050,70060,Blue,1,68057,68547,490
2022-12-10,70059,70049,Blue,0,20180,20654,474
2022-03-18,70059,70047,Blue,0,62299,62841,542
2022-12-27,70042,70044,Blue,1,88585,88621,36
2022-01-11,70055,70045,Blue,0,23564,24134,570
2022-10-11,70046,70060,Blue,1,68012,68767,755
2022-10-03,70038,70056,Blue,1,67724,68673,949
2022-12-16,70048,70056,Blue,1,53380,53777,397
2022-07-12,70059,70057,Blue,0,59529,59564,35
2022-07-22,70038,70054,Blue,1,34226,35080,854
2022-04-12,70053,70043,Blue,0,73472,74054,582
2022-08-22,70048,70060,Blue,1,35031,35726,695
2022-10-07,70044,70056,Blue,1,23467,24175,708
2022-01-05,70038,70058,Blue,1,80826,81833,1007
2022-11-03,70040,70050,Blue,1,30320,30847,527
2022-12-03,70057,70053,Blue,0,27765,27927,162
2022-12-11,70042,70056,Blue,1,70065,70877,812
2022-03-02,70052,70060,Blue,1,26842,27315,473
2022-12-08,70049,70039,Blue,0,33067,33613,546
2022-09-13,70042,70052,Blue,1,63978,64585,607
2022-01-05,70055,70047,Blue,0,37180,37658,478
2022-03-14,70055,70053,Blue,0,83069,83120,51
2022-04-23,70048,70054,Blue,1,84490,84788,298
2022-02-11,70046,70054,Blue,1,54930,55368,438
2022-07-25,70044,70058,Blue,1,77860,78697,837
2022-07-11,70059,70047,Blue,0,31409,32035,626
2022-06-25,70040,70048,Blue,1,78805,79266,461
2022-01-12,70040,70046,Blue,1,68286,68549,263
2022-09-06,70056,70060,Blue,1,68595,68771,176
2022-05-12,70052,70058,Blue,1,26716,26997,281
2022-04-05,70044,70050,Blue,1,73709,74020,311
2022-03-04,70044,70060,Blue,1,43198,44031,833
2022-12-13,70042,70050,Blue,1,80785,81201,416
2022-09-14,70057,70043,Blue,0,51026,51782,756
2022-03-15,70054,70056,Blue,1,24625,24672,47
2022-01-09,70042,70060,Blue,1,43095,43982,887
2022-06-20,70038,70040,Blue,1,21953,21971,18
2022-01-07,70057,70838,Blue,0,29758,30975,1217
2022-01-03,70059,70039,Blue,0,49223,50254,1031
2022-12-27,70040,70052,Blue,1,32531,33172,641
2022-02-16,70042,70048,Blue,1,22869,23255,386
2022-08-13,70038,70050,Blue,1,51793,52393,600
2022-08-04,70046,70056,Blue,1,53324,53842,518
2022-11-19,70045,70039,Blue,0,69935,70170,235
2022-09-21,70051,70049,Blue,0,31383,31484,101
2022-08-28,70049,70047,Blue,0,70014,70069,55
2022-11-29,70051,70039,Blue,0,59681,60339,658
2022-03-17,70049,70047,Blue,0,72036,72096,60
2022-08-09,70057,70041,Blue,0,34987,35916,929
2022-02-21,70059,70045,Blue,0,64008,64779,771
2022-07-09,70052,70056,Blue,1,83761,83902,141
2022-06-08,70049,70045,Blue,0,32273,32492,219
2022-11-20,70052,70056,Blue,1,46392,46547,155
2022-02-09,70044,70046,Blue,1,64261,64365,104
2022-12-31,70044,70046,Blue,1,88301,88404,103
2022-10-31,70042,70056,Blue,1,20382,21423,1041
2022-10-25,70041,70039,Blue,0,29642,29682,40
2022-03-09,70059,70045,Blue,0,41538,42230,692
2022-12-29,70051,70043,Blue,0,25998,26481,483
2022-01-31,70048,70050,Blue,1,54546,54605,59
2022-10-02,70040,70048,Blue,1,29285,29697,412
2022-03-04,70051,70043,Blue,0,34542,35061,519
2022-07-28,70047,70838,Blue,0,37652,38176,524
2022-01-05,70040,70044,Blue,1,22744,22868,124
2022-02-05,70047,70041,Blue,0,39106,39466,360
2022-04-11,70057,70039,Blue,0,29153,30153,1000
2022-02-04,70043,70039,Blue,0,28967,29077,110
2022-08-13,70054,70056,Blue,1,73733,73780,47
2022-08-17,70053,70047,Blue,0,70475,70758,283
2022-08-05,70048,70054,Blue,1,35914,36299,385
2022-12-18,70051,70047,Blue,0,48218,48400,182
2022-03-07,70051,70041,Blue,0,77541,78125,584
2022-12-23,70040,70048,Blue,1,46788,47203,415
2022-11-28,70040,70056,Blue,1,38186,38925,739
2022-08-22,70053,70838,Blue,0,19810,20803,993
2022-03-09,70053,70045,Blue,0,79761,80278,517
2022-11-11,70045,70043,Blue,0,35127,35214,87
2022-04-15,70052,70058,Blue,1,53928,54175,247
2022-07-11,70051,70045,Blue,0,55242,55568,326
2022-02-04,70059,70057,Blue,0,40880,40916,36
2022-10-20,70042,70052,Blue,1,34186,34858,672
2022-11-25,70053,70045,Blue,0,24942,25371,429
2022-08-29,70058,70060,Blue,1,86948,87008,60
2022-06-13,70055,70041,Blue,0,61278,62044,766
2022-05-24,70043,70039,Blue,0,34088,34197,109
2022-06-09,70044,70058,Blue,1,31149,32021,872
2022-02-11,70057,70043,Blue,0,58475,59304,829
2022-01-04,70040,70052,Blue,1,53797,54414,617
2022-07-29,70054,70058,Blue,1,32375,32531,156
2022-12-19,70049,70047,Blue,0,73043,73097,54
2022-06-16,70042,70052,Blue,1,80511,81112,601
2022-10-14,70055,70043,Blue,0,43882,44544,662
2022-02-25,70038,70042,Blue,1,38650,38775,125
2022-01-10,70057,70045,Blue,0,80669,81267,598
2022-12-03,70047,70043,Blue,0,24083,24314,231
2022-06-23,70045,70043,Blue,0,73971,74075,104
2022-08-27,70050,70056,Blue,1,51864,52355,491
2022-01-28,70050,70056,Blue,1,38293,38608,315
2022-03-13,70049,70039,Blue,0,75394,75895,501
2022-02-25,70043,70838,Blue,0,52149,52345,196
2022-12-17,70051,70838,Blue,0,52865,53608,743
2022-06-13,70043,70838,Blue,0,22608,22869,261
2022-03-26,70047,70041,Blue,0,76389,76695,306
2022-01-28,70040,70058,Blue,1,27013,28018,1005
2022-03-09,70044,70052,Blue,1,50522,51184,662
2022-05-30,70049,70045,Blue,0,48998,49206,208
2022-12-30,70049,70838,Blue,0,71904,72525,621
2022-11-26,70038,70044,Blue,1,38827,38989,162
2022-06-23,70048,70060,Blue,1,29287,30031,744
2022-03-29,70045,70039,Blue,0,77335,77556,221
2022-04-23,70052,70056,Blue,1,45573,45712,139
2022-11-13,70055,70838,Blue,0,69250,70121,871
2022-10-31,70042,70058,Blue,1,39626,40499,873
2022-03-14,70051,70043,Blue,0,61468,62043,575
2022-04-12,70046,70058,Blue,1,22493,23083,590
2022-10-03,70040,70048,Blue,1,51970,52378,408
2022-02-07,70042,70046,Blue,1,30707,30884,177
2022-04-21,70038,70042,Blue,1,70933,71026,93
2022-10-11,70049,70043,Blue,0,23142,23516,374
2022-08-05,70049,70039,Blue,0,27682,28252,570
2022-09-13,70054,70056,Blue,1,24968,25017,49
2022-07-12,70038,70060,Blue,1,23121,24330,1209
2022-02-17,70055,70053,Blue,0,76818,76875,57
2022-04-04,70038,70050,Blue,1,27873,28523,650
2022-07-17,70045,70838,Blue,0,61063,61444,381
2022-01-31,70040,70060,Blue,1,64435,66108,1673
2022-01-07,70051,70041,Blue,0,18790,19479,689
2022-05-26,70041,70039,Blue,0,54032,54064,32
2022-06-07,70041,70039,Blue,0,55414,55452,38
2022-03-08,70059,70049,Blue,0,74355,74836,481
2022-09-25,70044,70052,Blue,1,66897,67435,538
2022-10-28,70042,70056,Blue,1,45777,46485,708
2022-12-14,70051,70047,Blue,0,52842,53035,193
2022-04-03,70053,70045,Blue,0,64366,64809,443
2022-01-23,70044,70046,Blue,1,62593,62706,113
2022-09-23,70053,70838,Blue,0,44842,45764,922
2022-04-19,70048,70056,Blue,1,63699,64073,374
2022-04-22,70059,70055,Blue,0,24553,24704,151
2022-07-23,70046,70058,Blue,1,78643,79298,655
2022-01-18,70056,70058,Blue,1,68730,68816,86
2022-03-02,70051,70041,Blue,0,28818,29386,568
2022-03-17,70050,70052,Blue,1,39141,39264,123
2022-03-31,70040,70058,Blue,1,66195,67160,965
2022-07-26,70045,70043,Blue,0,73589,73684,95
2022-01-15,70059,70045,Blue,0,25583,26373,790
2022-02-14,70042,70060,Blue,1,45946,46997,1051
2022-03-09,70042,70048,Blue,1,64507,64802,295
2022-10-29,70042,70048,Blue,1,40055,40345,290
2022-07-23,70038,70058,Blue,1,51794,52839,1045
2022-11-24,70038,70056,Blue,1,76944,77780,836
2022-03-22,70052,70060,Blue,1,84630,84998,368
2022-11-08,70042,70054,Blue,1,29573,30287,714
2022-09-28,70046,70060,Blue,1,21538,22294,756
2022-04-11,70042,70052,Blue,1,73642,74163,521
2022-05-25,70038,70046,Blue,1,65596,65955,359
2022-04-13,70056,70058,Blue,1,45647,45716,69
2022-09-06,70045,70041,Blue,0,61600,61769,169
2022-02-11,70057,70053,Blue,0,56372,56539,167
2022-09-14,70055,70047,Blue,0,29514,29894,380
2022-12-02,70040,70058,Blue,1,30741,31662,921
2022-12-06,70059,70057,Blue,0,61577,61617,40
2022-08-12,70051,70041,Blue,0,21949,22555,606
2022-01-12,70041,70039,Blue,0,66361,66404,43
2022-06-17,70045,70043,Blue,0,66872,66997,125
2022-09-29,70041,70039,Blue,0,52423,52452,29
2022-09-05,70048,70050,Blue,1,85066,85131,65
2022-11-16,70045,70041,Blue,0,55460,55633,173
2022-03-09,70044,70050,Blue,1,70151,70471,320
2022-12-07,70048,70052,Blue,1,39879,40090,211
2022-06-15,70050,70060,Blue,1,56013,56564,551
2022-02-09,70053,70043,Blue,0,23098,23821,723
2022-10-02,70055,70051,Blue,0,78428,78559,131
2022-07-17,70048,70060,Blue,1,50551,51124,573
2022-09-02,70059,70051,Blue,0,54073,54404,331
2022-08-03,70046,70054,Blue,1,55284,55741,457
2022-04-09,70044,70050,Blue,1,84909,85283,374
2022-10-29,70045,70043,Blue,0,60953,61067,114
2022-12-16,70040,70060,Blue,1,50825,51844,1019
2022-03-15,70042,70056,Blue,1,32239,32966,727
2022-04-15,70053,70045,Blue,0,58659,59119,460
2022-02-07,70055,70047,Blue,0,22920,23290,370
2022-03-02,70042,70044,Blue,1,85659,85690,31
2022-12-09,70047,70039,Blue,0,84803,85206,403
2022-03-15,70042,70058,Blue,1,47105,48188,1083
2022-01-20,70044,70046,Blue,1,85148,85263,115
2022-09-30,70048,70060,Blue,1,48223,48820,597
2022-03-19,70051,70043,Blue,0,43098,43587,489
2022-10-08,70049,70838,Blue,0,64856,65409,553
2022-11-16,70052,70054,Blue,1,52061,52116,55
2022-05-19,70050,70054,Blue,1,55576,55813,237
2022-08-02,70045,70838,Blue,0,79814,80166,352
2022-04-23,70046,70050,Blue,1,23998,24168,170
2022-12-16,70038,70048,Blue,1,47432,47897,465
2022-03-28,70051,70043,Blue,0,33645,34214,569
2022-10-13,70048,70052,Blue,1,75398,75622,224
2022-01-24,70040,70048,Blue,1,36249,36634,385
2022-06-11,70056,70058,Blue,1,23510,23600,90
2022-03-04,70050,70058,Blue,1,23988,24395,407
2022-07-24,70055,70041,Blue,0,88399,89118,719
2022-12-01,70052,70054,Blue,1,51673,51725,52
2022-07-08,70053,70051,Blue,0,59570,59622,52
2022-07-14,70059,70055,Blue,0,81139,81274,135
2022-01-23,70059,70057,Blue,0,32616,32650,34
2022-12-03,70043,70838,Blue,0,51755,51948,193
2022-09-29,70055,70049,Blue,0,26965,27289,324
2022-11-24,70059,70838,Blue,0,60859,61966,1107
2022-10-14,70038,70044,Blue,1,70032,70231,199
2022-10-20,70042,70056,Blue,1,73302,74051,749
2022-10-24,70054,70056,Blue,1,42524,42583,59
2022-12-13,70045,70838,Blue,0,28304,28678,374
2022-06-24,70057,70043,Blue,0,87425,88219,794
2022-10-05,70038,70046,Blue,1,59937,60287,350
2022-12-03,70044,70054,Blue,1,75783,76359,576
2022-10-08,70055,70838,Blue,0,49933,50914,981
2022-07-25,70051,70041,Blue,0,48781,49410,629
2022-01-26,70053,70039,Blue,0,36788,37757,969
2022-09-14,70055,70053,Blue,0,58947,58995,48
2022-04-11,70057,70047,Blue,0,24934,25428,494
2022-09-18,70059,70043,Blue,0,53295,54214,919
2022-10-31,70052,70060,Blue,1,49967,50298,331
2022-05-19,70053,70051,Blue,0,29613,29674,61
2022-02-15,70057,70043,Blue,0,38772,39569,797
2022-08-09,70049,70043,Blue,0,55603,55950,347
2022-09-10,70042,70044,Blue,1,69221,69248,27
2022-03-05,70057,70838,Blue,0,53614,54673,1059
2022-07-12,70059,70053,Blue,0,50414,50657,243
2022-06-03,70047,70043,Blue,0,52571,52857,286
2022-05-05,70052,70060,Blue,1,49548,49882,334
2022-06-20,70038,70046,Blue,1,24003,24335,332
2022-03-20,70046,70048,Blue,1,64824,64901,77
2022-06-30,70053,70838,Blue,0,35974,37038,1064
2022-04-11,70046,70060,Blue,1,57640,58552,912
2022-04-05,70040,70058,Blue,1,33615,34594,979
2022-03-22,70038,70058,Blue,1,45796,46768,972
2022-08-13,70048,70056,Blue,1,53409,53808,399
2022-04-11,70040,70060,Blue,1,30911,32063,1152
2022-01-03,70040,70048,Blue,1,61479,61857,378
2022-07-16,70043,70041,Blue,0,70690,70718,28
2022-01-19,70059,70047,Blue,0,38864,39416,552
2022-06-29,70043,70039,Blue,0,67562,67668,106
2022-10-01,70046,70058,Blue,1,86876,87523,647
2022-11-13,70047,70043,Blue,0,52285,52519,234
2022-08-23,70054,70060,Blue,1,26243,26547,304
2022-03-16,70051,70039,Blue,0,30954,31660,706
2022-12-22,70038,70040,Blue,1,46184,46197,13
2022-11-05,70057,70838,Blue,0,55233,56346,1113
2022-06-26,70041,70838,Blue,0,55301,55489,188
2022-08-03,70045,70043,Blue,0,80732,80823,91
2022-04-24,70038,70040,Blue,1,61276,61290,14
2022-12-16,70043,70838,Blue,0,24123,24330,207
2022-10-06,70040,70054,Blue,1,27978,28764,786
2022-07-26,70057,70039,Blue,0,85816,86673,857
2022-08-26,70044,70056,Blue,1,24989,25632,643
2022-04-13,70059,70047,Blue,0,62597,63167,570
2022-07-07,70040,70048,Blue,1,52606,53029,423
2022-06-10,70042,70056,Blue,1,24560,25390,830
2022-06-18,70058,70060,Blue,1,54090,54179,89
2022-12-29,70059,70041,Blue,0,80594,81462,868
2022-12-01,70057,70049,Blue,0,54165,54620,455
2022-07-04,70045,70838,Blue,0,30518,30867,349
2022-06-16,70044,70046,Blue,1,34066,34211,145
2022-07-08,70041,70039,Blue,0,23220,23256,36
2022-04-30,70058,70060,Blue,1,29105,29175,70
2022-10-22,70048,70050,Blue,1,69302,69365,63
2022-07-19,70057,70043,Blue,0,20014,20843,829
2022-04-18,70042,70052,Blue,1,25865,26378,513
2022-09-23,70052,70056,Blue,1,69139,69275,136
2022-02-22,70057,70838,Blue,0,33037,34194,1157
2022-01-10,70042,70044,Blue,1,70071,70099,28
2022-09-18,70038,70058,Blue,1,75307,76258,951
2022-12-09,70059,70055,Blue,0,60171,60319,148
2022-07-29,70047,70045,Blue,0,35562,35652,90
2022-04-17,70051,70047,Blue,0,55815,56022,207
2022-03-24,70042,70046,Blue,1,55000,55189,189
2022-01-31,70042,70058,Blue,1,67547,68624,1077
2022-08-29,70055,70049,Blue,0,68246,68519,273
2022-09-17,70051,70039,Blue,0,64278,64956,678
2022-12-26,70049,70047,Blue,0,58697,58753,56
2022-08-24,70042,70058,Blue,1,61319,62422,1103
2022-12-13,70059,70053,Blue,0,31302,31552,250
2022-06-17,70046,70056,Blue,1,39120,39727,607
2022-01-04,70052,70058,Blue,1,37007,37288,281
2022-07-20,70042,70060,Blue,1,66803,67886,1083
2022-02-02,70055,70039,Blue,0,77978,78916,938
2022-12-31,70044,70054,Blue,1,83053,83644,591
2022-03-29,70051,70041,Blue,0,25820,26424,604
2022-12-23,70057,70055,Blue,0,57296,57371,75
2022-04-18,70051,70047,Blue,0,74707,74912,205
2022-12-23,70047,70043,Blue,0,41454,41688,234
2022-10-06,70057,70051,Blue,0,42211,42459,248
2022-08-20,70057,70051,Blue,0,83300,83545,245
2022-07-02,70046,70052,Blue,1,85050,85399,349
2022-08-20,70053,70045,Blue,0,37280,37784,504
2022-09-01,70053,70041,Blue,0,84564,85278,714
2022-09-28,70046,70052,Blue,1,62325,62647,322
2022-03-14,70042,70058,Blue,1,20463,21435,972
2022-09-24,70059,70057,Blue,0,64877,64913,36
2022-08-10,70045,70039,Blue,0,27587,27889,302
2022-07-15,70040,70054,Blue,1,21957,22711,754
2022-07-24,70047,70838,Blue,0,86145,86636,491
2022-08-22,70038,70048,Blue,1,82975,83450,475
2022-01-26,70044,70060,Blue,1,42255,43209,954
2022-03-17,70042,70050,Blue,1,30981,31403,422
2022-03-11,70038,70046,Blue,1,32295,32656,361
2022-08-03,70040,70046,Blue,1,22639,22878,239
2022-04-01,70049,70039,Blue,0,31412,32014,602
2022-11-03,70055,70041,Blue,0,53306,54064,758
2022-03-08,70038,70056,Blue,1,21791,22691,900
2022-01-12,70055,70049,Blue,0,45763,46078,315
2022-07-25,70038,70048,Blue,1,33704,34189,485
2022-06-13,70053,70049,Blue,0,51501,51729,228
2022-06-23,70044,70060,Blue,1,44470,45467,997
2022-02-23,70050,70060,Blue,1,79238,79779,541
2022-12-23,70049,70047,Blue,0,34102,34164,62
2022-02-17,70052,70060,Blue,1,63065,63432,367
2022-02-13,70055,70039,Blue,0,62720,63636,916
2022-12-07,70038,70054,Blue,1,63432,64240,808
2022-07-12,70056,70058,Blue,1,84341,84416,75
2022-12-07,70046,70060,Blue,1,45509,46251,742
2022-03-01,70040,70048,Blue,1,37441,37884,443
2022-07-18,70038,70052,Blue,1,28190,28940,750
2022-08-30,70055,70051,Blue,0,88280,88413,133
2022-08-09,70045,70838,Blue,0,83395,83694,299
2022-11-19,70041,70039,Blue,0,33466,33506,40
2022-01-18,70040,70042,Blue,1,25518,25551,33
2022-08-09,70052,70060,Blue,1,33736,34155,419
2022-03-05,70042,70046,Blue,1,51956,52153,197
2022-09-28,70059,70047,Blue,0,20415,20984,569
2022-01-31,70043,70041,Blue,0,22333,22368,35
2022-05-29,70044,70048,Blue,1,23915,24212,297
2022-08-16,70044,70052,Blue,1,25120,25630,510
2022-10-25,70043,70039,Blue,0,47723,47827,104
2022-02-11,70048,70060,Blue,1,60448,61072,624
2022-12-31,70053,70838,Blue,0,61783,62630,847
2022-12-10,70040,70058,Blue,1,80033,80961,928
2022-10-17,70050,70054,Blue,1,52920,53124,204
2022-05-20,70053,70043,Blue,0,26357,27175,818
2022-08-16,70040,70054,Blue,1,34694,35513,819
2022-11-30,70053,70049,Blue,0,60764,61009,245
2022-06-13,70046,70056,Blue,1,57307,57943,636
2022-10-28,70044,70058,Blue,1,60031,60816,785
2022-07-16,70038,70054,Blue,1,85513,86401,888
2022-01-19,70046,70054,Blue,1,33425,33876,451
2022-03-24,70040,70050,Blue,1,34809,35295,486
2022-10-07,70042,70054,Blue,1,23407,24086,679
2022-10-26,70057,70055,Blue,0,64954,65026,72
2022-10-10,70042,70056,Blue,1,85862,86672,810
2022-03-29,70040,70052,Blue,1,58421,59108,687
2022-11-01,70042,70058,Blue,1,76846,77695,849
2022-11-25,70042,70056,Blue,1,21182,21933,751
2022-08-10,70049,70838,Blue,0,87772,88322,550
2022-01-29,70038,70050,Blue,1,85138,85755,617
2022-06-04,70038,70050,Blue,1,38060,38742,682
2022-11-24,70040,70052,Blue,1,41040,41634,594
2022-01-24,70045,70043,Blue,0,25148,25297,149
2022-06-30,70059,70055,Blue,0,52493,52640,147
2022-09-15,70038,70056,Blue,1,30859,31795,936
2022-01-12,70053,70043,Blue,0,42375,43043,668
2022-06-10,70059,70047,Blue,0,54195,54809,614
2022-02-01,70049,70039,Blue,0,75435,75975,540
2022-07-26,70059,70051,Blue,0,26354,26759,405
2022-04-02,70043,70039,Blue,0,48531,48648,117
2022-01-09,70053,70049,Blue,0,66004,66199,195
2022-01-26,70042,70056,Blue,1,68196,68935,739
2022-10-20,70046,70058,Blue,1,56778,57405,627
2022-06-22,70044,70050,Blue,1,62230,62636,406
2022-02-10,70038,70060,Blue,1,82674,83886,1212
2022-02-08,70040,70046,Blue,1,22223,22491,268
2022-04-05,70038,70042,Blue,1,26063,26153,90
2022-05-21,70059,70039,Blue,0,38953,40138,1185
2022-01-04,70042,70044,Blue,1,78684,78713,29
2022-10-26,70042,70054,Blue,1,46471,47168,697
2022-04-05,70042,70046,Blue,1,58535,58718,183
2022-01-09,70059,70838,Blue,0,47894,48936,1042
2022-11-26,70055,70041,Blue,0,67211,67953,742
2022-01-21,70049,70047,Blue,0,71059,71112,53
2022-09-28,70042,70050,Blue,1,62515,62973,458
2022-09-14,70059,70051,Blue,0,29720,30071,351
2022-03-29,70045,70041,Blue,0,53854,54025,171
2022-01-26,70051,70838,Blue,0,34611,35413,802
2022-07-08,70059,70039,Blue,0,64296,65275,979
2022-04-20,70038,70058,Blue,1,89166,90099,933
2022-12-10,70048,70052,Blue,1,85183,85404,221
2022-04-04,70048,70060,Blue,1,51325,51963,638
2022-03-09,70057,70055,Blue,0,23133,23201,68
2022-08-25,70051,70838,Blue,0,59777,60596,819
2022-03-25,70054,70058,Blue,1,20711,20873,162
2022-03-03,70038,70046,Blue,1,41414,41776,362
2022-07-28,70054,70058,Blue,1,45595,45760,165
2022-03-12,70041,70838,Blue,0,27460,27575,115
2022-08-12,70041,70039,Blue,0,77924,77963,39
2022-03-04,70059,70051,Blue,0,25454,25824,370
2022-08-04,70038,70054,Blue,1,51434,52289,855
2022-01-15,70055,70049,Blue,0,32122,32416,294
2022-02-03,70055,70838,Blue,0,47296,48180,884
2022-06-18,70042,70050,Blue,1,31967,32458,491
2022-03-10,70049,70838,Blue,0,39935,40544,609
2022-11-22,70053,70045,Blue,0,57470,57897,427
2022-09-20,70053,70039,Blue,0,36167,37030,863
2022-08-24,70053,70043,Blue,0,49907,50464,557
2022-02-15,70056,70060,Blue,1,42937,43209,272
2022-06-17,70049,70041,Blue,0,51582,52075,493
2022-10-07,70059,70055,Blue,0,66555,66699,144
2022-01-02,70038,70046,Blue,1,87321,87666,345
2022-11-10,70043,70838,Blue,0,66822,67034,212
2022-11-12,70057,70049,Blue,0,26665,27075,410
2022-12-06,70051,70043,Blue,0,74795,75332,537
2022-02-02,70049,70043,Blue,0,74918,75329,411
2022-12-28,70040,70054,Blue,1,47652,48380,728
2022-01-17,70054,70058,Blue,1,20879,21040,161
2022-01-23,70038,70046,Blue,1,59113,59463,350
2022-11-09,70040,70056,Blue,1,77358,78162,804
2022-12-05,70048,70060,Blue,1,37072,37704,632
2022-07-31,70052,70060,Blue,1,78278,78650,372
2022-10-08,70038,70042,Blue,1,30736,30828,92
2022-02-19,70046,70060,Blue,1,32265,33014,749
2022-03-29,70057,70047,Blue,0,63270,63765,495
2022-12-15,70059,70043,Blue,0,80606,81878,1272
2022-08-17,70042,70056,Blue,1,33715,34479,764
2022-03-11,70059,70047,Blue,0,51192,51721,529
2022-09-08,70059,70039,Blue,0,61906,63057,1151
2022-02-10,70050,70060,Blue,1,44775,45313,538
2022-12-13,70038,70048,Blue,1,36528,37045,517
2022-11-13,70055,70053,Blue,0,57245,57290,45
2022-12-27,70038,70040,Blue,1,76508,76526,18
2022-12-15,70038,70058,Blue,1,86534,87475,941
2022-04-21,70054,70056,Blue,1,52586,52634,48
2022-02-02,70048,70058,Blue,1,69066,69574,508
2022-06-09,70038,70050,Blue,1,76386,77005,619
2022-01-11,70038,70046,Blue,1,70926,71232,306
2022-02-07,70059,70039,Blue,0,62894,63996,1102
2022-08-04,70038,70042,Blue,1,47773,47872,99
2022-02-13,70054,70058,Blue,1,48059,48215,156
2022-12-18,70055,70045,Blue,0,60523,61044,521
2022-03-14,70050,70056,Blue,1,83174,83470,296
2022-12-12,70048,70060,Blue,1,63921,64553,632
2022-02-01,70055,70039,Blue,0,75673,76526,853
2022-03-25,70059,70053,Blue,0,73750,73969,219
2022-12-15,70044,70054,Blue,1,29273,29866,593
2022-06-22,70040,70052,Blue,1,74774,75468,694
2022-11-23,70038,70048,Blue,1,82633,83125,492
2022-04-12,70045,70039,Blue,0,23230,23491,261
2022-07-09,70045,70039,Blue,0,41395,41674,279
2022-02-19,70044,70054,Blue,1,72531,73211,680
2022-09-21,70049,70039,Blue,0,20910,21470,560
2022-01-03,70054,70058,Blue,1,34312,34461,149
2022-10-07,70057,70049,Blue,0,44837,45216,379
2022-10-27,70057,70053,Blue,0,66294,66444,150
2022-01-14,70040,70058,Blue,1,64691,65648,957
2022-01-20,70053,70838,Blue,0,56595,57520,925
2022-03-29,70059,70049,Blue,0,56893,57346,453
2022-06-15,70049,70047,Blue,0,31144,31200,56
2022-08-03,70048,70056,Blue,1,49838,50252,414
2022-10-30,70051,70039,Blue,0,40531,41178,647
2022-09-20,70045,70039,Blue,0,83659,83896,237
2022-01-13,70046,70054,Blue,1,37704,38175,471
2022-03-28,70050,70058,Blue,1,40160,40586,426
2022-08-30,70059,70043,Blue,0,85064,85868,804
2022-09-21,70046,70058,Blue,1,69362,69972,610
2022-04-08,70050,70054,Blue,1,30239,30457,218
2022-01-05,70059,70051,Blue,0,69978,70346,368
2022-02-12,70059,70041,Blue,0,86749,87948,1199
2022-01-12,70057,70039,Blue,0,58785,59786,1001
2022-03-21,70054,70060,Blue,1,47848,48130,282
2022-09-16,70043,70838,Blue,0,52532,52750,218
2022-08-29,70053,70041,Blue,0,60046,60744,698
2022-07-22,70046,70050,Blue,1,42480,42669,189
2022-05-04,70057,70053,Blue,0,56906,57059,153
2022-12-12,70049,70045,Blue,0,37446,37636,190
2022-09-20,70048,70052,Blue,1,27912,28116,204
2022-07-03,70049,70039,Blue,0,31405,31905,500
2022-05-24,70039,70838,Blue,0,72798,72833,35
2022-04-20,70038,70046,Blue,1,25148,25452,304
2022-07-26,70055,70041,Blue,0,77124,77843,719
2022-01-03,70053,70049,Blue,0,73970,74190,220
2022-04-23,70057,70051,Blue,0,37411,37658,247
2022-03-01,70040,70056,Blue,1,52510,53386,876
2022-04-09,70051,70039,Blue,0,40457,41168,711
2022-08-26,70042,70046,Blue,1,51187,51430,243
2022-04-13,70046,70058,Blue,1,26724,27436,712
2022-04-07,70044,70046,Blue,1,56735,56836,101
2022-04-23,70049,70039,Blue,0,56773,57353,580
2022-10-28,70052,70058,Blue,1,77465,77721,256
2022-07-25,70054,70060,Blue,1,56070,56465,395
2022-03-01,70038,70052,Blue,1,29647,30343,696
2022-08-19,70050,70054,Blue,1,53982,54221,239
2022-10-12,70044,70046,Blue,1,36091,36195,104
2022-12-15,70044,70048,Blue,1,36553,36798,245
2022-01-22,70045,70838,Blue,0,80601,80933,332
2022-01-26,70045,70838,Blue,0,22890,23316,426
2022-01-04,70059,70039,Blue,0,69086,70084,998
2022-12-03,70057,70049,Blue,0,68731,69111,380
2022-07-18,70040,70044,Blue,1,43058,43180,122
2022-04-02,70051,70047,Blue,0,64191,64383,192
2022-12-30,70043,70039,Blue,0,59116,59231,115
2022-08-17,70038,70050,Blue,1,84277,84855,578
2022-12-07,70047,70045,Blue,0,57989,58105,116
2022-03-28,70039,70838,Blue,0,82805,82838,33
2022-11-09,70038,70050,Blue,1,63794,64418,624
2022-03-21,70038,70058,Blue,1,63752,64904,1152
2022-12-20,70047,70041,Blue,0,26070,26406,336
2022-04-16,70052,70054,Blue,1,72551,72606,55
2022-06-04,70049,70045,Blue,0,59162,59359,197
2022-01-25,70046,70048,Blue,1,55899,55985,86
2022-08-09,70054,70058,Blue,1,59441,59604,163
2022-12-04,70038,70060,Blue,1,51352,52441,1089
2022-08-22,70040,70058,Blue,1,58648,59615,967
2022-01-19,70040,70048,Blue,1,80897,81290,393
2022-12-02,70038,70060,Blue,1,29408,30548,1140
2022-06-28,70052,70060,Blue,1,78772,79158,386
2022-12-02,70042,70046,Blue,1,48898,49074,176
2022-06-12,70044,70050,Blue,1,30206,30533,327
2022-07-11,70049,70047,Blue,0,70221,70278,57
2022-04-05,70057,70051,Blue,0,79542,79799,257
2022-07-12,70040,70058,Blue,1,65301,66249,948
2022-10-19,70046,70054,Blue,1,54304,55152,848
2022-01-09,70040,70058,Blue,1,57037,57963,926
2022-06-27,70038,70052,Blue,1,55236,56235,999
2022-04-06,70045,70043,Blue,0,21833,21945,112
2022-08-10,70040,70044,Blue,1,32193,32300,107
2022-09-21,70049,70045,Blue,0,20439,20702,263
2022-12-23,70059,70838,Blue,0,64951,66220,1269
2022-07-04,70055,70049,Blue,0,61580,61868,288
2022-01-03,70040,70046,Blue,1,30610,30863,253
2022-02-04,70055,70049,Blue,0,43423,43744,321
2022-09-05,70048,70058,Blue,1,23642,24156,514
2022-10-01,70055,70045,Blue,0,73158,73657,499
2022-04-04,70052,70054,Blue,1,21828,21882,54
2022-07-22,70057,70049,Blue,0,31903,32344,441
2022-09-02,70049,70047,Blue,0,59017,59071,54
2022-10-25,70059,70043,Blue,0,25949,26880,931
2022-08-08,70040,70056,Blue,1,81481,82317,836
2022-04-15,70038,70056,Blue,1,21596,22614,1018
2022-12-13,70050,70060,Blue,1,72635,73191,556
2022-11-18,70056,70058,Blue,1,58211,58281,70
2022-07-05,70038,70058,Blue,1,31177,32259,1082
2022-08-21,70055,70041,Blue,0,61054,61788,734
2022-02-04,70038,70040,Blue,1,40667,40683,16
2022-09-29,70055,70039,Blue,0,26143,27175,1032
2022-10-09,70044,70060,Blue,1,43863,44778,915
2022-11-30,70044,70060,Blue,1,53698,54667,969
2022-11-13,70042,70060,Blue,1,54390,55324,934
2022-12-23,70055,70045,Blue,0,52905,53657,752
2022-12-03,70042,70060,Blue,1,47081,48083,1002
2022-05-16,70055,70051,Blue,0,60808,60944,136
2022-09-20,70059,70055,Blue,0,30578,30726,148
2022-11-23,70038,70054,Blue,1,49756,50531,775
2022-02-21,70038,70054,Blue,1,58290,59174,884
2022-12-24,70044,70060,Blue,1,29324,30251,927
2022-01-08,70044,70060,Blue,1,26493,27399,906
2022-03-28,70050,70060,Blue,1,27878,28404,526
2022-09-23,70055,70049,Blue,0,48557,48825,268
2022-03-02,70042,70050,Blue,1,19997,20436,439
2022-04-01,70046,70052,Blue,1,49627,49960,333
2022-03-08,70054,70056,Blue,1,41529,41579,50
2022-02-16,70057,70045,Blue,0,87555,88138,583
2022-10-20,70059,70055,Blue,0,67662,67800,138
2022-09-23,70046,70048,Blue,1,26863,26949,86
2022-02-27,70038,70058,Blue,1,52634,53726,1092
2022-08-18,70059,70049,Blue,0,70876,71324,448
2022-12-17,70045,70039,Blue,0,74787,75028,241
2022-05-19,70057,70047,Blue,0,21042,21559,517
2022-04-04,70044,70058,Blue,1,80501,81251,750
2022-10-17,70042,70050,Blue,1,56833,57241,408
2022-02-01,70040,70046,Blue,1,87936,88200,264
2022-07-26,70052,70060,Blue,1,31013,31592,579
2022-09-06,70045,70039,Blue,0,46830,47133,303
2022-01-22,70044,70058,Blue,1,46596,47405,809
2022-04-04,70051,70047,Blue,0,80471,80662,191
2022-12-29,70059,70043,Blue,0,35581,36506,925
2022-06-10,70040,70054,Blue,1,29345,30436,1091
2022-01-28,70044,70052,Blue,1,39272,39812,540
2022-01-22,70051,70039,Blue,0,26889,27455,566
2022-12-06,70055,70053,Blue,0,29851,29900,49
2022-08-02,70052,70060,Blue,1,34879,35278,399
2022-12-20,70040,70046,Blue,1,28649,28908,259
2022-03-26,70059,70057,Blue,0,54072,54107,35
2022-12-15,70049,70043,Blue,0,59827,60211,384
2022-12-02,70052,70056,Blue,1,82736,82882,146
2022-03-08,70040,70048,Blue,1,53105,53493,388
2022-02-16,70050,70054,Blue,1,52260,52454,194
2022-10-16,70059,70047,Blue,0,47895,48444,549
2022-10-20,70043,70838,Blue,0,49390,49580,190
2022-03-01,70057,70051,Blue,0,63474,63762,288
2022-01-26,70054,70060,Blue,1,81174,81432,258
2022-06-09,70057,70053,Blue,0,80130,80278,148
2022-11-08,70050,70056,Blue,1,45464,45796,332
2022-02-16,70055,70043,Blue,0,77355,77993,638
2022-01-25,70044,70046,Blue,1,35578,35688,110
2022-08-06,70046,70050,Blue,1,70542,70724,182
2022-06-15,70038,70056,Blue,1,74047,75002,955
2022-01-07,70054,70060,Blue,1,51262,51582,320
2022-12-02,70055,70051,Blue,0,26299,26451,152
2022-11-07,70049,70045,Blue,0,27042,27285,243
2022-05-20,70057,70049,Blue,0,33932,34308,376
2022-06-25,70059,70838,Blue,0,30857,32227,1370
2022-05-18,70059,70043,Blue,0,33607,34704,1097
2022-11-18,70051,70047,Blue,0,25812,26020,208
2022-08-08,70047,70045,Blue,0,62047,62153,106
2022-02-02,70044,70050,Blue,1,34441,34813,372
2022-02-02,70051,70045,Blue,0,57241,57575,334
2022-06-16,70042,70044,Blue,1,29607,29644,37
2022-01-01,70057,70043,Blue,0,22358,23148,790
2022-10-10,70038,70056,Blue,1,31508,32434,926
2022-04-05,70059,70055,Blue,0,54493,54631,138
2022-03-15,70051,70041,Blue,0,68220,68842,622
2022-06-26,70059,70053,Blue,0,51136,51367,231
2022-12-06,70044,70058,Blue,1,29638,30422,784
2022-02-05,70051,70049,Blue,0,71184,71287,103
2022-01-03,70053,70043,Blue,0,67068,68281,1213
2022-12-31,70047,70838,Blue,0,58703,59189,486
2022-07-09,70038,70060,Blue,1,83780,84973,1193
2022-12-19,70041,70838,Blue,0,77304,77420,116
2022-11-05,70053,70051,Blue,0,26815,26871,56
2022-10-21,70055,70039,Blue,0,27420,28322,902
2022-03-18,70042,70060,Blue,1,61891,62953,1062
2022-02-10,70044,70060,Blue,1,38153,39098,945
2022-09-11,70043,70838,Blue,0,67740,67943,203
2022-11-23,70052,70058,Blue,1,76587,76840,253
2022-04-06,70047,70039,Blue,0,51560,51969,409
2022-07-22,70059,70838,Blue,0,24356,25495,1139
2022-06-29,70042,70046,Blue,1,38874,39083,209
2022-06-18,70040,70058,Blue,1,83844,84828,984
2022-03-31,70051,70043,Blue,0,45864,46375,511
2022-03-18,70055,70049,Blue,0,66092,66366,274
2022-09-06,70059,70838,Blue,0,74972,76086,1114
2022-11-29,70038,70044,Blue,1,33190,33351,161
2022-11-22,70049,70043,Blue,0,57708,58031,323
2022-03-22,70043,70039,Blue,0,64253,64359,106
2022-06-04,70049,70043,Blue,0,31484,31888,404
2022-08-26,70059,70039,Blue,0,23414,24426,1012
2022-06-16,70055,70041,Blue,0,71072,71867,795
2022-04-14,70046,70048,Blue,1,67404,67479,75
2022-10-26,70059,70043,Blue,0,29715,30722,1007
2022-07-21,70038,70050,Blue,1,61707,62311,604
2022-02-06,70046,70054,Blue,1,86763,87160,397
2022-02-22,70049,70047,Blue,0,29600,29654,54
2022-11-28,70044,70050,Blue,1,88414,88759,345
2022-12-25,70041,70838,Blue,0,57996,58125,129
2022-06-18,70047,70043,Blue,0,59030,59293,263
2022-12-04,70038,70056,Blue,1,52841,53784,943
2022-12-12,70042,70054,Blue,1,49872,50618,746
2022-04-05,70038,70048,Blue,1,58034,58493,459
2022-11-02,70048,70054,Blue,1,35815,36335,520
2022-10-15,70040,70044,Blue,1,68073,68203,130
2022-04-04,70042,70060,Blue,1,56107,57325,1218
2022-03-25,70038,70048,Blue,1,54316,54814,498
2022-02-16,70057,70055,Blue,0,73827,73895,68
2022-03-31,70045,70041,Blue,0,39276,39449,173
2022-09-25,70059,70039,Blue,0,74394,75404,1010
2022-01-04,70048,70058,Blue,1,82470,82952,482
2022-08-02,70042,70056,Blue,1,52228,53009,781
2022-04-10,70051,70838,Blue,0,27319,28053,734
2022-09-27,70046,70050,Blue,1,26008,26198,190
2022-07-08,70046,70060,Blue,1,50644,51365,721
2022-03-31,70056,70060,Blue,1,68714,68888,174
2022-09-04,70040,70044,Blue,1,60276,60391,115
2022-12-15,70046,70060,Blue,1,65179,65913,734
2022-09-10,70055,70053,Blue,0,34835,34882,47
2022-04-20,70043,70838,Blue,0,47190,47400,210
2022-04-08,70042,70048,Blue,1,20876,21219,343
2022-08-13,70050,70056,Blue,1,81020,81317,297
2022-03-11,70048,70060,Blue,1,58312,58929,617
2022-06-21,70047,70043,Blue,0,86305,86534,229
2022-09-27,70051,70043,Blue,0,63805,64296,491
2022-01-13,70042,70058,Blue,1,25338,26271,933
2022-12-03,70038,70042,Blue,1,49629,49746,117
2022-06-29,70047,70039,Blue,0,47407,47852,445
2022-12-21,70051,70039,Blue,0,27057,27697,640
2022-02-21,70046,70052,Blue,1,39219,39562,343
2022-09-10,70055,70047,Blue,0,66134,66499,365
2022-01-28,70052,70056,Blue,1,78208,78348,140
2022-06-22,70042,70056,Blue,1,65932,66834,902
2022-11-27,70053,70838,Blue,0,69789,70647,858
2022-11-27,70053,70039,Blue,0,59003,59797,794
2022-08-29,70057,70838,Blue,0,39566,40588,1022
2022-12-04,70051,70047,Blue,0,70400,70595,195
2022-01-26,70049,70045,Blue,0,24496,24697,201
2022-03-18,70050,70054,Blue,1,29472,29690,218
2022-09-19,70043,70039,Blue,0,47951,48059,108
2022-02-01,70045,70838,Blue,0,51754,52166,412
2022-01-19,70053,70049,Blue,0,31529,31715,186
2022-02-08,70044,70054,Blue,1,48984,49624,640
2022-12-19,70053,70045,Blue,0,56789,57277,488
2022-02-03,70041,70039,Blue,0,74380,74419,39
2022-06-23,70044,70050,Blue,1,39861,40213,352
2022-06-24,70044,70046,Blue,1,59313,59444,131
2022-06-24,70049,70838,Blue,0,55871,56534,663
2022-02-01,70047,70041,Blue,0,74710,75025,315
2022-02-24,70038,70046,Blue,1,23956,24298,342
2022-11-17,70042,70048,Blue,1,71743,72021,278
2022-08-20,70048,70052,Blue,1,30732,30941,209
2022-01-22,70059,70049,Blue,0,45438,45908,470
2022-11-23,70042,70054,Blue,1,28647,29272,625
2022-04-13,70053,70049,Blue,0,64967,65196,229
2022-08-21,70053,70045,Blue,0,86666,87088,422
2022-03-31,70041,70039,Blue,0,78789,78824,35
2022-12-21,70051,70049,Blue,0,89235,89338,103
2022-07-06,70057,70055,Blue,0,64546,64617,71
2022-07-06,70057,70055,Blue,0,85202,85270,68
2022-05-19,70049,70045,Blue,0,38200,38522,322
2022-04-12,70049,70838,Blue,0,65476,66013,537
2022-12-11,70057,70055,Blue,0,30926,30995,69
2022-02-08,70054,70058,Blue,1,58371,58523,152
2022-02-27,70055,70047,Blue,0,49698,50089,391
2022-03-03,70052,70056,Blue,1,65719,65855,136
2022-06-13,70057,70049,Blue,0,30342,30761,419
2022-06-14,70053,70045,Blue,0,49499,49972,473
2022-12-25,70044,70056,Blue,1,72331,73021,690
2022-07-12,70047,70043,Blue,0,58358,58664,306
2022-10-15,70038,70052,Blue,1,62053,62844,791
2022-12-10,70040,70050,Blue,1,72908,73403,495
2022-11-17,70047,70039,Blue,0,69259,69674,415
2022-03-07,70054,70058,Blue,1,25846,26000,154
2022-03-28,70056,70060,Blue,1,86918,87101,183
2022-02-09,70051,70043,Blue,0,41371,41914,543
2022-03-31,70039,70838,Blue,0,33967,34006,39
2022-07-27,70038,70056,Blue,1,76762,77713,951
2022-03-22,70059,70055,Blue,0,69514,69660,146
2022-09-12,70049,70045,Blue,0,57415,57650,235
2022-03-07,70049,70041,Blue,0,50772,51191,419
2022-11-13,70046,70058,Blue,1,36606,37197,591
2022-08-22,70053,70041,Blue,0,63974,64657,683
2022-12-25,70059,70045,Blue,0,33194,33869,675
2022-01-18,70053,70043,Blue,0,55984,56578,594
2022-09-12,70047,70043,Blue,0,60760,61002,242
2022-05-12,70050,70058,Blue,1,52061,52456,395
2022-11-26,70059,70053,Blue,0,75135,75359,224
2022-02-14,70038,70048,Blue,1,39091,39533,442
2022-07-25,70050,70058,Blue,1,56474,56923,449
2022-12-19,70053,70043,Blue,0,30505,31423,918
2022-10-06,70044,70060,Blue,1,69894,70788,894
2022-11-05,70044,70046,Blue,1,45541,45651,110
2022-07-29,70049,70041,Blue,0,20026,20477,451
2022-11-06,70053,70041,Blue,0,35038,35743,705
2022-02-06,70038,70040,Blue,1,33128,33144,16
2022-07-29,70053,70051,Blue,0,73925,73981,56
2022-12-10,70042,70050,Blue,1,43844,44253,409
2022-10-18,70053,70049,Blue,0,73055,73247,192
2022-12-11,70057,70055,Blue,0,81628,81697,69
2022-11-13,70048,70058,Blue,1,82220,82730,510
2022-10-10,70044,70048,Blue,1,39886,40136,250
2022-10-10,70053,70041,Blue,0,65006,65653,647
2022-05-16,70057,70047,Blue,0,20132,20642,510
2022-09-27,70051,70043,Blue,0,36038,36615,577
2022-10-09,70038,70050,Blue,1,83715,84287,572
2022-10-15,70044,70060,Blue,1,73050,73924,874
2022-09-28,70055,70043,Blue,0,51676,52325,649
2022-02-03,70055,70039,Blue,0,24763,25676,913
2022-12-09,70045,70039,Blue,0,63862,64114,252
2022-03-03,70038,70058,Blue,1,53075,54115,1040
2022-02-28,70049,70039,Blue,0,65246,65795,549
2022-03-13,70050,70054,Blue,1,77517,77731,214
2022-11-13,70041,70838,Blue,0,48430,48548,118
2022-08-10,70046,70052,Blue,1,26422,26751,329
2022-12-13,70045,70039,Blue,0,42392,42640,248
2022-12-20,70055,70047,Blue,0,81380,81793,413
2022-07-23,70057,70055,Blue,0,73970,74039,69
2022-07-01,70059,70047,Blue,0,69396,69950,554
2022-09-29,70053,70039,Blue,0,52231,52968,737
2022-04-08,70048,70050,Blue,1,29521,29580,59
2022-01-21,70057,70045,Blue,0,64786,65470,684
2022-02-04,70038,70048,Blue,1,60977,61483,506
2022-11-03,70052,70054,Blue,1,28874,28928,54
2022-11-06,70045,70838,Blue,0,74528,74862,334
2022-03-26,70050,70058,Blue,1,51844,52323,479
2022-10-29,70041,70039,Blue,0,34492,34521,29
2022-02-25,70042,70052,Blue,1,51782,52372,590
2022-09-14,70044,70052,Blue,1,50710,51293,583
2022-03-10,70042,70046,Blue,1,57095,57299,204
2022-09-02,70038,70048,Blue,1,56776,57194,418
2022-11-10,70059,70039,Blue,0,60866,61953,1087
2022-03-15,70042,70056,Blue,1,58497,59499,1002
2022-11-29,70043,70041,Blue,0,63833,63862,29
2022-11-15,70045,70039,Blue,0,37893,38162,269
2022-10-18,70038,70056,Blue,1,27467,28414,947
2022-05-18,70049,70043,Blue,0,63819,64406,587
2022-10-10,70051,70043,Blue,0,63291,63824,533
2022-10-25,70055,70049,Blue,0,86862,87134,272
2022-11-09,70056,70060,Blue,1,40370,40565,195
2022-04-13,70057,70053,Blue,0,29434,29585,151
2022-03-08,70046,70058,Blue,1,53768,54446,678
2022-03-04,70059,70053,Blue,0,50716,50943,227
2022-07-01,70038,70058,Blue,1,74788,75870,1082
2022-04-01,70048,70054,Blue,1,67561,67853,292
2022-01-22,70038,70044,Blue,1,90076,91606,1530
2022-08-03,70052,70054,Blue,1,75547,75613,66
2022-03-16,70051,70045,Blue,0,64166,64529,363
2022-12-28,70057,70047,Blue,0,84471,84952,481
2022-08-30,70051,70045,Blue,0,42676,43029,353
2022-11-13,70042,70046,Blue,1,80594,80775,181
2022-01-21,70055,70039,Blue,0,72808,73615,807
2022-03-17,70051,70047,Blue,0,39678,39873,195
2022-10-05,70040,70048,Blue,1,37810,38175,365
2022-09-14,70059,70057,Blue,0,74895,74930,35
2022-09-06,70052,70058,Blue,1,45875,46126,251
2022-02-05,70038,70054,Blue,1,35594,36378,784
2022-03-23,70042,70044,Blue,1,63292,63321,29
2022-10-24,70042,70058,Blue,1,49460,50351,891
2022-11-23,70057,70051,Blue,0,31352,31597,245
2022-07-15,70053,70045,Blue,0,53643,54080,437
2022-08-01,70039,70838,Blue,0,45771,45801,30
2022-12-02,70057,70051,Blue,0,30210,30449,239
2022-07-07,70038,70052,Blue,1,26940,27675,735
2022-02-17,70051,70047,Blue,0,19198,19390,192
2022-09-16,70059,70045,Blue,0,69677,70406,729
2022-12-24,70049,70045,Blue,0,71304,71497,193
2022-08-08,70044,70058,Blue,1,63152,63932,780
2022-08-29,70042,70046,Blue,1,69112,69303,191
2022-01-04,70053,70838,Blue,0,78602,79437,835
2022-03-06,70052,70056,Blue,1,36951,37086,135
2022-12-04,70042,70060,Blue,1,58765,59834,1069
2022-08-13,70049,70039,Blue,0,59446,59979,533
2022-04-11,70046,70056,Blue,1,77299,77835,536
2022-04-02,70040,70048,Blue,1,52980,53402,422
2022-06-28,70057,70055,Blue,0,61404,61473,69
2022-10-24,70040,70058,Blue,1,74885,75789,904
2022-04-19,70049,70045,Blue,0,19420,19648,228
2022-03-07,70038,70054,Blue,1,57734,58612,878
2022-11-25,70057,70053,Blue,0,29792,29953,161
2022-02-16,70042,70058,Blue,1,53882,54776,894
2022-08-14,70053,70041,Blue,0,66518,67178,660
2022-03-18,70038,70050,Blue,1,72977,73551,574
2022-01-06,70053,70049,Blue,0,53439,53714,275
2022-04-29,70051,70047,Blue,0,78317,78525,208
2022-11-01,70050,70056,Blue,1,60830,61130,300
2022-11-04,70044,70060,Blue,1,65340,66430,1090
2022-07-14,70055,70051,Blue,0,61285,61419,134
2022-12-26,70047,70838,Blue,0,49562,50038,476
2022-08-15,70046,70060,Blue,1,69348,70073,725
2022-02-07,70057,70039,Blue,0,57284,58337,1053
2022-08-08,70049,70039,Blue,0,31099,31745,646
2022-01-24,70042,70052,Blue,1,61186,61754,568
2022-08-19,70057,70051,Blue,0,62033,62277,244
2022-02-16,70053,70049,Blue,0,60799,61032,233
2022-06-22,70046,70056,Blue,1,68545,69111,566
2022-03-14,70053,70049,Blue,0,19113,19331,218
2022-03-03,70057,70039,Blue,0,59976,60954,978
2022-03-22,70051,70039,Blue,0,55912,56540,628
2022-04-27,70052,70054,Blue,1,29644,29704,60
2022-08-10,70055,70043,Blue,0,21925,22608,683
2022-05-08,70055,70051,Blue,0,84880,85018,138
2022-04-15,70042,70048,Blue,1,55788,56114,326
2022-08-07,70057,70047,Blue,0,58786,59281,495
2022-12-05,70055,70053,Blue,0,55520,55567,47
2022-12-15,70055,70053,Blue,0,51751,51798,47
2022-10-29,70057,70047,Blue,0,86604,87107,503
2022-04-07,70044,70054,Blue,1,48887,49491,604
2022-06-17,70057,70051,Blue,0,59385,59647,262
2022-04-15,70059,70047,Blue,0,59597,60150,553
2022-07-12,70059,70053,Blue,0,75373,75614,241
2022-09-05,70059,70047,Blue,0,28513,29077,564
2022-02-17,70048,70054,Blue,1,81346,81636,290
2022-12-08,70057,70053,Blue,0,66125,66279,154
2022-06-05,70038,70040,Blue,1,74114,74129,15
2022-10-30,70051,70045,Blue,0,49329,49655,326
2022-02-24,70057,70045,Blue,0,63581,64226,645
2022-11-27,70053,70047,Blue,0,59003,59340,337
2022-12-25,70049,70041,Blue,0,57108,57531,423
2022-04-21,70058,70060,Blue,1,39739,39807,68
2022-11-25,70058,70060,Blue,1,71111,71180,69
2022-01-28,70055,70838,Blue,0,61265,62173,908
2022-11-25,70059,70047,Blue,0,42642,43245,603
2022-02-05,70055,70043,Blue,0,55357,56073,716
2022-05-19,70043,70039,Blue,0,87843,87941,98
2022-07-13,70038,70054,Blue,1,72054,72996,942
2022-12-03,70051,70043,Blue,0,25898,26425,527
2022-01-07,70051,70043,Blue,0,60925,61403,478
2022-08-04,70040,70046,Blue,1,30007,30278,271
2022-12-30,70038,70050,Blue,1,56835,57395,560
2022-01-09,70059,70053,Blue,0,36198,36465,267
2022-09-01,70052,70054,Blue,1,26328,26386,58
2022-04-15,70041,70838,Blue,0,23567,23696,129
2022-03-23,70050,70056,Blue,1,53496,53860,364
2022-10-12,70046,70050,Blue,1,79838,80009,171
2022-11-15,70048,70056,Blue,1,27357,27736,379
2022-06-18,70053,70043,Blue,0,62510,63152,642
2022-02-01,70052,70054,Blue,1,27737,27796,59
2022-05-12,70049,70047,Blue,0,70930,71019,89
2022-10-02,70059,70053,Blue,0,26180,26423,243
2022-08-01,70042,70050,Blue,1,32726,33108,382
2022-07-01,70057,70045,Blue,0,33146,33806,660
2022-05-01,70050,70058,Blue,1,46076,46468,392
2022-10-06,70040,70050,Blue,1,81518,82052,534
2022-03-17,70048,70060,Blue,1,57953,58636,683
2022-12-28,70059,70043,Blue,0,33077,33942,865
2022-01-19,70047,70045,Blue,0,19573,19673,100
2022-01-18,70046,70050,Blue,1,86381,86638,257
2022-07-29,70042,70050,Blue,1,67497,67921,424
2022-09-02,70045,70041,Blue,0,81353,81543,190
2022-12-30,70044,70048,Blue,1,60414,60647,233
2022-05-07,70049,70047,Blue,0,23357,23405,48
2022-04-04,70038,70042,Blue,1,35437,35533,96
2022-08-23,70059,70047,Blue,0,23019,23626,607
2022-05-01,70055,70049,Blue,0,54203,54484,281
2022-01-04,70051,70041,Blue,0,58143,58665,522
2022-08-24,70045,70039,Blue,0,89095,89414,319
2022-02-05,70059,70051,Blue,0,55160,55524,364
2022-02-16,70057,70053,Blue,0,64168,64354,186
2022-03-30,70059,70053,Blue,0,77772,77984,212
2022-11-01,70055,70051,Blue,0,70422,70550,128
2022-10-21,70058,70060,Blue,1,27198,27348,150
2022-06-09,70046,70050,Blue,1,57865,58073,208
2022-03-28,70044,70056,Blue,1,53965,54663,698
2022-09-27,70049,70838,Blue,0,40547,41207,660
2022-12-24,70042,70054,Blue,1,59536,60247,711
2022-02-03,70057,70055,Blue,0,63647,63716,69
2022-03-13,70055,70043,Blue,0,65368,66004,636
2022-09-16,70055,70045,Blue,0,26556,27116,560
2022-09-08,70055,70838,Blue,0,39318,40326,1008
2022-04-14,70048,70050,Blue,1,73969,74028,59
2022-01-07,70048,70056,Blue,1,27310,27927,617
2022-03-13,70041,70838,Blue,0,76386,76504,118
2022-08-12,70044,70054,Blue,1,44439,45084,645
2022-08-02,70045,70838,Blue,0,49615,49969,354
2022-04-10,70057,70043,Blue,0,66859,67581,722
2022-03-23,70057,70043,Blue,0,78984,79753,769
2022-03-24,70057,70041,Blue,0,85821,86953,1132
2022-07-11,70046,70050,Blue,1,48641,48821,180
2022-03-02,70049,70838,Blue,0,18896,19549,653
2022-08-19,70048,70050,Blue,1,62067,62129,62
2022-08-08,70038,70050,Blue,1,85693,86221,528
2022-04-12,70057,70053,Blue,0,67944,68091,147
2022-09-12,70040,70044,Blue,1,50837,50943,106
2022-04-19,70038,70054,Blue,1,69432,70330,898
2022-04-22,70038,70060,Blue,1,88335,89542,1207
2022-12-22,70047,70045,Blue,0,49099,49184,85
2022-10-08,70053,70041,Blue,0,60278,60932,654
2022-05-23,70041,70838,Blue,0,58905,59025,120
2022-04-11,70052,70060,Blue,1,61195,61716,521
2022-06-27,70059,70051,Blue,0,67441,67757,316
2022-07-10,70044,70060,Blue,1,87571,88539,968
2022-11-06,70038,70046,Blue,1,70460,70782,322
2022-02-16,70046,70060,Blue,1,73860,74542,682
2022-07-25,70044,70058,Blue,1,84378,85157,779
2022-02-08,70040,70046,Blue,1,50365,50610,245
2022-01-06,70046,70056,Blue,1,64379,64873,494
2022-03-02,70057,70041,Blue,0,31543,32466,923
2022-01-19,70047,70043,Blue,0,44514,44766,252
2022-09-30,70052,70060,Blue,1,54113,54465,352
2022-03-01,70055,70049,Blue,0,26849,27145,296
2022-11-15,70053,70047,Blue,0,31985,32304,319
2022-06-14,70057,70047,Blue,0,56098,56645,547
2022-12-10,70048,70052,Blue,1,77807,78015,208
2022-05-03,70052,70054,Blue,1,56304,56357,53
2022-05-17,70050,70060,Blue,1,67314,67845,531
2022-08-27,70043,70838,Blue,0,38217,38406,189
2022-09-20,70049,70043,Blue,0,70728,71058,330
2022-03-02,70050,70052,Blue,1,68973,69108,135
2022-10-27,70055,70049,Blue,0,47061,47358,297
2022-06-17,70042,70048,Blue,1,33429,33848,419
2022-11-15,70059,70057,Blue,0,82516,82558,42
2022-06-11,70057,70049,Blue,0,21631,22032,401
2022-01-06,70059,70055,Blue,0,75502,75663,161
2022-10-17,70051,70047,Blue,0,56652,56848,196
2022-09-17,70040,70056,Blue,1,26375,27192,817
2022-02-01,70059,70047,Blue,0,20966,21710,744
2022-12-15,70049,70045,Blue,0,77498,77701,203
2022-03-29,70044,70046,Blue,1,59159,59265,106
2022-05-19,70044,70050,Blue,1,41007,41444,437
2022-03-10,70058,70060,Blue,1,41176,41245,69
2022-12-19,70040,70054,Blue,1,53438,54237,799
2022-09-16,70042,70058,Blue,1,66812,68066,1254
2022-02-23,70049,70043,Blue,0,74268,74644,376
2022-03-03,70053,70051,Blue,0,25056,25112,56
2022-04-18,70050,70056,Blue,1,21244,21637,393
2022-12-02,70046,70052,Blue,1,65189,65515,326
2022-04-10,70038,70054,Blue,1,76937,77741,804
2022-09-24,70040,70054,Blue,1,42662,43355,693
2022-07-13,70040,70046,Blue,1,74784,75103,319
2022-12-18,70042,70050,Blue,1,37169,37566,397
2022-02-08,70040,70050,Blue,1,52920,53370,450
2022-11-22,70053,70051,Blue,0,80088,80138,50
2022-06-30,70040,70042,Blue,1,41917,41953,36
2022-01-17,70046,70048,Blue,1,54515,54593,78
2022-10-03,70048,70060,Blue,1,58118,58822,704
2022-08-15,70057,70838,Blue,0,45810,46852,1042
2022-08-05,70038,70060,Blue,1,52535,53769,1234
2022-02-26,70038,70042,Blue,1,55049,55152,103
2022-06-15,70042,70048,Blue,1,42138,42474,336
2022-07-29,70059,70053,Blue,0,43378,43608,230
2022-03-18,70041,70039,Blue,0,48744,48778,34
2022-07-23,70057,70049,Blue,0,30394,30782,388
2022-06-24,70059,70041,Blue,0,46901,47949,1048
2022-04-21,70055,70045,Blue,0,44537,45053,516
2022-05-09,70051,70047,Blue,0,33024,33220,196
2022-09-23,70040,70044,Blue,1,44213,44323,110
2022-06-21,70058,70060,Blue,1,64223,64305,82
2022-06-24,70057,70041,Blue,0,37579,38783,1204
2022-06-16,70047,70045,Blue,0,25558,25665,107
2022-07-18,70048,70052,Blue,1,44551,44765,214
2022-08-27,70049,70041,Blue,0,86195,86646,451
2022-02-07,70049,70045,Blue,0,86262,86451,189
2022-03-02,70059,70057,Blue,0,71539,71574,35
2022-12-26,70059,70045,Blue,0,45324,46044,720
2022-10-28,70046,70052,Blue,1,23179,23525,346
2022-03-08,70042,70050,Blue,1,51769,52165,396
2022-10-22,70055,70838,Blue,0,44532,45411,879
2022-11-10,70044,70056,Blue,1,48443,49106,663
2022-01-05,70051,70039,Blue,0,20945,21541,596
2022-07-04,70049,70047,Blue,0,64615,64673,58
2022-06-30,70058,70060,Blue,1,47895,47961,66
2022-09-22,70055,70049,Blue,0,84564,84833,269
2022-11-18,70042,70058,Blue,1,77496,78381,885
2022-12-28,70048,70050,Blue,1,27683,27738,55
2022-03-03,70059,70053,Blue,0,64399,64662,263
2022-02-02,70038,70040,Blue,1,78670,78685,15
2022-08-15,70059,70047,Blue,0,85526,86106,580
2022-06-28,70048,70050,Blue,1,75997,76052,55
2022-08-05,70051,70041,Blue,0,32592,33178,586
2022-02-17,70055,70053,Blue,0,51402,51470,68
2022-12-22,70048,70054,Blue,1,67050,67394,344
2022-06-21,70040,70054,Blue,1,65683,66572,889
2022-04-12,70057,70047,Blue,0,22114,22605,491
2022-01-04,70050,70058,Blue,1,35919,36430,511
2022-02-01,70046,70052,Blue,1,20376,20742,366
2022-11-23,70053,70049,Blue,0,30710,30901,191
2022-11-21,70044,70060,Blue,1,54191,55087,896
2022-11-06,70054,70056,Blue,1,82348,82395,47
2022-07-06,70059,70045,Blue,0,51999,52941,942
2022-09-13,70038,70040,Blue,1,80185,80199,14
2022-10-22,70059,70055,Blue,0,31397,31540,143
2022-11-21,70054,70058,Blue,1,65444,65603,159
2022-01-31,70038,70052,Blue,1,32192,33170,978
2022-02-16,70040,70058,Blue,1,82752,83763,1011
2022-03-18,70055,70053,Blue,0,62179,62224,45
2022-04-12,70049,70039,Blue,0,51263,51806,543
2022-07-13,70038,70044,Blue,1,80237,80467,230
2022-12-20,70048,70052,Blue,1,67502,67696,194
2022-01-07,70047,70045,Blue,0,54528,54628,100
2022-10-09,70042,70054,Blue,1,23147,23823,676
2022-10-28,70057,70051,Blue,0,55710,55965,255
2022-02-08,70038,70044,Blue,1,57136,57305,169
2022-08-09,70053,70041,Blue,0,46039,46769,730
2022-08-18,70053,70043,Blue,0,58529,59192,663
2022-07-20,70049,70039,Blue,0,78909,79396,487
2022-01-14,70051,70838,Blue,0,49048,49769,721
2022-05-05,70059,70057,Blue,0,73816,73853,37
2022-06-17,70053,70041,Blue,0,31134,31887,753
2022-02-16,70049,70043,Blue,0,82282,82652,370
2022-04-19,70050,70052,Blue,1,73627,73747,120
2022-11-02,70044,70046,Blue,1,23544,23654,110
2022-12-23,70040,70060,Blue,1,84986,86140,1154
2022-12-22,70038,70060,Blue,1,86293,87371,1078
2022-01-06,70040,70060,Blue,1,60806,61918,1112
2022-09-27,70046,70050,Blue,1,34616,34801,185
2022-01-26,70049,70041,Blue,0,34775,35232,457
2022-03-30,70043,70838,Blue,0,68135,68320,185
2022-07-20,70044,70056,Blue,1,58377,59234,857
2022-07-06,70038,70046,Blue,1,37458,37822,364
2022-03-11,70047,70043,Blue,0,49289,49551,262
2022-03-29,70042,70050,Blue,1,24468,24917,449
2022-01-05,70055,70049,Blue,0,50548,50882,334
2022-08-24,70051,70047,Blue,0,23790,23993,203
2022-06-24,70052,70060,Blue,1,56312,56681,369
2022-02-04,70046,70052,Blue,1,75192,75588,396
2022-04-27,70050,70058,Blue,1,44357,44741,384
2022-01-04,70059,70057,Blue,0,43244,43279,35
2022-06-14,70044,70056,Blue,1,76552,77263,711
2022-02-07,70052,70058,Blue,1,31911,32157,246
2022-09-28,70051,70043,Blue,0,39831,40318,487
2022-10-12,70038,70040,Blue,1,26064,26080,16
2022-01-25,70046,70050,Blue,1,63720,63914,194
2022-09-22,70052,70060,Blue,1,61559,61918,359
2022-12-17,70054,70060,Blue,1,29485,29776,291
2022-09-12,70045,70039,Blue,0,84895,85127,232
2022-10-13,70057,70055,Blue,0,83492,83562,70
2022-11-02,70057,70043,Blue,0,21855,22719,864
2022-02-04,70055,70041,Blue,0,32282,33049,767
2022-04-05,70055,70043,Blue,0,48885,49597,712
2022-07-04,70038,70058,Blue,1,85227,86334,1107
2022-10-19,70040,70046,Blue,1,37416,37676,260
2022-01-25,70040,70054,Blue,1,30009,30790,781
2022-01-15,70042,70060,Blue,1,36277,37240,963
2022-09-03,70038,70048,Blue,1,73941,74380,439
2022-11-16,70059,70051,Blue,0,23298,23681,383
2022-03-01,70057,70045,Blue,0,73297,74184,887
2022-03-07,70059,70043,Blue,0,61883,62781,898
2022-11-06,70038,70050,Blue,1,60195,60818,623
2022-05-20,70038,70054,Blue,1,29065,29979,914
2022-09-12,70044,70056,Blue,1,43393,44083,690
2022-01-22,70052,70060,Blue,1,38068,38428,360
2022-08-19,70040,70050,Blue,1,52221,52732,511
2022-10-20,70044,70046,Blue,1,67294,67396,102
2022-12-28,70047,70045,Blue,0,32156,32252,96
2022-10-11,70040,70042,Blue,1,79537,79566,29
2022-10-26,70040,70042,Blue,1,52931,52963,32
2022-07-22,70048,70054,Blue,1,26967,27283,316
2022-03-09,70040,70044,Blue,1,84309,84419,110
2022-06-14,70038,70060,Blue,1,37427,38673,1246
2022-04-06,70038,70056,Blue,1,87732,88629,897
2022-06-24,70040,70054,Blue,1,64688,65506,818
2022-01-28,70038,70046,Blue,1,35423,35759,336
2022-03-04,70055,70051,Blue,0,44587,44743,156
2022-10-31,70046,70048,Blue,1,47015,47091,76
2022-07-13,70043,70838,Blue,0,77404,77604,200
2022-01-14,70038,70052,Blue,1,30842,31670,828
2022-04-12,70051,70049,Blue,0,29154,29259,105
2022-06-19,70050,70060,Blue,1,71168,71718,550
2022-07-22,70038,70052,Blue,1,63901,64648,747
2022-10-13,70055,70047,Blue,0,42779,43198,419
2022-04-24,70042,70052,Blue,1,48463,49021,558
2022-06-15,70053,70047,Blue,0,30308,30652,344
2022-02-07,70046,70048,Blue,1,87473,87548,75
2022-06-14,70053,70049,Blue,0,20562,20773,211
2022-05-21,70038,70042,Blue,1,24313,24400,87
2022-07-08,70038,70060,Blue,1,24819,26182,1363
2022-03-18,70053,70049,Blue,0,38929,39135,206
2022-02-03,70052,70056,Blue,1,41556,41701,145
2022-04-19,70055,70051,Blue,0,83662,83805,143
2022-11-18,70048,70050,Blue,1,28247,28301,54
2022-10-01,70045,70838,Blue,0,73717,74069,352
2022-06-29,70049,70838,Blue,0,50041,50724,683
2022-10-07,70059,70041,Blue,0,24440,25408,968
2022-04-02,70056,70058,Blue,1,81497,81567,70
2022-10-10,70043,70039,Blue,0,86742,86845,103
2022-11-13,70042,70044,Blue,1,68097,68122,25
2022-10-31,70054,70058,Blue,1,70912,71070,158
2022-12-28,70047,70039,Blue,0,54902,55304,402
2022-01-09,70059,70838,Blue,0,59773,60820,1047
2022-04-18,70057,70039,Blue,0,55773,56714,941
2022-02-24,70042,70052,Blue,1,60098,60688,590
2022-08-30,70040,70054,Blue,1,36804,37544,740
2022-07-04,70057,70053,Blue,0,56685,56832,147
2022-01-31,70059,70049,Blue,0,40188,40757,569
2022-12-29,70047,70045,Blue,0,59105,59204,99
2022-02-28,70059,70057,Blue,0,23657,23692,35
2022-09-12,70049,70039,Blue,0,30673,31263,590
2022-10-28,70049,70043,Blue,0,76936,77265,329
2022-09-03,70059,70049,Blue,0,84861,85312,451
2022-11-23,70048,70060,Blue,1,75207,75806,599
2022-02-15,70046,70052,Blue,1,49094,49428,334
2022-04-22,70046,70048,Blue,1,47298,47386,88
2022-11-09,70055,70043,Blue,0,52699,53331,632
2022-07-08,70055,70039,Blue,0,65701,66540,839
2022-08-04,70041,70039,Blue,0,86875,86904,29
2022-08-08,70057,70049,Blue,0,60395,60834,439
2022-10-26,70040,70048,Blue,1,60012,60456,444
2022-07-18,70052,70054,Blue,1,67132,67203,71
2022-10-30,70056,70058,Blue,1,30961,31033,72
2022-01-22,70051,70047,Blue,0,49048,49239,191
2022-09-11,70054,70056,Blue,1,33241,33287,46
2022-11-07,70053,70041,Blue,0,67020,67665,645
2022-09-07,70040,70042,Blue,1,21871,21903,32
2022-10-26,70052,70058,Blue,1,89887,90138,251
2022-10-25,70045,70838,Blue,0,50696,51045,349
2022-04-01,70040,70048,Blue,1,31813,32312,499
2022-10-26,70045,70041,Blue,0,65869,66065,196
2022-02-16,70059,70055,Blue,0,74897,75036,139
2022-06-07,70043,70041,Blue,0,39030,39058,28
2022-10-20,70049,70045,Blue,0,66553,66756,203
2022-01-08,70038,70042,Blue,1,71777,71878,101
2022-01-02,70055,70041,Blue,0,61583,62421,838
2022-10-07,70057,70055,Blue,0,81267,81335,68
2022-02-05,70050,70060,Blue,1,56241,56795,554
2022-04-04,70051,70047,Blue,0,51117,51329,212
2022-01-10,70052,70058,Blue,1,82353,82603,250
2022-05-21,70038,70048,Blue,1,62475,63088,613
2022-11-07,70052,70058,Blue,1,49751,49985,234
2022-12-28,70047,70039,Blue,0,60671,61066,395
2022-09-13,70038,70054,Blue,1,21193,22061,868
2022-03-30,70047,70041,Blue,0,36517,36852,335
2022-01-29,70047,70045,Blue,0,42296,42403,107
2022-01-13,70040,70058,Blue,1,83766,84737,971
2022-07-02,70044,70060,Blue,1,21876,22817,941
2022-01-24,70052,70056,Blue,1,62383,62524,141
2022-03-08,70046,70048,Blue,1,67116,67227,111
2022-11-28,70044,70048,Blue,1,62735,62954,219
2022-08-16,70049,70041,Blue,0,64934,65348,414
2022-11-02,70049,70838,Blue,0,41237,41841,604
2022-12-30,70057,70045,Blue,0,33259,33921,662
2022-01-04,70038,70046,Blue,1,32656,32965,309
2022-12-10,70053,70045,Blue,0,45717,46128,411
2022-09-10,70048,70052,Blue,1,71833,72050,217
2022-02-08,70051,70047,Blue,0,24359,24572,213
2022-01-10,70043,70041,Blue,0,86619,86647,28
2022-11-10,70048,70056,Blue,1,34956,35356,400
2022-08-16,70053,70039,Blue,0,71507,72241,734
2022-11-12,70044,70050,Blue,1,43938,44306,368
2022-03-01,70055,70053,Blue,0,84811,84864,53
2022-05-06,70059,70049,Blue,0,23415,23908,493
2022-11-08,70054,70060,Blue,1,81377,81653,276
2022-07-11,70050,70058,Blue,1,29571,30018,447
2022-03-09,70053,70043,Blue,0,51017,51729,712
2022-08-29,70053,70043,Blue,0,30817,31533,716
2022-06-24,70059,70047,Blue,0,66017,66574,557
2022-04-16,70046,70054,Blue,1,77666,78117,451
2022-06-17,70059,70043,Blue,0,48754,49676,922
2022-03-16,70042,70058,Blue,1,28286,29100,814
2022-02-14,70054,70056,Blue,1,67041,67089,48
2022-06-20,70053,70043,Blue,0,58204,58844,640
2022-08-03,70059,70055,Blue,0,71831,71970,139
2022-02-23,70049,70043,Blue,0,50909,51287,378
2022-03-18,70050,70058,Blue,1,69222,69618,396
2022-12-14,70044,70046,Blue,1,79762,79860,98
2022-11-15,70054,70058,Blue,1,56754,56933,179
2022-12-31,70059,70057,Blue,0,63541,63578,37
2022-09-30,70042,70044,Blue,1,24645,24683,38
2022-06-18,70038,70054,Blue,1,39918,40930,1012
2022-02-18,70045,70838,Blue,0,61323,61667,344
2022-02-21,70049,70838,Blue,0,60650,61243,593
2022-09-25,70054,70056,Blue,1,65546,65593,47
2022-06-26,70044,70060,Blue,1,74446,75376,930
2022-03-27,70057,70039,Blue,0,74970,75895,925
2022-09-05,70048,70050,Blue,1,51069,51126,57
2022-08-03,70059,70041,Blue,0,66454,67377,923
2022-02-08,70051,70045,Blue,0,24018,24366,348
2022-01-23,70045,70041,Blue,0,51444,51628,184
2022-03-28,70045,70041,Blue,0,63120,63308,188
2022-09-15,70040,70044,Blue,1,32736,32844,108
2022-11-06,70038,70040,Blue,1,40332,40349,17
2022-03-20,70053,70043,Blue,0,86682,87238,556
2022-09-11,70044,70056,Blue,1,72284,72991,707
2022-04-08,70041,70039,Blue,0,25562,25599,37
2022-07-06,70049,70047,Blue,0,26033,26088,55
2022-08-21,70038,70052,Blue,1,67310,68043,733
2022-10-31,70049,70047,Blue,0,57181,57233,52
2022-12-27,70050,70054,Blue,1,73355,73561,206
2022-09-10,70049,70041,Blue,0,30309,30758,449
2022-09-22,70055,70043,Blue,0,76758,77449,691
2022-04-16,70052,70054,Blue,1,65516,65566,50
2022-05-18,70043,70041,Blue,0,35811,35840,29
2022-11-08,70049,70047,Blue,0,31828,31885,57
2022-08-20,70049,70045,Blue,0,19016,19243,227
2022-10-24,70042,70056,Blue,1,24050,24865,815
2022-09-03,70040,70060,Blue,1,41096,42145,1049
2022-09-18,70038,70056,Blue,1,84616,85512,896
2022-01-28,70047,70039,Blue,0,69443,69915,472
2022-06-22,70053,70051,Blue,0,50227,50281,54
2022-02-02,70040,70046,Blue,1,25968,26240,272
2022-11-27,70051,70838,Blue,0,49313,50020,707
2022-09-21,70055,70047,Blue,0,62165,62533,368
2022-03-04,70054,70060,Blue,1,69436,69764,328
2022-12-20,70040,70060,Blue,1,57535,58658,1123
2022-03-27,70052,70054,Blue,1,73319,73363,44
2022-07-17,70055,70041,Blue,0,44928,45768,840
2022-06-12,70038,70046,Blue,1,78012,78335,323
2022-11-11,70053,70047,Blue,0,52246,52536,290
2022-01-25,70053,70043,Blue,0,83118,83768,650
2022-08-19,70041,70838,Blue,0,60788,60971,183
2022-04-18,70059,70049,Blue,0,20234,20701,467
2022-10-05,70040,70060,Blue,1,88266,89341,1075
2022-08-03,70040,70050,Blue,1,75987,76488,501
2022-02-07,70045,70041,Blue,0,88188,88360,172
2022-09-09,70059,70838,Blue,0,20839,22190,1351
2022-02-15,70049,70045,Blue,0,62509,62722,213
2022-12-25,70051,70043,Blue,0,65203,65702,499
2022-11-11,70040,70054,Blue,1,64334,65042,708
2022-12-29,70049,70838,Blue,0,20248,20821,573
2022-02-10,70059,70838,Blue,0,66796,67958,1162
2022-02-10,70040,70056,Blue,1,72495,73510,1015
2022-07-28,70052,70056,Blue,1,68818,68966,148
2022-11-22,70052,70060,Blue,1,30623,31004,381
2022-09-04,70049,70039,Blue,0,62515,63053,538
2022-07-23,70054,70056,Blue,1,37514,37561,47
2022-03-03,70047,70838,Blue,0,49302,49814,512
2022-10-12,70038,70046,Blue,1,61817,62240,423
2022-11-21,70049,70838,Blue,0,66510,67074,564
2022-04-02,70038,70050,Blue,1,81366,81972,606
2022-08-27,70045,70043,Blue,0,77979,78104,125
2022-07-23,70057,70055,Blue,0,84215,84285,70
2022-01-20,70044,70056,Blue,1,68432,69252,820
2022-04-11,70053,70039,Blue,0,64066,64753,687
2022-02-15,70053,70043,Blue,0,79158,79886,728
2022-04-13,70055,70051,Blue,0,65474,65613,139
2022-07-07,70049,70039,Blue,0,84501,85052,551
2022-02-02,70051,70039,Blue,0,62394,63098,704
2022-03-28,70040,70050,Blue,1,70601,71096,495
2022-03-13,70045,70039,Blue,0,72413,72677,264
2022-08-23,70040,70052,Blue,1,75917,76512,595
2022-06-17,70053,70838,Blue,0,60175,61105,930
2022-01-08,70057,70043,Blue,0,52530,53339,809
2022-02-01,70050,70060,Blue,1,21104,21817,713
2022-12-18,70051,70047,Blue,0,32019,32219,200
2022-11-15,70054,70056,Blue,1,34440,34487,47
2022-10-01,70040,70060,Blue,1,41593,43195,1602
2022-02-23,70042,70046,Blue,1,26803,26991,188
2022-01-01,70040,70056,Blue,1,70502,71678,1176
2022-06-29,70040,70046,Blue,1,76853,77139,286
2022-07-25,70044,70054,Blue,1,20100,20690,590
2022-07-08,70047,70838,Blue,0,47415,47938,523
2022-12-31,70057,70043,Blue,0,69376,70123,747
2022-04-09,70044,70048,Blue,1,21189,21409,220
2022-01-18,70050,70054,Blue,1,62234,62437,203
2022-09-06,70049,70043,Blue,0,37994,38346,352
2022-01-13,70055,70045,Blue,0,84186,84682,496
2022-03-08,70038,70042,Blue,1,22147,22229,82
2022-06-13,70040,70052,Blue,1,76924,77562,638
2022-10-11,70054,70058,Blue,1,50656,50812,156
2022-03-20,70051,70049,Blue,0,72023,72126,103
2022-12-28,70051,70039,Blue,0,73083,73650,567
2022-07-30,70042,70054,Blue,1,49796,50522,726
2022-07-15,70048,70056,Blue,1,83866,84283,417
2022-11-13,70054,70060,Blue,1,67591,67877,286
2022-05-08,70054,70058,Blue,1,49924,50083,159
2022-09-12,70042,70056,Blue,1,77972,78678,706
2022-12-27,70049,70043,Blue,0,22444,22810,366
2022-06-17,70038,70044,Blue,1,86122,86320,198
2022-08-02,70044,70046,Blue,1,75467,75568,101
2022-04-12,70051,70043,Blue,0,20636,21170,534
2022-01-12,70046,70052,Blue,1,68954,69258,304
2022-12-15,70042,70060,Blue,1,57214,58240,1026
2022-09-22,70057,70055,Blue,0,40664,40734,70
2022-09-21,70057,70053,Blue,0,42682,42829,147
2022-04-04,70040,70060,Blue,1,27036,28162,1126
2022-03-16,70038,70044,Blue,1,58326,58517,191
2022-05-27,70048,70052,Blue,1,38005,38293,288
2022-12-30,70040,70056,Blue,1,28096,28914,818
2022-12-16,70047,70838,Blue,0,23822,24330,508
2022-11-30,70050,70056,Blue,1,82047,82352,305
2022-08-24,70045,70043,Blue,0,56482,56590,108
2022-03-16,70055,70043,Blue,0,74523,75218,695
2022-09-12,70044,70050,Blue,1,75410,75736,326
2022-04-19,70047,70041,Blue,0,29989,30383,394
2022-02-17,70059,70055,Blue,0,50722,50870,148
2022-12-09,70057,70041,Blue,0,61430,62321,891
2022-12-23,70046,70050,Blue,1,60621,60822,201
2022-01-16,70057,70051,Blue,0,32570,32840,270
2022-09-26,70052,70054,Blue,1,77508,77555,47
2022-10-20,70053,70041,Blue,0,77733,78402,669
2022-02-07,70054,70056,Blue,1,46716,46764,48
2022-10-29,70042,70060,Blue,1,29249,30187,938
2022-04-14,70048,70052,Blue,1,63059,63263,204
2022-09-28,70053,70041,Blue,0,63919,64600,681
2022-03-25,70049,70041,Blue,0,19415,19894,479
2022-12-11,70040,70046,Blue,1,79754,80013,259
2022-12-31,70049,70041,Blue,0,90043,90476,433
2022-12-18,70045,70041,Blue,0,59460,59619,159
2022-01-06,70051,70838,Blue,0,62391,63122,731
2022-02-08,70043,70838,Blue,0,54140,54339,199
2022-06-15,70043,70041,Blue,0,58538,58567,29
2022-07-12,70041,70039,Blue,0,21812,21852,40
2022-01-04,70042,70052,Blue,1,58217,58833,616
2022-09-27,70049,70838,Blue,0,41062,41870,808
2022-05-14,70050,70056,Blue,1,81163,81485,322
2022-04-07,70048,70052,Blue,1,55118,55329,211
2022-09-02,70048,70058,Blue,1,68195,68740,545
2022-02-08,70055,70049,Blue,0,72793,73084,291
2022-04-06,70050,70056,Blue,1,41899,42194,295
2022-09-27,70047,70043,Blue,0,20624,20949,325
2022-04-01,70059,70053,Blue,0,51196,51418,222
2022-04-02,70044,70052,Blue,1,27694,28190,496
2022-02-23,70042,70058,Blue,1,38060,38959,899
2022-02-14,70052,70058,Blue,1,54440,54679,239
2022-09-07,70055,70039,Blue,0,64180,64968,788
2022-06-21,70046,70050,Blue,1,56076,56290,214
2022-01-06,70053,70041,Blue,0,75178,75822,644
2022-11-01,70047,70039,Blue,0,39657,40088,431
2022-10-15,70054,70060,Blue,1,48860,49120,260
2022-10-11,70057,70053,Blue,0,63195,63339,144
2022-08-18,70051,70039,Blue,0,83742,84378,636
2022-09-24,70040,70054,Blue,1,35658,36420,762
2022-10-06,70040,70042,Blue,1,37530,37561,31
2022-01-31,70051,70045,Blue,0,83268,83628,360
2022-04-24,70056,70058,Blue,1,61655,61728,73
2022-04-19,70055,70051,Blue,0,30763,30909,146
2022-12-08,70059,70053,Blue,0,40114,40384,270
2022-08-06,70048,70054,Blue,1,38837,39254,417
2022-04-07,70048,70054,Blue,1,21032,21351,319
2022-05-27,70047,70838,Blue,0,25712,26274,562
2022-03-08,70038,70046,Blue,1,41236,41563,327
2022-08-05,70048,70056,Blue,1,35096,35514,418
2022-04-22,70043,70041,Blue,0,23942,23971,29
2022-08-27,70038,70050,Blue,1,50715,51282,567
2022-10-01,70048,70054,Blue,1,27992,28290,298
2022-12-01,70040,70050,Blue,1,36488,37015,527
2022-08-18,70050,70056,Blue,1,68548,68841,293
2022-10-26,70053,70041,Blue,0,65142,65931,789
2022-07-12,70040,70056,Blue,1,33698,34549,851
2022-11-16,70056,70058,Blue,1,86011,86079,68
2022-07-25,70042,70058,Blue,1,55117,56042,925
2022-07-19,70038,70060,Blue,1,36564,37845,1281
2022-11-11,70054,70060,Blue,1,23940,24207,267
2022-09-08,70048,70056,Blue,1,34957,35358,401
2022-10-20,70049,70047,Blue,0,67734,67792,58
2022-09-17,70053,70051,Blue,0,88472,88529,57
2022-09-18,70047,70838,Blue,0,63156,63766,610
2022-01-20,70055,70039,Blue,0,64579,65504,925
2022-08-10,70055,70051,Blue,0,75072,75201,129
2022-08-30,70057,70055,Blue,0,84268,84337,69
2022-02-15,70042,70054,Blue,1,56702,57426,724
2022-11-15,70042,70044,Blue,1,67242,67278,36
2022-04-06,70051,70043,Blue,0,71338,71852,514
2022-09-24,70059,70057,Blue,0,52457,52492,35
2022-09-24,70046,70058,Blue,1,36478,37056,578
2022-09-16,70057,70051,Blue,0,36476,36829,353
2022-04-04,70057,70047,Blue,0,37087,37704,617
2022-10-03,70055,70047,Blue,0,56838,57224,386
2022-01-09,70053,70043,Blue,0,55197,55780,583
2022-12-05,70040,70054,Blue,1,69029,69813,784
2022-10-09,70038,70050,Blue,1,59152,59775,623
2022-03-17,70044,70046,Blue,1,69390,69499,109
2022-12-22,70040,70058,Blue,1,25596,26530,934
2022-05-16,70057,70049,Blue,0,66998,67410,412
2022-01-05,70049,70045,Blue,0,57432,57631,199
2022-02-11,70059,70039,Blue,0,41568,42606,1038
2022-03-05,70052,70056,Blue,1,55823,55956,133
2022-01-03,70045,70043,Blue,0,29137,29219,82
2022-08-07,70038,70040,Blue,1,74233,74247,14
2022-04-01,70048,70054,Blue,1,42503,42837,334
2022-07-12,70050,70054,Blue,1,74240,74470,230
2022-03-28,70040,70044,Blue,1,47041,47146,105
2022-03-09,70055,70051,Blue,0,71177,71342,165
2022-02-04,70057,70041,Blue,0,60722,61846,1124
2022-06-19,70048,70054,Blue,1,47295,47600,305
2022-03-26,70040,70054,Blue,1,73987,74757,770
2022-03-29,70038,70050,Blue,1,67949,68522,573
2022-04-20,70052,70054,Blue,1,36593,36657,64
2022-01-10,70057,70041,Blue,0,41029,41935,906
2022-12-06,70054,70060,Blue,1,42915,43187,272
2022-04-07,70049,70838,Blue,0,85675,86242,567
2022-07-21,70053,70043,Blue,0,68533,69137,604
2022-09-26,70059,70051,Blue,0,19935,20285,350
2022-01-28,70044,70052,Blue,1,20006,20531,525
2022-02-11,70054,70056,Blue,1,21197,21245,48
2022-10-06,70052,70056,Blue,1,81127,81288,161
2022-02-03,70055,70043,Blue,0,63450,64149,699
2022-01-16,70038,70040,Blue,1,45611,45625,14
2022-09-13,70046,70058,Blue,1,29364,30010,646
2022-10-29,70041,70838,Blue,0,59979,60112,133
2022-11-02,70038,70044,Blue,1,38574,38756,182
2022-09-29,70040,70046,Blue,1,59683,59995,312
2022-06-28,70059,70043,Blue,0,30141,31093,952
2022-06-10,70040,70050,Blue,1,23415,24141,726
2022-10-26,70057,70043,Blue,0,55414,56220,806
2022-04-11,70052,70056,Blue,1,35175,35328,153
2022-12-02,70046,70050,Blue,1,37086,37277,191
2022-12-24,70058,70060,Blue,1,58802,58865,63
2022-03-28,70043,70039,Blue,0,66862,66983,121
2022-04-02,70046,70058,Blue,1,78958,79575,617
2022-05-20,70056,70060,Blue,1,52333,52515,182
2022-07-25,70056,70060,Blue,1,71000,71179,179
2022-02-28,70055,70043,Blue,0,65495,66229,734
2022-11-19,70053,70039,Blue,0,55421,56289,868
2022-03-20,70045,70043,Blue,0,82954,83047,93
2022-07-23,70055,70041,Blue,0,79430,80272,842
2022-09-14,70055,70053,Blue,0,55619,55666,47
2022-01-21,70053,70051,Blue,0,34191,34256,65
2022-04-16,70049,70045,Blue,0,77731,77934,203
2022-06-17,70059,70047,Blue,0,86294,86834,540
2022-06-15,70055,70039,Blue,0,78499,79412,913
2022-08-19,70044,70052,Blue,1,82691,83468,777
2022-07-18,70051,70838,Blue,0,41559,42348,789
2022-01-06,70054,70058,Blue,1,55977,56140,163
2022-10-15,70056,70058,Blue,1,43525,43597,72
2022-07-18,70038,70048,Blue,1,32910,33378,468
2022-09-18,70047,70039,Blue,0,44695,45104,409
2022-06-14,70050,70060,Blue,1,59921,60479,558
2022-06-04,70049,70043,Blue,0,30929,31285,356
2022-10-06,70038,70040,Blue,1,59469,59487,18
2022-01-17,70050,70054,Blue,1,80535,80760,225
2022-10-31,70055,70041,Blue,0,60560,61374,814
2022-06-15,70051,70043,Blue,0,66503,66997,494
2022-08-24,70047,70045,Blue,0,82285,82384,99
2022-11-13,70038,70040,Blue,1,46688,46705,17
2022-07-28,70042,70058,Blue,1,73299,74138,839
2022-02-02,70049,70043,Blue,0,29942,30368,426
2022-12-31,70054,70060,Blue,1,60628,60894,266
2022-07-31,70040,70052,Blue,1,40432,41133,701
2022-02-24,70046,70058,Blue,1,22478,23081,603
2022-02-04,70038,70050,Blue,1,87159,87690,531
2022-09-01,70044,70046,Blue,1,82930,83039,109
2022-02-28,70048,70052,Blue,1,51257,51452,195
2022-07-31,70053,70041,Blue,0,88465,89097,632
2022-01-31,70049,70041,Blue,0,87422,87919,497
2022-08-08,70057,70838,Blue,0,62045,63112,1067
2022-03-12,70055,70838,Blue,0,41298,42153,855
2022-12-19,70053,70049,Blue,0,28203,28419,216
2022-05-26,70038,70050,Blue,1,82811,83411,600
2022-09-21,70046,70052,Blue,1,29831,30174,343
2022-03-30,70052,70060,Blue,1,24368,24891,523
2022-01-28,70051,70838,Blue,0,51612,52382,770
2022-10-21,70040,70058,Blue,1,80037,80964,927
2022-11-19,70040,70048,Blue,1,37928,38348,420
2022-02-25,70052,70060,Blue,1,68772,69207,435
2022-07-05,70039,70838,Blue,0,74951,74985,34
2022-12-14,70042,70046,Blue,1,79147,79324,177
2022-04-04,70052,70056,Blue,1,67584,67720,136
2022-08-24,70042,70054,Blue,1,26473,27146,673
2022-01-25,70050,70052,Blue,1,42327,42450,123
2022-08-22,70051,70041,Blue,0,54454,55035,581
2022-12-11,70044,70052,Blue,1,81232,81732,500
2022-02-11,70055,70039,Blue,0,68068,69004,936
2022-09-15,70038,70058,Blue,1,28156,29211,1055
2022-06-23,70047,70041,Blue,0,48190,48521,331
2022-05-23,70044,70052,Blue,1,56306,56923,617
2022-09-27,70050,70060,Blue,1,32768,33308,540
2022-07-13,70055,70053,Blue,0,34576,34622,46
2022-01-26,70047,70838,Blue,0,70133,70631,498
2022-11-27,70056,70060,Blue,1,26180,26345,165
2022-08-03,70049,70047,Blue,0,44868,44933,65
2022-10-10,70047,70838,Blue,0,40980,41548,568
2022-02-18,70051,70838,Blue,0,60940,61667,727
2022-11-24,70044,70046,Blue,1,63091,63197,106
2022-08-30,70043,70039,Blue,0,46877,46975,98
2022-12-09,70057,70053,Blue,0,71863,72014,151
2022-07-07,70044,70046,Blue,1,76369,76477,108
2022-11-06,70040,70056,Blue,1,41063,41890,827
2022-04-11,70044,70046,Blue,1,73223,73329,106
2022-05-18,70048,70056,Blue,1,57608,58045,437
2022-11-11,70057,70043,Blue,0,37111,37931,820
2022-12-28,70040,70060,Blue,1,71103,72273,1170
2022-12-22,70053,70043,Blue,0,23343,23906,563
2022-03-15,70054,70058,Blue,1,66356,66527,171
2022-02-15,70038,70040,Blue,1,25457,25475,18
2022-06-28,70053,70051,Blue,0,78814,78872,58
2022-08-12,70042,70054,Blue,1,79209,79955,746
2022-06-14,70044,70054,Blue,1,84677,85295,618
2022-07-07,70053,70047,Blue,0,40851,41248,397
2022-09-14,70042,70060,Blue,1,63179,64193,1014
2022-05-20,70044,70048,Blue,1,43817,44103,286
2022-07-08,70040,70058,Blue,1,59777,60790,1013
2022-04-14,70046,70052,Blue,1,73371,73742,371
2022-06-14,70059,70043,Blue,0,49215,50164,949
2022-07-23,70038,70048,Blue,1,71904,72439,535
2022-12-29,70055,70838,Blue,0,27133,28067,934
2022-06-24,70040,70052,Blue,1,82524,83270,746
2022-12-13,70054,70056,Blue,1,32405,32445,40
2022-08-28,70059,70041,Blue,0,71666,72678,1012
2022-09-19,70050,70054,Blue,1,70717,70942,225
2022-03-12,70059,70053,Blue,0,20829,21093,264
2022-06-02,70049,70838,Blue,0,20313,21014,701
2022-04-19,70055,70039,Blue,0,64210,65039,829
2022-08-03,70038,70060,Blue,1,77357,78532,1175
2022-01-02,70057,70043,Blue,0,64219,65053,834
2022-02-15,70058,70060,Blue,1,61824,61912,88
2022-07-07,70057,70053,Blue,0,57364,57515,151
2022-08-10,70053,70045,Blue,0,80141,80552,411
2022-03-03,70049,70047,Blue,0,56816,56874,58
2022-10-11,70042,70050,Blue,1,48839,49255,416
2022-12-01,70045,70838,Blue,0,44016,44350,334
2022-03-24,70051,70043,Blue,0,77527,78010,483
2022-09-05,70055,70051,Blue,0,32595,32729,134
2022-03-03,70042,70046,Blue,1,32525,32717,192
2022-05-08,70054,70060,Blue,1,80327,80582,255
2022-11-21,70047,70043,Blue,0,46778,47019,241
2022-03-03,70059,70043,Blue,0,71538,72413,875
2022-07-10,70054,70058,Blue,1,23931,24088,157
2022-09-12,70055,70043,Blue,0,65789,66485,696
2022-08-31,70044,70050,Blue,1,50474,50792,318
2022-05-05,70059,70049,Blue,0,69615,70091,476
2022-11-16,70059,70041,Blue,0,59295,60206,911
2022-05-20,70055,70041,Blue,0,69939,70725,786
2022-08-28,70059,70057,Blue,0,35549,35584,35
2022-09-21,70044,70060,Blue,1,48515,49458,943
2022-04-11,70059,70045,Blue,0,26975,27703,728
2022-04-12,70055,70051,Blue,0,79095,79237,142
2022-09-04,70055,70838,Blue,0,79747,80720,973
2022-11-21,70042,70046,Blue,1,29537,29720,183
2022-04-12,70059,70045,Blue,0,76036,76831,795
2022-11-25,70044,70052,Blue,1,32980,33481,501
2022-12-08,70047,70043,Blue,0,29881,30148,267
2022-10-17,70045,70041,Blue,0,65176,65346,170
2022-01-04,70055,70053,Blue,0,39660,39726,66
2022-12-17,70057,70043,Blue,0,41263,42081,818
2022-09-14,70038,70056,Blue,1,64308,65315,1007
2022-08-29,70040,70048,Blue,1,27384,27760,376
2022-08-01,70054,70058,Blue,1,39750,39966,216
2022-01-02,70051,70838,Blue,0,27297,27978,681
2022-03-13,70042,70054,Blue,1,48454,49047,593
2022-11-01,70047,70045,Blue,0,75904,76002,98
2022-01-04,70044,70048,Blue,1,85098,85353,255
2022-12-13,70048,70056,Blue,1,50451,50880,429
2022-09-23,70044,70058,Blue,1,25188,25984,796
2022-11-29,70039,70838,Blue,0,32462,32499,37
2022-03-29,70054,70058,Blue,1,83410,83573,163
2022-12-28,70041,70039,Blue,0,34584,34624,40
2022-08-05,70040,70056,Blue,1,54610,55481,871
2022-12-29,70042,70050,Blue,1,87150,87563,413
2022-09-21,70051,70039,Blue,0,67560,68215,655
2022-01-14,70047,70043,Blue,0,27601,27896,295
2022-04-18,70051,70049,Blue,0,31505,31631,126
2022-08-27,70052,70058,Blue,1,79370,79621,251
2022-01-03,70040,70060,Blue,1,25325,26458,1133
2022-01-06,70048,70050,Blue,1,74639,74699,60
2022-03-27,70048,70058,Blue,1,69867,70375,508
2022-01-25,70046,70056,Blue,1,67674,68177,503
2022-01-12,70054,70060,Blue,1,74944,75210,266
2022-03-07,70057,70049,Blue,0,33393,33807,414
2022-10-11,70053,70039,Blue,0,68439,69202,763
2022-01-14,70048,70054,Blue,1,63746,64061,315
2022-10-11,70046,70048,Blue,1,45965,46050,85
2022-02-25,70046,70054,Blue,1,53812,54299,487
2022-05-30,70040,70042,Blue,1,46576,46606,30
2022-07-23,70054,70058,Blue,1,44585,44736,151
2022-03-18,70059,70055,Blue,0,85750,85892,142
2022-04-25,70057,70053,Blue,0,88212,88364,152
2022-08-23,70042,70046,Blue,1,77663,77860,197
2022-05-19,70049,70838,Blue,0,68977,69750,773
2022-01-21,70052,70056,Blue,1,43252,43390,138
2022-12-28,70043,70838,Blue,0,35690,35881,191
2022-02-16,70043,70039,Blue,0,77682,77802,120
2022-12-12,70048,70050,Blue,1,63921,63979,58
2022-02-22,70057,70053,Blue,0,59966,60149,183
2022-08-18,70040,70060,Blue,1,76743,77850,1107
2022-09-30,70041,70039,Blue,0,71645,71681,36
2022-02-23,70042,70060,Blue,1,69129,70123,994
2022-08-01,70053,70049,Blue,0,40314,40570,256
2022-02-11,70053,70043,Blue,0,21981,22612,631
2022-03-22,70056,70060,Blue,1,61363,61629,266
2022-05-18,70051,70039,Blue,0,31285,32100,815
2022-12-15,70038,70060,Blue,1,76755,77799,1044
2022-10-12,70051,70049,Blue,0,24460,24562,102
2022-12-22,70051,70045,Blue,0,45693,46020,327
2022-12-18,70057,70055,Blue,0,67414,67483,69
2022-08-04,70046,70054,Blue,1,47183,47605,422
2022-07-15,70038,70054,Blue,1,36426,37278,852
2022-04-18,70052,70054,Blue,1,41669,41728,59
2022-03-25,70057,70039,Blue,0,43356,44554,1198
2022-07-18,70038,70054,Blue,1,31935,32808,873
2022-12-30,70038,70040,Blue,1,80705,80720,15
2022-01-12,70059,70045,Blue,0,24564,25300,736
2022-04-09,70055,70053,Blue,0,67215,67260,45
2022-04-06,70055,70043,Blue,0,84800,85496,696
2022-01-21,70048,70054,Blue,1,57961,58270,309
2022-01-06,70051,70041,Blue,0,32751,33330,579
2022-10-03,70059,70049,Blue,0,63990,64463,473
2022-06-26,70049,70838,Blue,0,45746,46385,639
2022-02-02,70052,70058,Blue,1,67809,68069,260
2022-07-28,70057,70039,Blue,0,85745,86613,868
2022-04-08,70042,70050,Blue,1,78209,78619,410
2022-04-13,70059,70043,Blue,0,76033,76991,958
2022-09-14,70059,70045,Blue,0,76454,77112,658
2022-03-20,70059,70045,Blue,0,38188,38883,695
2022-07-16,70042,70050,Blue,1,62897,63337,440
2022-07-08,70055,70049,Blue,0,35462,35799,337
2022-04-28,70057,70047,Blue,0,24759,25312,553
2022-01-29,70057,70045,Blue,0,36105,37045,940
2022-06-13,70052,70056,Blue,1,78914,79062,148
2022-02-28,70050,70058,Blue,1,35101,35510,409
2022-08-19,70052,70060,Blue,1,58819,59197,378
2022-03-19,70051,70043,Blue,0,26347,26834,487
2022-09-04,70054,70058,Blue,1,66945,67111,166
2022-07-06,70055,70051,Blue,0,66567,66709,142
2022-03-23,70048,70060,Blue,1,50882,51543,661
2022-12-30,70052,70056,Blue,1,58767,58895,128
2022-01-11,70047,70043,Blue,0,68153,68401,248
2022-05-17,70057,70053,Blue,0,84152,84308,156
2022-03-01,70053,70047,Blue,0,19116,19450,334
2022-09-03,70048,70058,Blue,1,88166,88732,566
2022-04-23,70055,70051,Blue,0,19710,19853,143
2022-11-09,70040,70052,Blue,1,58960,59643,683
2022-06-23,70057,70045,Blue,0,19609,20308,699
2022-03-04,70050,70060,Blue,1,37300,37808,508
2022-01-20,70046,70054,Blue,1,65570,65988,418
2022-10-03,70049,70041,Blue,0,29059,29545,486
2022-01-11,70056,70060,Blue,1,44000,44277,277
2022-02-21,70047,70043,Blue,0,48790,49058,268
2022-01-09,70057,70838,Blue,0,23915,24898,983
2022-08-24,70040,70044,Blue,1,65677,65798,121
2022-11-03,70038,70048,Blue,1,34875,35358,483
2022-01-17,70056,70058,Blue,1,43758,43831,73
2022-03-25,70042,70048,Blue,1,78741,79059,318
2022-10-01,70040,70050,Blue,1,40003,40507,504
2022-01-30,70059,70051,Blue,0,86418,86867,449
2022-03-04,70057,70045,Blue,0,52597,53249,652
2022-04-12,70051,70039,Blue,0,83262,83989,727
2022-12-24,70046,70054,Blue,1,88556,88968,412
2022-04-14,70040,70060,Blue,1,53141,54535,1394
2022-09-19,70040,70048,Blue,1,84206,84593,387
2022-02-23,70051,70047,Blue,0,80978,81175,197
2022-10-20,70038,70048,Blue,1,19999,20558,559
2022-03-28,70059,70041,Blue,0,63797,64665,868
2022-09-25,70049,70045,Blue,0,32986,33194,208
2022-03-11,70047,70041,Blue,0,58913,59232,319
2022-08-07,70057,70055,Blue,0,22346,22413,67
2022-10-01,70045,70039,Blue,0,75325,75563,238
2022-09-12,70053,70047,Blue,0,30847,31172,325
2022-09-01,70042,70054,Blue,1,32781,33390,609
2022-10-11,70044,70050,Blue,1,42079,42444,365
2022-09-13,70050,70052,Blue,1,57676,57786,110
2022-12-20,70059,70055,Blue,0,26244,26390,146
2022-07-15,70045,70838,Blue,0,65624,65998,374
2022-02-25,70051,70041,Blue,0,59133,59728,595
2022-03-14,70038,70048,Blue,1,87729,88254,525
2022-10-13,70058,70060,Blue,1,59890,59968,78
2022-04-19,70044,70050,Blue,1,64023,64401,378
2022-10-30,70038,70052,Blue,1,55905,56640,735
2022-03-17,70051,70043,Blue,0,78136,78618,482
2022-09-24,70046,70050,Blue,1,71661,71839,178
2022-03-03,70057,70049,Blue,0,33639,34060,421
2022-09-20,70042,70052,Blue,1,87500,88043,543
2022-05-19,70046,70054,Blue,1,67598,68091,493
2022-11-07,70040,70044,Blue,1,74770,74872,102
2022-06-28,70041,70039,Blue,0,87442,87472,30
2022-06-22,70055,70039,Blue,0,38677,39606,929
2022-12-22,70050,70058,Blue,1,52595,53039,444
2022-03-14,70038,70042,Blue,1,65838,65938,100
2022-03-29,70040,70042,Blue,1,68014,68049,35
2022-05-19,70038,70050,Blue,1,54560,55535,975
2022-05-11,70058,70060,Blue,1,44278,44344,66
2022-02-22,70042,70056,Blue,1,25915,26655,740
2022-09-07,70051,70041,Blue,0,30115,30769,654
2022-07-11,70053,70838,Blue,0,57001,57850,849
2022-07-10,70048,70058,Blue,1,73149,73685,536
2022-12-11,70056,70060,Blue,1,46527,46759,232
2022-12-22,70040,70060,Blue,1,61516,62558,1042
2022-01-21,70046,70052,Blue,1,86584,86941,357
2022-02-07,70054,70060,Blue,1,82439,82712,273
2022-01-06,70050,70054,Blue,1,23598,23790,192
2022-03-10,70051,70049,Blue,0,67228,67331,103
2022-04-11,70042,70058,Blue,1,27709,28615,906
2022-08-10,70048,70052,Blue,1,65320,65533,213
2022-01-11,70054,70060,Blue,1,72332,72598,266
2022-04-14,70057,70838,Blue,0,70034,71078,1044
2022-07-03,70053,70041,Blue,0,54648,55371,723
2022-03-21,70041,70838,Blue,0,23554,23685,131
2022-07-07,70040,70044,Blue,1,53466,53595,129
2022-08-06,70045,70838,Blue,0,55914,56264,350
2022-11-23,70049,70041,Blue,0,49924,50374,450
2022-09-30,70042,70050,Blue,1,55615,56093,478
2022-01-15,70046,70052,Blue,1,66779,67119,340
2022-07-14,70040,70050,Blue,1,66377,66934,557
2022-08-27,70048,70060,Blue,1,79808,80425,617
2022-12-11,70044,70060,Blue,1,55587,56493,906
2022-12-09,70048,70050,Blue,1,49177,49387,210
2022-11-08,70056,70060,Blue,1,83743,83923,180
2022-02-07,70042,70060,Blue,1,61471,62504,1033
2022-01-14,70057,70049,Blue,0,55761,56154,393
2022-04-11,70054,70058,Blue,1,57780,58047,267
2022-02-18,70048,70054,Blue,1,78495,78776,281
2022-03-04,70038,70040,Blue,1,64039,64057,18
2022-04-13,70049,70043,Blue,0,71019,71358,339
2022-03-06,70043,70041,Blue,0,56346,56374,28
2022-10-27,70040,70044,Blue,1,21488,21595,107
2022-08-14,70046,70048,Blue,1,26486,26565,79
2022-07-18,70057,70045,Blue,0,74980,75574,594
2022-12-20,70051,70045,Blue,0,41423,41767,344
2022-12-27,70048,70054,Blue,1,60347,60655,308
2022-12-31,70044,70060,Blue,1,87057,87955,898
2022-10-23,70042,70056,Blue,1,77079,77833,754
2022-12-20,70059,70047,Blue,0,55548,56128,580
2022-07-22,70038,70056,Blue,1,76587,77543,956
2022-06-14,70044,70046,Blue,1,42719,42858,139
2022-10-16,70040,70044,Blue,1,41719,41821,102
2022-06-26,70049,70043,Blue,0,74908,75293,385
2022-12-20,70059,70039,Blue,0,62505,63521,1016
2022-12-02,70046,70052,Blue,1,25571,25896,325
2022-04-16,70050,70060,Blue,1,56865,57406,541
2022-06-28,70048,70054,Blue,1,80851,81181,330
2022-01-20,70040,70056,Blue,1,21117,22027,910
2022-02-08,70039,70838,Blue,0,20035,20074,39
2022-01-25,70044,70052,Blue,1,57326,57834,508
2022-05-25,70046,70052,Blue,1,56438,56908,470
2022-07-19,70038,70060,Blue,1,73173,74344,1171
2022-02-03,70050,70056,Blue,1,67937,68277,340
2022-01-01,70053,70043,Blue,0,64460,65121,661
2022-09-23,70050,70056,Blue,1,20557,20861,304
2022-02-09,70045,70838,Blue,0,67765,68114,349
2022-06-30,70049,70041,Blue,0,69993,70466,473
2022-06-18,70046,70056,Blue,1,24321,24904,583
2022-09-04,70059,70039,Blue,0,30073,31070,997
2022-03-10,70055,70051,Blue,0,63669,63818,149
2022-02-07,70054,70056,Blue,1,58460,58508,48
2022-01-03,70038,70044,Blue,1,21852,22021,169
2022-12-16,70042,70060,Blue,1,66570,67569,999
2022-07-02,70057,70041,Blue,0,59008,59943,935
2022-12-23,70049,70043,Blue,0,65097,65440,343
2022-06-17,70047,70043,Blue,0,51686,51992,306
2022-09-19,70042,70052,Blue,1,44225,44783,558
2022-04-06,70045,70041,Blue,0,82472,82638,166
2022-03-31,70038,70060,Blue,1,35054,36298,1244
2022-11-10,70051,70838,Blue,0,73771,74507,736
2022-04-18,70042,70058,Blue,1,65703,66517,814
2022-11-25,70053,70047,Blue,0,29136,29412,276
2022-03-09,70038,70044,Blue,1,26357,26530,173
2022-01-23,70050,70054,Blue,1,44504,44750,246
2022-09-04,70050,70058,Blue,1,64576,64995,419
2022-07-06,70040,70052,Blue,1,40575,41361,786
2022-03-17,70048,70052,Blue,1,69687,69912,225
2022-02-22,70038,70040,Blue,1,21306,21328,22
2022-09-02,70045,70838,Blue,0,56954,57315,361
2022-09-22,70049,70039,Blue,0,64637,65199,562
2022-07-31,70038,70050,Blue,1,53708,54286,578
2022-08-26,70059,70057,Blue,0,38482,38517,35
2022-02-20,70042,70054,Blue,1,35679,36322,643
2022-09-21,70040,70060,Blue,1,74296,75340,1044
2022-10-04,70057,70041,Blue,0,59372,60225,853
2022-05-21,70044,70056,Blue,1,65179,65984,805
2022-09-30,70052,70054,Blue,1,43843,43904,61
2022-09-09,70057,70043,Blue,0,56939,57686,747
2022-02-09,70053,70039,Blue,0,65290,66122,832
2022-12-04,70044,70052,Blue,1,61355,61874,519
2022-03-20,70055,70045,Blue,0,27936,28436,500
2022-10-04,70041,70838,Blue,0,43279,43403,124
2022-03-21,70057,70043,Blue,0,70593,71427,834
2022-02-24,70043,70039,Blue,0,60663,60783,120
2022-07-05,70047,70039,Blue,0,44480,44944,464
2022-03-31,70049,70043,Blue,0,47101,47429,328
2022-02-22,70038,70042,Blue,1,30847,30940,93
2022-12-28,70044,70058,Blue,1,40534,41497,963
2022-03-07,70048,70052,Blue,1,43424,43620,196
2022-01-11,70040,70046,Blue,1,22814,23176,362
2022-02-23,70052,70058,Blue,1,65309,65633,324
2022-03-27,70055,70039,Blue,0,70767,71650,883
2022-10-29,70041,70039,Blue,0,25140,25183,43
2022-08-17,70044,70058,Blue,1,52965,53775,810
2022-05-14,70058,70060,Blue,1,71758,71828,70
2022-01-03,70038,70060,Blue,1,81526,82656,1130
2022-10-17,70059,70041,Blue,0,63616,64559,943
2022-01-17,70050,70060,Blue,1,22464,22984,520
2022-10-22,70042,70048,Blue,1,67645,67963,318
2022-12-08,70049,70043,Blue,0,65193,65532,339
2022-02-21,70042,70044,Blue,1,76234,76263,29
2022-02-01,70049,70047,Blue,0,59848,59907,59
2022-02-23,70057,70051,Blue,0,56480,56758,278
2022-08-14,70044,70046,Blue,1,29425,29535,110
2022-01-12,70040,70042,Blue,1,56601,56633,32
2022-03-17,70042,70048,Blue,1,27767,28099,332
2022-01-06,70057,70039,Blue,0,60884,61882,998
2022-07-15,70059,70057,Blue,0,34113,34149,36
2022-01-21,70048,70050,Blue,1,36169,36225,56
2022-12-30,70057,70039,Blue,0,32008,32879,871
2022-04-20,70053,70039,Blue,0,56860,57613,753
2022-06-09,70040,70058,Blue,1,49824,50794,970
2022-09-19,70042,70048,Blue,1,38650,39003,353
2022-09-24,70053,70049,Blue,0,64583,64827,244
2022-10-12,70054,70056,Blue,1,74426,74472,46
2022-02-27,70051,70049,Blue,0,23447,23550,103
2022-03-27,70049,70045,Blue,0,82693,82898,205
2022-03-08,70044,70058,Blue,1,80594,81398,804
2022-06-13,70055,70053,Blue,0,48408,48453,45
2022-08-20,70057,70053,Blue,0,64963,65114,151
2022-12-21,70038,70046,Blue,1,81778,82144,366
2022-10-07,70050,70052,Blue,1,50835,50974,139
2022-07-30,70038,70044,Blue,1,45312,45484,172
2022-02-22,70057,70043,Blue,0,47722,48553,831
2022-08-25,70041,70039,Blue,0,34175,34212,37
2022-06-21,70053,70041,Blue,0,23362,24139,777
2022-05-20,70040,70056,Blue,1,66568,67542,974
2022-05-20,70045,70838,Blue,0,21954,22364,410
2022-02-24,70044,70056,Blue,1,36428,37308,880
2022-09-30,70057,70838,Blue,0,69218,70242,1024
2022-07-14,70052,70058,Blue,1,51263,51521,258
2022-01-29,70057,70055,Blue,0,87914,88150,236
2022-10-07,70050,70054,Blue,1,21756,21979,223
2022-01-27,70053,70047,Blue,0,57767,58055,288
2022-10-01,70042,70046,Blue,1,87461,87665,204
2022-01-24,70045,70041,Blue,0,54669,54862,193
2022-04-12,70055,70051,Blue,0,68045,68171,126
2022-03-07,70040,70046,Blue,1,36316,36565,249
2022-01-29,70052,70060,Blue,1,65556,66497,941
2022-11-09,70059,70047,Blue,0,43581,44139,558
2022-03-18,70059,70039,Blue,0,66775,67816,1041
2022-05-03,70050,70054,Blue,1,87406,87627,221
2022-06-11,70056,70060,Blue,1,41938,42121,183
2022-06-01,70046,70048,Blue,1,42500,42602,102
2022-11-01,70054,70056,Blue,1,79347,79394,47
2022-07-07,70044,70056,Blue,1,50792,51704,912
2022-06-06,70041,70838,Blue,0,61747,61879,132
2022-04-21,70046,70056,Blue,1,54399,56652,2253
2022-01-02,70048,70054,Blue,1,47803,48126,323
2022-03-01,70049,70041,Blue,0,24737,25132,395
2022-01-05,70055,70053,Blue,0,27150,27212,62
2022-01-04,70053,70039,Blue,0,26971,27783,812
2022-06-26,70042,70048,Blue,1,54951,55308,357
2022-02-12,70040,70054,Blue,1,30795,31498,703
2022-10-27,70044,70060,Blue,1,51585,52501,916
2022-02-10,70046,70048,Blue,1,60252,60337,85
2022-05-08,70054,70060,Blue,1,44405,44678,273
2022-12-23,70050,70058,Blue,1,43033,43576,543
2022-12-27,70040,70060,Blue,1,65177,66150,973
2022-07-22,70055,70049,Blue,0,31607,31906,299
2022-07-02,70055,70043,Blue,0,37515,38160,645
2022-09-10,70052,70054,Blue,1,86412,86462,50
2022-11-30,70047,70041,Blue,0,35905,36212,307
2022-03-14,70044,70048,Blue,1,34976,35199,223
2022-03-10,70041,70039,Blue,0,23717,23754,37
2022-03-04,70051,70041,Blue,0,51057,51584,527
2022-07-31,70044,70052,Blue,1,56118,56627,509
2022-08-22,70050,70054,Blue,1,64735,64959,224
2022-03-27,70038,70050,Blue,1,34690,35185,495
2022-05-17,70053,70047,Blue,0,80524,80931,407
2022-10-04,70053,70039,Blue,0,60308,61063,755
2022-11-13,70058,70060,Blue,1,71500,71560,60
2022-12-26,70059,70041,Blue,0,54913,55777,864
2022-06-07,70038,70048,Blue,1,26714,27205,491
2022-10-24,70053,70041,Blue,0,23332,24062,730
2022-03-24,70055,70039,Blue,0,45131,45933,802
2022-06-09,70044,70060,Blue,1,38079,39027,948
2022-07-10,70055,70043,Blue,0,56720,57404,684
2022-06-11,70045,70838,Blue,0,42502,42872,370
2022-01-20,70042,70056,Blue,1,23481,24250,769
2022-01-03,70051,70049,Blue,0,84387,84490,103
2022-05-20,70040,70058,Blue,1,44266,45379,1113
2022-06-19,70049,70047,Blue,0,48957,49014,57
2022-07-13,70055,70838,Blue,0,70711,71728,1017
2022-04-15,70057,70047,Blue,0,74967,75440,473
2022-09-16,70038,70040,Blue,1,28212,28228,16
2022-03-01,70040,70060,Blue,1,48742,49719,977
2022-02-16,70042,70060,Blue,1,79958,80967,1009
2022-08-13,70038,70044,Blue,1,81372,81558,186
2022-07-01,70059,70047,Blue,0,41976,42546,570
2022-06-24,70055,70053,Blue,0,63672,63718,46
2022-10-20,70057,70047,Blue,0,79936,80396,460
2022-07-01,70050,70052,Blue,1,44184,44300,116
2022-11-02,70038,70044,Blue,1,42314,42506,192
2022-03-07,70046,70058,Blue,1,36614,37437,823
2022-11-16,70051,70047,Blue,0,48682,48877,195
2022-01-11,70059,70045,Blue,0,49761,50617,856
2022-01-06,70038,70050,Blue,1,37337,37882,545
2022-12-11,70059,70041,Blue,0,21493,22494,1001
2022-12-23,70049,70047,Blue,0,72288,72349,61
2022-09-22,70056,70058,Blue,1,32131,32233,102
2022-03-13,70051,70039,Blue,0,41198,41871,673
2022-04-05,70056,70058,Blue,1,79583,79663,80
2022-11-03,70040,70054,Blue,1,53666,54488,822
2022-07-07,70046,70054,Blue,1,40122,40672,550
2022-02-22,70045,70043,Blue,0,64890,65020,130
2022-03-27,70046,70056,Blue,1,58951,59511,560
2022-04-10,70059,70041,Blue,0,65175,66040,865
2022-02-18,70052,70056,Blue,1,77101,77238,137
2022-05-24,70048,70050,Blue,1,71999,72062,63
2022-10-27,70052,70054,Blue,1,63254,63309,55
2022-03-31,70052,70060,Blue,1,30381,30781,400
2022-04-21,70038,70056,Blue,1,76327,77258,931
2022-11-07,70051,70047,Blue,0,55463,55681,218
2022-09-30,70059,70039,Blue,0,35341,36358,1017
2022-02-05,70057,70838,Blue,0,34186,35203,1017
2022-05-13,70053,70051,Blue,0,79617,79677,60
2022-03-10,70046,70056,Blue,1,83505,84026,521
2022-06-15,70055,70049,Blue,0,33474,33799,325
2022-01-06,70053,70045,Blue,0,59594,60033,439
2022-07-30,70059,70039,Blue,0,70287,71333,1046
2022-01-28,70055,70047,Blue,0,84810,85206,396
2022-12-23,70048,70054,Blue,1,84466,84795,329
2022-01-04,70045,70039,Blue,0,22891,23129,238
2022-12-21,70044,70048,Blue,1,81077,81323,246
2022-08-24,70040,70058,Blue,1,32889,33896,1007
2022-02-28,70038,70046,Blue,1,78631,78992,361
2022-10-16,70053,70045,Blue,0,39754,40178,424
2022-02-19,70059,70043,Blue,0,28162,29112,950
2022-10-04,70045,70043,Blue,0,60554,60640,86
2022-05-20,70038,70052,Blue,1,57729,58509,780
2022-05-11,70056,70058,Blue,1,80518,80598,80
2022-02-12,70058,70060,Blue,1,27358,27423,65
2022-12-19,70051,70045,Blue,0,82775,83126,351
2022-12-06,70052,70056,Blue,1,30967,31106,139
2022-06-05,70040,70048,Blue,1,23769,24212,443
2022-05-20,70040,70050,Blue,1,33310,33927,617
2022-11-26,70050,70060,Blue,1,62137,62645,508
2022-09-12,70040,70054,Blue,1,78939,79692,753
2022-07-15,70043,70039,Blue,0,21343,21465,122
2022-10-08,70041,70838,Blue,0,72871,72982,111
2022-08-04,70040,70044,Blue,1,27834,27964,130
2022-06-11,70038,70048,Blue,1,39913,40416,503
2022-08-21,70055,70053,Blue,0,54565,54611,46
2022-03-01,70041,70039,Blue,0,55843,55875,32
2022-09-08,70059,70838,Blue,0,62315,64079,1764
2022-12-22,70043,70039,Blue,0,30668,30772,104
2022-07-05,70057,70043,Blue,0,82280,82999,719
2022-03-02,70038,70046,Blue,1,35209,35572,363
2022-08-25,70057,70047,Blue,0,29807,30335,528
2022-08-16,70052,70060,Blue,1,51779,52159,380
2022-01-02,70055,70047,Blue,0,52549,52952,403
2022-01-21,70041,70838,Blue,0,60145,60262,117
2022-04-10,70047,70039,Blue,0,57124,57535,411
2022-03-17,70056,70060,Blue,1,58977,59231,254
2022-02-25,70051,70043,Blue,0,57852,58336,484
2022-01-17,70055,70043,Blue,0,74870,75568,698
2022-04-25,70055,70051,Blue,0,77965,78102,137
2022-04-12,70041,70039,Blue,0,56698,56730,32
2022-12-29,70038,70060,Blue,1,64544,65765,1221
2022-07-11,70045,70041,Blue,0,32599,32815,216
2022-02-14,70055,70043,Blue,0,23916,24587,671
2022-07-19,70053,70838,Blue,0,55448,56400,952
2022-07-22,70059,70041,Blue,0,68885,70206,1321
2022-08-24,70040,70050,Blue,1,53232,53714,482
2022-02-19,70059,70838,Blue,0,79879,81002,1123
2022-12-18,70050,70058,Blue,1,68097,68554,457
2022-06-19,70045,70838,Blue,0,60025,60473,448
2022-11-10,70038,70050,Blue,1,81929,82595,666
2022-12-31,70047,70043,Blue,0,29854,30101,247
2022-07-16,70038,70050,Blue,1,33426,33948,522
2022-12-13,70057,70039,Blue,0,82986,83927,941
2022-01-20,70048,70060,Blue,1,57504,58112,608
2022-07-28,70049,70047,Blue,0,35488,35541,53
2022-03-23,70042,70058,Blue,1,86171,87059,888
2022-09-07,70056,70060,Blue,1,29873,30056,183
2022-03-28,70047,70045,Blue,0,40439,40529,90
2022-03-15,70040,70046,Blue,1,62600,62861,261
2022-04-04,70059,70041,Blue,0,37521,38555,1034
2022-08-17,70046,70054,Blue,1,50280,50778,498
2022-05-13,70050,70052,Blue,1,24032,24148,116
2022-10-13,70049,70047,Blue,0,22589,22655,66
2022-06-28,70050,70056,Blue,1,35711,36062,351
2022-03-16,70042,70050,Blue,1,60029,60472,443
2022-01-28,70046,70058,Blue,1,60485,61139,654
2022-01-28,70042,70052,Blue,1,20920,21531,611
2022-06-29,70051,70049,Blue,0,22393,22519,126
2022-08-05,70056,70060,Blue,1,88466,88649,183
2022-11-27,70048,70050,Blue,1,30479,30536,57
2022-02-11,70053,70043,Blue,0,47384,47938,554
2022-06-02,70038,70042,Blue,1,25583,25662,79
2022-05-20,70053,70047,Blue,0,28424,28721,297
2022-09-08,70057,70041,Blue,0,52294,53204,910
2022-04-22,70055,70838,Blue,0,76906,77829,923
2022-04-16,70051,70838,Blue,0,78149,78850,701
2022-11-02,70052,70056,Blue,1,29304,29447,143
2022-06-03,70049,70041,Blue,0,27989,28492,503
2022-01-26,70047,70043,Blue,0,33030,33316,286
2022-07-31,70047,70041,Blue,0,74948,75309,361
2022-02-01,70053,70039,Blue,0,44678,45500,822
2022-11-22,70047,70039,Blue,0,64723,65088,365
2022-09-17,70053,70838,Blue,0,21101,22007,906
2022-07-08,70057,70051,Blue,0,60190,60430,240
2022-01-08,70057,70051,Blue,0,57968,58236,268
2022-08-06,70051,70838,Blue,0,55518,56264,746
2022-02-25,70056,70060,Blue,1,66870,67106,236
2022-02-12,70058,70060,Blue,1,38376,38443,67
2022-01-20,70057,70049,Blue,0,67592,67974,382
2022-10-07,70053,70838,Blue,0,75163,75978,815
2022-07-21,70044,70054,Blue,1,33737,34374,637
2022-11-24,70057,70039,Blue,0,43529,44423,894
2022-12-26,70041,70039,Blue,0,72076,72112,36
2022-04-11,70057,70039,Blue,0,22493,23539,1046
2022-02-12,70045,70041,Blue,0,33272,33479,207
2022-01-12,70053,70051,Blue,0,45329,45379,50
2022-12-05,70042,70050,Blue,1,57781,58248,467
2022-04-05,70055,70049,Blue,0,59182,59487,305
2022-02-10,70057,70039,Blue,0,65677,66761,1084
2022-02-16,70057,70049,Blue,0,68550,68946,396
2022-12-31,70038,70050,Blue,1,66584,67101,517
2022-02-04,70040,70042,Blue,1,60140,60174,34
2022-11-19,70059,70047,Blue,0,41183,41717,534
2022-09-08,70046,70056,Blue,1,70070,70586,516
2022-06-16,70049,70045,Blue,0,39858,40099,241
2022-11-12,70043,70838,Blue,0,69822,70007,185
2022-02-09,70051,70043,Blue,0,72511,73055,544
2022-11-02,70038,70048,Blue,1,59602,60137,535
2022-01-13,70055,70041,Blue,0,30451,31308,857
2022-09-15,70053,70051,Blue,0,75347,75412,65
2022-05-31,70040,70046,Blue,1,55133,55461,328
2022-06-22,70055,70838,Blue,0,21617,22606,989
2022-08-04,70058,70060,Blue,1,47340,47409,69
2022-04-06,70049,70045,Blue,0,27757,27950,193
2022-01-01,70044,70048,Blue,1,30203,30413,210
2022-03-10,70057,70051,Blue,0,72693,72934,241
2022-06-15,70043,70041,Blue,0,34283,34311,28
2022-07-31,70057,70039,Blue,0,21611,22588,977
2022-03-21,70048,70050,Blue,1,66671,66728,57
2022-03-08,70045,70043,Blue,0,37876,37966,90
2022-03-09,70038,70044,Blue,1,70942,71141,199
2022-04-04,70038,70048,Blue,1,59536,60056,520
2022-12-14,70050,70060,Blue,1,24958,25494,536
2022-02-26,70041,70838,Blue,0,85094,85229,135
2022-11-01,70038,70050,Blue,1,47829,48406,577
2022-01-04,70040,70044,Blue,1,21212,21323,111
2022-04-02,70053,70838,Blue,0,83440,84238,798
2022-01-26,70051,70045,Blue,0,57254,57574,320
2022-03-16,70053,70838,Blue,0,33208,34044,836
2022-03-15,70042,70044,Blue,1,66328,66362,34
2022-01-22,70038,70054,Blue,1,44779,45573,794
2022-02-17,70049,70039,Blue,0,61574,62082,508
2022-02-25,70052,70058,Blue,1,22024,22294,270
2022-07-29,70045,70043,Blue,0,36811,36975,164
2022-01-06,70044,70050,Blue,1,54449,54782,333
2022-04-18,70044,70050,Blue,1,82799,83135,336
2022-08-02,70049,70041,Blue,0,43160,43602,442
2022-11-07,70057,70045,Blue,0,84298,84951,653
2022-12-29,70047,70041,Blue,0,35249,35558,309
2022-08-29,70049,70047,Blue,0,68553,68607,54
2022-02-08,70044,70058,Blue,1,63041,63832,791
2022-03-20,70052,70056,Blue,1,40564,40707,143
2022-09-11,70038,70056,Blue,1,65589,66484,895
2022-02-03,70040,70056,Blue,1,66153,67072,919
2022-12-06,70046,70052,Blue,1,62926,63276,350
2022-12-20,70048,70058,Blue,1,40458,41077,619
2022-04-28,70054,70058,Blue,1,67151,67310,159
2022-02-26,70057,70051,Blue,0,43883,44111,228
2022-11-19,70048,70056,Blue,1,44832,45209,377
2022-10-19,70053,70047,Blue,0,39294,39644,350
2022-07-25,70058,70060,Blue,1,51054,51130,76
2022-07-19,70046,70050,Blue,1,35329,35556,227
2022-02-15,70047,70838,Blue,0,59667,60172,505
2022-02-01,70038,70060,Blue,1,75893,77068,1175
2022-07-05,70054,70060,Blue,1,89935,90184,249
2022-01-01,70040,70044,Blue,1,73318,73434,116
2022-02-17,70040,70048,Blue,1,55401,55867,466
2022-12-30,70050,70056,Blue,1,40484,40803,319
2022-12-28,70053,70041,Blue,0,82074,82713,639
2022-10-27,70043,70838,Blue,0,25409,25610,201
2022-01-08,70055,70041,Blue,0,32716,33542,826
2022-08-17,70041,70039,Blue,0,69106,69136,30
2022-09-13,70049,70045,Blue,0,42650,42847,197
2022-02-18,70040,70056,Blue,1,60213,61097,884
2022-06-09,70038,70046,Blue,1,85448,85800,352
2022-01-19,70059,70057,Blue,0,36374,36443,69
2022-07-24,70038,70044,Blue,1,75852,76016,164
2022-07-12,70043,70039,Blue,0,78331,78427,96
2022-09-09,70044,70050,Blue,1,42377,42719,342
2022-11-12,70055,70051,Blue,0,52652,52802,150
2022-11-06,70038,70042,Blue,1,34686,34781,95
2022-12-26,70044,70048,Blue,1,77697,77933,236
2022-10-21,70053,70838,Blue,0,47542,48360,818
2022-02-14,70038,70042,Blue,1,64937,65040,103
2022-11-05,70049,70045,Blue,0,31386,31576,190
2022-09-11,70050,70052,Blue,1,35300,35415,115
2022-01-13,70038,70042,Blue,1,56665,56768,103
2022-03-29,70057,70053,Blue,0,19951,20107,156
2022-02-19,70042,70050,Blue,1,69204,69622,418
2022-09-24,70038,70052,Blue,1,27507,28189,682
2022-06-11,70042,70056,Blue,1,63821,64613,792
2022-05-29,70050,70052,Blue,1,80220,80408,188
2022-10-09,70040,70048,Blue,1,36311,36679,368
2022-12-26,70049,70838,Blue,0,63524,64094,570
2022-03-07,70049,70039,Blue,0,62244,62791,547
2022-08-29,70044,70056,Blue,1,55197,55860,663
2022-01-05,70042,70052,Blue,1,24103,24695,592
2022-04-09,70053,70045,Blue,0,58119,58551,432
2022-01-04,70042,70060,Blue,1,58496,59521,1025
2022-10-01,70051,70041,Blue,0,43129,43726,597
2022-03-05,70055,70053,Blue,0,26716,26761,45
2022-07-04,70046,70052,Blue,1,76040,76365,325
2022-04-23,70057,70049,Blue,0,70355,70748,393
2022-03-08,70059,70047,Blue,0,65594,66158,564
2022-07-04,70046,70060,Blue,1,32793,33559,766
2022-12-14,70057,70039,Blue,0,54156,55125,969
2022-03-13,70056,70058,Blue,1,76753,76823,70
2022-02-26,70042,70052,Blue,1,27096,27659,563
2022-02-22,70038,70040,Blue,1,89166,89180,14
2022-07-27,70049,70039,Blue,0,77971,78498,527
2022-09-20,70048,70052,Blue,1,50319,50519,200
2022-11-06,70051,70043,Blue,0,87656,88139,483
2022-05-26,70047,70045,Blue,0,79457,79554,97
2022-04-06,70040,70046,Blue,1,32406,32649,243
2022-11-07,70042,70050,Blue,1,52754,53274,520
2022-04-29,70053,70049,Blue,0,75267,75484,217
2022-09-01,70042,70058,Blue,1,52221,53000,779
2022-02-17,70053,70838,Blue,0,36694,37761,1067
2022-10-22,70040,70052,Blue,1,33484,34080,596
2022-12-22,70049,70045,Blue,0,79745,79949,204
2022-11-30,70057,70053,Blue,0,29259,29420,161
2022-01-26,70042,70048,Blue,1,22899,23218,319
2022-05-19,70057,70039,Blue,0,62087,63163,1076
2022-06-16,70054,70058,Blue,1,90109,90260,151
2022-10-14,70048,70056,Blue,1,54041,54417,376
2022-09-11,70052,70054,Blue,1,76044,76100,56
2022-10-23,70042,70054,Blue,1,53895,54541,646
2022-08-17,70059,70043,Blue,0,45254,46456,1202
2022-08-21,70049,70045,Blue,0,81385,81595,210
2022-04-19,70046,70060,Blue,1,29400,30356,956
2022-02-22,70044,70054,Blue,1,69228,69842,614
2022-04-08,70042,70060,Blue,1,66322,67642,1320
2022-01-15,70044,70052,Blue,1,42814,43319,505
2022-07-08,70048,70060,Blue,1,54697,55312,615
2022-07-14,70057,70838,Blue,0,52174,53298,1124
2022-07-27,70046,70058,Blue,1,81356,82003,647
2022-07-17,70051,70045,Blue,0,55336,55686,350
2022-12-13,70038,70050,Blue,1,58259,58880,621
2022-02-25,70047,70039,Blue,0,74962,75371,409
2022-09-26,70038,70058,Blue,1,44752,45768,1016
2022-08-11,70051,70039,Blue,0,38556,39267,711
2022-06-18,70057,70047,Blue,0,34722,35206,484
2022-01-09,70055,70053,Blue,0,22464,22515,51
2022-10-29,70042,70056,Blue,1,20007,20749,742
2022-07-29,70059,70838,Blue,0,36385,37543,1158
2022-05-25,70042,70044,Blue,1,62416,62452,36
2022-06-02,70047,70039,Blue,0,67948,68399,451
2022-09-23,70043,70041,Blue,0,86932,86961,29
2022-12-27,70041,70838,Blue,0,23816,23986,170
2022-08-15,70055,70838,Blue,0,67766,68635,869
2022-09-18,70040,70048,Blue,1,29288,29720,432
2022-09-06,70049,70041,Blue,0,50922,51355,433
2022-01-05,70038,70050,Blue,1,27563,28167,604
2022-10-30,70044,70052,Blue,1,24774,25262,488
2022-01-24,70057,70055,Blue,0,31227,31311,84
2022-04-05,70049,70047,Blue,0,53373,53432,59
2022-05-30,70043,70039,Blue,0,68100,68231,131
2022-10-30,70057,70053,Blue,0,38907,39054,147
2022-04-08,70042,70050,Blue,1,25012,25439,427
2022-07-07,70049,70039,Blue,0,25304,25843,539
2022-01-19,70038,70040,Blue,1,37697,37716,19
2022-03-01,70059,70039,Blue,0,85759,86808,1049
2022-08-01,70055,70039,Blue,0,60204,61071,867
2022-09-30,70040,70048,Blue,1,55849,56271,422
2022-08-12,70059,70051,Blue,0,20842,21188,346
2022-02-15,70042,70056,Blue,1,53185,54069,884
2022-12-01,70042,70048,Blue,1,77476,77777,301
2022-03-16,70055,70047,Blue,0,76234,76684,450
2022-02-22,70050,70056,Blue,1,85006,85309,303
2022-03-23,70043,70041,Blue,0,86024,86052,28
2022-09-30,70057,70055,Blue,0,50708,50777,69
2022-09-27,70053,70838,Blue,0,56445,57305,860
2022-04-22,70048,70058,Blue,1,66896,67399,503
2022-08-03,70042,70046,Blue,1,35981,36151,170
2022-06-03,70047,70838,Blue,0,70860,71398,538
2022-06-17,70042,70054,Blue,1,37495,38248,753
2022-03-25,70051,70047,Blue,0,26115,26309,194
2022-04-08,70051,70043,Blue,0,70534,71018,484
2022-02-20,70059,70041,Blue,0,32414,33374,960
2022-12-18,70054,70058,Blue,1,62734,62893,159
2022-11-15,70044,70054,Blue,1,71800,72362,562
2022-03-09,70042,70054,Blue,1,83403,84092,689
2022-08-12,70056,70058,Blue,1,32894,32965,71
2022-10-18,70059,70047,Blue,0,43218,43830,612
2022-12-28,70049,70838,Blue,0,33588,34217,629
2022-02-18,70059,70043,Blue,0,85837,86661,824
2022-03-25,70040,70056,Blue,1,82039,82981,942
2022-09-22,70053,70838,Blue,0,47553,48469,916
2022-03-09,70059,70041,Blue,0,40937,41937,1000
2022-04-05,70057,70039,Blue,0,65372,66297,925
2022-12-06,70051,70047,Blue,0,45094,45296,202
2022-06-04,70049,70043,Blue,0,80172,80579,407
2022-01-21,70048,70060,Blue,1,55039,55744,705
2022-06-24,70040,70044,Blue,1,56349,56469,120
2022-07-01,70053,70043,Blue,0,31292,31917,625
2022-08-19,70045,70041,Blue,0,43220,43427,207
2022-04-19,70053,70051,Blue,0,63691,63754,63
2022-11-16,70040,70046,Blue,1,71723,71968,245
2022-01-03,70057,70049,Blue,0,72164,72580,416
2022-07-19,70055,70049,Blue,0,86026,86290,264
2022-08-01,70052,70058,Blue,1,74399,74645,246
2022-12-05,70046,70058,Blue,1,42956,43640,684
2022-05-26,70045,70041,Blue,0,85038,85220,182
2022-03-10,70051,70047,Blue,0,84966,85161,195
2022-08-14,70055,70051,Blue,0,50248,50385,137
2022-02-28,70048,70052,Blue,1,48052,48259,207
2022-05-19,70048,70060,Blue,1,75405,76013,608
2022-02-02,70044,70056,Blue,1,30464,31121,657
2022-03-23,70044,70048,Blue,1,36009,36313,304
2022-12-09,70042,70046,Blue,1,63964,64154,190
2022-06-09,70057,70045,Blue,0,76731,77382,651
2022-02-17,70050,70054,Blue,1,52649,52921,272
2022-03-16,70057,70051,Blue,0,71070,71304,234
2022-01-14,70059,70057,Blue,0,58094,58130,36
2022-01-27,70059,70039,Blue,0,42204,43175,971
2022-05-21,70040,70052,Blue,1,71565,72326,761
2022-03-28,70047,70041,Blue,0,31292,31661,369
2022-09-08,70053,70041,Blue,0,62177,62971,794
2022-03-09,70041,70039,Blue,0,46643,46679,36
2022-02-10,70038,70048,Blue,1,44779,45309,530
2022-12-12,70038,70052,Blue,1,52866,53543,677
2022-12-15,70059,70053,Blue,0,29594,29850,256
2022-03-30,70048,70060,Blue,1,30512,31171,659
2022-12-24,70047,70041,Blue,0,70339,70630,291
2022-07-25,70040,70056,Blue,1,32011,32913,902
2022-09-26,70053,70041,Blue,0,55355,56039,684
2022-12-14,70054,70056,Blue,1,82341,82388,47
2022-07-28,70046,70056,Blue,1,54110,54659,549
2022-11-11,70055,70041,Blue,0,52752,53559,807
2022-02-06,70038,70044,Blue,1,33915,34075,160
2022-11-18,70040,70042,Blue,1,64385,64418,33
2022-09-01,70056,70060,Blue,1,34548,34721,173
2022-01-23,70056,70058,Blue,1,42005,42076,71
2022-07-09,70053,70045,Blue,0,33298,33760,462
2022-01-21,70046,70060,Blue,1,22323,23240,917
2022-10-20,70059,70041,Blue,0,19514,20554,1040
2022-12-30,70042,70054,Blue,1,26011,26660,649
2022-01-20,70059,70838,Blue,0,60194,61296,1102
2022-06-04,70045,70838,Blue,0,26394,26780,386
2022-02-02,70051,70049,Blue,0,57776,57880,104
2022-08-29,70038,70044,Blue,1,41657,41836,179
2022-02-11,70047,70041,Blue,0,21590,21966,376
2022-01-12,70046,70060,Blue,1,42873,43648,775
2022-01-01,70055,70041,Blue,0,41009,41816,807
2022-02-04,70045,70041,Blue,0,76295,76450,155
2022-04-08,70046,70056,Blue,1,27031,27570,539
2022-01-27,70059,70049,Blue,0,23415,23964,549
2022-08-08,70055,70051,Blue,0,61600,61789,189
2022-10-11,70044,70058,Blue,1,56740,57538,798
2022-03-20,70047,70039,Blue,0,39424,39856,432
2022-11-15,70057,70039,Blue,0,59473,60517,1044
2022-04-06,70046,70058,Blue,1,60105,60746,641
2022-06-16,70040,70048,Blue,1,33409,33921,512
2022-06-18,70057,70039,Blue,0,26082,27129,1047
2022-02-09,70054,70056,Blue,1,52800,52847,47
2022-11-25,70054,70060,Blue,1,41375,41703,328
2022-09-23,70056,70060,Blue,1,58848,59038,190
2022-12-28,70051,70049,Blue,0,54261,54361,100
2022-12-22,70041,70838,Blue,0,65743,65974,231
2022-06-27,70057,70055,Blue,0,23493,23561,68
2022-12-20,70040,70050,Blue,1,63260,63803,543
2022-12-30,70051,70049,Blue,0,61777,61881,104
2022-09-07,70059,70047,Blue,0,33923,34560,637
2022-08-21,70038,70052,Blue,1,84604,85328,724
2022-01-18,70059,70047,Blue,0,47115,47668,553
2022-12-18,70057,70041,Blue,0,30926,31709,783
2022-08-01,70057,70053,Blue,0,73880,74027,147
2022-12-08,70042,70054,Blue,1,56754,57569,815
2022-11-13,70042,70044,Blue,1,33276,33304,28
2022-09-07,70057,70039,Blue,0,29806,30865,1059
2022-09-11,70038,70056,Blue,1,88221,89060,839
2022-12-21,70049,70039,Blue,0,51350,51789,439
2022-12-17,70053,70047,Blue,0,32330,32676,346
2022-03-03,70040,70054,Blue,1,30472,31293,821
2022-01-28,70044,70052,Blue,1,52973,53504,531
2022-02-01,70051,70045,Blue,0,59966,60286,320
2022-04-16,70040,70050,Blue,1,55151,55670,519
2022-02-23,70053,70045,Blue,0,36117,36586,469
2022-10-28,70056,70060,Blue,1,57970,58270,300
2022-12-08,70045,70838,Blue,0,60680,60987,307
2022-06-14,70057,70045,Blue,0,21061,21735,674
2022-08-14,70046,70054,Blue,1,52527,53010,483
2022-06-10,70055,70047,Blue,0,61413,61815,402
2022-04-23,70042,70056,Blue,1,48732,49526,794
2022-12-13,70047,70045,Blue,0,75572,75677,105
2022-12-24,70050,70054,Blue,1,80558,80776,218
2022-01-09,70055,70045,Blue,0,77243,77802,559
2022-09-01,70059,70045,Blue,0,25938,26670,732
2022-04-19,70054,70058,Blue,1,78422,78582,160
2022-12-26,70038,70042,Blue,1,77476,77579,103
2022-06-24,70055,70047,Blue,0,55779,56150,371
2022-11-15,70048,70054,Blue,1,62422,62804,382
2022-04-04,70046,70048,Blue,1,59960,60056,96
2022-06-20,70047,70039,Blue,0,60639,61056,417
2022-02-02,70046,70048,Blue,1,79032,79117,85
2022-01-13,70040,70054,Blue,1,50350,51075,725
2022-02-23,70057,70051,Blue,0,74981,75241,260
2022-02-25,70043,70039,Blue,0,23462,23581,119
2022-07-10,70052,70058,Blue,1,49635,49910,275
2022-03-03,70038,70042,Blue,1,59230,59337,107
2022-10-02,70040,70046,Blue,1,75360,75592,232
2022-07-23,70051,70043,Blue,0,42021,42545,524
2022-03-01,70059,70049,Blue,0,79453,79895,442
2022-11-09,70044,70058,Blue,1,42653,43606,953
2022-08-31,70045,70838,Blue,0,47571,47917,346
2022-03-23,70042,70056,Blue,1,61836,62744,908
2022-11-28,70057,70051,Blue,0,54174,54437,263
2022-06-01,70038,70048,Blue,1,22395,22901,506
2022-12-22,70059,70055,Blue,0,34289,34437,148
2022-04-05,70050,70052,Blue,1,20634,20778,144
2022-11-17,70038,70046,Blue,1,63070,63421,351
2022-07-30,70044,70060,Blue,1,61758,62697,939
2022-11-16,70042,70050,Blue,1,52165,52570,405
2022-09-01,70042,70052,Blue,1,23462,24010,548
2022-10-25,70040,70052,Blue,1,47200,47831,631
2022-03-15,70055,70047,Blue,0,29273,29689,416
2022-08-24,70042,70050,Blue,1,51445,51848,403
2022-11-07,70048,70054,Blue,1,25867,26173,306
2022-03-30,70038,70044,Blue,1,25207,25419,212
2022-08-13,70040,70044,Blue,1,60487,60604,117
2022-07-01,70048,70052,Blue,1,54312,54530,218
2022-07-11,70055,70045,Blue,0,55934,56444,510
2022-08-17,70055,70049,Blue,0,29434,29719,285
2022-08-30,70054,70058,Blue,1,41863,42020,157
2022-02-12,70050,70058,Blue,1,48705,49149,444
2022-12-03,70055,70049,Blue,0,21031,21336,305
2022-08-25,70038,70060,Blue,1,79022,80197,1175
2022-11-27,70050,70054,Blue,1,64613,64823,210
2022-04-12,70043,70041,Blue,0,31232,31263,31
2022-09-09,70048,70060,Blue,1,27985,28620,635
2022-03-24,70051,70047,Blue,0,83320,83551,231
2022-11-01,70039,70838,Blue,0,47357,47392,35
2022-06-14,70042,70044,Blue,1,27797,27830,33
2022-11-22,70047,70838,Blue,0,26492,27040,548
2022-12-05,70059,70041,Blue,0,62899,63849,950
2022-06-17,70050,70054,Blue,1,61212,61546,334
2022-07-18,70051,70838,Blue,0,52927,53711,784
2022-05-10,70051,70047,Blue,0,43327,43530,203
2022-02-24,70049,70041,Blue,0,24189,24665,476
2022-09-20,70051,70838,Blue,0,42990,43806,816
2022-01-12,70047,70039,Blue,0,47306,47715,409
2022-12-24,70047,70045,Blue,0,66186,66287,101
2022-10-19,70053,70051,Blue,0,39988,40048,60
2022-11-18,70053,70045,Blue,0,63117,63647,530
2022-06-08,70038,70040,Blue,1,85209,85228,19
2022-01-25,70055,70047,Blue,0,64583,64989,406
2022-08-15,70054,70060,Blue,1,69299,69578,279
2022-08-17,70057,70049,Blue,0,71322,71721,399
2022-12-16,70053,70051,Blue,0,74081,74129,48
2022-09-19,70051,70045,Blue,0,54968,55343,375
2022-02-20,70059,70041,Blue,0,58174,59185,1011
2022-10-05,70055,70049,Blue,0,83918,84193,275
2022-10-04,70048,70056,Blue,1,22262,22647,385
2022-09-17,70049,70045,Blue,0,44833,45057,224
2022-01-27,70059,70053,Blue,0,44958,45186,228
2022-03-24,70056,70060,Blue,1,30215,30455,240
2022-09-05,70057,70045,Blue,0,46347,47069,722
2022-08-19,70053,70838,Blue,0,80161,80996,835
2022-08-19,70051,70045,Blue,0,58207,58550,343
2022-04-18,70045,70039,Blue,0,45157,45396,239
2022-10-07,70051,70041,Blue,0,71040,71573,533
2022-08-07,70038,70056,Blue,1,61538,62494,956
2022-10-01,70048,70060,Blue,1,42550,43195,645
2022-04-06,70047,70041,Blue,0,37640,38151,511
2022-08-27,70045,70838,Blue,0,82380,82722,342
2022-07-11,70051,70039,Blue,0,45086,45758,672
2022-11-08,70040,70046,Blue,1,51427,51677,250
2022-01-21,70043,70039,Blue,0,28050,28173,123
2022-09-21,70051,70838,Blue,0,75257,76005,748
2022-07-02,70059,70047,Blue,0,35714,36274,560
2022-11-04,70040,70060,Blue,1,53526,54656,1130
2022-04-04,70053,70838,Blue,0,77448,78238,790
2022-06-15,70044,70054,Blue,1,27840,28443,603
2022-03-25,70038,70046,Blue,1,51188,51520,332
2022-10-02,70057,70051,Blue,0,62012,62295,283
2022-04-01,70042,70058,Blue,1,65684,66877,1193
2022-12-30,70050,70060,Blue,1,55506,55983,477
2022-08-03,70040,70060,Blue,1,53971,55094,1123
2022-06-08,70049,70838,Blue,0,30812,31502,690
2022-01-20,70047,70041,Blue,0,24789,25207,418
2022-03-16,70059,70838,Blue,0,72030,73039,1009
2022-06-15,70047,70041,Blue,0,66739,67071,332
2022-11-01,70057,70051,Blue,0,19640,19983,343
2022-08-15,70056,70060,Blue,1,57457,57628,171
2022-09-15,70042,70046,Blue,1,76668,76856,188
2022-12-28,70040,70056,Blue,1,77124,77882,758
2022-04-20,70038,70044,Blue,1,28209,28394,185
2022-05-20,70053,70047,Blue,0,68181,68459,278
2022-05-29,70050,70052,Blue,1,77775,77956,181
2022-07-08,70059,70055,Blue,0,23654,23809,155
2022-08-01,70050,70060,Blue,1,29768,30375,607
2022-01-09,70051,70049,Blue,0,41826,41928,102
2022-04-15,70045,70041,Blue,0,30828,31009,181
2022-02-07,70052,70056,Blue,1,28472,28618,146
2022-02-13,70050,70054,Blue,1,78059,78254,195
2022-01-21,70051,70047,Blue,0,84993,85191,198
2022-12-31,70056,70058,Blue,1,60250,60320,70
2022-11-09,70044,70052,Blue,1,74377,74852,475
2022-02-03,70043,70039,Blue,0,53745,53853,108
2022-07-07,70059,70041,Blue,0,42154,43230,1076
2022-01-26,70038,70044,Blue,1,20778,20959,181
2022-02-25,70042,70046,Blue,1,22312,22505,193
2022-01-08,70043,70039,Blue,0,30636,30742,106
2022-03-31,70044,70058,Blue,1,25965,26743,778
2022-04-23,70042,70054,Blue,1,31943,32671,728
2022-11-16,70055,70047,Blue,0,21946,22387,441
2022-01-28,70042,70052,Blue,1,87901,88498,597
2022-04-17,70051,70047,Blue,0,59615,59807,192
2022-03-28,70044,70054,Blue,1,32002,32680,678
2022-04-04,70042,70058,Blue,1,72114,72975,861
2022-11-27,70053,70043,Blue,0,42449,43075,626
2022-09-23,70047,70039,Blue,0,52903,53295,392
2022-02-07,70049,70043,Blue,0,54155,54532,377
2022-06-23,70042,70050,Blue,1,82832,83279,447
2022-11-03,70038,70042,Blue,1,72076,72180,104
2022-01-06,70046,70054,Blue,1,70327,70749,422
2022-01-13,70057,70051,Blue,0,55763,56018,255
2022-05-20,70053,70047,Blue,0,52447,52735,288
2022-06-22,70048,70054,Blue,1,68321,68634,313
2022-12-01,70038,70058,Blue,1,26182,27210,1028
2022-12-14,70054,70056,Blue,1,61087,61134,47
2022-12-26,70038,70058,Blue,1,81666,82673,1007
2022-12-25,70040,70046,Blue,1,29314,29560,246
2022-12-30,70040,70048,Blue,1,52847,53268,421
2022-09-18,70054,70060,Blue,1,48044,48295,251
2022-09-23,70044,70054,Blue,1,73000,73613,613
2022-06-15,70059,70043,Blue,0,69543,70419,876
2022-02-18,70046,70052,Blue,1,44507,44856,349
2022-02-28,70040,70042,Blue,1,51696,51728,32
2022-06-17,70047,70041,Blue,0,77759,78092,333
2022-10-02,70059,70049,Blue,0,36196,36656,460
2022-03-22,70051,70041,Blue,0,66880,67438,558
2022-05-27,70047,70045,Blue,0,21848,21950,102
2022-10-25,70057,70053,Blue,0,75983,76130,147
2022-11-29,70042,70054,Blue,1,29624,30301,677
2022-04-13,70052,70056,Blue,1,25419,25576,157
2022-04-05,70058,70060,Blue,1,28981,29047,66
2022-07-26,70051,70043,Blue,0,70070,70548,478
2022-07-16,70040,70060,Blue,1,32605,33752,1147
2022-02-28,70057,70055,Blue,0,70049,70118,69
2022-06-20,70051,70041,Blue,0,37079,37660,581
2022-07-28,70048,70056,Blue,1,45623,46043,420
2022-04-08,70038,70050,Blue,1,69906,70415,509
2022-10-05,70052,70060,Blue,1,57670,58031,361
2022-11-10,70038,70058,Blue,1,76745,77674,929
2022-07-02,70043,70039,Blue,0,70660,70761,101
2022-05-27,70039,70838,Blue,0,54089,54121,32
2022-03-08,70057,70055,Blue,0,81832,81902,70
2022-02-27,70051,70049,Blue,0,35113,35215,102
2022-01-19,70052,70060,Blue,1,29426,29873,447
2022-04-09,70055,70051,Blue,0,59658,59780,122
2022-08-12,70054,70056,Blue,1,80000,80047,47
2022-12-04,70043,70039,Blue,0,89174,89612,438
2022-11-28,70051,70043,Blue,0,22829,23328,499
2022-04-05,70038,70052,Blue,1,67947,68674,727
2022-08-16,70044,70056,Blue,1,79880,80538,658
2022-02-17,70043,70838,Blue,0,51816,52026,210
2022-07-20,70051,70045,Blue,0,84503,84844,341
2022-12-27,70057,70041,Blue,0,82466,83264,798
2022-03-26,70052,70054,Blue,1,42899,42960,61
2022-10-19,70055,70045,Blue,0,59933,60438,505
2022-03-31,70038,70058,Blue,1,33252,34352,1100
2022-03-18,70044,70048,Blue,1,52380,52618,238
2022-08-10,70059,70041,Blue,0,69673,70597,924
2022-10-22,70038,70052,Blue,1,61004,61761,757
2022-01-28,70055,70051,Blue,0,86494,86673,179
2022-09-07,70040,70058,Blue,1,81993,82911,918
2022-12-08,70040,70060,Blue,1,58353,59514,1161
2022-03-24,70042,70058,Blue,1,89297,90116,819
2022-01-22,70059,70055,Blue,0,52473,52620,147
2022-09-30,70053,70041,Blue,0,58488,59147,659
2022-02-02,70038,70058,Blue,1,31790,32903,1113
2022-01-26,70048,70058,Blue,1,79643,80193,550
2022-03-08,70044,70060,Blue,1,56154,57155,1001
2022-08-03,70040,70052,Blue,1,78911,79507,596
2022-01-19,70057,70043,Blue,0,32949,33770,821
2022-10-13,70057,70838,Blue,0,70766,71741,975
2022-06-09,70042,70058,Blue,1,33816,34782,966
2022-12-25,70048,70058,Blue,1,86926,87448,522
2022-01-03,70044,70058,Blue,1,35270,36224,954
2022-08-14,70045,70039,Blue,0,43559,43808,249
2022-09-10,70038,70054,Blue,1,68043,68924,881
2022-11-06,70040,70056,Blue,1,82504,83643,1139
2022-09-24,70038,70040,Blue,1,21025,21042,17
2022-01-06,70055,70045,Blue,0,62188,62742,554
2022-03-14,70040,70046,Blue,1,38583,38892,309
2022-02-01,70042,70056,Blue,1,68755,69623,868
2022-11-22,70050,70058,Blue,1,65763,66151,388
2022-12-29,70045,70041,Blue,0,67038,67205,167
2022-11-12,70046,70060,Blue,1,43501,44197,696
2022-03-24,70043,70838,Blue,0,53449,53641,192
2022-05-20,70044,70050,Blue,1,57664,58067,403
2022-10-15,70040,70054,Blue,1,70792,71500,708
2022-02-02,70055,70045,Blue,0,21274,21900,626
2022-01-13,70045,70039,Blue,0,87698,87964,266
2022-02-28,70038,70048,Blue,1,74052,74502,450
2022-07-22,70040,70042,Blue,1,67249,67281,32
2022-08-03,70057,70051,Blue,0,25191,25455,264
2022-11-20,70049,70043,Blue,0,36800,37154,354
2022-07-06,70038,70056,Blue,1,63633,64588,955
2022-12-19,70056,70060,Blue,1,71424,71612,188
2022-12-09,70040,70058,Blue,1,49870,50977,1107
2022-08-09,70051,70039,Blue,0,35753,36507,754
2022-02-16,70052,70056,Blue,1,23558,23703,145
2022-10-11,70046,70052,Blue,1,65782,66114,332
2022-06-09,70043,70039,Blue,0,59699,59818,119
2022-04-26,70053,70051,Blue,0,45591,45654,63
2022-12-05,70055,70838,Blue,0,51662,52530,868
2022-07-10,70042,70044,Blue,1,52221,52250,29
2022-04-07,70051,70039,Blue,0,27939,28603,664
2022-07-13,70049,70041,Blue,0,24932,25521,589
2022-12-29,70057,70043,Blue,0,22892,23636,744
2022-03-15,70038,70046,Blue,1,23129,23470,341
2022-04-08,70053,70039,Blue,0,64732,65423,691
2022-02-06,70049,70043,Blue,0,73812,74170,358
2022-11-04,70042,70060,Blue,1,83591,84898,1307
2022-07-15,70050,70056,Blue,1,56631,56951,320
2022-08-02,70040,70046,Blue,1,52151,52398,247
2022-11-27,70055,70053,Blue,0,30954,31000,46
2022-02-08,70059,70043,Blue,0,22406,23399,993
2022-02-11,70059,70053,Blue,0,32357,32588,231
2022-03-04,70044,70052,Blue,1,45514,45977,463
2022-03-25,70059,70838,Blue,0,33258,34446,1188
2022-10-23,70051,70047,Blue,0,36599,36796,197
2022-07-09,70059,70057,Blue,0,76149,76185,36
2022-01-26,70057,70838,Blue,0,28841,29997,1156
2022-10-15,70044,70054,Blue,1,54174,54757,583
2022-11-20,70049,70045,Blue,0,53294,53500,206
2022-07-30,70047,70045,Blue,0,75181,75287,106
2022-09-19,70043,70041,Blue,0,27068,27098,30
2022-01-28,70048,70056,Blue,1,36235,36704,469
2022-04-23,70038,70054,Blue,1,85513,86473,960
2022-07-25,70055,70043,Blue,0,52893,53655,762
2022-08-25,70051,70039,Blue,0,26748,27450,702
2022-03-30,70047,70045,Blue,0,40445,40532,87
2022-11-19,70050,70056,Blue,1,81242,81538,296
2022-07-29,70057,70043,Blue,0,68141,68927,786
2022-02-11,70051,70049,Blue,0,46514,46618,104
2022-08-27,70046,70054,Blue,1,54917,55355,438
2022-12-18,70038,70050,Blue,1,36253,36762,509
2022-11-28,70047,70043,Blue,0,31180,31450,270
2022-05-29,70046,70052,Blue,1,37941,38376,435
2022-04-02,70040,70042,Blue,1,72915,72948,33
2022-09-27,70059,70041,Blue,0,87315,88248,933
2022-03-29,70059,70045,Blue,0,70618,71358,740
2022-12-03,70057,70045,Blue,0,73606,74220,614
2022-04-18,70040,70050,Blue,1,24309,24787,478
2022-08-14,70042,70060,Blue,1,34063,35055,992
2022-03-27,70046,70048,Blue,1,41975,42048,73
2022-01-11,70057,70045,Blue,0,25270,25953,683
2022-09-15,70049,70043,Blue,0,32776,33136,360
2022-03-29,70045,70039,Blue,0,52267,52512,245
2022-12-19,70044,70052,Blue,1,87236,87748,512
2022-10-03,70040,70060,Blue,1,60273,61367,1094
2022-03-23,70038,70048,Blue,1,51613,52075,462
2022-04-19,70048,70054,Blue,1,44898,45179,281
2022-09-21,70057,70045,Blue,0,54692,55330,638
2022-11-24,70052,70056,Blue,1,28605,28742,137
2022-11-30,70048,70050,Blue,1,91386,91438,52
2022-03-12,70048,70052,Blue,1,70306,70524,218
2022-12-31,70046,70056,Blue,1,86172,86697,525
2022-02-25,70056,70058,Blue,1,27619,27728,109
2022-12-21,70038,70056,Blue,1,58573,59516,943
2022-12-04,70042,70058,Blue,1,31977,32918,941
2022-03-27,70053,70838,Blue,0,65974,66758,784
2022-03-02,70057,70053,Blue,0,22490,22673,183
2022-05-05,70050,70056,Blue,1,76754,77055,301
2022-04-26,70052,70060,Blue,1,53781,54147,366
2022-12-26,70040,70056,Blue,1,56465,57292,827
2022-11-08,70052,70056,Blue,1,27608,27742,134
2022-06-08,70038,70042,Blue,1,77406,77500,94
2022-02-16,70040,70056,Blue,1,35123,36074,951
2022-07-02,70050,70056,Blue,1,55144,55445,301
2022-01-28,70054,70056,Blue,1,62466,62512,46
2022-09-15,70051,70045,Blue,0,25066,25406,340
2022-11-22,70057,70049,Blue,0,57803,58184,381
2022-11-10,70045,70838,Blue,0,37846,38232,386
2022-01-31,70044,70048,Blue,1,51951,52182,231
2022-12-31,70047,70039,Blue,0,88171,88667,496
2022-08-03,70056,70060,Blue,1,70089,70267,178
2022-11-06,70055,70043,Blue,0,80420,81065,645
2022-09-21,70059,70838,Blue,0,87315,88416,1101
2022-01-04,70040,70048,Blue,1,68301,68674,373
2022-02-28,70043,70838,Blue,0,78677,78872,195
2022-11-26,70046,70058,Blue,1,43536,44177,641
2022-12-03,70059,70039,Blue,0,49790,50897,1107
2022-02-23,70048,70050,Blue,1,57957,58011,54
2022-10-16,70042,70046,Blue,1,71131,71310,179
2022-09-09,70045,70043,Blue,0,57584,57686,102
2022-01-02,70055,70045,Blue,0,25688,26209,521
2022-04-03,70054,70058,Blue,1,67505,67667,162
2022-09-01,70048,70056,Blue,1,21617,22027,410
2022-01-10,70051,70047,Blue,0,52909,53099,190
2022-04-23,70048,70058,Blue,1,81093,81608,515
2022-01-12,70059,70053,Blue,0,60199,60465,266
2022-04-17,70053,70047,Blue,0,31900,32174,274
2022-08-16,70048,70050,Blue,1,71048,71105,57
2022-03-25,70057,70041,Blue,0,49830,50676,846
2022-11-04,70045,70039,Blue,0,40222,40503,281
2022-01-21,70058,70060,Blue,1,31261,31385,124
2022-08-22,70038,70050,Blue,1,53607,54239,632
2022-07-29,70050,70056,Blue,1,36879,37217,338
2022-11-18,70055,70047,Blue,0,70874,71252,378
2022-01-01,70051,70043,Blue,0,85168,85742,574
2022-10-16,70055,70838,Blue,0,31818,32750,932
2022-06-13,70038,70048,Blue,1,39841,40320,479
2022-11-19,70044,70056,Blue,1,67118,67763,645
2022-06-09,70054,70056,Blue,1,29953,30002,49
2022-09-13,70044,70060,Blue,1,23651,24536,885
2022-12-13,70045,70039,Blue,0,86659,86907,248
2022-01-13,70040,70046,Blue,1,51969,52238,269
2022-06-23,70044,70058,Blue,1,25165,26009,844
2022-03-23,70053,70045,Blue,0,46376,46835,459
2022-06-26,70055,70043,Blue,0,62165,62852,687
2022-06-27,70050,70056,Blue,1,26181,26534,353
2022-03-16,70046,70054,Blue,1,28234,28683,449
2022-08-29,70042,70048,Blue,1,57739,58087,348
2022-01-02,70044,70050,Blue,1,27189,27513,324
2022-12-15,70053,70047,Blue,0,49263,49712,449
2022-06-10,70049,70045,Blue,0,58334,58557,223
2022-03-16,70050,70058,Blue,1,23242,23640,398
2022-02-17,70059,70043,Blue,0,32356,33283,927
2022-02-22,70043,70838,Blue,0,33563,33807,244
2022-03-08,70057,70049,Blue,0,66868,67237,369
2022-01-27,70056,70060,Blue,1,24974,25790,816
2022-10-12,70038,70042,Blue,1,49209,49329,120
2022-01-06,70039,70838,Blue,0,77160,77199,39
2022-02-09,70059,70053,Blue,0,28467,28765,298
2022-07-20,70047,70041,Blue,0,39795,40135,340
2022-06-27,70050,70058,Blue,1,85352,85783,431
2022-09-02,70038,70040,Blue,1,65877,65893,16
2022-08-27,70051,70838,Blue,0,34428,35144,716
2022-08-06,70049,70041,Blue,0,37430,37909,479
2022-07-17,70046,70060,Blue,1,54102,54865,763
2022-08-08,70045,70043,Blue,0,56332,56428,96
2022-08-26,70059,70838,Blue,0,37048,38254,1206
2022-12-02,70047,70045,Blue,0,45888,45982,94
2022-02-26,70042,70056,Blue,1,41151,41874,723
2022-09-19,70051,70838,Blue,0,30567,31458,891
2022-10-01,70053,70045,Blue,0,53271,53728,457
2022-12-07,70050,70052,Blue,1,63608,63728,120
2022-01-17,70055,70039,Blue,0,74870,75723,853
2022-10-22,70057,70043,Blue,0,86618,87374,756
2022-04-21,70047,70043,Blue,0,45558,45799,241
2022-02-17,70046,70052,Blue,1,53202,53570,368
2022-09-10,70059,70055,Blue,0,60588,60736,148
2022-09-19,70059,70051,Blue,0,50446,50881,435
2022-12-16,70053,70039,Blue,0,30058,30931,873
2022-10-20,70046,70056,Blue,1,66287,66797,510
2022-11-03,70049,70838,Blue,0,69615,70168,553
2022-03-03,70057,70055,Blue,0,50787,50855,68
2022-11-23,70057,70055,Blue,0,56283,56352,69
2022-09-23,70055,70049,Blue,0,74537,74846,309
2022-11-20,70057,70053,Blue,0,38813,38964,151
2022-06-30,70059,70057,Blue,0,71687,71729,42
2022-10-10,70045,70838,Blue,0,72139,72484,345
2022-11-03,70056,70058,Blue,1,40911,40987,76
2022-09-29,70055,70047,Blue,0,21036,21480,444
2022-04-14,70051,70047,Blue,0,83270,83508,238
2022-10-21,70051,70047,Blue,0,25142,25349,207
2022-09-19,70056,70060,Blue,1,59004,59202,198
2022-10-25,70059,70051,Blue,0,74356,74683,327
2022-08-18,70056,70060,Blue,1,88261,88424,163
2022-02-03,70059,70039,Blue,0,40934,42024,1090
2022-08-16,70042,70058,Blue,1,21413,22399,986
2022-09-25,70040,70056,Blue,1,50545,51338,793
2022-04-21,70059,70039,Blue,0,63821,64793,972
2022-06-20,70053,70039,Blue,0,87269,88009,740
2022-10-16,70059,70043,Blue,0,29296,30109,813
2022-03-15,70047,70039,Blue,0,30836,31615,779
2022-08-09,70051,70043,Blue,0,54449,54941,492
2022-11-05,70050,70060,Blue,1,88970,89552,582
2022-08-16,70041,70039,Blue,0,34522,34555,33
2022-06-18,70045,70041,Blue,0,48009,48202,193
2022-01-06,70057,70838,Blue,0,35944,37029,1085
2022-04-18,70040,70054,Blue,1,75306,76201,895
2022-09-02,70044,70060,Blue,1,78109,79005,896
2022-08-26,70051,70041,Blue,0,53975,54565,590
2022-12-08,70044,70060,Blue,1,30902,31851,949
2022-10-27,70038,70050,Blue,1,67628,68174,546
2022-03-28,70056,70058,Blue,1,25562,25644,82
2022-10-20,70042,70048,Blue,1,56657,57083,426
2022-07-05,70042,70048,Blue,1,22346,22672,326
2022-01-27,70051,70838,Blue,0,36852,37805,953
2022-08-06,70051,70039,Blue,0,80276,80898,622
2022-02-02,70044,70052,Blue,1,57646,58193,547
2022-08-31,70055,70049,Blue,0,42778,43291,513
2022-09-19,70054,70058,Blue,1,74401,74552,151
2022-07-03,70042,70060,Blue,1,58742,59763,1021
2022-09-17,70055,70039,Blue,0,42568,43514,946
2022-02-02,70059,70049,Blue,0,61726,62260,534
2022-09-18,70056,70058,Blue,1,60614,60684,70
2022-02-23,70059,70039,Blue,0,65596,66643,1047
2022-09-29,70047,70043,Blue,0,31621,31898,277
2022-07-16,70052,70060,Blue,1,60692,61070,378
2022-07-15,70055,70039,Blue,0,32038,32887,849
2022-10-06,70048,70052,Blue,1,23757,23976,219
2022-02-20,70046,70048,Blue,1,31914,31987,73
2022-11-30,70046,70052,Blue,1,45247,45611,364
2022-03-23,70057,70049,Blue,0,60867,61230,363
2022-07-08,70040,70054,Blue,1,86057,86910,853
2022-03-26,70038,70054,Blue,1,70687,71652,965
2022-02-11,70059,70047,Blue,0,22407,23038,631
2022-10-18,70045,70041,Blue,0,51354,51564,210
2022-08-30,70049,70045,Blue,0,23088,23287,199
2022-08-20,70040,70058,Blue,1,44856,45812,956
2022-04-08,70050,70060,Blue,1,54629,55143,514
2022-12-31,70059,70047,Blue,0,50295,50857,562
2022-06-13,70038,70052,Blue,1,35199,35936,737
2022-09-03,70051,70041,Blue,0,36179,36757,578
2022-12-12,70042,70046,Blue,1,41079,41239,160
2022-05-10,70057,70053,Blue,0,47780,47929,149
2022-12-11,70046,70050,Blue,1,62233,62466,233
2022-11-15,70044,70052,Blue,1,29217,29707,490
2022-06-10,70038,70056,Blue,1,52200,53308,1108
2022-04-23,70059,70057,Blue,0,56235,56270,35
2022-06-28,70052,70056,Blue,1,27777,27921,144
2022-11-29,70059,70049,Blue,0,61335,61792,457
2022-05-26,70049,70041,Blue,0,51837,52305,468
2022-02-01,70052,70060,Blue,1,23490,24201,711
2022-08-09,70059,70051,Blue,0,27619,27955,336
2022-10-02,70038,70046,Blue,1,53849,54167,318
2022-04-05,70046,70050,Blue,1,31842,32056,214
2022-05-18,70044,70048,Blue,1,83552,83858,306
2022-11-16,70040,70046,Blue,1,23006,23279,273
2022-09-06,70040,70044,Blue,1,31293,31402,109
2022-05-20,70053,70041,Blue,0,73488,74308,820
2022-11-17,70055,70051,Blue,0,37112,37246,134
2022-11-14,70057,70043,Blue,0,28042,28853,811
2022-01-01,70057,70838,Blue,0,26315,27339,1024
2022-10-25,70051,70043,Blue,0,53446,53941,495
2022-03-01,70042,70046,Blue,1,68751,68931,180
2022-07-09,70040,70046,Blue,1,86478,86769,291
2022-10-10,70050,70056,Blue,1,81529,81809,280
2022-06-24,70042,70044,Blue,1,84114,84141,27
2022-12-09,70057,70041,Blue,0,73891,74718,827
2022-02-06,70059,70045,Blue,0,82997,83701,704
2022-08-09,70045,70838,Blue,0,50160,50630,470
2022-06-18,70046,70058,Blue,1,67843,68490,647
2022-12-08,70046,70052,Blue,1,53893,54243,350
2022-01-25,70041,70039,Blue,0,20710,20747,37
2022-02-18,70057,70051,Blue,0,54576,54824,248
2022-04-07,70057,70039,Blue,0,54269,55202,933
2022-12-31,70042,70046,Blue,1,81549,81741,192
2022-07-23,70057,70055,Blue,0,71083,71152,69
2022-12-21,70038,70044,Blue,1,67425,67607,182
2022-12-22,70038,70054,Blue,1,35773,36554,781
2022-10-03,70046,70056,Blue,1,66875,67383,508
2022-07-24,70057,70047,Blue,0,21574,22093,519
2022-03-25,70041,70039,Blue,0,60572,60603,31
2022-03-07,70046,70048,Blue,1,67691,67766,75
2022-06-27,70051,70039,Blue,0,51931,52576,645
2022-01-04,70040,70054,Blue,1,86052,86760,708
2022-09-24,70059,70041,Blue,0,54073,54974,901
2022-08-28,70043,70838,Blue,0,33327,33512,185
2022-07-11,70047,70039,Blue,0,30774,31241,467
2022-06-30,70044,70060,Blue,1,32694,33646,952
2022-11-05,70042,70044,Blue,1,51439,51466,27
2022-09-09,70042,70044,Blue,1,52359,52385,26
2022-07-04,70059,70049,Blue,0,64092,64572,480
2022-05-15,70054,70056,Blue,1,83030,83077,47
2022-02-07,70045,70043,Blue,0,63967,64087,120
2022-10-26,70046,70056,Blue,1,48626,49136,510
2022-02-05,70040,70052,Blue,1,83242,83902,660
2022-11-09,70046,70048,Blue,1,46242,46330,88
2022-12-31,70051,70039,Blue,0,59761,60419,658
2022-06-06,70038,70048,Blue,1,65112,65657,545
2022-11-23,70057,70041,Blue,0,86629,87429,800
2022-01-29,70055,70838,Blue,0,80535,82378,1843
2022-10-10,70046,70058,Blue,1,36144,36978,834
2022-04-22,70059,70039,Blue,0,68462,69433,971
2022-05-13,70059,70055,Blue,0,85214,85358,144
2022-04-11,70046,70060,Blue,1,64252,65067,815
2022-02-03,70059,70057,Blue,0,21674,21711,37
2022-08-21,70047,70041,Blue,0,85482,85856,374
2022-02-12,70059,70049,Blue,0,44353,44813,460
2022-05-05,70057,70051,Blue,0,53100,53345,245
2022-02-23,70054,70060,Blue,1,21075,21346,271
2022-09-15,70050,70056,Blue,1,34268,34608,340
2022-02-08,70059,70838,Blue,0,59600,60744,1144
2022-10-18,70049,70041,Blue,0,62360,62772,412
2022-08-01,70045,70039,Blue,0,43991,44279,288
2022-12-08,70042,70056,Blue,1,31652,32386,734
2022-06-30,70055,70039,Blue,0,26117,26979,862
2022-11-22,70040,70056,Blue,1,40571,41458,887
2022-02-13,70042,70044,Blue,1,40560,40588,28
2022-09-11,70053,70047,Blue,0,64389,64714,325
2022-04-16,70055,70045,Blue,0,68957,69466,509
2022-01-26,70051,70043,Blue,0,25869,26431,562
2022-08-27,70042,70052,Blue,1,41673,42220,547
2022-03-04,70057,70051,Blue,0,82412,82683,271
2022-03-10,70046,70060,Blue,1,31845,32731,886
2022-12-01,70044,70056,Blue,1,61391,62444,1053
2022-06-09,70042,70050,Blue,1,64972,65406,434
2022-10-28,70055,70043,Blue,0,48565,49245,680
2022-05-17,70059,70057,Blue,0,73146,73189,43
2022-09-07,70047,70838,Blue,0,20558,21134,576
2022-06-18,70059,70041,Blue,0,59478,60413,935
2022-02-17,70058,70060,Blue,1,59145,59215,70
2022-02-05,70054,70056,Blue,1,31029,31076,47
2022-07-06,70050,70058,Blue,1,68630,69124,494
2022-03-05,70040,70042,Blue,1,75079,75115,36
2022-09-01,70040,70048,Blue,1,62422,62874,452
2022-07-25,70057,70043,Blue,0,54426,55247,821
2022-12-25,70044,70054,Blue,1,58290,58877,587
2022-07-29,70040,70048,Blue,1,47451,47896,445
2022-04-07,70051,70049,Blue,0,61747,61850,103
2022-04-11,70043,70039,Blue,0,34252,34385,133
2022-02-22,70059,70057,Blue,0,51553,51588,35
2022-11-05,70044,70048,Blue,1,53659,53900,241
2022-08-30,70055,70043,Blue,0,77060,77699,639
2022-01-07,70042,70054,Blue,1,31145,31828,683
2022-09-22,70044,70056,Blue,1,64614,65347,733
2022-11-19,70056,70060,Blue,1,43198,43372,174
2022-02-09,70051,70047,Blue,0,84967,85165,198
2022-06-12,70050,70058,Blue,1,72183,72613,430
2022-07-18,70040,70058,Blue,1,61338,62319,981
2022-12-23,70038,70054,Blue,1,47083,47888,805
2022-12-09,70048,70050,Blue,1,31390,31450,60
2022-02-12,70044,70050,Blue,1,45525,45857,332
2022-08-22,70044,70052,Blue,1,61908,62404,496
2022-01-07,70053,70051,Blue,0,41247,41314,67
2022-04-22,70052,70060,Blue,1,57271,57836,565
2022-01-27,70044,70046,Blue,1,64835,64940,105
2022-09-19,70057,70047,Blue,0,38055,38685,630
2022-12-26,70046,70056,Blue,1,31117,31595,478
2022-05-18,70053,70043,Blue,0,44921,45663,742
2022-10-15,70038,70042,Blue,1,60977,61070,93
2022-07-21,70042,70050,Blue,1,71022,72079,1057
2022-09-14,70052,70058,Blue,1,32106,32386,280
2022-02-24,70059,70049,Blue,0,22040,22575,535
2022-07-05,70044,70058,Blue,1,59187,60025,838
2022-10-31,70055,70838,Blue,0,35052,36088,1036
2022-04-13,70055,70047,Blue,0,33762,34228,466
2022-03-28,70057,70838,Blue,0,66907,67901,994
2022-03-31,70056,70058,Blue,1,63140,63210,70
2022-08-16,70048,70050,Blue,1,20425,20484,59
2022-01-17,70051,70049,Blue,0,73330,73433,103
2022-01-17,70052,70056,Blue,1,46050,46189,139
2022-04-20,70051,70045,Blue,0,66360,66743,383
2022-02-11,70044,70052,Blue,1,60454,60961,507
2022-01-13,70044,70054,Blue,1,34776,35602,826
2022-11-01,70053,70045,Blue,0,29957,30446,489
2022-10-13,70051,70039,Blue,0,50314,50934,620
2022-07-01,70057,70053,Blue,0,21832,22006,174
2022-01-24,70044,70046,Blue,1,25703,25812,109
2022-12-17,70055,70041,Blue,0,85878,86600,722
2022-02-24,70048,70052,Blue,1,28402,28619,217
2022-03-02,70056,70060,Blue,1,89353,89566,213
2022-10-16,70058,70060,Blue,1,77481,77578,97
2022-04-22,70046,70056,Blue,1,29185,29701,516
2022-06-26,70055,70049,Blue,0,44330,44602,272
2022-03-21,70059,70039,Blue,0,20236,21339,1103
2022-03-28,70040,70058,Blue,1,57194,58114,920
2022-09-13,70046,70052,Blue,1,62401,62760,359
2022-08-04,70048,70058,Blue,1,33729,34300,571
2022-08-15,70042,70058,Blue,1,44869,45832,963
2022-10-14,70053,70041,Blue,0,64958,65627,669
2022-09-22,70051,70045,Blue,0,23037,23422,385
2022-11-03,70042,70050,Blue,1,25051,25464,413
2022-07-16,70044,70058,Blue,1,43370,44204,834
2022-01-08,70044,70054,Blue,1,50428,51004,576
2022-01-26,70043,70838,Blue,0,70435,70631,196
2022-09-20,70048,70050,Blue,1,43608,43669,61
2022-09-29,70053,70045,Blue,0,82222,82651,429
2022-06-21,70047,70041,Blue,0,70261,70641,380
2022-07-29,70057,70838,Blue,0,57575,58639,1064
2022-12-01,70046,70050,Blue,1,47112,47283,171
2022-01-11,70040,70042,Blue,1,81586,81620,34
2022-07-08,70053,70039,Blue,0,69890,70680,790
2022-06-10,70042,70052,Blue,1,27099,27700,601
2022-04-23,70057,70053,Blue,0,41186,41337,151
2022-11-13,70043,70838,Blue,0,70422,70625,203
2022-12-05,70057,70055,Blue,0,25969,26038,69
2022-10-14,70048,70050,Blue,1,80444,80504,60
2022-01-18,70047,70045,Blue,0,41124,41222,98
2022-12-28,70042,70052,Blue,1,61349,61978,629
2022-10-04,70038,70058,Blue,1,85710,86800,1090
2022-08-22,70042,70060,Blue,1,67828,68797,969
2022-01-23,70040,70050,Blue,1,46239,46685,446
2022-04-22,70051,70045,Blue,0,76441,76787,346
2022-11-05,70055,70039,Blue,0,46714,47562,848
2022-03-03,70038,70058,Blue,1,34754,35786,1032
2022-10-18,70056,70058,Blue,1,25511,25588,77
2022-02-01,70040,70060,Blue,1,27375,28517,1142
2022-08-07,70042,70058,Blue,1,74367,75241,874
2022-07-18,70042,70058,Blue,1,23404,24306,902
2022-04-21,70046,70056,Blue,1,39975,40499,524
2022-04-16,70038,70060,Blue,1,56200,57406,1206
2022-08-26,70059,70043,Blue,0,70860,71704,844
2022-02-07,70058,70060,Blue,1,51915,51982,67
2022-02-08,70055,70041,Blue,0,57671,58404,733
2022-02-09,70057,70053,Blue,0,56098,56286,188
2022-08-11,70044,70050,Blue,1,72287,72852,565
2022-03-09,70059,70057,Blue,0,76644,76681,37
2022-01-15,70038,70048,Blue,1,29108,29567,459
2022-02-19,70052,70060,Blue,1,34200,34535,335
2022-12-19,70047,70039,Blue,0,63612,64053,441
2022-01-20,70038,70044,Blue,1,71431,71606,175
2022-05-21,70053,70049,Blue,0,44070,44264,194
2022-02-24,70051,70045,Blue,0,86668,86984,316
2022-08-07,70046,70060,Blue,1,87810,88570,760
2022-01-25,70047,70041,Blue,0,61430,61819,389
2022-08-17,70051,70043,Blue,0,25903,26541,638
2022-12-14,70059,70051,Blue,0,66019,66362,343
2022-01-04,70038,70056,Blue,1,62832,63677,845
2022-07-14,70057,70053,Blue,0,36009,36190,181
2022-02-02,70059,70043,Blue,0,56559,57494,935
2022-05-16,70055,70051,Blue,0,28215,28355,140
2022-03-12,70051,70838,Blue,0,33922,34684,762
2022-12-08,70040,70042,Blue,1,21108,21145,37
2022-03-21,70038,70044,Blue,1,26056,26221,165
2022-05-20,70057,70041,Blue,0,21112,22194,1082
2022-05-02,70051,70047,Blue,0,19224,19507,283
2022-10-14,70042,70052,Blue,1,81685,82286,601
2022-10-06,70049,70039,Blue,0,39987,40482,495
2022-02-11,70049,70838,Blue,0,62787,63824,1037
2022-01-20,70059,70051,Blue,0,21313,21735,422
2022-08-23,70051,70045,Blue,0,71821,72152,331
2022-07-12,70045,70039,Blue,0,35723,36022,299
2022-04-20,70047,70045,Blue,0,31771,31871,100
2022-07-07,70042,70054,Blue,1,20415,21203,788
2022-08-19,70059,70053,Blue,0,41596,42228,632
2022-05-18,70038,70048,Blue,1,59556,60083,527
2022-02-01,70043,70838,Blue,0,53439,53762,323
2022-09-13,70038,70056,Blue,1,52967,53952,985
2022-10-02,70054,70060,Blue,1,78923,79211,288
2022-10-17,70041,70838,Blue,0,63098,63231,133
2022-02-26,70038,70052,Blue,1,73433,74184,751
2022-02-17,70045,70838,Blue,0,29320,29775,455
2022-11-15,70055,70049,Blue,0,27686,27985,299
2022-07-08,70038,70044,Blue,1,76990,77163,173
2022-04-08,70059,70055,Blue,0,73214,73360,146
2022-03-10,70046,70060,Blue,1,46196,46947,751
2022-01-20,70059,70057,Blue,0,20603,20643,40
2022-09-12,70051,70039,Blue,0,44132,44804,672
2022-04-22,70048,70052,Blue,1,88204,88394,190
2022-06-29,70045,70043,Blue,0,49086,49189,103
2022-01-13,70055,70051,Blue,0,25638,25823,185
2022-11-19,70056,70058,Blue,1,76001,76076,75
2022-01-05,70040,70046,Blue,1,31814,32079,265
2022-08-31,70042,70060,Blue,1,21795,22912,1117
2022-10-04,70055,70041,Blue,0,33682,34566,884
2022-07-06,70040,70042,Blue,1,32106,32141,35
2022-02-05,70051,70838,Blue,0,34466,35203,737
2022-03-22,70044,70050,Blue,1,57997,58354,357
2022-07-04,70053,70047,Blue,0,61962,62259,297
2022-10-25,70053,70041,Blue,0,59027,59725,698
2022-02-12,70038,70044,Blue,1,53414,53610,196
2022-09-05,70059,70039,Blue,0,54377,55525,1148
2022-08-31,70055,70043,Blue,0,40270,41026,756
2022-12-27,70044,70058,Blue,1,56064,56854,790
2022-01-04,70047,70041,Blue,0,30935,31315,380
2022-09-26,70042,70060,Blue,1,53872,54850,978
2022-07-21,70045,70041,Blue,0,25911,26098,187
2022-02-16,70048,70054,Blue,1,63043,63397,354
2022-05-10,70052,70054,Blue,1,28194,28247,53
2022-10-14,70048,70058,Blue,1,85021,85548,527
2022-01-10,70039,70838,Blue,0,27515,27553,38
2022-02-22,70050,70052,Blue,1,83748,83865,117
2022-01-27,70048,70054,Blue,1,74620,74960,340
2022-03-25,70053,70043,Blue,0,74002,74618,616
2022-04-18,70045,70041,Blue,0,52290,52456,166
2022-08-24,70053,70049,Blue,0,65515,65712,197
2022-06-15,70047,70043,Blue,0,88719,88985,266
2022-12-31,70044,70046,Blue,1,26507,26610,103
2022-03-15,70040,70044,Blue,1,25309,25425,116
2022-09-08,70040,70042,Blue,1,38945,38977,32
2022-08-06,70053,70049,Blue,0,29501,29686,185
2022-11-05,70054,70056,Blue,1,71673,71719,46
2022-07-21,70057,70045,Blue,0,25606,26249,643
2022-03-12,70051,70043,Blue,0,41465,41921,456
2022-04-07,70040,70046,Blue,1,84381,84687,306
2022-03-21,70048,70052,Blue,1,69080,69368,288
2022-08-02,70048,70058,Blue,1,86190,86690,500
2022-08-01,70048,70058,Blue,1,51441,51952,511
2022-10-14,70044,70052,Blue,1,64484,64992,508
2022-11-11,70047,70041,Blue,0,73429,73771,342
2022-08-03,70057,70051,Blue,0,70898,71147,249
2022-06-05,70043,70041,Blue,0,79286,79313,27
2022-01-20,70046,70060,Blue,1,22587,23722,1135
2022-11-03,70042,70054,Blue,1,77424,78039,615
2022-09-19,70044,70054,Blue,1,41806,42421,615
2022-12-17,70042,70044,Blue,1,33579,33606,27
2022-06-29,70038,70046,Blue,1,53196,53574,378
2022-09-17,70047,70039,Blue,0,43956,44451,495
2022-10-14,70052,70060,Blue,1,63180,63551,371
2022-09-01,70038,70044,Blue,1,39501,39775,274
2022-01-13,70040,70046,Blue,1,71190,71504,314
2022-01-03,70049,70045,Blue,0,51683,51872,189
2022-04-10,70042,70050,Blue,1,57122,57515,393
2022-11-22,70056,70060,Blue,1,76817,76997,180
2022-02-17,70059,70043,Blue,0,73219,74126,907
2022-04-17,70042,70044,Blue,1,45807,45840,33
2022-04-01,70059,70039,Blue,0,64694,65732,1038
2022-09-24,70057,70055,Blue,0,39576,39645,69
2022-05-19,70042,70060,Blue,1,24616,25777,1161
2022-09-01,70042,70048,Blue,1,49504,49866,362
2022-11-10,70046,70054,Blue,1,81747,82295,548
2022-10-27,70049,70043,Blue,0,30883,31276,393
2022-02-14,70050,70060,Blue,1,76503,77128,625
2022-12-22,70042,70048,Blue,1,69148,69453,305
2022-05-06,70054,70058,Blue,1,34820,34985,165
2022-03-03,70040,70054,Blue,1,82042,82764,722
2022-12-05,70038,70048,Blue,1,60129,60613,484
2022-08-22,70044,70058,Blue,1,24755,25600,845
2022-01-20,70038,70040,Blue,1,60733,60749,16
2022-11-02,70053,70041,Blue,0,76180,76849,669
2022-02-09,70049,70039,Blue,0,75403,75935,532
2022-12-27,70048,70056,Blue,1,72262,72657,395
2022-03-23,70038,70054,Blue,1,35478,36395,917
2022-02-26,70038,70048,Blue,1,75015,75464,449
2022-09-09,70049,70041,Blue,0,45272,45694,422
2022-11-17,70040,70046,Blue,1,38893,39136,243
2022-11-21,70044,70060,Blue,1,54694,55614,920
2022-01-25,70046,70052,Blue,1,63882,64244,362
2022-08-01,70055,70051,Blue,0,55280,55422,142
2022-07-31,70040,70046,Blue,1,30843,31082,239
2022-06-07,70042,70052,Blue,1,86542,87232,690
2022-02-27,70051,70039,Blue,0,68289,68926,637
2022-08-11,70047,70039,Blue,0,21492,21936,444
2022-09-03,70046,70048,Blue,1,47896,47973,77
2022-07-18,70051,70043,Blue,0,48198,48696,498
2022-07-11,70038,70050,Blue,1,39858,40517,659
2022-12-06,70044,70058,Blue,1,27002,27772,770
2022-10-14,70054,70060,Blue,1,69820,70075,255
2022-07-24,70055,70838,Blue,0,47000,47923,923
2022-03-08,70043,70039,Blue,0,23780,23905,125
2022-11-21,70056,70060,Blue,1,86637,86820,183
2022-01-25,70054,70060,Blue,1,61830,62353,523
2022-10-28,70044,70056,Blue,1,42258,42968,710
2022-02-02,70044,70056,Blue,1,23267,23951,684
2022-03-20,70038,70060,Blue,1,78560,79672,1112
2022-02-11,70038,70050,Blue,1,86133,86807,674
2022-04-04,70044,70054,Blue,1,39314,39978,664
2022-11-25,70050,70052,Blue,1,85698,85814,116
2022-08-15,70046,70058,Blue,1,65769,66417,648
2022-03-31,70046,70054,Blue,1,62895,63362,467
2022-10-11,70045,70043,Blue,0,47170,47263,93
2022-09-11,70052,70058,Blue,1,45061,45307,246
2022-09-12,70044,70048,Blue,1,82869,83114,245
2022-06-20,70057,70055,Blue,0,64999,65070,71
2022-08-05,70041,70838,Blue,0,37393,37520,127
2022-12-22,70044,70060,Blue,1,47744,48812,1068
2022-10-11,70046,70052,Blue,1,83713,84016,303
2022-02-14,70040,70060,Blue,1,63809,64904,1095
2022-02-06,70044,70052,Blue,1,69582,70104,522
2022-12-18,70044,70054,Blue,1,78334,79035,701
2022-07-09,70049,70043,Blue,0,57841,58222,381
2022-07-01,70055,70039,Blue,0,66460,67336,876
2022-09-02,70040,70050,Blue,1,51428,51948,520
2022-02-19,70050,70054,Blue,1,56872,57088,216
2022-01-14,70053,70049,Blue,0,88389,88578,189
2022-11-07,70050,70056,Blue,1,68248,68577,329
2022-07-15,70044,70050,Blue,1,51264,51652,388
2022-09-16,70041,70039,Blue,0,48235,48266,31
2022-02-23,70053,70043,Blue,0,52793,53418,625
2022-06-17,70053,70043,Blue,0,34633,35343,710
2022-02-15,70059,70051,Blue,0,68525,68844,319
2022-02-06,70056,70060,Blue,1,33530,33722,192
2022-11-05,70042,70044,Blue,1,82369,82398,29
2022-01-06,70042,70058,Blue,1,58840,59776,936
2022-03-05,70044,70060,Blue,1,79500,80351,851
2022-01-02,70040,70058,Blue,1,43022,43900,878
2022-10-19,70053,70838,Blue,0,56141,57099,958
2022-02-13,70055,70043,Blue,0,55105,55777,672
2022-10-28,70046,70050,Blue,1,35680,35864,184
2022-01-14,70057,70051,Blue,0,78976,79219,243
2022-01-04,70059,70053,Blue,0,25159,25454,295
2022-06-25,70045,70041,Blue,0,71009,71204,195
2022-02-05,70038,70052,Blue,1,36126,36815,689
2022-08-19,70053,70838,Blue,0,60677,61570,893
2022-06-21,70044,70056,Blue,1,23374,24120,746
2022-11-14,70038,70058,Blue,1,45603,46601,998
2022-04-18,70048,70050,Blue,1,44745,44810,65
2022-09-04,70051,70039,Blue,0,60150,60812,662
2022-01-11,70042,70052,Blue,1,33150,33840,690
2022-02-17,70038,70048,Blue,1,82750,83297,547
2022-07-29,70054,70056,Blue,1,25177,25224,47
2022-02-07,70059,70051,Blue,0,67522,67879,357
2022-11-21,70041,70838,Blue,0,65940,66056,116
2022-09-09,70049,70039,Blue,0,54601,55089,488
2022-09-17,70047,70039,Blue,0,62890,63306,416
2022-02-02,70045,70043,Blue,0,88864,88989,125
2022-06-29,70045,70041,Blue,0,31393,31596,203
2022-04-15,70049,70039,Blue,0,42637,43163,526
2022-03-25,70055,70047,Blue,0,45152,45545,393
2022-02-09,70057,70039,Blue,0,63866,64865,999
2022-10-03,70044,70058,Blue,1,67680,68505,825
2022-07-17,70051,70838,Blue,0,33572,34351,779
2022-03-30,70053,70041,Blue,0,84887,85511,624
2022-10-16,70044,70060,Blue,1,48068,48918,850
2022-02-13,70038,70054,Blue,1,62896,63725,829
2022-10-22,70049,70045,Blue,0,50326,50525,199
2022-02-16,70040,70050,Blue,1,41381,41859,478
2022-03-19,70038,70054,Blue,1,36147,37009,862
2022-01-04,70038,70046,Blue,1,52458,52813,355
2022-12-29,70040,70046,Blue,1,46350,46608,258
2022-02-06,70042,70052,Blue,1,73853,74398,545
2022-07-14,70047,70838,Blue,0,32862,33369,507
2022-08-24,70059,70051,Blue,0,59443,59775,332
2022-02-26,70048,70056,Blue,1,34470,34862,392
2022-02-25,70051,70049,Blue,0,32847,32958,111
2022-06-28,70038,70052,Blue,1,66295,67143,848
2022-08-02,70050,70056,Blue,1,38497,38820,323
2022-01-26,70044,70058,Blue,1,86230,87104,874
2022-02-10,70059,70043,Blue,0,32954,33919,965
2022-12-19,70042,70060,Blue,1,34073,35020,947
2022-05-23,70043,70838,Blue,0,48242,48444,202
2022-07-29,70040,70050,Blue,1,34594,35131,537
2022-03-23,70057,70043,Blue,0,64463,65229,766
2022-11-07,70053,70041,Blue,0,86021,86630,609
2022-05-16,70057,70047,Blue,0,75090,75611,521
2022-10-14,70040,70046,Blue,1,47726,47981,255
2022-06-25,70040,70046,Blue,1,44875,45145,270
2022-05-20,70050,70058,Blue,1,57591,58034,443
2022-07-10,70047,70039,Blue,0,22218,22676,458
2022-03-19,70047,70045,Blue,0,67626,67725,99
2022-11-25,70059,70045,Blue,0,54084,54805,721
2022-12-30,70055,70047,Blue,0,74020,74400,380
2022-09-28,70057,70045,Blue,0,55180,55828,648
2022-12-23,70048,70050,Blue,1,26316,26385,69
2022-04-08,70044,70058,Blue,1,55219,55974,755
2022-03-20,70055,70047,Blue,0,86598,86960,362
2022-05-27,70042,70044,Blue,1,71818,71855,37
2022-10-02,70053,70049,Blue,0,23220,23434,214
2022-02-07,70055,70053,Blue,0,40756,40804,48
2022-03-30,70046,70054,Blue,1,42293,42786,493
2022-02-02,70056,70058,Blue,1,54227,54303,76
2022-01-12,70038,70050,Blue,1,81019,81760,741
2022-09-29,70046,70054,Blue,1,23933,24372,439
2022-03-02,70052,70060,Blue,1,37144,37511,367
2022-04-20,70057,70047,Blue,0,43934,44500,566
2022-08-05,70053,70039,Blue,0,24945,25680,735
2022-05-20,70057,70043,Blue,0,63871,64852,981
2022-04-28,70054,70060,Blue,1,62916,63173,257
2022-09-27,70047,70043,Blue,0,29165,29437,272
2022-10-20,70046,70050,Blue,1,73538,73720,182
2022-06-30,70057,70047,Blue,0,20929,21435,506
2022-07-14,70052,70056,Blue,1,69502,69702,200
2022-01-12,70040,70058,Blue,1,63219,64254,1035
2022-08-09,70046,70056,Blue,1,56949,57465,516
2022-05-20,70044,70048,Blue,1,31723,32050,327
2022-10-14,70059,70045,Blue,0,32232,32947,715
2022-11-16,70059,70045,Blue,0,59295,59987,692
2022-10-07,70053,70039,Blue,0,26224,27026,802
2022-12-31,70040,70048,Blue,1,41093,41479,386
2022-07-11,70053,70039,Blue,0,80758,81491,733
2022-11-20,70053,70043,Blue,0,77304,77839,535
2022-04-18,70059,70051,Blue,0,88112,88467,355
2022-09-08,70041,70838,Blue,0,61745,62067,322
2022-07-05,70043,70041,Blue,0,60330,60365,35
2022-08-23,70040,70060,Blue,1,87431,88416,985
2022-06-28,70054,70058,Blue,1,68332,68492,160
2022-01-12,70053,70047,Blue,0,61091,61404,313
2022-12-02,70055,70051,Blue,0,24416,24554,138
2022-06-08,70040,70052,Blue,1,33977,34774,797
2022-12-31,70042,70058,Blue,1,58647,59538,891
2022-03-09,70054,70056,Blue,1,30821,30869,48
2022-07-12,70048,70052,Blue,1,69564,69777,213
2022-04-24,70043,70838,Blue,0,59615,59797,182
2022-12-30,70053,70838,Blue,0,67460,68440,980
2022-11-15,70054,70060,Blue,1,27377,27644,267
2022-06-18,70051,70039,Blue,0,28578,29296,718
2022-10-03,70040,70056,Blue,1,69756,70593,837
2022-01-01,70050,70054,Blue,1,65142,65370,228
2022-07-19,70054,70058,Blue,1,22223,22376,153
2022-10-17,70057,70053,Blue,0,21838,22001,163
2022-07-01,70038,70050,Blue,1,77582,78497,915
2022-12-06,70042,70048,Blue,1,77987,78271,284
2022-11-13,70041,70039,Blue,0,55447,55479,32
2022-10-11,70054,70060,Blue,1,28617,28943,326
2022-02-13,70053,70045,Blue,0,75726,76149,423
2022-02-07,70046,70056,Blue,1,68317,68833,516
2022-11-09,70057,70043,Blue,0,52063,52848,785
2022-07-21,70057,70047,Blue,0,61418,61893,475
2022-06-25,70040,70056,Blue,1,29757,30537,780
2022-12-22,70040,70054,Blue,1,20362,21636,1274
2022-12-17,70044,70052,Blue,1,40769,41244,475
2022-04-13,70055,70041,Blue,0,23281,24128,847
2022-04-15,70048,70050,Blue,1,29651,29707,56
2022-02-28,70053,70039,Blue,0,65002,65795,793
2022-07-19,70050,70054,Blue,1,21782,22019,237
2022-12-17,70038,70058,Blue,1,34513,35486,973
2022-10-12,70051,70045,Blue,0,63810,64145,335
2022-09-21,70044,70060,Blue,1,26150,27047,897
2022-03-13,70043,70039,Blue,0,45034,45164,130
2022-11-03,70057,70045,Blue,0,28894,29570,676
2022-10-12,70038,70050,Blue,1,78347,78926,579
2022-04-03,70038,70060,Blue,1,73187,74325,1138
2022-02-15,70044,70052,Blue,1,28396,28936,540
2022-06-11,70044,70048,Blue,1,58083,58349,266
2022-02-06,70038,70040,Blue,1,55337,55354,17
2022-10-23,70048,70056,Blue,1,46613,46987,374
2022-04-28,70050,70056,Blue,1,39700,39994,294
2022-09-15,70038,70046,Blue,1,35294,35601,307
2022-04-28,70059,70047,Blue,0,29295,29875,580
2022-03-18,70038,70054,Blue,1,58025,58799,774
2022-03-01,70042,70058,Blue,1,57010,57901,891
2022-04-02,70053,70045,Blue,0,25702,26185,483
2022-10-10,70057,70047,Blue,0,28529,29026,497
2022-09-24,70055,70039,Blue,0,36990,37929,939
2022-01-03,70048,70058,Blue,1,75928,76443,515
2022-11-19,70044,70058,Blue,1,50386,51129,743
2022-07-06,70043,70838,Blue,0,24587,24832,245
2022-05-16,70053,70051,Blue,0,49116,49176,60
2022-06-27,70045,70039,Blue,0,56748,57120,372
2022-11-03,70055,70043,Blue,0,50121,50794,673
2022-08-19,70057,70051,Blue,0,26450,26712,262
2022-04-24,70038,70044,Blue,1,53730,53918,188
2022-10-25,70041,70838,Blue,0,73841,73957,116
2022-03-31,70049,70039,Blue,0,20757,21295,538
2022-09-23,70051,70049,Blue,0,30547,30654,107
2022-02-08,70038,70048,Blue,1,72607,73202,595
2022-01-20,70051,70049,Blue,0,59427,59530,103
2022-09-11,70050,70056,Blue,1,44412,44742,330
2022-03-04,70051,70039,Blue,0,30653,31380,727
2022-03-24,70057,70043,Blue,0,56669,57438,769
2022-03-11,70048,70058,Blue,1,56179,56672,493
2022-02-01,70050,70054,Blue,1,26365,26588,223
2022-09-20,70052,70056,Blue,1,79235,79377,142
2022-03-24,70042,70058,Blue,1,75333,76219,886
2022-08-11,70038,70060,Blue,1,67936,69135,1199
2022-11-26,70053,70051,Blue,0,62453,62505,52
2022-07-12,70057,70047,Blue,0,23089,23604,515
2022-12-01,70049,70047,Blue,0,86279,86335,56
2022-10-03,70040,70060,Blue,1,77406,78427,1021
2022-06-22,70057,70838,Blue,0,30654,31823,1169
2022-12-20,70057,70055,Blue,0,24040,24114,74
2022-01-26,70040,70052,Blue,1,73034,73707,673
2022-12-22,70057,70838,Blue,0,70037,71036,999
2022-03-21,70044,70052,Blue,1,31094,31689,595
2022-07-02,70050,70060,Blue,1,67632,68197,565
2022-10-27,70042,70048,Blue,1,42192,42502,310
2022-04-13,70040,70048,Blue,1,79789,80198,409
2022-01-24,70059,70055,Blue,0,24853,24998,145
2022-04-08,70059,70043,Blue,0,58106,58967,861
2022-12-16,70044,70060,Blue,1,67940,68858,918
2022-03-10,70038,70046,Blue,1,34445,34775,330
2022-08-14,70058,70060,Blue,1,83406,83483,77
2022-04-02,70043,70039,Blue,0,25589,25689,100
2022-09-01,70047,70041,Blue,0,38033,38361,328
2022-03-17,70038,70050,Blue,1,34453,34988,535
2022-03-21,70048,70058,Blue,1,61283,61844,561
2022-09-16,70059,70049,Blue,0,47838,48308,470
2022-03-01,70045,70043,Blue,0,25429,25528,99
2022-12-15,70050,70054,Blue,1,65398,65611,213
2022-06-24,70048,70054,Blue,1,72138,72426,288
2022-09-26,70052,70060,Blue,1,54728,55107,379
2022-01-09,70057,70055,Blue,0,58763,58831,68
2022-12-16,70059,70057,Blue,0,61877,61913,36
2022-01-12,70046,70050,Blue,1,37243,37420,177
2022-02-11,70053,70041,Blue,0,26084,26812,728
2022-01-17,70049,70838,Blue,0,73467,74022,555
2022-09-26,70038,70046,Blue,1,89113,89461,348
2022-05-27,70047,70045,Blue,0,60288,60387,99
2022-06-06,70038,70052,Blue,1,38471,39379,908
2022-04-23,70043,70039,Blue,0,49107,49245,138
2022-12-01,70057,70055,Blue,0,73409,73479,70
2022-01-22,70041,70838,Blue,0,51883,52016,133
2022-10-28,70055,70051,Blue,0,38663,38809,146
2022-02-24,70043,70838,Blue,0,80331,80527,196
2022-04-21,70052,70058,Blue,1,66366,66621,255
2022-08-08,70042,70050,Blue,1,58358,58824,466
2022-05-11,70057,70049,Blue,0,42998,43396,398
2022-11-01,70057,70051,Blue,0,42211,42470,259
2022-10-29,70040,70060,Blue,1,49156,50165,1009
2022-02-26,70044,70050,Blue,1,55825,56177,352
2022-12-14,70038,70056,Blue,1,45571,46437,866
2022-12-06,70044,70060,Blue,1,50540,51420,880
2022-12-05,70038,70048,Blue,1,68476,68933,457
2022-07-02,70040,70042,Blue,1,83835,83871,36
2022-09-07,70040,70042,Blue,1,32995,33030,35
2022-02-05,70049,70047,Blue,0,56192,56246,54
2022-12-05,70045,70039,Blue,0,65733,65971,238
2022-11-05,70046,70054,Blue,1,74376,74893,517
2022-03-28,70059,70057,Blue,0,61709,61745,36
2022-03-18,70046,70048,Blue,1,45616,45716,100
2022-01-18,70038,70048,Blue,1,28453,29049,596
2022-07-25,70047,70039,Blue,0,20169,20657,488
2022-10-30,70047,70838,Blue,0,57124,57643,519
2022-07-06,70054,70056,Blue,1,73138,73200,62
2022-12-13,70050,70054,Blue,1,32138,32397,259
2022-11-17,70042,70052,Blue,1,23205,23801,596
2022-06-29,70041,70039,Blue,0,35979,36012,33
2022-12-04,70053,70043,Blue,0,84878,85470,592
2022-01-14,70047,70039,Blue,0,39905,40340,435
2022-10-11,70059,70039,Blue,0,21614,22746,1132
2022-03-29,70038,70056,Blue,1,21117,22089,972
2022-10-18,70059,70049,Blue,0,24748,25234,486
2022-02-03,70048,70060,Blue,1,49142,49747,605
2022-07-23,70057,70039,Blue,0,65853,66787,934
2022-06-18,70059,70838,Blue,0,81583,82698,1115
2022-08-29,70043,70838,Blue,0,62238,62459,221
2022-07-20,70038,70040,Blue,1,50228,50245,17
2022-11-18,70040,70050,Blue,1,48734,49230,496
2022-08-23,70057,70041,Blue,0,32259,33144,885
2022-10-22,70042,70052,Blue,1,61184,61761,577
2022-10-02,70042,70054,Blue,1,78152,78880,728
2022-10-18,70057,70053,Blue,0,78219,78366,147
2022-02-09,70046,70054,Blue,1,84822,85315,493
2022-08-29,70055,70041,Blue,0,68246,68967,721
2022-06-15,70059,70057,Blue,0,84015,84052,37
2022-04-14,70044,70058,Blue,1,21271,22061,790
2022-06-14,70047,70043,Blue,0,27669,27965,296
2022-09-12,70043,70039,Blue,0,69541,69643,102
2022-02-01,70046,70060,Blue,1,68063,69421,1358
2022-03-29,70044,70060,Blue,1,25685,26610,925
2022-10-28,70049,70047,Blue,0,43807,43869,62
2022-04-17,70039,70838,Blue,0,30314,30349,35
2022-09-11,70047,70838,Blue,0,76096,76611,515
2022-10-31,70047,70041,Blue,0,27057,27434,377
2022-09-13,70059,70043,Blue,0,73332,74144,812
2022-04-12,70054,70056,Blue,1,43007,43054,47
2022-07-14,70038,70056,Blue,1,38172,39151,979
2022-02-19,70047,70039,Blue,0,73098,73486,388
2022-02-24,70041,70838,Blue,0,58298,58424,126
2022-10-12,70045,70039,Blue,0,35776,36050,274
2022-12-18,70046,70058,Blue,1,51418,52069,651
2022-01-08,70059,70053,Blue,0,39569,39841,272
2022-07-18,70045,70043,Blue,0,68993,69087,94
2022-08-31,70050,70060,Blue,1,27133,27693,560
2022-01-14,70038,70056,Blue,1,70599,71541,942
2022-01-21,70057,70039,Blue,0,21075,22025,950
2022-12-30,70045,70838,Blue,0,62167,62584,417
2022-12-20,70057,70039,Blue,0,41833,42892,1059
2022-02-20,70057,70838,Blue,0,49049,50087,1038
2022-12-31,70044,70054,Blue,1,44986,45582,596
2022-01-07,70057,70041,Blue,0,24663,25734,1071
2022-01-28,70043,70039,Blue,0,21210,21318,108
2022-03-28,70048,70050,Blue,1,25980,26047,67
2022-02-16,70045,70043,Blue,0,66458,66582,124
2022-07-08,70049,70838,Blue,0,53567,54204,637
2022-09-30,70049,70045,Blue,0,36407,36615,208
2022-06-21,70055,70043,Blue,0,85169,85856,687
2022-08-08,70040,70052,Blue,1,85026,85714,688
2022-01-06,70047,70838,Blue,0,60571,61090,519
2022-03-05,70045,70838,Blue,0,66730,67055,325
2022-06-21,70053,70039,Blue,0,75224,75981,757
2022-06-25,70042,70056,Blue,1,67773,68718,945
2022-07-31,70040,70048,Blue,1,77010,77405,395
2022-01-21,70040,70050,Blue,1,66499,67002,503
2022-09-22,70053,70041,Blue,0,54873,55548,675
2022-04-15,70046,70050,Blue,1,70207,70381,174
2022-10-05,70055,70039,Blue,0,83918,84731,813
2022-10-28,70055,70043,Blue,0,32011,32693,682
2022-11-19,70053,70043,Blue,0,36527,37143,616
2022-02-28,70049,70047,Blue,0,31368,31422,54
2022-11-10,70050,70052,Blue,1,50928,51041,113
2022-12-10,70055,70838,Blue,0,67221,68137,916
2022-04-26,70051,70047,Blue,0,50463,50685,222
2022-07-30,70046,70050,Blue,1,55421,55607,186
2022-01-24,70057,70039,Blue,0,29433,30597,1164
2022-04-07,70045,70041,Blue,0,79101,79264,163
2022-04-24,70050,70054,Blue,1,29930,30175,245
2022-10-05,70051,70041,Blue,0,74183,74744,561
2022-11-22,70059,70049,Blue,0,40037,40523,486
2022-08-12,70048,70052,Blue,1,70750,70953,203
2022-11-17,70047,70039,Blue,0,44771,45198,427
2022-10-13,70053,70838,Blue,0,35709,36665,956
2022-03-24,70056,70060,Blue,1,24357,24544,187
2022-09-14,70059,70041,Blue,0,22578,23586,1008
2022-06-15,70045,70039,Blue,0,63183,63480,297
2022-02-22,70047,70838,Blue,0,61467,62016,549
2022-06-26,70057,70041,Blue,0,57739,58623,884
2022-03-10,70059,70053,Blue,0,56594,56818,224
2022-07-01,70040,70058,Blue,1,35427,36465,1038
2022-11-07,70049,70047,Blue,0,43002,43077,75
2022-01-07,70059,70049,Blue,0,79457,79942,485
2022-03-23,70038,70042,Blue,1,43513,43605,92
2022-11-05,70059,70047,Blue,0,86534,87082,548
2022-10-09,70045,70838,Blue,0,53594,53985,391
2022-07-27,70047,70041,Blue,0,72361,72670,309
2022-09-27,70059,70039,Blue,0,46899,47994,1095
2022-03-02,70049,70039,Blue,0,88628,89454,826
2022-12-22,70040,70060,Blue,1,52704,53806,1102
2022-04-28,70049,70047,Blue,0,30258,30322,64
2022-03-04,70057,70053,Blue,0,42762,42960,198
2022-08-29,70054,70058,Blue,1,53218,53386,168
2022-03-18,70055,70045,Blue,0,70153,70681,528
2022-02-07,70059,70047,Blue,0,63792,64359,567
2022-06-18,70045,70838,Blue,0,48009,48372,363
2022-11-02,70044,70060,Blue,1,67598,68484,886
2022-10-24,70044,70058,Blue,1,66082,66857,775
2022-01-22,70040,70058,Blue,1,48076,49050,974
2022-01-06,70051,70041,Blue,0,65406,65962,556
2022-08-06,70059,70047,Blue,0,23475,24018,543
2022-09-12,70053,70045,Blue,0,52761,53172,411
2022-11-25,70059,70041,Blue,0,54378,55257,879
2022-10-14,70053,70039,Blue,0,38748,39483,735
2022-06-24,70049,70047,Blue,0,33259,33315,56
2022-08-24,70042,70050,Blue,1,77479,77915,436
2022-03-06,70040,70060,Blue,1,67278,68411,1133
2022-04-21,70050,70056,Blue,1,32798,33144,346
2022-11-21,70052,70060,Blue,1,22224,22612,388
2022-03-27,70057,70045,Blue,0,42868,43496,628
2022-08-15,70055,70049,Blue,0,59955,60220,265
2022-12-20,70051,70047,Blue,0,77837,78030,193
2022-06-21,70044,70046,Blue,1,66894,67021,127
2022-07-13,70044,70058,Blue,1,28956,29818,862
2022-11-17,70046,70048,Blue,1,69331,69400,69
2022-08-15,70056,70058,Blue,1,87028,87101,73
2022-06-23,70048,70058,Blue,1,44364,44982,618
2022-01-28,70051,70039,Blue,0,68815,69421,606
2022-09-06,70053,70043,Blue,0,80265,80835,570
2022-04-20,70053,70039,Blue,0,74014,74846,832
2022-07-19,70057,70055,Blue,0,31055,31124,69
2022-03-21,70038,70056,Blue,1,74675,75584,909
2022-12-20,70059,70045,Blue,0,57420,58090,670
2022-08-02,70047,70039,Blue,0,20634,21086,452
2022-11-10,70044,70050,Blue,1,82236,82595,359
2022-12-25,70049,70039,Blue,0,81373,81862,489
2022-03-03,70038,70040,Blue,1,59230,59245,15
2022-06-15,70057,70049,Blue,0,67945,68321,376
2022-10-16,70052,70054,Blue,1,26872,26926,54
2022-02-13,70042,70056,Blue,1,59848,60616,768
2022-10-24,70044,70048,Blue,1,36131,36512,381
2022-04-08,70055,70041,Blue,0,62766,63477,711
2022-09-09,70042,70050,Blue,1,25437,25838,401
2022-07-07,70044,70054,Blue,1,74886,75543,657
2022-10-13,70053,70838,Blue,0,68516,69331,815
2022-01-27,70040,70054,Blue,1,59618,60432,814
2022-07-31,70042,70048,Blue,1,74948,75257,309
2022-01-19,70056,70058,Blue,1,25580,25653,73
2022-07-28,70042,70054,Blue,1,31221,32012,791
2022-05-21,70059,70043,Blue,0,53126,54173,1047
2022-06-14,70059,70043,Blue,0,29357,30262,905
2022-07-14,70038,70054,Blue,1,21376,22226,850
2022-07-04,70059,70055,Blue,0,30319,30468,149
2022-11-22,70050,70060,Blue,1,26288,26818,530
2022-09-07,70038,70048,Blue,1,30362,30782,420
2022-02-07,70045,70043,Blue,0,21928,22015,87
2022-05-06,70059,70047,Blue,0,58515,59138,623
2022-07-26,70050,70060,Blue,1,57779,58420,641
2022-12-28,70044,70050,Blue,1,65952,66295,343
2022-12-09,70053,70047,Blue,0,52240,52539,299
2022-04-19,70057,70049,Blue,0,75559,75982,423
2022-12-02,70050,70060,Blue,1,78949,79469,520
2022-09-29,70040,70058,Blue,1,73238,74181,943
2022-09-13,70049,70039,Blue,0,34441,34971,530
2022-12-22,70057,70051,Blue,0,47694,47939,245
2022-09-04,70050,70060,Blue,1,84373,84909,536
2022-04-09,70042,70050,Blue,1,38490,38953,463
2022-02-17,70051,70838,Blue,0,62105,62854,749
2022-02-14,70049,70045,Blue,0,22983,23200,217
2022-01-26,70050,70056,Blue,1,27575,27878,303
2022-01-02,70054,70058,Blue,1,63865,64028,163
2022-07-12,70048,70050,Blue,1,71584,71643,59
2022-06-12,70042,70060,Blue,1,28655,29681,1026
2022-03-02,70053,70047,Blue,0,32988,33272,284
2022-10-29,70044,70058,Blue,1,32004,32723,719
2022-07-03,70059,70051,Blue,0,82215,82548,333
2022-06-15,70057,70041,Blue,0,33362,34311,949
2022-06-24,70055,70047,Blue,0,72307,72666,359
2022-03-26,70057,70043,Blue,0,28245,29056,811
2022-10-03,70050,70054,Blue,1,55772,55980,208
2022-02-27,70057,70041,Blue,0,69027,69862,835
2022-07-14,70051,70039,Blue,0,47711,48350,639
2022-03-01,70044,70050,Blue,1,30775,31140,365
2022-07-01,70051,70045,Blue,0,58483,58823,340
2022-08-01,70048,70050,Blue,1,47734,47793,59
2022-12-20,70040,70048,Blue,1,75235,75600,365
2022-05-17,70059,70051,Blue,0,33099,33419,320
2022-01-27,70051,70041,Blue,0,75837,76377,540
2022-08-28,70040,70052,Blue,1,33974,34582,608
2022-02-24,70049,70041,Blue,0,60145,60692,547
2022-01-27,70042,70048,Blue,1,60581,60876,295
2022-11-02,70046,70054,Blue,1,62157,62600,443
2022-02-08,70051,70045,Blue,0,56690,57038,348
2022-10-14,70053,70043,Blue,0,56461,57051,590
2022-10-06,70044,70056,Blue,1,57341,58051,710
2022-02-01,70056,70058,Blue,1,43960,44037,77
2022-01-24,70046,70060,Blue,1,89510,90213,703
2022-12-24,70054,70056,Blue,1,67210,67257,47
2022-07-01,70059,70047,Blue,0,26775,27330,555
2022-04-24,70059,70049,Blue,0,34754,35220,466
2022-02-10,70051,70045,Blue,0,28589,28921,332
2022-02-27,70051,70045,Blue,0,54748,55093,345
2022-12-20,70046,70052,Blue,1,66537,66872,335
2022-10-12,70057,70838,Blue,0,30666,31788,1122
2022-04-20,70048,70060,Blue,1,24464,25226,762
2022-03-26,70050,70056,Blue,1,27607,27898,291
2022-12-30,70055,70041,Blue,0,75844,76504,660
2022-07-22,70046,70060,Blue,1,27262,28030,768
2022-01-20,70059,70051,Blue,0,34693,35069,376
2022-03-22,70054,70058,Blue,1,89942,90092,150
2022-12-09,70042,70060,Blue,1,70177,71147,970
2022-05-03,70054,70056,Blue,1,70788,70838,50
2022-01-03,70044,70054,Blue,1,28071,28688,617
2022-02-01,70038,70056,Blue,1,67029,67916,887
2022-10-17,70049,70047,Blue,0,23565,23621,56
2022-02-22,70052,70054,Blue,1,21907,21965,58
2022-11-30,70047,70045,Blue,0,22024,22121,97
2022-01-23,70051,70049,Blue,0,68249,68354,105
2022-01-24,70059,70053,Blue,0,65892,66147,255
2022-02-19,70042,70044,Blue,1,89292,89327,35
2022-07-16,70048,70058,Blue,1,35110,35879,769
2022-06-15,70051,70049,Blue,0,35637,35739,102
2022-01-17,70059,70049,Blue,0,27621,28122,501
2022-03-09,70040,70048,Blue,1,55683,56053,370
2022-10-11,70048,70058,Blue,1,25431,25951,520
2022-02-25,70053,70043,Blue,0,23084,23793,709
2022-07-05,70042,70052,Blue,1,57807,58450,643
2022-02-14,70054,70056,Blue,1,23902,23950,48
2022-04-08,70059,70051,Blue,0,55719,56038,319
2022-02-18,70049,70043,Blue,0,24200,24579,379
2022-02-10,70055,70051,Blue,0,45681,45843,162
2022-02-16,70050,70056,Blue,1,23962,24260,298
2022-02-13,70051,70043,Blue,0,28898,29425,527
2022-08-13,70059,70041,Blue,0,82286,83195,909
2022-12-09,70059,70055,Blue,0,31946,32099,153
2022-07-16,70045,70838,Blue,0,66164,66540,376
2022-03-04,70059,70049,Blue,0,84012,84493,481
2022-10-11,70059,70051,Blue,0,80469,80804,335
2022-01-10,70042,70058,Blue,1,55659,56781,1122
2022-10-27,70038,70048,Blue,1,66436,67027,591
2022-06-17,70040,70058,Blue,1,35236,36342,1106
2022-02-25,70046,70056,Blue,1,54886,55496,610
2022-05-10,70059,70047,Blue,0,58642,59292,650
2022-06-16,70047,70043,Blue,0,30869,31153,284
2022-12-02,70059,70051,Blue,0,20417,20745,328
2022-04-22,70038,70050,Blue,1,67334,67935,601
2022-07-03,70059,70045,Blue,0,26956,27646,690
2022-02-10,70042,70054,Blue,1,66893,67511,618
2022-07-01,70050,70060,Blue,1,82106,82978,872
2022-01-22,70057,70047,Blue,0,64959,65458,499
2022-08-05,70047,70041,Blue,0,56772,57143,371
2022-10-17,70040,70060,Blue,1,45690,46785,1095
2022-10-25,70046,70050,Blue,1,77720,77902,182
2022-03-13,70052,70058,Blue,1,24098,24374,276
2022-04-15,70057,70049,Blue,0,62075,62460,385
2022-08-19,70038,70046,Blue,1,24490,24835,345
2022-10-05,70047,70045,Blue,0,71274,71389,115
2022-12-14,70055,70045,Blue,0,57451,58110,659
2022-01-17,70050,70058,Blue,1,34555,34954,399
2022-11-26,70050,70052,Blue,1,82029,82150,121
2022-10-23,70049,70041,Blue,0,62558,63014,456
2022-11-23,70056,70058,Blue,1,26139,26213,74
2022-02-04,70044,70050,Blue,1,82997,83387,390
2022-05-05,70050,70052,Blue,1,44163,44278,115
2022-03-29,70046,70052,Blue,1,61177,61522,345
2022-05-13,70052,70056,Blue,1,26655,26799,144
2022-09-24,70059,70039,Blue,0,70270,71347,1077
2022-08-15,70053,70049,Blue,0,73066,73258,192
2022-09-16,70053,70039,Blue,0,65329,66050,721
2022-02-04,70038,70054,Blue,1,58151,59187,1036
2022-11-15,70057,70051,Blue,0,47268,47517,249
2022-08-19,70059,70057,Blue,0,49397,49432,35
2022-04-13,70042,70044,Blue,1,26499,26531,32
2022-06-24,70057,70047,Blue,0,64787,65280,493
2022-11-01,70049,70043,Blue,0,20965,21340,375
2022-09-13,70052,70054,Blue,1,82820,82868,48
2022-12-14,70044,70052,Blue,1,21205,21739,534
2022-03-02,70043,70838,Blue,0,63564,63776,212
2022-11-05,70044,70056,Blue,1,89396,90138,742
2022-11-10,70040,70048,Blue,1,73216,73612,396
2022-04-10,70049,70047,Blue,0,48935,48990,55
2022-10-05,70040,70052,Blue,1,41770,42481,711
2022-10-25,70055,70838,Blue,0,62660,63660,1000
2022-08-02,70048,70054,Blue,1,72608,72934,326
2022-04-17,70042,70052,Blue,1,79873,80464,591
2022-01-20,70053,70047,Blue,0,32658,32955,297
2022-11-04,70057,70049,Blue,0,29849,30262,413
2022-09-11,70055,70053,Blue,0,34159,34205,46
2022-07-06,70055,70047,Blue,0,41062,41460,398
2022-11-06,70059,70053,Blue,0,66260,66498,238
2022-03-01,70044,70056,Blue,1,32862,33525,663
2022-04-14,70039,70838,Blue,0,34875,34916,41
2022-06-16,70059,70039,Blue,0,60532,61713,1181
2022-07-01,70051,70838,Blue,0,68289,69049,760
2022-10-24,70040,70050,Blue,1,74885,75357,472
2022-10-02,70050,70058,Blue,1,57033,57408,375
2022-08-21,70042,70044,Blue,1,39822,39851,29
2022-10-02,70057,70039,Blue,0,56628,57556,928
2022-07-27,70055,70838,Blue,0,64651,65584,933
2022-11-22,70046,70060,Blue,1,28122,28852,730
2022-08-23,70040,70056,Blue,1,75453,76242,789
2022-07-29,70057,70045,Blue,0,44799,45426,627
2022-08-25,70059,70049,Blue,0,60907,61395,488
2022-06-28,70046,70050,Blue,1,56426,56613,187
2022-08-19,70047,70041,Blue,0,74426,74768,342
2022-09-28,70050,70058,Blue,1,52567,53002,435
2022-11-23,70057,70047,Blue,0,30933,31403,470
2022-11-06,70042,70060,Blue,1,78679,79677,998
2022-12-24,70047,70043,Blue,0,27513,27744,231
2022-04-14,70044,70056,Blue,1,78266,78903,637
2022-04-10,70051,70047,Blue,0,86770,86960,190
2022-01-06,70056,70058,Blue,1,22019,22201,182
2022-02-18,70055,70045,Blue,0,50425,51025,600
2022-01-04,70057,70838,Blue,0,67585,68645,1060
2022-11-13,70049,70047,Blue,0,22948,23017,69
2022-03-31,70038,70060,Blue,1,75419,76559,1140
2022-09-02,70042,70056,Blue,1,73956,74769,813
2022-07-13,70044,70054,Blue,1,87569,88118,549
2022-06-11,70052,70054,Blue,1,23300,23364,64
2022-07-11,70040,70060,Blue,1,80948,81985,1037
2022-07-31,70042,70060,Blue,1,59824,60830,1006
2022-08-28,70051,70039,Blue,0,86757,87379,622
2022-06-15,70056,70060,Blue,1,73957,74125,168
2022-05-10,70056,70058,Blue,1,35728,35801,73
2022-03-13,70046,70056,Blue,1,43993,44533,540
2022-03-01,70046,70060,Blue,1,30671,31497,826
2022-04-19,70044,70046,Blue,1,28446,28560,114
2022-01-16,70057,70043,Blue,0,22369,23154,785
2022-12-20,70055,70039,Blue,0,26431,27361,930
2022-07-20,70045,70041,Blue,0,61556,61731,175
2022-09-21,70048,70058,Blue,1,83217,83741,524
2022-08-24,70055,70051,Blue,0,45433,45579,146
2022-12-29,70040,70046,Blue,1,28771,29028,257
2022-12-25,70045,70041,Blue,0,71492,71650,158
2022-09-07,70038,70060,Blue,1,34996,36184,1188
2022-12-28,70046,70056,Blue,1,67392,67895,503
2022-08-11,70042,70050,Blue,1,48354,48775,421
2022-10-09,70053,70838,Blue,0,87588,88393,805
2022-06-26,70053,70838,Blue,0,75172,76017,845
2022-03-21,70051,70049,Blue,0,70339,70443,104
2022-01-01,70046,70052,Blue,1,87728,88084,356
2022-04-01,70052,70060,Blue,1,68621,69029,408
2022-08-29,70059,70039,Blue,0,81077,82174,1097
2022-01-07,70042,70056,Blue,1,58815,59643,828
2022-12-08,70057,70043,Blue,0,62718,63493,775
2022-10-06,70051,70039,Blue,0,54132,54761,629
2022-11-17,70049,70043,Blue,0,46728,47066,338
2022-07-10,70052,70060,Blue,1,49635,50004,369
2022-02-08,70042,70052,Blue,1,35380,35998,618
2022-03-27,70038,70050,Blue,1,82326,82851,525
2022-11-15,70048,70050,Blue,1,68648,68706,58
2022-04-08,70046,70056,Blue,1,89516,90032,516
2022-06-14,70042,70044,Blue,1,62082,62110,28
2022-02-08,70045,70039,Blue,0,46337,46612,275
2022-12-23,70038,70048,Blue,1,24262,24732,470
2022-08-24,70053,70041,Blue,0,24689,25577,888
2022-04-09,70057,70045,Blue,0,69271,69879,608
2022-11-05,70053,70047,Blue,0,63546,63840,294
2022-09-01,70048,70054,Blue,1,43572,43902,330
2022-12-19,70049,70045,Blue,0,48604,48812,208
2022-01-17,70053,70043,Blue,0,34388,34989,601
2022-01-25,70059,70057,Blue,0,87485,87520,35
2022-10-25,70038,70046,Blue,1,59118,59446,328
2022-03-06,70059,70041,Blue,0,69523,70471,948
2022-10-25,70052,70054,Blue,1,52559,52612,53
2022-09-13,70051,70041,Blue,0,65490,66039,549
2022-06-12,70038,70042,Blue,1,26896,26981,85
2022-04-05,70059,70045,Blue,0,55092,55767,675
2022-11-05,70051,70047,Blue,0,34667,34858,191
2022-08-06,70044,70054,Blue,1,34188,34770,582
2022-04-04,70042,70044,Blue,1,59976,60004,28
2022-12-15,70057,70043,Blue,0,33877,34700,823
2022-08-28,70055,70049,Blue,0,57254,57540,286
2022-12-04,70055,70051,Blue,0,77232,77360,128
2022-04-02,70038,70042,Blue,1,34534,34627,93
2022-08-06,70044,70056,Blue,1,63361,64071,710
2022-09-22,70040,70056,Blue,1,40509,41439,930
2022-11-18,70057,70055,Blue,0,63750,63818,68
2022-01-13,70059,70838,Blue,0,34699,35914,1215
2022-07-19,70050,70054,Blue,1,42215,42448,233
2022-03-03,70053,70838,Blue,0,77448,78268,820
2022-09-10,70046,70050,Blue,1,51127,51311,184
2022-07-19,70046,70052,Blue,1,64211,64560,349
2022-12-21,70046,70058,Blue,1,57158,57785,627
2022-09-26,70055,70053,Blue,0,57920,57966,46
2022-03-11,70040,70046,Blue,1,34231,34491,260
2022-12-24,70053,70039,Blue,0,19786,20591,805
2022-03-08,70042,70054,Blue,1,38741,39551,810
2022-01-25,70057,70053,Blue,0,46710,46879,169
2022-01-02,70046,70060,Blue,1,70289,71010,721
2022-07-11,70045,70041,Blue,0,28210,28419,209
2022-02-09,70055,70045,Blue,0,32557,33126,569
2022-07-18,70050,70052,Blue,1,49853,49966,113
2022-10-28,70045,70043,Blue,0,23007,23102,95
2022-07-18,70059,70041,Blue,0,60656,61632,976
2022-04-12,70050,70056,Blue,1,24554,25038,484
2022-07-07,70044,70054,Blue,1,36031,36719,688
2022-12-18,70049,70041,Blue,0,88716,89152,436
2022-08-22,70040,70052,Blue,1,37965,38668,703
2022-01-15,70049,70041,Blue,0,70247,71121,874
2022-11-25,70048,70060,Blue,1,66337,66957,620
2022-08-28,70050,70054,Blue,1,62414,62661,247
2022-09-06,70049,70045,Blue,0,49932,50120,188
2022-01-10,70049,70043,Blue,0,40460,40779,319
2022-04-06,70057,70053,Blue,0,19583,19733,150
2022-12-14,70046,70056,Blue,1,82344,82850,506
2022-03-15,70040,70054,Blue,1,64679,65479,800
2022-09-16,70038,70044,Blue,1,76779,76947,168
2022-09-02,70038,70048,Blue,1,80368,80812,444
2022-03-25,70044,70050,Blue,1,22058,22413,355
2022-01-19,70048,70054,Blue,1,82080,82405,325
2022-12-27,70055,70049,Blue,0,65699,65980,281
2022-07-13,70051,70041,Blue,0,48762,49438,676
2022-09-22,70040,70044,Blue,1,69042,69155,113
2022-01-26,70055,70049,Blue,0,62477,62753,276
2022-10-14,70045,70041,Blue,0,49579,49751,172
2022-12-19,70051,70049,Blue,0,54202,54315,113
2022-03-11,70054,70056,Blue,1,65146,65193,47
2022-03-31,70057,70045,Blue,0,33025,33806,781
2022-09-11,70057,70049,Blue,0,61474,61861,387
2022-11-19,70049,70043,Blue,0,71338,71684,346
2022-01-18,70057,70039,Blue,0,54270,55224,954
2022-01-31,70050,70056,Blue,1,75422,75710,288
2022-01-26,70041,70838,Blue,0,39626,39756,130
2022-05-10,70049,70047,Blue,0,23530,23577,47
2022-08-29,70054,70056,Blue,1,52772,52819,47
2022-12-16,70038,70046,Blue,1,67936,68247,311
2022-03-17,70049,70043,Blue,0,81111,81448,337
2022-08-31,70048,70050,Blue,1,81766,81828,62
2022-10-29,70044,70054,Blue,1,73603,74182,579
2022-08-03,70048,70054,Blue,1,67464,67783,319
2022-10-23,70059,70047,Blue,0,83776,84314,538
2022-08-22,70054,70058,Blue,1,50791,50961,170
2022-04-04,70052,70060,Blue,1,89928,90248,320
2022-02-07,70042,70044,Blue,1,59435,59461,26
2022-11-02,70054,70060,Blue,1,43550,43807,257
2022-06-11,70038,70052,Blue,1,62701,63569,868
2022-08-20,70057,70047,Blue,0,88401,88879,478
2022-10-28,70059,70041,Blue,0,29338,30372,1034
2022-10-05,70053,70045,Blue,0,30415,30873,458
2022-03-12,70040,70050,Blue,1,78748,79258,510
2022-04-15,70044,70054,Blue,1,64279,64866,587
2022-07-17,70051,70838,Blue,0,72635,73384,749
2022-02-02,70041,70039,Blue,0,54788,54821,33
2022-09-04,70045,70041,Blue,0,52418,52587,169
2022-12-06,70042,70052,Blue,1,22877,23631,754
2022-04-22,70059,70049,Blue,0,29719,30241,522
2022-03-24,70049,70047,Blue,0,74256,74314,58
2022-09-14,70053,70041,Blue,0,48102,48766,664
2022-07-29,70050,70058,Blue,1,34915,35377,462
2022-07-21,70043,70039,Blue,0,32959,33086,127
2022-07-28,70042,70048,Blue,1,65984,66300,316
2022-05-03,70057,70051,Blue,0,75700,75960,260
2022-11-19,70048,70050,Blue,1,37126,37182,56
2022-11-17,70042,70056,Blue,1,36565,37358,793
2022-02-14,70045,70041,Blue,0,79150,79361,211
2022-10-29,70046,70054,Blue,1,64743,65198,455
2022-06-10,70047,70838,Blue,0,72626,73129,503
2022-12-14,70059,70057,Blue,0,83579,83616,37
2022-08-08,70040,70054,Blue,1,66290,67058,768
2022-09-29,70057,70051,Blue,0,32316,32558,242
2022-02-06,70042,70052,Blue,1,56163,56695,532
2022-10-25,70042,70052,Blue,1,21419,22003,584
2022-03-01,70054,70056,Blue,1,72808,72856,48
2022-07-20,70058,70060,Blue,1,82376,82436,60
2022-11-02,70046,70054,Blue,1,49043,49467,424
2022-06-18,70055,70045,Blue,0,43700,44244,544
2022-01-19,70049,70043,Blue,0,70513,70878,365
2022-12-29,70038,70060,Blue,1,20599,22060,1461
2022-08-05,70038,70052,Blue,1,75309,76061,752
2022-06-14,70054,70060,Blue,1,47878,48164,286
2022-07-15,70051,70838,Blue,0,23793,24567,774
2022-11-08,70059,70049,Blue,0,67663,68119,456
2022-02-05,70040,70058,Blue,1,32943,33887,944
2022-03-08,70048,70054,Blue,1,58045,58325,280
2022-04-12,70046,70050,Blue,1,26750,26969,219
2022-11-12,70055,70043,Blue,0,26254,27037,783
2022-03-15,70057,70055,Blue,0,54556,54625,69
2022-04-09,70059,70051,Blue,0,26609,26937,328
2022-01-10,70053,70039,Blue,0,58401,59149,748
2022-08-01,70055,70049,Blue,0,48552,48892,340
2022-06-24,70048,70052,Blue,1,47636,47844,208
2022-12-24,70038,70050,Blue,1,56722,57295,573
2022-01-25,70038,70052,Blue,1,79814,80547,733
2022-07-24,70047,70041,Blue,0,67923,68225,302
2022-04-13,70052,70058,Blue,1,24121,24398,277
2022-11-08,70048,70060,Blue,1,40457,41125,668
2022-03-04,70051,70043,Blue,0,30094,30582,488
2022-04-07,70055,70053,Blue,0,29883,29929,46
2022-03-16,70051,70045,Blue,0,80396,80721,325
2022-02-17,70048,70050,Blue,1,65461,65519,58
2022-07-26,70038,70054,Blue,1,51870,52732,862
2022-11-28,70059,70838,Blue,0,33793,34960,1167
2022-02-24,70042,70048,Blue,1,35238,35706,468
2022-12-28,70059,70838,Blue,0,48736,49849,1113
2022-04-09,70050,70052,Blue,1,60594,60700,106
2022-12-25,70045,70041,Blue,0,52965,53135,170
2022-12-29,70057,70838,Blue,0,68777,69801,1024
2022-05-20,70055,70838,Blue,0,47839,49051,1212
2022-10-13,70038,70044,Blue,1,24273,24444,171
2022-01-20,70040,70054,Blue,1,28811,29527,716
2022-12-27,70053,70041,Blue,0,61245,61915,670
2022-08-13,70040,70046,Blue,1,35668,35928,260
2022-08-24,70050,70052,Blue,1,20568,20680,112
2022-02-15,70040,70056,Blue,1,71060,71865,805
2022-03-29,70044,70046,Blue,1,79363,79464,101
2022-02-25,70052,70054,Blue,1,78886,78942,56
2022-08-29,70042,70058,Blue,1,38565,39506,941
2022-09-20,70055,70838,Blue,0,64639,65524,885
2022-10-07,70052,70056,Blue,1,49399,49550,151
2022-10-23,70057,70055,Blue,0,48511,48580,69
2022-07-17,70046,70060,Blue,1,50891,51625,734
2022-03-25,70044,70056,Blue,1,62760,63534,774
2022-08-02,70038,70046,Blue,1,89783,91293,1510
2022-09-02,70044,70060,Blue,1,40091,41000,909
2022-08-29,70055,70043,Blue,0,36079,36740,661
2022-01-06,70055,70039,Blue,0,21139,21953,814
2022-07-24,70044,70054,Blue,1,64340,64945,605
2022-03-05,70051,70838,Blue,0,65268,66008,740
2022-10-28,70059,70053,Blue,0,42617,42841,224
2022-07-23,70050,70054,Blue,1,48697,48921,224
2022-06-20,70052,70058,Blue,1,72969,73231,262
2022-01-16,70044,70054,Blue,1,39236,39822,586
2022-06-21,70046,70060,Blue,1,72527,73341,814
2022-09-30,70040,70048,Blue,1,89180,89618,438
2022-09-19,70038,70054,Blue,1,71612,72447,835
2022-03-28,70055,70047,Blue,0,56468,56833,365
2022-08-16,70049,70041,Blue,0,48344,48774,430
2022-12-19,70055,70049,Blue,0,34397,34695,298
2022-02-16,70047,70041,Blue,0,58077,58432,355
2022-04-07,70052,70056,Blue,1,73261,73399,138
2022-03-30,70049,70043,Blue,0,30511,30895,384
2022-04-15,70046,70054,Blue,1,57270,57730,460
2022-03-21,70044,70060,Blue,1,56137,57173,1036
2022-02-15,70044,70054,Blue,1,50525,51133,608
2022-10-16,70038,70048,Blue,1,47862,48298,436
2022-12-30,70055,70053,Blue,0,65430,65481,51
2022-11-24,70046,70048,Blue,1,45348,45427,79
2022-04-29,70052,70054,Blue,1,89321,89372,51
2022-02-08,70049,70041,Blue,0,77143,77612,469
2022-03-25,70044,70056,Blue,1,46026,46746,720
2022-02-15,70055,70043,Blue,0,52732,53429,697
2022-12-03,70040,70048,Blue,1,43440,43840,400
2022-10-21,70049,70838,Blue,0,47327,47937,610
2022-03-24,70045,70838,Blue,0,76238,76540,302
2022-03-10,70051,70039,Blue,0,36268,36979,711
2022-07-12,70059,70045,Blue,0,26360,27185,825
2022-12-08,70054,70060,Blue,1,55518,55835,317
2022-02-07,70047,70045,Blue,0,88699,88800,101
2022-11-15,70038,70042,Blue,1,58158,58260,102
2022-07-23,70042,70058,Blue,1,36306,37161,855
2022-09-08,70049,70043,Blue,0,20914,21260,346
2022-06-23,70059,70045,Blue,0,76455,77188,733
2022-10-24,70044,70054,Blue,1,47318,47893,575
2022-12-15,70051,70039,Blue,0,52944,53609,665
2022-01-05,70042,70050,Blue,1,28589,28984,395
2022-08-21,70049,70838,Blue,0,40680,41475,795
2022-03-14,70057,70053,Blue,0,27041,27199,158
2022-11-06,70048,70056,Blue,1,59673,60077,404
2022-07-19,70038,70044,Blue,1,70034,70237,203
2022-07-16,70044,70054,Blue,1,47939,48525,586
2022-08-05,70044,70052,Blue,1,44003,44565,562
2022-03-14,70055,70039,Blue,0,47839,48653,814
2022-06-28,70049,70041,Blue,0,64583,65006,423
2022-10-29,70043,70041,Blue,0,38270,38299,29
2022-10-22,70053,70047,Blue,0,70611,70904,293
2022-04-03,70052,70060,Blue,1,60440,60796,356
2022-04-17,70043,70041,Blue,0,75815,75844,29
2022-11-10,70049,70041,Blue,0,70165,70600,435
2022-03-12,70038,70060,Blue,1,32366,33487,1121
2022-04-13,70048,70052,Blue,1,60765,60997,232
2022-06-21,70057,70045,Blue,0,47487,48092,605
2022-02-08,70059,70041,Blue,0,43815,44888,1073
2022-09-08,70051,70049,Blue,0,58076,58176,100
2022-06-17,70057,70041,Blue,0,78983,79868,885
2022-04-24,70057,70049,Blue,0,28587,28974,387
2022-07-18,70038,70042,Blue,1,71052,71145,93
2022-03-11,70059,70055,Blue,0,65895,66036,141
2022-04-06,70042,70046,Blue,1,44889,45056,167
2022-07-19,70040,70044,Blue,1,56116,56242,126
2022-08-13,70038,70046,Blue,1,70155,70510,355
2022-10-19,70059,70043,Blue,0,31437,32439,1002
2022-12-18,70053,70051,Blue,0,76773,76828,55
2022-09-25,70044,70054,Blue,1,42729,43406,677
2022-09-21,70042,70056,Blue,1,35916,36631,715
2022-09-08,70038,70054,Blue,1,87373,88138,765
2022-05-31,70041,70838,Blue,0,66879,67003,124
2022-09-28,70046,70052,Blue,1,73564,73910,346
2022-11-30,70057,70051,Blue,0,77882,78202,320
2022-10-07,70049,70047,Blue,0,22129,22190,61
2022-05-21,70044,70050,Blue,1,85977,86389,412
2022-01-13,70047,70045,Blue,0,65360,65465,105
2022-08-09,70042,70044,Blue,1,68688,68717,29
2022-06-23,70040,70042,Blue,1,61430,61460,30
2022-04-13,70046,70056,Blue,1,68027,68591,564
2022-01-20,70045,70039,Blue,0,77919,78209,290
2022-09-09,70055,70838,Blue,0,19739,20855,1116
2022-01-12,70040,70042,Blue,1,52508,52537,29
2022-09-16,70055,70838,Blue,0,21780,22774,994
2022-01-06,70038,70042,Blue,1,60743,60838,95
2022-01-24,70040,70056,Blue,1,88724,89632,908
2022-09-10,70047,70838,Blue,0,60625,61161,536
2022-12-06,70045,70039,Blue,0,42456,42700,244
2022-02-25,70049,70039,Blue,0,33553,34130,577
2022-03-04,70059,70049,Blue,0,21471,22031,560
2022-06-18,70057,70049,Blue,0,71035,71420,385
2022-10-23,70042,70054,Blue,1,53324,53976,652
2022-01-16,70053,70047,Blue,0,61142,61432,290
2022-08-31,70050,70056,Blue,1,36530,36833,303
2022-08-07,70046,70060,Blue,1,80883,81664,781
2022-09-11,70053,70041,Blue,0,57883,58540,657
2022-07-23,70048,70056,Blue,1,51924,52324,400
2022-02-17,70047,70045,Blue,0,34906,35021,115
2022-02-26,70054,70056,Blue,1,47813,47859,46
2022-10-23,70049,70045,Blue,0,79577,79784,207
2022-04-26,70050,70052,Blue,1,74571,74680,109
2022-03-29,70041,70039,Blue,0,57876,57913,37
2022-07-21,70046,70058,Blue,1,39489,40169,680
2022-09-21,70051,70049,Blue,0,44541,44642,101
2022-06-21,70046,70060,Blue,1,79434,80271,837
2022-11-18,70045,70838,Blue,0,38057,38370,313
2022-10-29,70055,70043,Blue,0,88382,89047,665
2022-11-14,70049,70041,Blue,0,68633,69089,456
2022-03-11,70057,70838,Blue,0,60005,61038,1033
2022-01-02,70043,70041,Blue,0,41750,41781,31
2022-07-07,70057,70043,Blue,0,63828,64591,763
2022-12-09,70054,70060,Blue,1,24771,25053,282
2022-08-18,70045,70041,Blue,0,86539,86695,156
2022-06-18,70050,70058,Blue,1,51484,51905,421
2022-05-18,70053,70838,Blue,0,87744,88685,941
2022-10-18,70051,70838,Blue,0,47689,48407,718
2022-08-01,70042,70050,Blue,1,36355,36748,393
2022-09-12,70053,70051,Blue,0,53840,53901,61
2022-07-09,70059,70057,Blue,0,61650,61687,37
2022-11-04,70057,70039,Blue,0,22053,23360,1307
2022-07-26,70046,70060,Blue,1,49744,50529,785
2022-02-19,70059,70043,Blue,0,35255,36164,909
2022-03-10,70052,70058,Blue,1,64535,64795,260
2022-12-20,70044,70060,Blue,1,32092,33069,977
2022-02-14,70048,70058,Blue,1,46858,47327,469
2022-07-06,70042,70048,Blue,1,20066,20388,322
2022-07-20,70042,70054,Blue,1,35485,36180,695
2022-11-10,70042,70054,Blue,1,75937,76606,669
2022-09-21,70052,70060,Blue,1,54800,55161,361
2022-02-16,70056,70060,Blue,1,39612,39921,309
2022-12-17,70048,70050,Blue,1,56705,56760,55
2022-03-25,70054,70056,Blue,1,49572,49619,47
2022-01-17,70038,70054,Blue,1,39629,40526,897
2022-07-21,70043,70039,Blue,0,54985,55090,105
2022-03-02,70053,70838,Blue,0,29690,30632,942
2022-01-06,70059,70838,Blue,0,58398,59591,1193
2022-04-01,70053,70051,Blue,0,20502,20551,49
2022-04-22,70044,70052,Blue,1,74960,75480,520
2022-08-15,70049,70041,Blue,0,28154,28620,466
2022-12-16,70057,70039,Blue,0,62496,63486,990
2022-07-23,70054,70056,Blue,1,31918,31965,47
2022-04-14,70038,70052,Blue,1,21858,22608,750
2022-11-18,70038,70042,Blue,1,43810,43916,106
2022-11-20,70047,70045,Blue,0,37297,37387,90
2022-03-24,70042,70054,Blue,1,77181,77795,614
2022-03-18,70059,70043,Blue,0,70562,71377,815
2022-03-15,70038,70042,Blue,1,82572,82666,94
2022-10-06,70053,70047,Blue,0,84703,85029,326
2022-05-27,70041,70838,Blue,0,26646,26777,131
2022-09-29,70038,70050,Blue,1,34874,35417,543
2022-12-06,70042,70046,Blue,1,78457,78631,174
2022-03-22,70055,70047,Blue,0,84789,85148,359
2022-12-26,70059,70051,Blue,0,52217,52519,302
2022-10-25,70046,70054,Blue,1,52173,52612,439
2022-11-14,70047,70039,Blue,0,32347,32767,420
2022-12-14,70055,70838,Blue,0,35025,36126,1101
2022-01-14,70057,70041,Blue,0,38251,39184,933
2022-09-24,70044,70058,Blue,1,27212,28009,797
2022-08-02,70057,70043,Blue,0,47368,48128,760
2022-11-12,70038,70058,Blue,1,32352,33318,966
2022-09-01,70059,70047,Blue,0,54606,55163,557
2022-02-01,70053,70838,Blue,0,25348,26267,919
2022-08-27,70053,70039,Blue,0,76969,77844,875
2022-11-28,70054,70058,Blue,1,23109,23273,164
2022-07-08,70051,70049,Blue,0,22236,22340,104
2022-08-18,70044,70056,Blue,1,20176,21065,889
2022-03-31,70059,70053,Blue,0,70992,71219,227
2022-12-26,70049,70043,Blue,0,29759,30072,313
2022-01-27,70042,70048,Blue,1,52594,52884,290
2022-12-23,70046,70056,Blue,1,50153,50727,574
2022-06-24,70055,70043,Blue,0,28245,28924,679
2022-02-14,70048,70054,Blue,1,65706,66005,299
2022-08-14,70038,70046,Blue,1,58576,58916,340
2022-10-20,70050,70060,Blue,1,74863,75367,504
2022-03-14,70044,70046,Blue,1,52159,52269,110
2022-11-16,70053,70043,Blue,0,55373,55960,587
2022-04-04,70055,70838,Blue,0,61879,62891,1012
2022-12-12,70040,70048,Blue,1,50296,50678,382
2022-03-18,70038,70040,Blue,1,55639,55656,17
2022-08-09,70049,70039,Blue,0,74897,75383,486
2022-09-15,70057,70043,Blue,0,22231,23039,808
2022-02-06,70053,70049,Blue,0,85795,85983,188
2022-09-08,70048,70060,Blue,1,21650,22317,667
2022-06-30,70055,70049,Blue,0,64167,64445,278
2022-01-21,70043,70039,Blue,0,67708,67815,107
2022-12-15,70049,70043,Blue,0,69674,70052,378
2022-05-08,70050,70054,Blue,1,48503,48730,227
2022-04-22,70054,70056,Blue,1,35408,35457,49
2022-04-12,70055,70045,Blue,0,21871,22428,557
2022-08-28,70040,70046,Blue,1,68367,68627,260
2022-03-30,70057,70047,Blue,0,56368,56853,485
2022-04-15,70059,70053,Blue,0,47670,47914,244
2022-02-15,70046,70056,Blue,1,30324,30863,539
2022-02-02,70042,70060,Blue,1,59396,60943,1547
2022-03-07,70044,70054,Blue,1,79445,80056,611
2022-05-06,70050,70052,Blue,1,52287,52401,114
2022-11-28,70040,70046,Blue,1,33255,33518,263
2022-03-30,70052,70060,Blue,1,36509,36924,415
2022-12-31,70040,70042,Blue,1,37270,37308,38
2022-03-14,70042,70058,Blue,1,35817,36755,938
2022-06-09,70059,70053,Blue,0,28458,28715,257
2022-07-30,70056,70060,Blue,1,33304,33477,173
2022-06-17,70041,70838,Blue,0,63639,63758,119
2022-08-23,70052,70054,Blue,1,85110,85186,76
2022-11-28,70038,70058,Blue,1,28164,29246,1082
2022-03-10,70050,70054,Blue,1,28433,28660,227
2022-02-06,70053,70043,Blue,0,54123,54743,620
2022-02-25,70053,70043,Blue,0,41837,42463,626
2022-07-10,70051,70047,Blue,0,55858,56065,207
2022-02-14,70047,70039,Blue,0,65027,65484,457
2022-02-27,70038,70040,Blue,1,72610,72629,19
2022-08-18,70058,70060,Blue,1,79913,79977,64
2022-07-16,70042,70050,Blue,1,47207,47608,401
2022-12-20,70049,70045,Blue,0,40329,40569,240
2022-12-08,70055,70041,Blue,0,45448,46185,737
2022-04-01,70057,70043,Blue,0,37101,37902,801
2022-12-07,70055,70047,Blue,0,31488,31892,404
2022-03-08,70047,70039,Blue,0,48813,49202,389
2022-09-13,70047,70045,Blue,0,88756,88839,83
2022-09-14,70049,70039,Blue,0,52447,52962,515
2022-03-21,70059,70047,Blue,0,77174,77786,612
2022-07-09,70051,70045,Blue,0,58225,58575,350
2022-05-27,70040,70050,Blue,1,39403,40053,650
2022-08-13,70059,70049,Blue,0,40587,41074,487
2022-10-05,70042,70054,Blue,1,24665,25337,672
2022-04-28,70052,70054,Blue,1,44604,44650,46
2022-07-02,70055,70043,Blue,0,38064,38727,663
2022-11-14,70048,70052,Blue,1,40928,41135,207
2022-01-11,70041,70838,Blue,0,24167,24335,168
2022-10-11,70052,70060,Blue,1,81963,82328,365
2022-05-25,70042,70046,Blue,1,72686,72873,187
2022-01-19,70046,70056,Blue,1,85725,86191,466
2022-06-15,70042,70050,Blue,1,57700,58187,487
2022-07-14,70051,70049,Blue,0,57555,57657,102
2022-08-16,70043,70039,Blue,0,79174,79273,99
2022-10-20,70042,70054,Blue,1,39992,40792,800
2022-06-29,70057,70041,Blue,0,22075,23050,975
2022-03-08,70038,70044,Blue,1,33866,34046,180
2022-03-03,70042,70060,Blue,1,56677,57775,1098
2022-04-14,70047,70838,Blue,0,51678,52355,677
2022-03-16,70040,70042,Blue,1,29398,29428,30
2022-12-29,70059,70047,Blue,0,75672,76190,518
2022-07-20,70042,70048,Blue,1,44681,45004,323
2022-03-18,70053,70043,Blue,0,86547,87080,533
2022-04-04,70040,70044,Blue,1,24440,24566,126
2022-02-19,70042,70052,Blue,1,73067,73620,553
2022-03-12,70045,70039,Blue,0,67276,67512,236
2022-07-06,70042,70056,Blue,1,35218,36104,886
2022-07-01,70044,70052,Blue,1,24200,24751,551
2022-07-15,70046,70054,Blue,1,55373,55839,466
2022-08-28,70059,70838,Blue,0,79765,80822,1057
2022-10-22,70057,70047,Blue,0,46588,47062,474
2022-07-29,70042,70060,Blue,1,42581,43600,1019
2022-01-03,70046,70056,Blue,1,64050,64585,535
2022-03-01,70059,70057,Blue,0,25457,25492,35
2022-11-19,70055,70051,Blue,0,27311,27447,136
2022-08-17,70049,70041,Blue,0,28546,29095,549
2022-12-08,70055,70051,Blue,0,47472,47610,138
2022-04-11,70053,70051,Blue,0,78572,78628,56
2022-07-12,70046,70056,Blue,1,40329,41064,735
2022-06-29,70051,70838,Blue,0,79693,80392,699
2022-01-16,70053,70051,Blue,0,43090,43148,58
2022-11-14,70056,70060,Blue,1,29926,30120,194
2022-10-20,70044,70054,Blue,1,62503,63118,615
2022-12-13,70042,70058,Blue,1,42857,43748,891
2022-07-31,70051,70838,Blue,0,76879,77632,753
2022-08-03,70046,70058,Blue,1,58851,59486,635
2022-03-26,70048,70056,Blue,1,78018,78492,474
2022-08-04,70059,70043,Blue,0,22160,23028,868
2022-10-24,70040,70060,Blue,1,53408,54444,1036
2022-04-01,70052,70058,Blue,1,85021,85265,244
2022-10-13,70043,70041,Blue,0,56236,56263,27
2022-07-30,70046,70048,Blue,1,53796,53876,80
2022-07-30,70054,70056,Blue,1,76935,76983,48
2022-03-02,70042,70056,Blue,1,40293,41024,731
2022-01-10,70050,70054,Blue,1,87210,87425,215
2022-07-13,70038,70042,Blue,1,63795,63907,112
2022-06-29,70042,70050,Blue,1,52212,52675,463
2022-01-15,70050,70058,Blue,1,22917,23343,426
2022-12-11,70055,70838,Blue,0,41665,42561,896
2022-08-28,70054,70058,Blue,1,82589,82750,161
2022-01-19,70043,70041,Blue,0,80331,80359,28
2022-12-14,70044,70050,Blue,1,40051,40369,318
2022-11-10,70048,70052,Blue,1,53959,54408,449
2022-06-21,70049,70043,Blue,0,21436,21842,406
2022-11-16,70057,70049,Blue,0,33534,33987,453
2022-03-10,70059,70047,Blue,0,62595,63142,547
2022-12-04,70052,70056,Blue,1,83719,83855,136
2022-03-17,70057,70043,Blue,0,27926,28659,733
2022-12-09,70048,70052,Blue,1,26563,26780,217
2022-06-17,70044,70046,Blue,1,26254,26383,129
2022-01-31,70058,70060,Blue,1,81559,81621,62
2022-10-07,70054,70056,Blue,1,51108,51154,46
2022-04-14,70051,70039,Blue,0,23196,23981,785
2022-11-29,70044,70052,Blue,1,52061,52550,489
2022-09-26,70048,70054,Blue,1,20418,20739,321
2022-01-17,70042,70050,Blue,1,24446,24904,458
2022-10-12,70059,70053,Blue,0,42233,42474,241
2022-12-21,70059,70838,Blue,0,69601,70688,1087
2022-09-23,70048,70052,Blue,1,65044,65252,208
2022-02-18,70044,70058,Blue,1,36100,36991,891
2022-10-10,70047,70045,Blue,0,65321,65411,90
2022-11-11,70053,70045,Blue,0,25871,26351,480
2022-10-20,70057,70043,Blue,0,65152,65925,773
2022-03-22,70047,70838,Blue,0,71643,72228,585
2022-10-21,70055,70053,Blue,0,31470,31517,47
2022-11-01,70042,70050,Blue,1,45301,45721,420
2022-08-29,70041,70039,Blue,0,41566,41596,30
2022-02-10,70040,70050,Blue,1,22261,22721,460
2022-06-01,70040,70048,Blue,1,40958,41419,461
2022-10-13,70046,70056,Blue,1,27318,27835,517
2022-03-16,70042,70046,Blue,1,67218,67437,219
2022-08-16,70048,70056,Blue,1,58323,58772,449
2022-01-06,70044,70048,Blue,1,61532,61768,236
2022-05-25,70042,70044,Blue,1,63380,63411,31
2022-03-24,70055,70049,Blue,0,75670,75939,269
2022-01-05,70057,70047,Blue,0,59987,60552,565
2022-02-24,70048,70050,Blue,1,70020,70092,72
2022-06-21,70059,70047,Blue,0,37935,38675,740
2022-07-08,70051,70838,Blue,0,38977,39773,796
2022-11-11,70048,70054,Blue,1,45170,45480,310
2022-01-06,70040,70044,Blue,1,71495,71615,120
2022-08-28,70051,70043,Blue,0,54205,54728,523
2022-02-23,70047,70041,Blue,0,74373,74714,341
2022-01-20,70052,70054,Blue,1,73848,73906,58
2022-07-13,70038,70060,Blue,1,21958,23087,1129
2022-05-19,70051,70838,Blue,0,33306,34191,885
2022-04-23,70052,70054,Blue,1,34274,34317,43
2022-08-07,70049,70041,Blue,0,86379,86854,475
2022-08-24,70053,70838,Blue,0,64391,65322,931
2022-05-12,70059,70047,Blue,0,20486,21086,600
2022-02-09,70059,70047,Blue,0,58418,59060,642
2022-03-22,70038,70060,Blue,1,42375,43673,1298
2022-02-18,70055,70039,Blue,0,27148,28081,933
2022-05-08,70056,70060,Blue,1,53529,53708,179
2022-12-01,70057,70045,Blue,0,42285,42936,651
2022-04-24,70042,70044,Blue,1,66250,66281,31
2022-01-21,70052,70060,Blue,1,23103,23487,384
2022-08-25,70043,70039,Blue,0,54120,54236,116
2022-03-04,70055,70045,Blue,0,52701,53249,548
2022-04-05,70053,70041,Blue,0,65853,66487,634
2022-06-14,70040,70050,Blue,1,33641,34207,566
2022-10-14,70039,70838,Blue,0,67272,67336,64
2022-02-22,70059,70055,Blue,0,46094,46237,143
2022-02-06,70042,70056,Blue,1,37856,38596,740
2022-03-22,70039,70838,Blue,0,22915,22958,43
2022-09-22,70055,70043,Blue,0,56383,57092,709
2022-10-04,70042,70052,Blue,1,75355,75909,554
2022-08-20,70053,70049,Blue,0,72705,72932,227
2022-11-02,70040,70046,Blue,1,67090,67352,262
2022-03-03,70057,70045,Blue,0,44432,45198,766
2022-03-24,70051,70049,Blue,0,31549,31660,111
2022-07-22,70059,70057,Blue,0,82813,82849,36
2022-01-23,70050,70056,Blue,1,82392,82699,307
2022-12-13,70053,70049,Blue,0,52262,52491,229
2022-07-19,70039,70838,Blue,0,21075,21111,36
2022-09-06,70057,70043,Blue,0,57273,58049,776
2022-02-22,70053,70041,Blue,0,49499,50197,698
2022-09-15,70040,70042,Blue,1,74500,74529,29
2022-12-17,70055,70041,Blue,0,38057,38974,917
2022-09-30,70052,70060,Blue,1,20657,21022,365
2022-06-11,70038,70052,Blue,1,39371,40149,778
2022-07-15,70042,70044,Blue,1,67133,67162,29
2022-05-03,70051,70049,Blue,0,74847,74949,102
2022-04-08,70059,70043,Blue,0,25756,26703,947
2022-05-14,70055,70053,Blue,0,51210,51256,46
2022-07-14,70054,70060,Blue,1,41985,42248,263
2022-07-03,70048,70056,Blue,1,55869,56291,422
2022-11-11,70040,70044,Blue,1,61222,61339,117
2022-08-04,70040,70042,Blue,1,33286,33320,34
2022-09-05,70049,70041,Blue,0,29011,29455,444
2022-07-20,70051,70043,Blue,0,43028,43548,520
2022-06-18,70057,70043,Blue,0,42304,43068,764
2022-10-10,70050,70058,Blue,1,33252,33659,407
2022-01-04,70046,70054,Blue,1,21182,21792,610
2022-07-18,70040,70042,Blue,1,76358,76389,31
2022-11-25,70058,70060,Blue,1,74206,74270,64
2022-04-18,70051,70045,Blue,0,50077,50496,419
2022-03-31,70038,70048,Blue,1,20709,21214,505
2022-08-10,70050,70054,Blue,1,51924,52167,243
2022-10-01,70050,70058,Blue,1,36175,36578,403
2022-08-23,70038,70052,Blue,1,66738,67550,812
2022-07-13,70050,70054,Blue,1,33895,34126,231
2022-07-23,70040,70046,Blue,1,61585,61857,272
2022-08-03,70040,70056,Blue,1,19961,20790,829
2022-09-30,70050,70060,Blue,1,29168,29648,480
2022-07-07,70045,70043,Blue,0,67570,67671,101
2022-07-02,70041,70838,Blue,0,21204,21331,127
2022-04-15,70044,70058,Blue,1,73166,74022,856
2022-08-19,70050,70058,Blue,1,65466,65901,435
2022-03-05,70059,70041,Blue,0,43810,44725,915
2022-03-22,70049,70047,Blue,0,23237,23300,63
2022-04-19,70048,70054,Blue,1,55161,55471,310
2022-10-28,70047,70039,Blue,0,30432,30872,440
2022-03-07,70053,70039,Blue,0,34548,35343,795
2022-06-27,70044,70060,Blue,1,55694,56810,1116
2022-11-28,70052,70060,Blue,1,52174,52535,361
2022-02-09,70044,70056,Blue,1,32873,33570,697
2022-02-11,70052,70060,Blue,1,22347,22787,440
2022-06-25,70051,70039,Blue,0,84615,85338,723
2022-09-15,70053,70045,Blue,0,42674,43690,1016
2022-12-19,70050,70052,Blue,1,37748,37868,120
2022-03-30,70049,70041,Blue,0,65475,65885,410
2022-05-13,70055,70047,Blue,0,37097,37525,428
2022-11-02,70051,70047,Blue,0,58071,58253,182
2022-04-08,70048,70054,Blue,1,27500,27818,318
2022-08-04,70059,70041,Blue,0,61876,62871,995
2022-09-26,70041,70039,Blue,0,46847,46883,36
2022-04-06,70040,70050,Blue,1,50388,50963,575
2022-03-23,70052,70060,Blue,1,47743,48132,389
2022-02-20,70041,70838,Blue,0,44396,44510,114
2022-12-30,70054,70056,Blue,1,80453,80500,47
2022-01-26,70059,70043,Blue,0,53594,55189,1595
2022-10-07,70047,70041,Blue,0,47879,48206,327
2022-06-26,70044,70054,Blue,1,51842,52506,664
2022-09-11,70042,70044,Blue,1,86548,86577,29
2022-02-19,70042,70060,Blue,1,76288,77292,1004
2022-08-07,70038,70042,Blue,1,85526,85622,96
2022-08-22,70059,70053,Blue,0,49940,50166,226
2022-04-12,70046,70054,Blue,1,63792,64197,405
2022-09-24,70057,70053,Blue,0,48211,48361,150
2022-09-08,70057,70053,Blue,0,66089,66240,151
2022-07-15,70043,70039,Blue,0,61941,62070,129
2022-11-22,70057,70053,Blue,0,53191,53358,167
2022-12-30,70053,70838,Blue,0,86636,87478,842
2022-08-14,70050,70060,Blue,1,29817,30366,549
2022-01-13,70051,70045,Blue,0,35634,35998,364
2022-01-02,70050,70056,Blue,1,79634,79913,279
2022-02-16,70044,70056,Blue,1,23262,23984,722
2022-03-17,70053,70047,Blue,0,31169,31474,305
2022-07-10,70055,70051,Blue,0,59973,60107,134
2022-11-25,70059,70047,Blue,0,66554,67092,538
2022-08-04,70057,70041,Blue,0,64532,65354,822
2022-09-23,70043,70039,Blue,0,33070,33185,115
2022-04-20,70040,70054,Blue,1,44717,45421,704
2022-07-08,70053,70051,Blue,0,58489,58545,56
2022-12-27,70046,70056,Blue,1,30132,30721,589
2022-01-15,70041,70838,Blue,0,46668,46802,134
2022-01-04,70040,70054,Blue,1,23483,24260,777
2022-03-26,70046,70048,Blue,1,72373,72458,85
2022-03-05,70050,70054,Blue,1,39398,39587,189
2022-05-13,70058,70060,Blue,1,21628,21696,68
2022-08-11,70038,70050,Blue,1,43190,43771,581
2022-09-13,70045,70043,Blue,0,64724,64827,103
2022-11-11,70050,70052,Blue,1,42645,42753,108
2022-09-16,70041,70039,Blue,0,50973,51004,31
2022-06-22,70057,70045,Blue,0,28371,29032,661
2022-03-21,70054,70056,Blue,1,80261,80307,46
2022-12-18,70056,70058,Blue,1,46987,47058,71
2022-11-23,70040,70050,Blue,1,38664,39168,504
2022-12-09,70046,70060,Blue,1,68864,69638,774
2022-10-17,70059,70045,Blue,0,55990,56678,688
2022-01-07,70046,70054,Blue,1,67696,68130,434
2022-09-07,70049,70041,Blue,0,22031,22489,458
2022-08-26,70047,70045,Blue,0,62806,62908,102
2022-09-12,70047,70043,Blue,0,20548,20820,272
2022-04-10,70045,70041,Blue,0,76723,76886,163
2022-06-28,70040,70054,Blue,1,29768,30542,774
2022-10-22,70055,70053,Blue,0,87555,87601,46
2022-11-22,70044,70050,Blue,1,27963,28296,333
2022-10-29,70038,70058,Blue,1,67456,68445,989
2022-06-21,70046,70056,Blue,1,29561,30160,599
2022-06-17,70057,70049,Blue,0,26145,26563,418
2022-06-13,70055,70051,Blue,0,45687,45835,148
2022-02-05,70059,70057,Blue,0,65955,65991,36
2022-04-21,70049,70045,Blue,0,54690,54879,189
2022-07-30,70048,70056,Blue,1,21511,21922,411
2022-03-30,70040,70050,Blue,1,53439,53975,536
2022-07-13,70038,70056,Blue,1,48821,49759,938
2022-10-17,70057,70041,Blue,0,64059,64894,835
2022-11-12,70052,70056,Blue,1,39026,39170,144
2022-03-02,70059,70047,Blue,0,19162,19792,630
2022-09-25,70059,70039,Blue,0,37517,38697,1180
2022-01-24,70041,70838,Blue,0,88433,88627,194
2022-01-01,70059,70053,Blue,0,75483,75752,269
2022-03-22,70040,70054,Blue,1,26421,27237,816
2022-11-29,70046,70052,Blue,1,52734,53066,332
2022-01-05,70040,70042,Blue,1,71195,71227,32
2022-05-07,70052,70056,Blue,1,63149,63290,141
2022-10-05,70051,70043,Blue,0,28522,29024,502
2022-06-22,70053,70041,Blue,0,28571,29258,687
2022-06-10,70048,70052,Blue,1,82088,82297,209
2022-09-22,70046,70060,Blue,1,21888,22626,738
2022-06-06,70041,70039,Blue,0,65476,65510,34
2022-06-26,70049,70047,Blue,0,52187,52244,57
2022-02-28,70057,70049,Blue,0,23734,24110,376
2022-07-16,70049,70047,Blue,0,77664,77720,56
2022-10-08,70052,70058,Blue,1,63940,64196,256
2022-02-28,70053,70041,Blue,0,48472,49092,620
2022-08-05,70040,70060,Blue,1,24058,25080,1022
2022-01-27,70052,70060,Blue,1,38900,39265,365
2022-07-16,70038,70048,Blue,1,67446,68007,561
2022-01-12,70040,70058,Blue,1,45936,46893,957
2022-07-14,70043,70838,Blue,0,51324,51872,548
2022-09-08,70043,70838,Blue,0,65010,65251,241
2022-10-03,70044,70054,Blue,1,31418,32020,602
2022-08-31,70057,70838,Blue,0,54684,55668,984
2022-12-28,70057,70053,Blue,0,59093,59245,152
2022-11-28,70045,70041,Blue,0,78220,78384,164
2022-01-29,70047,70045,Blue,0,89363,89521,158
2022-04-19,70050,70056,Blue,1,68646,68996,350
2022-03-29,70057,70043,Blue,0,26442,27320,878
2022-06-24,70051,70041,Blue,0,54934,55563,629
2022-11-18,70051,70049,Blue,0,55346,55449,103
2022-09-08,70053,70838,Blue,0,58704,59903,1199
2022-01-16,70059,70041,Blue,0,47957,48828,871
2022-07-07,70044,70050,Blue,1,36605,37050,445
2022-12-25,70059,70051,Blue,0,54918,55265,347
2022-01-14,70059,70045,Blue,0,63494,64215,721
2022-10-25,70051,70049,Blue,0,81561,81666,105
2022-06-10,70041,70039,Blue,0,53863,53900,37
2022-04-09,70047,70039,Blue,0,53589,54024,435
2022-04-11,70042,70054,Blue,1,82722,83372,650
2022-02-07,70047,70039,Blue,0,38139,38617,478
2022-06-09,70050,70056,Blue,1,51465,51798,333
2022-04-21,70059,70057,Blue,0,52095,52131,36
2022-12-12,70051,70043,Blue,0,30999,31527,528
2022-10-23,70053,70051,Blue,0,68126,68186,60
2022-10-13,70055,70838,Blue,0,52703,53599,896
2022-04-06,70057,70838,Blue,0,53685,54814,1129
2022-06-30,70051,70041,Blue,0,59783,60341,558
2022-01-16,70059,70039,Blue,0,82223,83235,1012
2022-10-26,70038,70056,Blue,1,34334,35239,905
2022-05-11,70057,70049,Blue,0,63633,64064,431
2022-11-09,70048,70056,Blue,1,38248,38645,397
2022-01-06,70055,70047,Blue,0,22693,23145,452
2022-03-16,70044,70056,Blue,1,29253,29939,686
2022-12-28,70038,70048,Blue,1,60735,61210,475
2022-05-11,70056,70060,Blue,1,77535,77721,186
2022-12-28,70048,70054,Blue,1,37527,37835,308
2022-03-01,70040,70046,Blue,1,63683,63942,259
2022-07-03,70043,70039,Blue,0,70994,71100,106
2022-11-02,70053,70045,Blue,0,48691,49087,396
2022-03-13,70044,70048,Blue,1,87507,87738,231
2022-03-25,70040,70052,Blue,1,48186,48828,642
2022-04-20,70053,70045,Blue,0,55062,55525,463
2022-08-15,70059,70045,Blue,0,38641,39349,708
2022-09-01,70055,70051,Blue,0,71606,71741,135
2022-12-29,70049,70045,Blue,0,33109,33318,209
2022-07-07,70055,70049,Blue,0,30328,30630,302
2022-12-30,70047,70043,Blue,0,60293,60531,238
2022-09-20,70057,70041,Blue,0,33526,34468,942
2022-10-21,70055,70043,Blue,0,67751,68394,643
2022-12-16,70047,70039,Blue,0,34093,34494,401
2022-12-26,70059,70051,Blue,0,23843,24166,323
2022-09-29,70056,70058,Blue,1,52306,52376,70
2022-09-04,70059,70838,Blue,0,50056,51121,1065
2022-04-03,70052,70060,Blue,1,81878,82221,343
2022-06-20,70044,70056,Blue,1,53698,54481,783
2022-04-17,70044,70056,Blue,1,42572,43202,630
2022-08-03,70054,70060,Blue,1,63720,63987,267
2022-01-06,70045,70838,Blue,0,29915,30246,331
2022-08-30,70039,70838,Blue,0,54601,54633,32
2022-12-19,70058,70060,Blue,1,76998,77076,78
2022-12-07,70056,70058,Blue,1,76814,76891,77
2022-11-07,70049,70047,Blue,0,72282,72341,59
2022-11-18,70059,70039,Blue,0,70696,71683,987
2022-07-19,70049,70838,Blue,0,62392,63023,631
2022-09-28,70051,70039,Blue,0,24306,25593,1287
2022-04-11,70040,70056,Blue,1,25194,25974,780
2022-02-05,70056,70060,Blue,1,40916,41133,217
2022-09-20,70055,70043,Blue,0,79445,80055,610
2022-06-15,70040,70050,Blue,1,34212,34795,583
2022-09-27,70055,70045,Blue,0,21218,21770,552
2022-02-17,70040,70048,Blue,1,62012,62405,393
2022-09-02,70038,70044,Blue,1,74663,74858,195
2022-09-14,70046,70048,Blue,1,22579,22660,81
2022-02-07,70047,70039,Blue,0,88699,89504,805
2022-07-29,70052,70056,Blue,1,24342,24505,163
2022-10-26,70040,70046,Blue,1,61209,61502,293
2022-02-24,70048,70056,Blue,1,67813,68173,360
2022-02-07,70045,70838,Blue,0,40049,40371,322
2022-11-29,70055,70053,Blue,0,39191,39240,49
2022-05-19,70057,70051,Blue,0,19246,19512,266
2022-07-23,70056,70060,Blue,1,25215,25383,168
2022-12-26,70042,70060,Blue,1,88366,89348,982
2022-10-20,70055,70041,Blue,0,35555,36289,734
2022-11-14,70051,70041,Blue,0,66395,66963,568
2022-07-12,70047,70838,Blue,0,53652,54208,556
2022-07-03,70044,70056,Blue,1,54481,55159,678
2022-04-29,70057,70051,Blue,0,26862,27130,268
2022-05-16,70051,70047,Blue,0,82027,82397,370
2022-03-18,70059,70838,Blue,0,27787,28945,1158
2022-06-11,70050,70056,Blue,1,23101,23468,367
2022-10-25,70058,70060,Blue,1,49838,49898,60
2022-11-02,70055,70041,Blue,0,84377,85118,741
2022-01-30,70046,70048,Blue,1,90024,90097,73
2022-12-25,70051,70039,Blue,0,62290,62934,644
2022-10-20,70040,70046,Blue,1,23203,23473,270
2022-02-21,70057,70053,Blue,0,49833,50033,200
2022-04-18,70057,70051,Blue,0,76150,76419,269
2022-06-16,70046,70048,Blue,1,71128,71221,93
2022-06-30,70049,70041,Blue,0,58669,59142,473
2022-06-18,70059,70041,Blue,0,84015,84977,962
2022-08-14,70048,70054,Blue,1,54762,55077,315
2022-05-13,70052,70056,Blue,1,62658,62808,150
2022-12-20,70044,70056,Blue,1,91031,91684,653
2022-08-18,70059,70051,Blue,0,51005,51341,336
2022-02-24,70038,70040,Blue,1,75794,75809,15
2022-11-07,70050,70056,Blue,1,28221,28619,398
2022-08-18,70048,70050,Blue,1,23079,23138,59
2022-07-20,70053,70039,Blue,0,24108,24903,795
2022-12-20,70040,70058,Blue,1,55162,56132,970
2022-11-19,70056,70060,Blue,1,61525,61694,169
2022-09-29,70042,70056,Blue,1,33748,34505,757
2022-08-21,70044,70052,Blue,1,45250,45737,487
2022-04-11,70059,70838,Blue,0,27252,28327,1075
2022-12-06,70048,70054,Blue,1,33739,34081,342
2022-09-08,70059,70047,Blue,0,20840,21409,569
2022-02-07,70050,70060,Blue,1,34729,35400,671
2022-08-09,70040,70050,Blue,1,36617,37141,524
2022-12-31,70051,70838,Blue,0,77233,77955,722
2022-08-12,70046,70056,Blue,1,33135,33643,508
2022-02-28,70040,70054,Blue,1,36322,37483,1161
2022-07-07,70046,70050,Blue,1,44001,44195,194
2022-01-22,70042,70058,Blue,1,46525,47405,880
2022-10-16,70050,70058,Blue,1,87975,88392,417
2022-06-18,70042,70054,Blue,1,22562,23359,797
2022-11-08,70045,70041,Blue,0,69796,69966,170
2022-11-10,70048,70052,Blue,1,41519,41723,204
2022-07-24,70059,70057,Blue,0,68002,68036,34
2022-03-05,70044,70050,Blue,1,59063,59413,350
2022-02-01,70054,70058,Blue,1,87979,88146,167
2022-12-29,70044,70046,Blue,1,38753,38870,117
2022-06-30,70045,70041,Blue,0,64730,64907,177
2022-10-23,70046,70050,Blue,1,42019,42191,172
2022-05-18,70059,70051,Blue,0,84064,84383,319
2022-03-21,70057,70039,Blue,0,61466,62359,893
2022-04-24,70044,70046,Blue,1,60463,60563,100
2022-12-06,70053,70039,Blue,0,55657,56426,769
2022-12-18,70053,70039,Blue,0,81155,81857,702
2022-01-10,70047,70039,Blue,0,81820,82199,379
2022-03-24,70053,70051,Blue,0,33868,33942,74
2022-08-01,70058,70060,Blue,1,21263,21343,80
2022-09-22,70042,70060,Blue,1,29645,30632,987
2022-01-05,70040,70058,Blue,1,55462,56605,1143
2022-09-19,70038,70050,Blue,1,34070,34641,571
2022-12-25,70038,70042,Blue,1,51559,51659,100
2022-05-19,70055,70041,Blue,0,84796,85686,890
2022-03-17,70049,70039,Blue,0,69990,70471,481
2022-07-11,70046,70048,Blue,1,68167,68247,80
2022-07-27,70051,70045,Blue,0,37425,37784,359
2022-12-11,70048,70052,Blue,1,23584,23849,265
2022-11-25,70044,70050,Blue,1,64548,64908,360
2022-12-20,70057,70055,Blue,0,47484,47552,68
2022-02-11,70051,70043,Blue,0,63601,64123,522
2022-06-29,70040,70050,Blue,1,49315,49864,549
2022-11-14,70038,70050,Blue,1,66371,66980,609
2022-12-19,70047,70838,Blue,0,46111,46885,774
2022-09-27,70057,70045,Blue,0,27753,28489,736
2022-11-18,70038,70048,Blue,1,90008,91653,1645
2022-02-24,70057,70055,Blue,0,51294,51361,67
2022-09-05,70043,70838,Blue,0,62265,62448,183
2022-06-13,70051,70039,Blue,0,73655,74333,678
2022-06-25,70041,70838,Blue,0,48102,48251,149
2022-03-14,70051,70047,Blue,0,54844,55050,206
2022-09-22,70056,70060,Blue,1,39329,39514,185
2022-02-07,70047,70045,Blue,0,65965,66058,93
2022-08-03,70046,70058,Blue,1,79200,79778,578
2022-04-17,70059,70051,Blue,0,33181,33504,323
2022-10-27,70046,70060,Blue,1,56407,57170,763
2022-08-25,70042,70046,Blue,1,72254,72426,172
2022-06-23,70040,70060,Blue,1,47718,48834,1116
2022-07-14,70042,70044,Blue,1,59779,59812,33
2022-12-22,70059,70053,Blue,0,33439,33711,272
2022-08-08,70046,70060,Blue,1,50683,51441,758
2022-09-20,70038,70040,Blue,1,61147,61162,15
2022-09-06,70053,70043,Blue,0,39526,40157,631
2022-08-16,70042,70050,Blue,1,72840,73244,404
2022-04-16,70042,70048,Blue,1,34109,34398,289
2022-12-16,70054,70058,Blue,1,48491,48641,150
2022-08-16,70039,70838,Blue,0,56466,56499,33
2022-03-20,70059,70047,Blue,0,88273,88905,632
2022-12-12,70050,70058,Blue,1,36351,36797,446
2022-09-27,70055,70051,Blue,0,44388,44535,147
2022-01-23,70044,70052,Blue,1,38551,39072,521
2022-01-04,70042,70058,Blue,1,71613,72478,865
2022-08-01,70042,70048,Blue,1,26645,26949,304
2022-08-13,70043,70039,Blue,0,53922,54030,108
2022-11-25,70051,70043,Blue,0,70589,71093,504
2022-02-11,70043,70838,Blue,0,76962,77143,181
2022-09-22,70059,70055,Blue,0,44173,44310,137
2022-10-18,70042,70044,Blue,1,50610,50639,29
2022-01-03,70047,70838,Blue,0,41600,42111,511
2022-11-11,70043,70039,Blue,0,87477,87591,114
2022-11-04,70057,70039,Blue,0,61728,62738,1010
2022-08-04,70057,70049,Blue,0,46935,47327,392
2022-06-15,70048,70052,Blue,1,34735,34968,233
2022-09-07,70042,70054,Blue,1,88374,88956,582
2022-01-10,70055,70047,Blue,0,33095,33506,411
2022-12-12,70040,70056,Blue,1,53959,54810,851
2022-11-10,70038,70048,Blue,1,25941,26406,465
2022-02-10,70042,70058,Blue,1,77588,78477,889
2022-02-17,70040,70058,Blue,1,67160,68192,1032
2022-09-18,70038,70048,Blue,1,54794,55260,466
2022-08-08,70051,70049,Blue,0,30505,30612,107
2022-08-05,70057,70039,Blue,0,35120,36142,1022
2022-05-30,70045,70838,Blue,0,67395,67770,375
2022-11-02,70055,70039,Blue,0,76096,76927,831
2022-10-16,70058,70060,Blue,1,45292,45358,66
2022-08-26,70042,70046,Blue,1,70413,70589,176
2022-07-24,70053,70043,Blue,0,65448,66096,648
2022-01-11,70047,70838,Blue,0,81811,82259,448
2022-11-20,70049,70047,Blue,0,75496,75557,61
2022-08-20,70044,70050,Blue,1,73105,73444,339
2022-10-15,70053,70043,Blue,0,39793,40373,580
2022-04-13,70040,70054,Blue,1,35724,36550,826
2022-01-28,70057,70043,Blue,0,30953,31845,892
2022-02-13,70053,70045,Blue,0,55724,56181,457
2022-09-24,70042,70048,Blue,1,34681,34996,315
2022-07-26,70044,70058,Blue,1,46393,47218,825
2022-11-29,70040,70052,Blue,1,21886,22554,668
2022-11-30,70055,70041,Blue,0,58034,58844,810
2022-07-11,70055,70047,Blue,0,79252,79625,373
2022-09-25,70051,70045,Blue,0,87693,88031,338
2022-09-07,70049,70039,Blue,0,63377,63913,536
2022-05-24,70039,70838,Blue,0,34246,34276,30
2022-03-29,70059,70051,Blue,0,82886,83222,336
2022-11-01,70059,70051,Blue,0,49954,50281,327
2022-09-19,70042,70050,Blue,1,30947,31341,394
2022-12-06,70055,70041,Blue,0,51155,51898,743
2022-08-29,70047,70043,Blue,0,57396,57682,286
2022-11-14,70050,70056,Blue,1,62779,63053,274
2022-12-13,70038,70058,Blue,1,35298,36370,1072
2022-10-14,70055,70051,Blue,0,81367,81510,143
2022-03-11,70038,70056,Blue,1,52754,53582,828
2022-06-20,70047,70041,Blue,0,66630,66986,356
2022-12-07,70040,70048,Blue,1,32859,33291,432
2022-12-29,70052,70056,Blue,1,48567,48727,160
2022-02-10,70056,70060,Blue,1,34136,34392,256
2022-08-11,70052,70056,Blue,1,33841,34008,167
2022-09-09,70044,70048,Blue,1,56270,56516,246
2022-07-24,70050,70058,Blue,1,62430,62862,432
2022-05-22,70040,70052,Blue,1,39985,40733,748
2022-11-10,70059,70039,Blue,0,21502,22652,1150
2022-09-15,70044,70056,Blue,1,62099,62938,839
2022-07-13,70057,70055,Blue,0,45084,45156,72
2022-07-02,70050,70052,Blue,1,30293,30428,135
2022-03-04,70038,70060,Blue,1,36193,37371,1178
2022-04-15,70053,70051,Blue,0,32035,32100,65
2022-06-30,70042,70052,Blue,1,25422,26073,651
2022-01-28,70055,70045,Blue,0,29561,30159,598
2022-11-11,70051,70047,Blue,0,77844,78041,197
2022-04-28,70055,70047,Blue,0,55149,55539,390
2022-07-12,70042,70046,Blue,1,33778,33957,179
2022-09-29,70059,70051,Blue,0,38474,38795,321
2022-12-02,70046,70054,Blue,1,46496,46944,448
2022-02-15,70044,70046,Blue,1,65123,65223,100
2022-02-21,70044,70058,Blue,1,29353,30145,792
2022-07-01,70040,70056,Blue,1,50844,51892,1048
2022-07-22,70040,70048,Blue,1,59697,60263,566
2022-03-12,70058,70060,Blue,1,63096,63162,66
2022-11-30,70049,70838,Blue,0,28467,29173,706
2022-02-18,70053,70041,Blue,0,60478,61143,665
2022-06-11,70057,70041,Blue,0,30421,31295,874
2022-03-15,70051,70043,Blue,0,65667,66143,476
2022-04-01,70040,70058,Blue,1,85500,86545,1045
2022-01-27,70040,70052,Blue,1,23450,24178,728
2022-08-19,70046,70056,Blue,1,64766,65309,543
2022-06-20,70038,70050,Blue,1,30265,30856,591
2022-03-03,70038,70050,Blue,1,33866,34512,646
2022-01-20,70046,70048,Blue,1,70281,70356,75
2022-01-05,70054,70060,Blue,1,70813,71063,250
2022-01-07,70049,70838,Blue,0,81720,82298,578
2022-04-20,70057,70047,Blue,0,43285,43752,467
2022-06-04,70047,70041,Blue,0,34608,35002,394
2022-12-09,70044,70060,Blue,1,26279,27185,906
2022-01-21,70057,70051,Blue,0,27065,27342,277
2022-08-01,70038,70044,Blue,1,58098,58279,181
2022-12-28,70042,70054,Blue,1,28592,29299,707
2022-11-09,70042,70048,Blue,1,45997,46330,333
2022-11-29,70050,70056,Blue,1,73244,73534,290
2022-05-20,70042,70044,Blue,1,29202,29235,33
2022-09-06,70048,70058,Blue,1,82651,83147,496
2022-05-18,70055,70053,Blue,0,55275,55320,45
2022-12-31,70049,70041,Blue,0,68718,69154,436
2022-05-06,70057,70053,Blue,0,31059,31214,155
2022-03-11,70049,70043,Blue,0,52618,52987,369
2022-10-27,70053,70049,Blue,0,65264,65461,197
2022-01-19,70040,70044,Blue,1,89213,89310,97
2022-06-02,70048,70050,Blue,1,46249,46309,60
2022-06-04,70043,70041,Blue,0,42200,42229,29
2022-12-01,70043,70039,Blue,0,45713,45833,120
2022-11-01,70042,70046,Blue,1,72231,72407,176
2022-02-24,70051,70041,Blue,0,58686,59253,567
2022-10-25,70042,70052,Blue,1,22431,23006,575
2022-11-29,70052,70058,Blue,1,44723,44968,245
2022-11-16,70057,70043,Blue,0,52053,52838,785
2022-11-04,70051,70049,Blue,0,53117,53225,108
2022-06-29,70051,70045,Blue,0,57146,57526,380
2022-01-03,70057,70039,Blue,0,30334,31210,876
2022-09-03,70040,70060,Blue,1,72405,73452,1047
2022-02-15,70056,70060,Blue,1,35576,35748,172
2022-04-04,70046,70054,Blue,1,35464,35914,450
2022-02-19,70059,70043,Blue,0,42249,43179,930
2022-07-13,70042,70056,Blue,1,87492,88201,709
2022-08-22,70054,70060,Blue,1,22395,22651,256
2022-04-06,70054,70056,Blue,1,86166,86212,46
2022-12-18,70044,70046,Blue,1,31794,31898,104
2022-09-10,70054,70058,Blue,1,36449,36598,149
2022-09-06,70040,70046,Blue,1,39466,39751,285
2022-07-24,70040,70048,Blue,1,72388,72804,416
2022-07-13,70055,70047,Blue,0,27432,27828,396
2022-05-18,70049,70043,Blue,0,47801,48287,486
2022-08-29,70049,70041,Blue,0,48348,48790,442
2022-04-15,70052,70060,Blue,1,72695,73036,341
2022-05-30,70049,70043,Blue,0,48998,49396,398
2022-08-23,70057,70838,Blue,0,83120,84083,963
2022-02-14,70050,70058,Blue,1,58630,59105,475
2022-02-15,70057,70049,Blue,0,80676,81054,378
2022-07-29,70059,70039,Blue,0,19936,20943,1007
2022-08-18,70053,70051,Blue,0,26635,26698,63
2022-11-22,70056,70060,Blue,1,79213,79384,171
2022-03-01,70038,70048,Blue,1,68953,69429,476
2022-04-14,70038,70040,Blue,1,24073,24091,18
2022-10-06,70057,70051,Blue,0,64197,64430,233
2022-04-19,70051,70043,Blue,0,30113,30676,563
2022-10-16,70044,70058,Blue,1,49096,49874,778
2022-02-17,70050,70058,Blue,1,86921,87365,444
2022-12-05,70052,70058,Blue,1,81976,82220,244
2022-12-06,70038,70052,Blue,1,79131,79935,804
2022-06-21,70059,70039,Blue,0,58339,59421,1082
2022-07-10,70059,70055,Blue,0,37514,37663,149
2022-11-25,70042,70060,Blue,1,23660,24547,887
2022-11-21,70046,70058,Blue,1,33835,34488,653
2022-05-23,70045,70043,Blue,0,37954,38070,116
2022-09-12,70059,70838,Blue,0,28051,29278,1227
2022-10-07,70059,70039,Blue,0,73813,74780,967
2022-03-28,70049,70047,Blue,0,26051,26111,60
2022-06-12,70053,70041,Blue,0,39124,39932,808
2022-10-14,70038,70050,Blue,1,21362,21934,572
2022-10-29,70052,70056,Blue,1,27725,27874,149
2022-06-28,70058,70060,Blue,1,24079,24151,72
2022-12-01,70057,70041,Blue,0,49486,50373,887
2022-11-16,70044,70060,Blue,1,71866,72703,837
2022-05-17,70052,70056,Blue,1,48871,49012,141
2022-07-09,70042,70044,Blue,1,75696,75734,38
2022-10-01,70057,70043,Blue,0,45576,46409,833
2022-07-20,70046,70058,Blue,1,52311,53141,830
2022-09-27,70057,70051,Blue,0,60087,60320,233
2022-02-04,70048,70058,Blue,1,36483,37417,934
2022-08-20,70049,70041,Blue,0,35117,35566,449
2022-07-07,70052,70056,Blue,1,50252,50421,169
2022-03-07,70052,70054,Blue,1,62188,62246,58
2022-03-28,70047,70045,Blue,0,59005,59108,103
2022-07-11,70052,70056,Blue,1,52751,52902,151
2022-03-16,70046,70054,Blue,1,70920,71348,428
2022-08-07,70040,70056,Blue,1,40490,41398,908
2022-11-08,70051,70047,Blue,0,77811,78008,197
2022-08-04,70057,70043,Blue,0,56252,57075,823
2022-10-21,70048,70054,Blue,1,30812,31137,325
2022-01-03,70042,70056,Blue,1,58759,59535,776
2022-02-09,70047,70041,Blue,0,50449,50878,429
2022-01-01,70044,70050,Blue,1,49574,49895,321
2022-01-27,70044,70060,Blue,1,32566,33842,1276
2022-09-03,70044,70046,Blue,1,49328,49428,100
2022-11-08,70038,70050,Blue,1,66092,66680,588
2022-10-03,70059,70051,Blue,0,56177,56503,326
2022-10-02,70059,70057,Blue,0,25396,25430,34
2022-04-11,70040,70056,Blue,1,46442,47221,779
2022-07-06,70040,70048,Blue,1,54498,54971,473
2022-09-25,70055,70053,Blue,0,69662,69708,46
2022-07-12,70054,70060,Blue,1,24484,24746,262
2022-02-19,70044,70048,Blue,1,21883,22104,221
2022-07-13,70038,70054,Blue,1,28992,29766,774
2022-03-02,70040,70042,Blue,1,74790,74828,38
2022-02-07,70057,70053,Blue,0,57593,57745,152
2022-09-02,70059,70047,Blue,0,26773,27324,551
2022-12-22,70059,70043,Blue,0,38588,39471,883
2022-02-10,70059,70043,Blue,0,72612,73486,874
2022-02-04,70056,70060,Blue,1,63994,64187,193
2022-01-20,70048,70056,Blue,1,69063,69449,386
2022-07-07,70058,70060,Blue,1,39135,39210,75
2022-01-26,70053,70051,Blue,0,55067,55136,69
2022-11-07,70059,70043,Blue,0,26113,26991,878
2022-06-16,70053,70047,Blue,0,42282,42633,351
2022-06-14,70057,70047,Blue,0,32159,32698,539
2022-08-11,70040,70046,Blue,1,84194,84451,257
2022-06-26,70055,70041,Blue,0,64851,65678,827
2022-11-29,70048,70056,Blue,1,81688,82065,377
2022-04-20,70051,70047,Blue,0,55467,55666,199
2022-12-22,70048,70058,Blue,1,57802,58402,600
2022-01-05,70052,70058,Blue,1,27490,27819,329
2022-04-15,70059,70043,Blue,0,75491,76740,1249
2022-02-10,70047,70045,Blue,0,48809,48893,84
2022-08-12,70052,70054,Blue,1,82262,82324,62
2022-11-23,70038,70052,Blue,1,26046,26756,710
2022-10-09,70055,70041,Blue,0,63916,64614,698
2022-04-07,70044,70058,Blue,1,36399,37300,901
2022-06-19,70059,70057,Blue,0,47353,47388,35
2022-12-29,70038,70058,Blue,1,70130,71170,1040
2022-10-30,70038,70040,Blue,1,35468,35484,16
2022-10-26,70048,70052,Blue,1,28291,28505,214
2022-01-18,70038,70040,Blue,1,45307,45323,16
2022-09-22,70054,70056,Blue,1,85317,85363,46
2022-12-09,70047,70045,Blue,0,31565,31666,101
2022-07-07,70053,70043,Blue,0,54461,55050,589
2022-03-25,70057,70051,Blue,0,44449,44693,244
2022-07-03,70049,70039,Blue,0,66251,66797,546
2022-06-05,70049,70838,Blue,0,61542,62264,722
2022-08-08,70057,70051,Blue,0,61712,61977,265
2022-01-26,70053,70039,Blue,0,32359,33240,881
2022-04-19,70042,70052,Blue,1,86727,87347,620
2022-11-10,70044,70052,Blue,1,27981,28446,465
2022-02-16,70053,70039,Blue,0,78583,79419,836
2022-06-16,70059,70041,Blue,0,53614,54709,1095
2022-09-30,70041,70838,Blue,0,36009,36134,125
2022-08-05,70057,70051,Blue,0,74568,74861,293
2022-02-26,70038,70056,Blue,1,48082,49036,954
2022-01-04,70040,70046,Blue,1,78137,78430,293
2022-02-26,70043,70041,Blue,0,38747,38773,26
2022-03-28,70055,70049,Blue,0,49927,50206,279
2022-07-06,70038,70058,Blue,1,84134,85318,1184
2022-09-20,70051,70041,Blue,0,62234,62787,553
2022-06-12,70048,70052,Blue,1,74957,75167,210
2022-03-08,70050,70052,Blue,1,29907,30014,107
2022-01-11,70052,70060,Blue,1,66969,67520,551
2022-06-19,70038,70044,Blue,1,49699,49880,181
2022-09-02,70045,70039,Blue,0,20691,20937,246
2022-08-04,70057,70051,Blue,0,25173,25429,256
2022-07-08,70047,70838,Blue,0,52243,52814,571
2022-04-21,70050,70054,Blue,1,75842,76039,197
2022-09-23,70045,70838,Blue,0,54913,55276,363
2022-03-14,70048,70060,Blue,1,51279,51858,579
2022-03-22,70047,70039,Blue,0,54206,54590,384
2022-12-22,70059,70049,Blue,0,30174,30699,525
2022-11-05,70059,70051,Blue,0,53012,53341,329
2022-07-19,70050,70052,Blue,1,78435,78547,112
2022-01-20,70057,70047,Blue,0,57579,58053,474
2022-03-16,70048,70060,Blue,1,57017,57709,692
2022-08-10,70057,70838,Blue,0,26868,27982,1114
2022-04-01,70055,70045,Blue,0,64568,65041,473
2022-10-09,70059,70039,Blue,0,25403,26476,1073
2022-12-16,70050,70054,Blue,1,24922,25191,269
2022-03-29,70038,70044,Blue,1,61326,61488,162
2022-08-16,70047,70043,Blue,0,48444,48689,245
2022-07-24,70041,70838,Blue,0,52129,52255,126
2022-03-13,70057,70045,Blue,0,48542,49210,668
2022-06-22,70059,70039,Blue,0,25514,26617,1103
2022-02-12,70044,70054,Blue,1,72518,73090,572
2022-01-25,70040,70048,Blue,1,57490,57846,356
2022-08-31,70048,70056,Blue,1,76425,76831,406
2022-01-19,70053,70043,Blue,0,53453,54068,615
2022-01-19,70059,70057,Blue,0,54494,54529,35
2022-07-03,70050,70054,Blue,1,53899,54139,240
2022-08-22,70048,70052,Blue,1,59403,59623,220
2022-11-19,70038,70044,Blue,1,19865,20030,165
2022-01-14,70056,70058,Blue,1,64722,64794,72
2022-05-29,70049,70838,Blue,0,25083,25738,655
2022-02-21,70038,70046,Blue,1,84613,84947,334
2022-05-24,70046,70050,Blue,1,38378,38601,223
2022-11-25,70049,70041,Blue,0,52032,52437,405
2022-09-21,70042,70058,Blue,1,40591,41439,848
2022-04-19,70050,70056,Blue,1,59576,59891,315
2022-11-08,70044,70054,Blue,1,56603,57222,619
2022-12-23,70038,70060,Blue,1,64594,65849,1255
2022-02-16,70038,70048,Blue,1,77414,77909,495
2022-12-22,70058,70060,Blue,1,62497,62558,61
2022-09-19,70040,70054,Blue,1,60985,61688,703
2022-05-04,70054,70058,Blue,1,88684,88831,147
2022-12-30,70048,70056,Blue,1,31459,31860,401
2022-07-09,70042,70050,Blue,1,85702,86279,577
2022-03-09,70059,70045,Blue,0,60808,61652,844
2022-12-31,70040,70050,Blue,1,57994,58527,533
2022-04-17,70040,70050,Blue,1,45493,45999,506
2022-04-23,70057,70039,Blue,0,77243,78196,953
2022-07-05,70040,70044,Blue,1,21570,21674,104
2022-12-28,70040,70050,Blue,1,70183,70680,497
2022-12-29,70043,70838,Blue,0,65623,65805,182
2022-02-14,70040,70058,Blue,1,55991,57071,1080
2022-02-25,70043,70041,Blue,0,38272,38303,31
2022-12-08,70042,70048,Blue,1,49885,50170,285
2022-12-21,70048,70052,Blue,1,57825,58050,225
2022-11-07,70057,70053,Blue,0,87412,87560,148
2022-02-12,70057,70043,Blue,0,58471,59287,816
2022-08-21,70056,70058,Blue,1,42735,42808,73
2022-04-22,70055,70043,Blue,0,66074,66712,638
2022-07-26,70038,70040,Blue,1,40967,40997,30
2022-03-22,70047,70041,Blue,0,26119,26491,372
2022-03-24,70040,70052,Blue,1,52513,53200,687
2022-07-13,70052,70060,Blue,1,25371,25761,390
2022-06-10,70042,70060,Blue,1,32963,34155,1192
2022-04-17,70048,70050,Blue,1,67714,67773,59
2022-09-28,70048,70058,Blue,1,26423,26942,519
2022-05-18,70046,70060,Blue,1,49894,50657,763
2022-08-10,70055,70049,Blue,0,40349,40669,320
2022-04-04,70040,70042,Blue,1,89223,89253,30
2022-11-23,70055,70053,Blue,0,44990,45036,46
2022-01-04,70038,70056,Blue,1,75835,76771,936
2022-12-18,70052,70060,Blue,1,33041,33410,369
2022-01-22,70049,70045,Blue,0,62129,62322,193
2022-03-22,70045,70838,Blue,0,54344,54678,334
2022-07-06,70057,70053,Blue,0,79456,79604,148
2022-06-15,70049,70039,Blue,0,50266,50814,548
2022-07-15,70059,70045,Blue,0,69907,70610,703
2022-02-09,70052,70056,Blue,1,72194,72337,143
2022-03-10,70059,70053,Blue,0,72069,72318,249
2022-02-10,70038,70056,Blue,1,67932,68841,909
2022-11-11,70053,70041,Blue,0,66850,67496,646
2022-03-30,70055,70049,Blue,0,31636,31920,284
2022-08-04,70052,70054,Blue,1,28585,28650,65
2022-07-07,70054,70056,Blue,1,50368,50421,53
2022-03-20,70046,70054,Blue,1,63802,64223,421
2022-04-03,70040,70058,Blue,1,82396,83286,890
2022-02-06,70045,70043,Blue,0,67564,67660,96
2022-01-24,70052,70056,Blue,1,85074,85226,152
2022-02-17,70049,70039,Blue,0,32232,32769,537
2022-03-10,70053,70041,Blue,0,41211,41911,700
2022-01-20,70059,70838,Blue,0,32354,33519,1165
2022-10-26,70042,70050,Blue,1,90788,91430,642
2022-04-11,70048,70050,Blue,1,86556,86615,59
2022-02-02,70040,70054,Blue,1,86625,87320,695
2022-11-13,70051,70049,Blue,0,46143,46247,104
2022-09-13,70057,70045,Blue,0,20491,21157,666
2022-03-04,70043,70041,Blue,0,77655,77688,33
2022-04-10,70048,70058,Blue,1,70920,71443,523
2022-10-30,70057,70043,Blue,0,41559,42370,811
2022-09-30,70057,70049,Blue,0,21616,22024,408
2022-03-25,70047,70838,Blue,0,66210,66703,493
2022-07-04,70056,70058,Blue,1,46818,46895,77
2022-07-22,70040,70044,Blue,1,61058,61174,116
2022-08-07,70056,70060,Blue,1,83901,84065,164
2022-12-21,70057,70045,Blue,0,53907,54472,565
2022-01-13,70056,70060,Blue,1,58015,58342,327
2022-01-22,70044,70048,Blue,1,57529,57778,249
2022-07-16,70042,70054,Blue,1,67665,68355,690
2022-02-25,70040,70052,Blue,1,47604,48223,619
2022-10-07,70040,70050,Blue,1,55263,55753,490
2022-12-20,70054,70056,Blue,1,30881,30969,88
2022-10-25,70041,70838,Blue,0,30378,30515,137
2022-10-28,70045,70043,Blue,0,20702,20785,83
2022-02-04,70048,70052,Blue,1,26270,26579,309
2022-11-15,70042,70058,Blue,1,38635,39656,1021
2022-06-21,70046,70058,Blue,1,68915,69603,688
2022-04-05,70049,70039,Blue,0,86241,86729,488
2022-05-18,70042,70054,Blue,1,33425,34210,785
2022-01-12,70045,70039,Blue,0,28104,28358,254
2022-12-22,70039,70838,Blue,0,35747,35868,121
2022-04-23,70052,70058,Blue,1,75293,75542,249
2022-02-16,70044,70054,Blue,1,63347,63910,563
2022-05-21,70044,70054,Blue,1,40702,41357,655
2022-11-14,70040,70046,Blue,1,53421,53698,277
2022-10-02,70040,70052,Blue,1,63519,64185,666
2022-10-17,70042,70044,Blue,1,26612,26643,31
2022-07-10,70057,70051,Blue,0,74429,74677,248
2022-09-21,70041,70039,Blue,0,20696,20730,34
2022-05-20,70046,70048,Blue,1,61197,61305,108
2022-07-14,70038,70050,Blue,1,39827,40708,881
2022-03-28,70042,70054,Blue,1,64770,65439,669
2022-10-27,70053,70049,Blue,0,67354,67546,192
2022-07-22,70042,70052,Blue,1,22398,23045,647
2022-10-03,70046,70054,Blue,1,74681,75091,410
2022-06-12,70052,70056,Blue,1,25361,25498,137
2022-03-12,70055,70051,Blue,0,54931,55080,149
2022-11-13,70048,70050,Blue,1,30509,30571,62
2022-01-04,70059,70057,Blue,0,77172,77207,35
2022-09-01,70044,70048,Blue,1,30478,30719,241
2022-06-10,70048,70058,Blue,1,32574,33148,574
2022-09-12,70052,70060,Blue,1,65045,65397,352
2022-03-11,70042,70046,Blue,1,68352,68523,171
2022-11-10,70039,70838,Blue,0,73725,73757,32
2022-08-14,70038,70060,Blue,1,49388,50559,1171
2022-02-05,70054,70060,Blue,1,73797,74069,272
2022-05-22,70048,70052,Blue,1,62495,62977,482
2022-04-03,70046,70050,Blue,1,35840,36041,201
2022-08-23,70056,70060,Blue,1,69183,69424,241
2022-05-03,70058,70060,Blue,1,30260,30327,67
2022-04-06,70042,70056,Blue,1,65409,66155,746
2022-08-28,70048,70056,Blue,1,36755,37114,359
2022-10-11,70045,70039,Blue,0,24207,24508,301
2022-01-13,70040,70050,Blue,1,23406,23958,552
2022-11-28,70043,70838,Blue,0,84059,84259,200
2022-06-22,70038,70058,Blue,1,32930,33978,1048
2022-06-16,70053,70047,Blue,0,29640,29934,294
2022-12-02,70050,70054,Blue,1,65242,65436,194
2022-06-23,70053,70051,Blue,0,39040,39138,98
2022-09-13,70038,70050,Blue,1,45106,45667,561
2022-04-20,70038,70046,Blue,1,57763,58107,344
2022-01-17,70040,70054,Blue,1,75633,76367,734
2022-07-18,70040,70054,Blue,1,21843,22523,680
2022-01-01,70057,70053,Blue,0,52838,53015,177
2022-02-25,70053,70045,Blue,0,67800,68226,426
2022-11-28,70044,70056,Blue,1,50071,50701,630
2022-10-16,70059,70049,Blue,0,66254,66741,487
2022-12-20,70059,70047,Blue,0,88103,88644,541
2022-04-07,70055,70045,Blue,0,26556,27120,564
2022-06-13,70059,70053,Blue,0,41535,41769,234
2022-09-22,70040,70042,Blue,1,48464,48495,31
2022-02-24,70050,70058,Blue,1,20905,21383,478
2022-12-07,70059,70045,Blue,0,35833,36565,732
2022-11-12,70057,70045,Blue,0,37974,38601,627
2022-06-11,70059,70041,Blue,0,67575,68524,949
2022-09-27,70047,70838,Blue,0,42308,42821,513
2022-06-19,70055,70041,Blue,0,66025,66762,737
2022-09-24,70057,70047,Blue,0,63886,64404,518
2022-02-06,70038,70050,Blue,1,68827,69385,558
2022-08-08,70038,70050,Blue,1,57769,58411,642
2022-11-11,70044,70046,Blue,1,49990,50090,100
2022-08-16,70052,70060,Blue,1,73444,73849,405
2022-02-03,70059,70043,Blue,0,60019,61045,1026
2022-09-16,70038,70058,Blue,1,63867,65494,1627
2022-06-29,70059,70838,Blue,0,67064,68277,1213
2022-10-15,70040,70048,Blue,1,36428,36855,427
2022-02-01,70049,70039,Blue,0,35749,36274,525
2022-03-18,70040,70054,Blue,1,41337,42118,781
2022-08-02,70045,70039,Blue,0,80502,80732,230
2022-09-13,70042,70050,Blue,1,63286,63715,429
2022-03-14,70052,70060,Blue,1,63015,63410,395
2022-12-04,70038,70042,Blue,1,59428,59533,105
2022-03-13,70046,70052,Blue,1,35907,36373,466
2022-08-04,70038,70044,Blue,1,64348,64535,187
2022-07-14,70046,70050,Blue,1,83021,83189,168
2022-08-03,70045,70041,Blue,0,40460,40732,272
2022-09-22,70038,70042,Blue,1,35292,35383,91
2022-05-19,70038,70058,Blue,1,44861,46150,1289
2022-07-20,70051,70049,Blue,0,20370,20480,110
2022-01-19,70048,70052,Blue,1,76873,77086,213
2022-06-09,70048,70056,Blue,1,23874,24382,508
2022-12-01,70052,70054,Blue,1,33054,33108,54
2022-04-25,70051,70047,Blue,0,64218,64619,401
2022-01-14,70059,70039,Blue,0,74897,75928,1031
2022-03-17,70057,70055,Blue,0,66597,66667,70
2022-12-20,70059,70053,Blue,0,32332,32550,218
2022-10-06,70039,70838,Blue,0,58755,58789,34
2022-09-16,70048,70054,Blue,1,73132,73428,296
2022-06-27,70044,70050,Blue,1,77450,77831,381
2022-02-01,70059,70045,Blue,0,78906,79673,767
2022-01-08,70038,70042,Blue,1,42069,42166,97
2022-06-16,70049,70838,Blue,0,49792,50448,656
2022-07-16,70053,70838,Blue,0,76073,76946,873
2022-11-13,70052,70060,Blue,1,64206,64581,375
2022-09-18,70059,70057,Blue,0,52761,52796,35
2022-10-21,70045,70043,Blue,0,85703,85814,111
2022-03-01,70051,70045,Blue,0,67879,68249,370
2022-08-03,70057,70051,Blue,0,58529,58775,246
2022-06-12,70038,70042,Blue,1,58573,58675,102
2022-07-11,70059,70047,Blue,0,56205,56783,578
2022-06-17,70046,70056,Blue,1,24925,25565,640
2022-08-13,70040,70048,Blue,1,42687,43099,412
2022-11-04,70053,70049,Blue,0,74212,74424,212
2022-08-31,70053,70049,Blue,0,25406,25624,218
2022-08-03,70052,70058,Blue,1,47746,48014,268
2022-04-20,70054,70056,Blue,1,25929,25976,47
2022-08-15,70038,70060,Blue,1,44713,45937,1224
2022-01-22,70059,70057,Blue,0,36793,36828,35
2022-03-04,70045,70838,Blue,0,70236,70572,336
2022-04-12,70039,70838,Blue,0,30859,30897,38
2022-01-24,70049,70045,Blue,0,44445,44658,213
2022-03-15,70053,70041,Blue,0,29043,29942,899
2022-07-06,70059,70053,Blue,0,64947,65174,227
2022-10-19,70044,70050,Blue,1,33124,33494,370
2022-10-07,70055,70045,Blue,0,29500,30054,554
2022-10-23,70053,70045,Blue,0,77857,78289,432
2022-10-22,70055,70047,Blue,0,80054,80511,457
2022-04-08,70051,70043,Blue,0,66817,67301,484
2022-06-25,70042,70060,Blue,1,53113,54212,1099
2022-10-21,70055,70053,Blue,0,65350,65396,46
2022-03-28,70044,70050,Blue,1,70111,70424,313
2022-03-14,70055,70041,Blue,0,66423,67166,743
2022-03-20,70052,70054,Blue,1,59423,59473,50
2022-01-07,70043,70838,Blue,0,87857,88047,190
2022-12-25,70059,70057,Blue,0,45734,45771,37
2022-02-07,70039,70838,Blue,0,52020,52091,71
2022-08-23,70048,70050,Blue,1,81745,81800,55
2022-04-20,70038,70050,Blue,1,24252,24836,584
2022-02-02,70046,70054,Blue,1,70064,70588,524
2022-02-03,70046,70060,Blue,1,54376,55142,766
2022-07-03,70046,70058,Blue,1,88625,89272,647
2022-10-08,70051,70049,Blue,0,42551,42653,102
2022-05-21,70051,70043,Blue,0,47409,47957,548
2022-09-23,70042,70044,Blue,1,49306,49337,31
2022-10-07,70059,70045,Blue,0,68857,69600,743
2022-10-16,70051,70043,Blue,0,61741,62224,483
2022-06-29,70042,70054,Blue,1,68759,69501,742
2022-09-27,70055,70045,Blue,0,46560,47108,548
2022-02-05,70044,70056,Blue,1,74192,74855,663
2022-10-30,70057,70039,Blue,0,87389,88438,1049
2022-04-13,70038,70054,Blue,1,58335,59223,888
2022-07-06,70041,70838,Blue,0,21796,21919,123
2022-03-24,70055,70047,Blue,0,31361,31756,395
2022-11-30,70044,70056,Blue,1,30449,31095,646
2022-09-10,70048,70052,Blue,1,45337,45565,228
2022-06-25,70059,70043,Blue,0,35186,36065,879
2022-10-23,70047,70039,Blue,0,60397,60800,403
2022-08-31,70050,70052,Blue,1,63836,63943,107
2022-08-09,70040,70058,Blue,1,72143,73091,948
2022-07-20,70042,70058,Blue,1,29976,30854,878
2022-07-24,70055,70049,Blue,0,22480,22781,301
2022-12-06,70038,70060,Blue,1,65833,66977,1144
2022-05-17,70059,70057,Blue,0,35730,35768,38
2022-04-21,70040,70056,Blue,1,23713,24473,760
2022-01-12,70055,70043,Blue,0,75658,76304,646
2022-02-03,70051,70041,Blue,0,24379,24999,620
2022-03-18,70057,70051,Blue,0,65969,66229,260
2022-07-14,70055,70039,Blue,0,65943,66779,836
2022-02-16,70059,70039,Blue,0,43833,44901,1068
2022-01-18,70046,70054,Blue,1,46800,47214,414
2022-10-25,70050,70056,Blue,1,81929,82267,338
2022-11-23,70043,70838,Blue,0,68983,69164,181
2022-07-07,70048,70050,Blue,1,59469,59525,56
2022-03-02,70051,70049,Blue,0,50835,50937,102
2022-04-21,70059,70047,Blue,0,38659,39292,633
2022-12-05,70049,70043,Blue,0,51454,51785,331
2022-10-01,70051,70047,Blue,0,21962,22168,206
2022-05-21,70048,70060,Blue,1,74491,75127,636
2022-09-24,70049,70838,Blue,0,28116,28745,629
2022-08-01,70045,70041,Blue,0,45466,45637,171
2022-10-15,70038,70054,Blue,1,53415,54270,855
2022-08-25,70053,70047,Blue,0,71522,71809,287
2022-03-08,70053,70039,Blue,0,82046,82785,739
2022-05-31,70040,70052,Blue,1,29667,30460,793
2022-01-11,70049,70045,Blue,0,58984,59173,189
2022-03-10,70046,70056,Blue,1,44537,45099,562
2022-11-18,70051,70041,Blue,0,77307,77909,602
2022-01-18,70044,70056,Blue,1,26922,27909,987
2022-08-06,70051,70045,Blue,0,67929,68264,335
2022-02-25,70040,70054,Blue,1,75269,75973,704
2022-06-02,70043,70039,Blue,0,63447,63560,113
2022-01-07,70040,70042,Blue,1,68292,68325,33
2022-02-21,70057,70039,Blue,0,87522,88451,929
2022-08-15,70057,70039,Blue,0,35989,36970,981
2022-11-23,70051,70041,Blue,0,59120,59713,593
2022-07-08,70040,70056,Blue,1,34925,35758,833
2022-03-11,70048,70060,Blue,1,61847,62539,692
2022-10-25,70042,70054,Blue,1,30991,31672,681
2022-10-28,70057,70049,Blue,0,67663,68040,377
2022-12-29,70053,70047,Blue,0,54379,54664,285
2022-03-01,70045,70043,Blue,0,75759,75864,105
2022-08-10,70050,70054,Blue,1,30475,30709,234
2022-02-25,70053,70039,Blue,0,28172,28972,800
2022-06-27,70055,70838,Blue,0,19718,20820,1102
2022-04-19,70045,70041,Blue,0,30868,31038,170
2022-04-06,70053,70838,Blue,0,37278,38330,1052
2022-02-25,70056,70058,Blue,1,65532,65619,87
2022-11-19,70038,70054,Blue,1,53953,54763,810
2022-07-18,70054,70060,Blue,1,42937,43245,308
2022-07-25,70057,70045,Blue,0,33167,33868,701
2022-02-24,70048,70058,Blue,1,20804,21383,579
2022-08-30,70057,70045,Blue,0,37643,38299,656
2022-07-02,70042,70054,Blue,1,69221,69950,729
2022-08-28,70042,70060,Blue,1,75984,76893,909
2022-10-04,70047,70043,Blue,0,21017,21258,241
2022-02-23,70057,70055,Blue,0,71610,71677,67
2022-01-04,70046,70056,Blue,1,63716,64255,539
2022-09-10,70048,70052,Blue,1,33386,33592,206
2022-10-11,70047,70045,Blue,0,47450,47543,93
2022-09-08,70052,70058,Blue,1,83412,83681,269
2022-08-28,70057,70051,Blue,0,69038,69288,250
2022-11-03,70059,70053,Blue,0,46828,47064,236
2022-08-12,70041,70039,Blue,0,24153,24186,33
2022-04-28,70059,70055,Blue,0,68415,68555,140
2022-07-03,70041,70039,Blue,0,24024,24058,34
2022-04-18,70055,70039,Blue,0,51725,52538,813
2022-02-02,70055,70039,Blue,0,67662,68685,1023
2022-08-08,70052,70058,Blue,1,28110,28378,268
2022-01-20,70040,70058,Blue,1,29708,30614,906
2022-03-16,70038,70040,Blue,1,80953,80971,18
2022-07-16,70038,70048,Blue,1,84604,85132,528
2022-03-25,70044,70058,Blue,1,60389,61279,890
2022-11-21,70051,70045,Blue,0,41877,42240,363
2022-03-20,70042,70054,Blue,1,78693,79350,657
2022-07-27,70053,70045,Blue,0,31731,32218,487
2022-02-23,70053,70041,Blue,0,57763,58577,814
2022-12-15,70052,70054,Blue,1,43042,43102,60
2022-06-14,70055,70051,Blue,0,80041,80186,145
2022-10-24,70049,70838,Blue,0,41850,42480,630
2022-04-12,70043,70041,Blue,0,54218,54248,30
2022-04-01,70059,70055,Blue,0,56892,57036,144
2022-02-09,70042,70048,Blue,1,48828,49144,316
2022-01-03,70046,70056,Blue,1,60425,60958,533
2022-10-06,70055,70838,Blue,0,84617,85559,942
2022-10-21,70050,70058,Blue,1,52756,53172,416
2022-06-01,70050,70052,Blue,1,22067,22282,215
2022-06-10,70044,70058,Blue,1,40967,41825,858
2022-02-19,70057,70838,Blue,0,49286,50334,1048
2022-10-21,70044,70048,Blue,1,76969,77209,240
2022-11-01,70047,70039,Blue,0,23714,24149,435
2022-04-16,70057,70043,Blue,0,69289,70062,773
2022-12-27,70040,70046,Blue,1,30733,30991,258
2022-03-23,70040,70060,Blue,1,69514,70535,1021
2022-02-05,70045,70041,Blue,0,61315,61503,188
2022-10-07,70046,70054,Blue,1,50106,50522,416
2022-08-17,70046,70050,Blue,1,36826,37023,197
2022-03-15,70038,70058,Blue,1,88933,89856,923
2022-03-24,70051,70838,Blue,0,87240,87920,680
2022-03-07,70050,70052,Blue,1,63412,63529,117
2022-11-23,70046,70052,Blue,1,70451,70786,335
2022-12-16,70042,70050,Blue,1,38165,38560,395
2022-04-19,70045,70838,Blue,0,74670,75018,348
2022-03-23,70047,70043,Blue,0,29984,30259,275
2022-12-13,70043,70838,Blue,0,79740,79939,199
2022-04-17,70058,70060,Blue,1,46703,46767,64
2022-08-30,70052,70054,Blue,1,51709,51764,55
2022-12-08,70049,70041,Blue,0,20905,21318,413
2022-03-29,70059,70053,Blue,0,61994,62216,222
2022-11-30,70059,70045,Blue,0,58215,58928,713
2022-01-12,70050,70060,Blue,1,38116,38659,543
2022-09-16,70040,70048,Blue,1,33688,34064,376
2022-11-29,70038,70044,Blue,1,77316,77517,201
2022-09-01,70052,70054,Blue,1,37518,37573,55
2022-12-31,70040,70050,Blue,1,77086,77573,487
2022-05-02,70057,70047,Blue,0,23907,24392,485
2022-07-05,70042,70048,Blue,1,57998,58343,345
2022-12-14,70057,70047,Blue,0,45341,45875,534
2022-12-25,70038,70054,Blue,1,89105,89847,742
2022-03-04,70059,70055,Blue,0,49217,49373,156
2022-06-17,70044,70060,Blue,1,40565,41661,1096
2022-12-26,70047,70045,Blue,0,71708,71811,103
2022-07-06,70059,70045,Blue,0,55932,56673,741
2022-02-28,70040,70058,Blue,1,68673,69578,905
2022-06-24,70049,70041,Blue,0,32513,33005,492
2022-04-22,70046,70058,Blue,1,80273,80979,706
2022-03-14,70057,70047,Blue,0,27324,27784,460
2022-01-18,70047,70838,Blue,0,52165,52686,521
2022-06-02,70040,70052,Blue,1,66625,67462,837
2022-12-27,70038,70046,Blue,1,50711,51040,329
2022-11-21,70057,70047,Blue,0,37664,38188,524
2022-03-25,70051,70045,Blue,0,78148,78483,335
2022-09-07,70057,70053,Blue,0,49709,49866,157
2022-09-20,70045,70838,Blue,0,29356,29738,382
2022-12-31,70044,70046,Blue,1,61264,61376,112
2022-02-10,70048,70056,Blue,1,46463,46855,392
2022-11-03,70052,70060,Blue,1,44963,45303,340
2022-10-22,70040,70042,Blue,1,21071,21105,34
2022-11-25,70054,70058,Blue,1,61617,61783,166
2022-03-02,70057,70838,Blue,0,67973,69156,1183
2022-11-20,70050,70058,Blue,1,57026,57411,385
2022-03-05,70059,70057,Blue,0,32475,32510,35
2022-11-12,70049,70041,Blue,0,23389,23829,440
2022-02-06,70038,70054,Blue,1,70457,71270,813
2022-01-20,70055,70045,Blue,0,61881,62410,529
2022-07-07,70051,70039,Blue,0,49731,50458,727
2022-10-30,70046,70056,Blue,1,60103,60693,590
2022-12-27,70051,70838,Blue,0,76620,77289,669
2022-03-22,70047,70041,Blue,0,80138,80481,343
2022-12-28,70054,70056,Blue,1,70965,71012,47
2022-03-26,70042,70058,Blue,1,33587,34458,871
2022-02-16,70047,70041,Blue,0,49249,49614,365
2022-01-04,70053,70045,Blue,0,56874,57299,425
2022-08-29,70040,70044,Blue,1,46703,46803,100
2022-12-12,70057,70049,Blue,0,71759,72144,385
2022-09-17,70054,70058,Blue,1,26486,26634,148
2022-08-22,70044,70046,Blue,1,38711,38818,107
2022-07-23,70051,70039,Blue,0,67528,68289,761
2022-06-29,70046,70052,Blue,1,67317,67686,369
2022-09-03,70057,70838,Blue,0,51992,53091,1099
2022-11-10,70057,70043,Blue,0,25501,26345,844
2022-02-11,70046,70052,Blue,1,72888,73301,413
2022-04-10,70059,70053,Blue,0,61928,62149,221
2022-10-31,70057,70041,Blue,0,73466,74260,794
2022-01-05,70042,70054,Blue,1,39730,40460,730
2022-04-18,70051,70049,Blue,0,33005,33124,119
2022-09-17,70040,70056,Blue,1,50839,51673,834
2022-07-22,70051,70041,Blue,0,60542,61150,608
2022-10-15,70051,70039,Blue,0,57666,58347,681
2022-04-18,70052,70054,Blue,1,46350,46398,48
2022-06-20,70046,70054,Blue,1,67261,67686,425
2022-01-02,70040,70050,Blue,1,37086,37672,586
2022-07-08,70042,70060,Blue,1,86722,87777,1055
2022-10-17,70054,70058,Blue,1,38122,38275,153
2022-05-18,70048,70054,Blue,1,26523,26845,322
2022-11-29,70051,70043,Blue,0,62233,62723,490
2022-08-26,70038,70050,Blue,1,34881,35519,638
2022-08-16,70042,70054,Blue,1,53137,53864,727
2022-03-05,70047,70041,Blue,0,70920,71235,315
2022-02-09,70038,70058,Blue,1,35538,36744,1206
2022-09-12,70043,70838,Blue,0,22657,22899,242
2022-10-03,70045,70043,Blue,0,75694,75786,92
2022-08-09,70040,70048,Blue,1,50488,50916,428
2022-11-18,70040,70042,Blue,1,51754,51789,35
2022-04-13,70038,70044,Blue,1,26955,27124,169
2022-09-01,70044,70058,Blue,1,73866,74632,766
2022-07-27,70048,70050,Blue,1,43806,43897,91
2022-04-06,70049,70043,Blue,0,43708,44075,367
2022-08-08,70050,70052,Blue,1,73257,73378,121
2022-04-14,70051,70838,Blue,0,70875,71617,742
2022-04-09,70049,70043,Blue,0,62147,62503,356
2022-05-18,70038,70054,Blue,1,61727,62704,977
2022-11-17,70049,70041,Blue,0,65482,65904,422
2022-12-31,70055,70043,Blue,0,30517,31211,694
2022-07-17,70044,70058,Blue,1,30209,30941,732
2022-01-12,70049,70838,Blue,0,28358,28916,558
2022-01-21,70042,70050,Blue,1,23113,23542,429
2022-07-07,70042,70046,Blue,1,30586,30793,207
2022-10-07,70044,70046,Blue,1,20210,20319,109
2022-09-07,70059,70051,Blue,0,70697,71013,316
2022-03-31,70038,70056,Blue,1,33252,34250,998
2022-08-03,70040,70054,Blue,1,62063,62838,775
2022-09-07,70059,70047,Blue,0,54373,54961,588
2022-10-22,70057,70055,Blue,0,26636,26705,69
2022-03-16,70053,70838,Blue,0,63753,64593,840
2022-11-06,70044,70048,Blue,1,41868,42085,217
2022-07-30,70038,70054,Blue,1,80596,81449,853
2022-01-01,70040,70056,Blue,1,34739,35550,811
2022-08-12,70050,70058,Blue,1,31883,32299,416
2022-09-30,70048,70060,Blue,1,51001,51590,589
2022-06-13,70055,70838,Blue,0,30450,31481,1031
2022-01-20,70054,70056,Blue,1,81133,81180,47
2022-10-10,70059,70055,Blue,0,23836,23980,144
2022-12-24,70038,70048,Blue,1,39432,39886,454
2022-10-22,70057,70053,Blue,0,34184,34332,148
2022-02-16,70048,70058,Blue,1,70102,70635,533
2022-01-14,70059,70045,Blue,0,28459,29241,782
2022-12-26,70051,70041,Blue,0,80014,80567,553
2022-01-17,70042,70052,Blue,1,46533,47176,643
2022-05-10,70050,70056,Blue,1,86298,86575,277
2022-10-27,70059,70051,Blue,0,65534,65866,332
2022-01-26,70044,70052,Blue,1,34877,35407,530
2022-11-03,70046,70048,Blue,1,75082,75164,82
2022-09-28,70055,70043,Blue,0,48181,48856,675
2022-06-08,70045,70039,Blue,0,76845,77100,255
2022-09-20,70054,70058,Blue,1,65309,65461,152
2022-02-01,70038,70044,Blue,1,59240,59441,201
2022-12-27,70048,70050,Blue,1,33269,33330,61
2022-09-15,70049,70043,Blue,0,77034,77384,350
2022-09-09,70057,70053,Blue,0,53617,53772,155
2022-12-02,70038,70050,Blue,1,76329,76881,552
2022-03-22,70040,70052,Blue,1,59896,60514,618
2022-03-05,70043,70039,Blue,0,84074,84172,98
2022-12-11,70047,70039,Blue,0,87000,87367,367
2022-10-18,70042,70060,Blue,1,36620,37646,1026
2022-04-17,70048,70060,Blue,1,44312,44967,655
2022-07-31,70047,70043,Blue,0,54432,54671,239
2022-10-29,70059,70039,Blue,0,43272,44311,1039
2022-07-07,70038,70060,Blue,1,29176,30378,1202
2022-02-28,70040,70054,Blue,1,37999,38751,752
2022-04-21,70049,70041,Blue,0,39237,39678,441
2022-09-29,70055,70041,Blue,0,35072,36045,973
2022-03-31,70050,70056,Blue,1,32136,32491,355
2022-02-15,70045,70041,Blue,0,22523,22732,209
2022-01-16,70042,70046,Blue,1,72274,72498,224
2022-07-07,70059,70041,Blue,0,38107,39164,1057
2022-04-04,70052,70056,Blue,1,35531,35690,159
2022-08-19,70059,70838,Blue,0,71264,72370,1106
2022-03-16,70050,70058,Blue,1,33257,33677,420
2022-03-04,70052,70058,Blue,1,74263,74516,253
2022-07-08,70059,70047,Blue,0,42073,42627,554
2022-06-26,70049,70043,Blue,0,65187,65570,383
2022-01-17,70059,70053,Blue,0,29238,29510,272
2022-03-17,70047,70045,Blue,0,49304,49423,119
2022-10-07,70044,70054,Blue,1,71912,72529,617
2022-06-12,70050,70056,Blue,1,56552,56849,297
2022-10-27,70046,70050,Blue,1,31339,31517,178
2022-10-21,70050,70056,Blue,1,75874,76161,287
2022-01-05,70042,70060,Blue,1,43088,43975,887
2022-10-20,70051,70039,Blue,0,71044,71670,626
2022-12-13,70042,70060,Blue,1,30387,31309,922
2022-08-03,70049,70047,Blue,0,83452,83505,53
2022-08-04,70049,70045,Blue,0,32339,32537,198
2022-01-15,70045,70039,Blue,0,29561,29828,267
2022-02-03,70050,70058,Blue,1,71338,71761,423
2022-12-18,70057,70043,Blue,0,27805,28519,714
2022-03-19,70059,70041,Blue,0,43815,44719,904
2022-10-19,70055,70053,Blue,0,51193,51241,48
2022-10-28,70048,70058,Blue,1,81237,81714,477
2022-11-05,70050,70060,Blue,1,24174,24667,493
2022-01-03,70040,70056,Blue,1,87204,88029,825
2022-10-10,70047,70045,Blue,0,29875,29973,98
2022-09-26,70057,70055,Blue,0,41154,41225,71
2022-04-01,70059,70045,Blue,0,61696,62397,701
2022-02-14,70053,70045,Blue,0,19521,19981,460
2022-03-31,70049,70041,Blue,0,32568,33174,606
2022-10-29,70050,70056,Blue,1,80536,80826,290
2022-01-20,70038,70046,Blue,1,79784,80120,336
2022-12-04,70044,70048,Blue,1,85729,85980,251
2022-01-10,70046,70056,Blue,1,67730,68359,629
2022-12-11,70052,70054,Blue,1,70104,70157,53
2022-04-07,70059,70039,Blue,0,44954,45991,1037
2022-01-13,70055,70043,Blue,0,36021,36714,693
2022-12-19,70051,70043,Blue,0,84630,85095,465
2022-11-03,70049,70838,Blue,0,30248,30974,726
2022-03-10,70052,70056,Blue,1,25457,25584,127
2022-02-20,70059,70055,Blue,0,74893,75042,149
2022-10-03,70040,70056,Blue,1,29550,30413,863
2022-10-02,70038,70044,Blue,1,89113,89294,181
2022-04-11,70040,70052,Blue,1,82647,83268,621
2022-02-10,70042,70052,Blue,1,23806,24401,595
2022-11-11,70053,70051,Blue,0,58007,58063,56
2022-12-06,70051,70838,Blue,0,60198,60942,744
2022-07-02,70057,70045,Blue,0,56865,57485,620
2022-03-11,70038,70056,Blue,1,31747,32762,1015
2022-04-19,70042,70060,Blue,1,50921,51874,953
2022-02-11,70053,70043,Blue,0,20533,21158,625
2022-11-02,70052,70054,Blue,1,39375,39430,55
2022-09-05,70038,70056,Blue,1,62354,63328,974
2022-11-10,70055,70053,Blue,0,45815,45861,46
2022-10-29,70057,70053,Blue,0,22916,23073,157
2022-03-30,70044,70054,Blue,1,79516,80167,651
2022-11-12,70045,70838,Blue,0,79843,80183,340
2022-03-14,70048,70060,Blue,1,27187,27863,676
2022-07-25,70057,70047,Blue,0,45994,46512,518
2022-08-02,70042,70050,Blue,1,47867,48309,442
2022-11-11,70055,70049,Blue,0,41274,41546,272
2022-02-21,70038,70042,Blue,1,78620,78721,101
2022-03-04,70054,70060,Blue,1,73865,74120,255
2022-09-13,70054,70056,Blue,1,89029,89076,47
2022-09-05,70044,70058,Blue,1,31061,31812,751
2022-06-27,70057,70047,Blue,0,75809,76310,501
2022-08-31,70052,70058,Blue,1,35178,35419,241
2022-03-22,70038,70040,Blue,1,40269,40284,15
2022-07-23,70059,70043,Blue,0,26595,27411,816
2022-01-26,70049,70045,Blue,0,38096,38309,213
2022-02-15,70055,70047,Blue,0,20773,21138,365
2022-10-26,70045,70039,Blue,0,55849,56109,260
2022-10-19,70043,70041,Blue,0,43124,43154,30
2022-01-05,70038,70054,Blue,1,25453,26253,800
2022-02-11,70059,70055,Blue,0,67174,67319,145
2022-08-13,70051,70039,Blue,0,19868,20702,834
2022-03-15,70040,70042,Blue,1,65593,65627,34
2022-06-15,70055,70051,Blue,0,68046,68188,142
2022-02-06,70048,70052,Blue,1,26917,27145,228
2022-07-16,70040,70054,Blue,1,68060,68811,751
2022-01-06,70039,70838,Blue,0,44285,44321,36
2022-06-12,70053,70043,Blue,0,29547,30190,643
2022-12-14,70057,70051,Blue,0,53849,54079,230
2022-06-08,70050,70052,Blue,1,76909,77118,209
2022-03-11,70055,70053,Blue,0,41126,41171,45
2022-08-27,70043,70041,Blue,0,51234,51264,30
2022-06-13,70059,70043,Blue,0,51194,52161,967
2022-08-25,70046,70050,Blue,1,31573,31765,192
2022-01-21,70053,70051,Blue,0,75750,75805,55
2022-10-06,70046,70048,Blue,1,72452,72521,69
2022-08-11,70055,70039,Blue,0,32429,33273,844
2022-02-03,70055,70049,Blue,0,63751,64062,311
2022-02-04,70042,70056,Blue,1,85531,86509,978
2022-09-03,70045,70039,Blue,0,30519,30790,271
2022-06-26,70042,70060,Blue,1,73909,74969,1060
2022-12-29,70047,70041,Blue,0,50926,51242,316
2022-01-12,70055,70039,Blue,0,26542,27407,865
2022-05-20,70056,70058,Blue,1,60706,60780,74
2022-03-14,70055,70051,Blue,0,53294,53430,136
2022-10-10,70057,70039,Blue,0,58532,59434,902
2022-10-13,70047,70838,Blue,0,32211,32764,553
2022-06-15,70059,70051,Blue,0,54224,54557,333
2022-12-04,70044,70058,Blue,1,78230,78999,769
2022-12-20,70051,70043,Blue,0,23346,23886,540
2022-10-23,70040,70050,Blue,1,74290,74793,503
2022-09-24,70059,70838,Blue,0,77768,78825,1057
2022-10-28,70038,70060,Blue,1,70035,71155,1120
2022-04-17,70047,70039,Blue,0,51751,52185,434
2022-03-08,70046,70056,Blue,1,40560,41080,520
2022-06-11,70045,70041,Blue,0,52218,52431,213
2022-11-21,70040,70046,Blue,1,85752,86016,264
2022-04-01,70038,70050,Blue,1,67039,67615,576
2022-04-11,70042,70054,Blue,1,57940,58600,660
2022-02-03,70050,70056,Blue,1,24948,25257,309
2022-08-19,70038,70058,Blue,1,78324,79386,1062
2022-12-07,70040,70048,Blue,1,30734,31117,383
2022-06-10,70047,70043,Blue,0,72159,72447,288
2022-12-18,70048,70060,Blue,1,59192,59801,609
2022-10-20,70040,70048,Blue,1,77339,77729,390
2022-10-01,70059,70045,Blue,0,38956,39682,726
2022-10-15,70043,70039,Blue,0,77214,77327,113
2022-08-15,70040,70050,Blue,1,57191,57754,563
2022-09-15,70038,70046,Blue,1,75359,75751,392
2022-01-05,70047,70039,Blue,0,27047,27477,430
2022-11-01,70038,70054,Blue,1,44711,45534,823
2022-11-29,70050,70056,Blue,1,26236,26541,305
2022-01-17,70059,70053,Blue,0,46515,46773,258
2022-05-18,70043,70039,Blue,0,70682,70784,102
2022-11-16,70042,70050,Blue,1,73141,73595,454
2022-05-18,70051,70049,Blue,0,45889,46022,133
2022-02-20,70046,70060,Blue,1,74627,75406,779
2022-04-21,70038,70042,Blue,1,48675,48790,115
2022-02-27,70038,70048,Blue,1,55419,55980,561
2022-07-04,70049,70047,Blue,0,82814,82870,56
2022-07-20,70043,70838,Blue,0,49757,49966,209
2022-08-05,70054,70056,Blue,1,46449,46502,53
2022-09-25,70055,70051,Blue,0,54027,54171,144
2022-01-25,70038,70058,Blue,1,68224,69179,955
2022-03-27,70057,70055,Blue,0,80411,80481,70
2022-08-12,70055,70838,Blue,0,78599,79526,927
2022-04-21,70044,70054,Blue,1,78286,78900,614
2022-07-27,70043,70838,Blue,0,61272,61485,213
2022-01-16,70042,70050,Blue,1,63052,63502,450
2022-06-19,70043,70039,Blue,0,70423,70526,103
2022-07-26,70042,70052,Blue,1,69783,70369,586
2022-12-22,70042,70050,Blue,1,86432,86833,401
2022-12-22,70042,70050,Blue,1,32210,32791,581
2022-05-08,70056,70058,Blue,1,68563,68635,72
2022-01-16,70051,70039,Blue,0,76906,77578,672
2022-04-24,70059,70039,Blue,0,36853,37869,1016
2022-06-20,70048,70052,Blue,1,33370,33607,237
2022-08-09,70047,70041,Blue,0,24837,25174,337
2022-02-17,70049,70047,Blue,0,56498,56553,55
2022-02-06,70057,70055,Blue,0,50138,50207,69
2022-01-24,70057,70047,Blue,0,82443,82958,515
2022-01-14,70048,70052,Blue,1,88952,89193,241
2022-09-01,70056,70058,Blue,1,62192,62263,71
2022-07-05,70050,70052,Blue,1,87989,88108,119
2022-01-01,70059,70051,Blue,0,40154,40502,348
2022-11-23,70046,70058,Blue,1,76199,76840,641
2022-07-18,70038,70042,Blue,1,49788,49891,103
2022-08-29,70038,70042,Blue,1,23093,23190,97
2022-01-22,70040,70042,Blue,1,42132,42171,39
2022-01-29,70044,70058,Blue,1,34556,35912,1356
2022-09-13,70043,70838,Blue,0,78971,79140,169
2022-12-30,70053,70049,Blue,0,49628,49857,229
2022-03-26,70048,70054,Blue,1,56138,56507,369
2022-02-19,70057,70041,Blue,0,45553,46498,945
2022-06-22,70049,70838,Blue,0,51469,52096,627
2022-09-15,70047,70043,Blue,0,72068,72310,242
2022-08-29,70050,70054,Blue,1,22599,22797,198
2022-05-18,70051,70039,Blue,0,66841,67774,933
2022-06-24,70041,70039,Blue,0,31225,31268,43
2022-02-24,70059,70057,Blue,0,80059,80097,38
2022-02-09,70044,70050,Blue,1,67713,68059,346
2022-09-10,70057,70045,Blue,0,36358,36980,622
2022-11-07,70052,70058,Blue,1,85764,86025,261
2022-01-10,70049,70041,Blue,0,23973,24430,457
2022-12-28,70055,70838,Blue,0,47608,48565,957
2022-08-03,70048,70050,Blue,1,42111,42187,76
2022-11-10,70042,70050,Blue,1,53064,53497,433
2022-03-29,70040,70060,Blue,1,83956,85076,1120
2022-11-21,70040,70060,Blue,1,82148,83202,1054
2022-05-21,70059,70838,Blue,0,43817,45021,1204
2022-06-29,70040,70054,Blue,1,63538,64426,888
2022-03-18,70049,70039,Blue,0,28954,29451,497
2022-09-29,70044,70056,Blue,1,33472,34227,755
2022-06-16,70045,70039,Blue,0,69614,69902,288
2022-09-20,70059,70047,Blue,0,74896,75497,601
2022-11-12,70038,70050,Blue,1,68653,69224,571
2022-09-27,70057,70055,Blue,0,65690,65758,68
2022-01-06,70053,70045,Blue,0,62862,63279,417
2022-06-20,70046,70052,Blue,1,75784,76126,342
2022-08-05,70059,70047,Blue,0,44175,44745,570
2022-06-10,70055,70043,Blue,0,36580,37323,743
2022-02-02,70053,70838,Blue,0,67749,68827,1078
2022-09-03,70048,70056,Blue,1,40978,41350,372
2022-12-25,70046,70056,Blue,1,61084,61617,533
2022-12-16,70054,70058,Blue,1,73452,73612,160
2022-10-30,70042,70054,Blue,1,47948,48624,676
2022-03-07,70051,70039,Blue,0,73639,74286,647
2022-09-08,70050,70052,Blue,1,63262,63378,116
2022-02-16,70044,70048,Blue,1,25948,26199,251
2022-09-27,70054,70060,Blue,1,53697,53940,243
2022-03-30,70038,70040,Blue,1,34156,34171,15
2022-10-18,70055,70039,Blue,0,34097,34904,807
2022-04-24,70053,70049,Blue,0,24964,25162,198
2022-08-17,70055,70047,Blue,0,35634,36018,384
2022-04-23,70044,70060,Blue,1,78825,79731,906
2022-06-06,70043,70041,Blue,0,35181,35209,28
2022-04-20,70048,70058,Blue,1,54898,55417,519
2022-07-14,70053,70041,Blue,0,80229,80933,704
2022-03-10,70048,70060,Blue,1,68151,68790,639
2022-10-02,70047,70043,Blue,0,54566,54845,279
2022-08-20,70042,70060,Blue,1,56800,57820,1020
2022-07-25,70040,70060,Blue,1,84202,85255,1053
2022-01-21,70038,70056,Blue,1,77432,78268,836
2022-07-17,70052,70054,Blue,1,70712,70767,55
2022-04-05,70053,70045,Blue,0,61650,62070,420
2022-04-11,70057,70041,Blue,0,35329,36222,893
2022-02-18,70041,70039,Blue,0,55764,55796,32
2022-10-14,70053,70049,Blue,0,43965,44163,198
2022-07-20,70039,70838,Blue,0,65830,65863,33
2022-03-17,70038,70060,Blue,1,59833,60994,1161
2022-01-19,70044,70052,Blue,1,30441,31292,851
2022-04-02,70038,70040,Blue,1,51296,51311,15
2022-04-11,70058,70060,Blue,1,46915,46983,68
2022-03-30,70059,70039,Blue,0,23368,24478,1110
2022-07-08,70051,70041,Blue,0,65710,66293,583
2022-01-18,70046,70048,Blue,1,69817,69908,91
2022-01-12,70052,70060,Blue,1,55172,55538,366
2022-01-24,70042,70044,Blue,1,27723,27871,148
2022-11-17,70058,70060,Blue,1,80485,80549,64
2022-10-13,70047,70039,Blue,0,57093,57508,415
2022-02-17,70047,70041,Blue,0,31828,32216,388
2022-07-03,70046,70050,Blue,1,77339,77545,206
2022-10-13,70055,70041,Blue,0,70466,71319,853
2022-04-18,70038,70056,Blue,1,20654,21637,983
2022-07-13,70057,70055,Blue,0,34007,34075,68
2022-06-18,70045,70043,Blue,0,27423,27561,138
2022-02-27,70055,70047,Blue,0,28039,28422,383
2022-01-06,70053,70838,Blue,0,58368,59215,847
2022-06-17,70045,70041,Blue,0,37967,38167,200
2022-04-23,70040,70044,Blue,1,58886,59016,130
2022-07-28,70044,70052,Blue,1,58528,59043,515
2022-07-12,70051,70041,Blue,0,20866,21512,646
2022-11-13,70041,70039,Blue,0,89910,89945,35
2022-09-27,70045,70041,Blue,0,27730,27924,194
2022-09-20,70038,70054,Blue,1,65359,66231,872
2022-01-13,70041,70039,Blue,0,54313,54361,48
2022-03-27,70045,70041,Blue,0,26996,27179,183
2022-01-04,70059,70051,Blue,0,57793,58112,319
2022-12-25,70040,70044,Blue,1,81723,81828,105
2022-02-06,70059,70055,Blue,0,69498,69642,144
2022-11-01,70058,70060,Blue,1,23729,23796,67
2022-04-30,70050,70058,Blue,1,87711,88235,524
2022-09-26,70048,70058,Blue,1,31249,31924,675
2022-02-22,70055,70039,Blue,0,32837,33670,833
2022-01-10,70052,70054,Blue,1,44151,44212,61
2022-01-26,70052,70058,Blue,1,55251,55510,259
2022-08-24,70042,70044,Blue,1,56583,56608,25
2022-09-18,70051,70045,Blue,0,75250,75594,344
2022-05-21,70053,70045,Blue,0,50043,50569,526
2022-06-19,70045,70043,Blue,0,53518,53635,117
2022-05-21,70059,70057,Blue,0,33014,33055,41
2022-03-11,70047,70045,Blue,0,35821,35924,103
2022-03-29,70044,70056,Blue,1,34359,35048,689
2022-02-17,70051,70047,Blue,0,53748,53944,196
2022-01-29,70047,70043,Blue,0,77373,77698,325
2022-09-30,70055,70053,Blue,0,29497,29542,45
2022-10-23,70051,70049,Blue,0,73649,73756,107
2022-09-01,70054,70058,Blue,1,77535,77687,152
2022-10-28,70040,70050,Blue,1,79479,79950,471
2022-05-25,70043,70039,Blue,0,19901,20017,116
2022-10-02,70056,70060,Blue,1,26319,26478,159
2022-03-23,70052,70054,Blue,1,23802,23862,60
2022-06-19,70057,70043,Blue,0,55841,56699,858
2022-10-13,70055,70049,Blue,0,69348,69610,262
2022-02-03,70051,70039,Blue,0,34264,35018,754
2022-06-28,70050,70060,Blue,1,58525,59177,652
2022-02-12,70043,70041,Blue,0,44199,44227,28
2022-04-08,70055,70047,Blue,0,60982,61325,343
2022-02-08,70050,70052,Blue,1,26334,26457,123
2022-02-28,70057,70051,Blue,0,37089,37396,307
2022-11-08,70038,70052,Blue,1,65308,66066,758
2022-05-19,70047,70039,Blue,0,42246,42778,532
2022-07-01,70052,70056,Blue,1,52923,53061,138
2022-08-10,70045,70838,Blue,0,75584,75899,315
2022-12-14,70054,70058,Blue,1,47559,47716,157
2022-01-11,70040,70048,Blue,1,89226,89628,402
2022-05-21,70042,70050,Blue,1,34747,35300,553
2022-10-30,70053,70041,Blue,0,55251,55975,724
2022-08-08,70057,70049,Blue,0,52296,52708,412
2022-03-15,70046,70054,Blue,1,31844,32284,440
2022-08-29,70059,70053,Blue,0,76933,77162,229
2022-11-15,70050,70060,Blue,1,65704,66312,608
2022-02-07,70047,70043,Blue,0,65331,65631,300
2022-05-19,70046,70048,Blue,1,20323,20451,128
2022-08-10,70045,70041,Blue,0,34747,34955,208
2022-09-23,70057,70039,Blue,0,66088,67042,954
2022-04-08,70042,70046,Blue,1,65660,65872,212
2022-04-04,70039,70838,Blue,0,54137,54198,61
2022-08-06,70048,70054,Blue,1,76654,76985,331
2022-01-22,70047,70039,Blue,0,68538,69197,659
2022-09-19,70039,70838,Blue,0,71223,71292,69
2022-12-11,70055,70039,Blue,0,39694,40498,804
2022-04-13,70053,70051,Blue,0,26649,26708,59
2022-02-17,70053,70049,Blue,0,58959,59142,183
2022-10-01,70046,70058,Blue,1,65135,65810,675
2022-10-02,70042,70044,Blue,1,85663,85697,34
2022-06-19,70043,70838,Blue,0,77506,77699,193
2022-03-23,70059,70043,Blue,0,49216,50108,892
2022-01-11,70050,70052,Blue,1,72575,72691,116
2022-09-10,70041,70838,Blue,0,33464,33598,134
2022-05-21,70057,70055,Blue,0,47662,47731,69
2022-07-07,70059,70051,Blue,0,40575,40913,338
2022-01-14,70038,70046,Blue,1,58080,58483,403
2022-07-12,70048,70052,Blue,1,65590,65802,212
2022-01-02,70046,70058,Blue,1,77858,78480,622
2022-07-28,70046,70060,Blue,1,82655,83479,824
2022-06-23,70042,70046,Blue,1,63073,63281,208
2022-08-24,70040,70044,Blue,1,25902,26002,100
2022-01-07,70053,70049,Blue,0,27561,27816,255
2022-03-05,70051,70047,Blue,0,74409,74596,187
2022-03-02,70042,70044,Blue,1,62432,62459,27
2022-07-10,70053,70043,Blue,0,65077,65719,642
2022-09-17,70048,70052,Blue,1,79803,80004,201
2022-06-09,70055,70838,Blue,0,68818,69774,956
2022-12-17,70055,70041,Blue,0,63465,64236,771
2022-07-05,70038,70040,Blue,1,82033,82048,15
2022-08-07,70050,70052,Blue,1,29035,29138,103
2022-01-28,70053,70049,Blue,0,50611,50817,206
2022-02-18,70045,70039,Blue,0,39387,39640,253
2022-12-08,70048,70060,Blue,1,81264,82454,1190
2022-10-05,70058,70060,Blue,1,35412,35559,147
2022-10-22,70059,70057,Blue,0,62723,62758,35
2022-06-30,70050,70056,Blue,1,38417,38871,454
2022-09-27,70048,70054,Blue,1,44166,44490,324
2022-07-10,70038,70050,Blue,1,26892,27414,522
2022-04-12,70052,70058,Blue,1,71652,71907,255
2022-03-16,70046,70060,Blue,1,54093,54835,742
2022-02-02,70050,70052,Blue,1,41669,41825,156
2022-03-08,70042,70044,Blue,1,54293,54323,30
2022-12-31,70041,70039,Blue,0,65818,65858,40
2022-02-16,70046,70058,Blue,1,54404,55012,608
2022-08-23,70038,70046,Blue,1,89983,91557,1574
2022-04-07,70055,70045,Blue,0,33758,34285,527
2022-10-12,70059,70041,Blue,0,70207,71087,880
2022-12-19,70057,70055,Blue,0,55424,55495,71
2022-07-15,70059,70051,Blue,0,63607,63929,322
2022-09-03,70042,70048,Blue,1,71458,71783,325
2022-01-02,70059,70043,Blue,0,50061,50882,821
2022-07-26,70038,70060,Blue,1,30672,31912,1240
2022-05-14,70055,70049,Blue,0,23003,23292,289
2022-10-26,70048,70052,Blue,1,30333,30560,227
2022-12-22,70059,70838,Blue,0,55047,56145,1098
2022-01-15,70040,70042,Blue,1,69405,69442,37
2022-11-20,70047,70043,Blue,0,63671,63925,254
2022-01-28,70047,70039,Blue,0,69667,70097,430
2022-06-12,70043,70039,Blue,0,57993,58099,106
2022-04-05,70049,70045,Blue,0,54069,54250,181
2022-06-12,70059,70838,Blue,0,80238,81352,1114
2022-01-09,70038,70054,Blue,1,55351,56245,894
2022-02-05,70046,70048,Blue,1,81008,81083,75
2022-12-01,70038,70056,Blue,1,34455,35300,845
2022-03-04,70043,70041,Blue,0,56870,56899,29
2022-09-28,70044,70048,Blue,1,60531,60781,250
2022-04-18,70057,70039,Blue,0,80133,81085,952
2022-02-25,70053,70043,Blue,0,75802,76394,592
2022-03-02,70042,70044,Blue,1,25638,25668,30
2022-11-12,70055,70051,Blue,0,43481,43625,144
2022-03-01,70051,70045,Blue,0,59442,59783,341
2022-09-17,70045,70039,Blue,0,68858,69122,264
2022-12-24,70040,70056,Blue,1,84667,85491,824
2022-10-28,70055,70043,Blue,0,31416,32115,699
2022-07-12,70059,70055,Blue,0,28901,29049,148
2022-03-25,70049,70047,Blue,0,69633,69690,57
2022-12-31,70046,70050,Blue,1,81053,81236,183
2022-06-09,70042,70052,Blue,1,76092,76700,608
2022-11-14,70059,70838,Blue,0,19880,21107,1227
2022-01-26,70057,70055,Blue,0,82408,82475,67
2022-07-07,70045,70039,Blue,0,23414,23690,276
2022-12-06,70049,70838,Blue,0,23997,24684,687
2022-09-13,70038,70052,Blue,1,73738,74391,653
2022-11-11,70047,70045,Blue,0,56823,56915,92
2022-01-08,70052,70054,Blue,1,79501,79547,46
2022-02-09,70043,70041,Blue,0,72445,72473,28
2022-04-23,70042,70058,Blue,1,73540,74412,872
2022-02-09,70040,70044,Blue,1,35915,36056,141
2022-10-11,70040,70042,Blue,1,54995,55026,31
2022-05-20,70052,70056,Blue,1,51682,51838,156
2022-01-07,70055,70049,Blue,0,83680,84030,350
2022-02-24,70050,70056,Blue,1,49316,49660,344
2022-12-11,70059,70039,Blue,0,46280,47284,1004
2022-01-25,70051,70838,Blue,0,54009,54902,893
2022-11-30,70054,70058,Blue,1,78260,78422,162
2022-12-16,70055,70041,Blue,0,70400,71164,764
2022-08-03,70054,70056,Blue,1,63720,63769,49
2022-07-04,70043,70039,Blue,0,58429,58540,111
2022-05-21,70057,70039,Blue,0,31029,32092,1063
2022-12-21,70040,70050,Blue,1,23328,23809,481
2022-07-26,70047,70838,Blue,0,48472,49028,556
2022-09-22,70059,70838,Blue,0,32658,33984,1326
2022-04-21,70046,70056,Blue,1,34232,34783,551
2022-11-03,70049,70838,Blue,0,25183,25794,611
2022-02-06,70056,70058,Blue,1,68153,68229,76
2022-05-18,70055,70051,Blue,0,24171,24346,175
2022-07-01,70057,70055,Blue,0,58205,58273,68
2022-03-23,70038,70050,Blue,1,68230,68822,592
2022-04-03,70055,70053,Blue,0,69139,69185,46
2022-10-08,70057,70053,Blue,0,27682,27834,152
2022-06-03,70048,70052,Blue,1,88207,88566,359
2022-11-08,70040,70058,Blue,1,84982,85916,934
2022-07-12,70059,70053,Blue,0,44256,44475,219
2022-08-02,70059,70043,Blue,0,58865,59802,937
2022-12-24,70055,70053,Blue,0,83341,83387,46
2022-04-11,70051,70041,Blue,0,61167,61708,541
2022-11-04,70051,70047,Blue,0,30686,30896,210
2022-05-18,70051,70049,Blue,0,64209,64315,106
2022-08-01,70051,70041,Blue,0,79265,79824,559
2022-11-22,70051,70041,Blue,0,66877,67400,523
2022-01-05,70059,70047,Blue,0,27852,28397,545
2022-05-29,70038,70048,Blue,1,41115,41588,473
2022-01-14,70042,70048,Blue,1,41970,42293,323
2022-06-18,70059,70043,Blue,0,53281,54196,915
2022-01-10,70057,70045,Blue,0,59377,60012,635
2022-09-04,70047,70045,Blue,0,63696,63784,88
2022-01-18,70050,70060,Blue,1,36573,37223,650
2022-06-12,70059,70051,Blue,0,48430,48754,324
2022-12-30,70048,70058,Blue,1,39059,39582,523
2022-01-06,70053,70043,Blue,0,84302,84882,580
2022-10-12,70046,70052,Blue,1,58065,58413,348
2022-08-17,70044,70046,Blue,1,73427,73527,100
2022-11-10,70055,70049,Blue,0,56059,56356,297
2022-08-21,70042,70058,Blue,1,55496,56417,921
2022-09-01,70059,70049,Blue,0,53834,54281,447
2022-08-03,70055,70047,Blue,0,27797,28172,375
2022-12-05,70059,70043,Blue,0,33384,34265,881
2022-08-02,70053,70838,Blue,0,22909,23787,878
2022-02-18,70043,70041,Blue,0,54621,54649,28
2022-02-23,70038,70054,Blue,1,66182,67101,919
2022-08-13,70048,70058,Blue,1,37275,37756,481
2022-08-02,70042,70044,Blue,1,82830,82870,40
2022-01-12,70046,70054,Blue,1,34234,34677,443
2022-02-07,70044,70056,Blue,1,69266,69963,697
2022-10-22,70053,70045,Blue,0,80137,80659,522
2022-08-26,70059,70049,Blue,0,42195,42678,483
2022-10-01,70054,70058,Blue,1,67790,67954,164
2022-05-15,70057,70047,Blue,0,40287,40801,514
2022-04-01,70041,70039,Blue,0,51887,51928,41
2022-10-13,70042,70048,Blue,1,57212,57526,314
2022-01-12,70048,70056,Blue,1,61548,61938,390
2022-01-26,70042,70060,Blue,1,46033,47078,1045
2022-02-28,70042,70052,Blue,1,65384,65930,546
2022-09-25,70055,70043,Blue,0,31814,32480,666
2022-04-19,70059,70838,Blue,0,40419,41820,1401
2022-11-14,70057,70053,Blue,0,27791,27942,151
2022-09-12,70038,70054,Blue,1,20062,20919,857
2022-09-06,70042,70052,Blue,1,47844,48408,564
2022-07-26,70038,70044,Blue,1,90016,91381,1365
2022-09-29,70057,70041,Blue,0,37004,38017,1013
2022-01-10,70046,70052,Blue,1,62437,62766,329
2022-02-25,70049,70043,Blue,0,87421,87785,364
2022-12-19,70048,70054,Blue,1,53914,54237,323
2022-04-22,70051,70045,Blue,0,26468,26824,356
2022-09-16,70051,70041,Blue,0,52884,53438,554
2022-11-10,70046,70048,Blue,1,20344,20436,92
2022-04-12,70053,70041,Blue,0,33880,34641,761
2022-08-26,70042,70056,Blue,1,38069,38797,728
2022-07-16,70049,70043,Blue,0,24652,24995,343
2022-10-05,70054,70060,Blue,1,42891,43138,247
2022-04-01,70059,70838,Blue,0,49220,50373,1153
2022-07-07,70048,70052,Blue,1,51097,51413,316
2022-07-12,70040,70046,Blue,1,76826,77101,275
2022-04-12,70049,70043,Blue,0,53874,54315,441
2022-09-09,70053,70039,Blue,0,46018,46748,730
2022-08-30,70055,70051,Blue,0,28391,28538,147
2022-02-17,70050,70052,Blue,1,41409,41540,131
2022-03-23,70049,70838,Blue,0,57970,58548,578
2022-01-31,70053,70041,Blue,0,65306,66040,734
2022-08-08,70059,70055,Blue,0,57194,57370,176
2022-09-24,70040,70056,Blue,1,25694,26527,833
2022-03-31,70042,70054,Blue,1,61514,62223,709
2022-09-13,70049,70838,Blue,0,41116,41719,603
2022-05-09,70055,70049,Blue,0,78804,79086,282
2022-12-12,70049,70039,Blue,0,61843,62331,488
2022-07-01,70057,70045,Blue,0,68447,69141,694
2022-01-08,70055,70049,Blue,0,33221,33538,317
2022-12-26,70057,70053,Blue,0,70662,70813,151
2022-04-15,70044,70050,Blue,1,26561,26937,376
2022-04-02,70053,70049,Blue,0,32182,32364,182
2022-08-23,70050,70054,Blue,1,73038,73275,237
2022-12-05,70051,70039,Blue,0,23832,24521,689
2022-12-24,70059,70047,Blue,0,36253,36785,532
2022-02-19,70047,70838,Blue,0,73098,73565,467
2022-01-12,70045,70043,Blue,0,21568,21662,94
2022-06-23,70043,70838,Blue,0,48488,48805,317
2022-08-18,70045,70043,Blue,0,66369,66457,88
2022-04-02,70059,70051,Blue,0,29765,30107,342
2022-10-22,70038,70044,Blue,1,39944,40117,173
2022-05-20,70050,70052,Blue,1,82862,82978,116
2022-11-17,70044,70046,Blue,1,48914,49020,106
2022-12-14,70043,70838,Blue,0,58996,59195,199
2022-04-30,70051,70049,Blue,0,21205,21312,107
2022-08-28,70050,70054,Blue,1,60277,60513,236
2022-04-20,70059,70043,Blue,0,22398,23293,895
2022-12-05,70054,70058,Blue,1,20880,21074,194
2022-01-27,70049,70838,Blue,0,55009,55611,602
2022-03-28,70055,70049,Blue,0,40602,40915,313
2022-11-04,70046,70060,Blue,1,27455,28236,781
2022-07-20,70057,70053,Blue,0,44804,44959,155
2022-06-06,70048,70052,Blue,1,61888,62186,298
2022-10-19,70054,70058,Blue,1,57042,57223,181
2022-07-08,70044,70058,Blue,1,67515,68492,977
2022-08-10,70043,70041,Blue,0,54489,54519,30
2022-09-15,70038,70056,Blue,1,24133,25061,928
2022-02-21,70044,70054,Blue,1,54287,54912,625
2022-04-06,70040,70056,Blue,1,24008,24906,898
2022-03-17,70047,70838,Blue,0,72742,73276,534
2022-04-26,70057,70049,Blue,0,56197,56607,410
2022-08-08,70057,70045,Blue,0,64846,65485,639
2022-11-29,70048,70060,Blue,1,73142,73764,622
2022-02-13,70057,70049,Blue,0,28593,29003,410
2022-12-31,70043,70838,Blue,0,47419,47608,189
2022-06-04,70045,70838,Blue,0,23456,23826,370
2022-08-27,70048,70052,Blue,1,45258,45494,236
2022-12-20,70047,70838,Blue,0,30597,31160,563
2022-05-31,70039,70838,Blue,0,66601,66635,34
2022-03-18,70050,70058,Blue,1,55453,55868,415
2022-04-15,70059,70055,Blue,0,55093,55235,142
2022-08-12,70044,70060,Blue,1,31403,32413,1010
2022-03-27,70042,70050,Blue,1,80503,80934,431
2022-02-11,70048,70056,Blue,1,75699,76088,389
2022-07-06,70049,70043,Blue,0,63137,63491,354
2022-10-28,70055,70045,Blue,0,43884,44414,530
2022-03-22,70054,70056,Blue,1,70968,71017,49
2022-03-23,70038,70050,Blue,1,71412,72013,601
2022-10-19,70054,70058,Blue,1,32414,32568,154
2022-09-07,70047,70045,Blue,0,66149,66260,111
2022-02-06,70059,70057,Blue,0,49513,49548,35
2022-02-02,70059,70053,Blue,0,22767,23052,285
2022-12-27,70044,70052,Blue,1,29060,29513,453
2022-03-26,70046,70054,Blue,1,48923,49432,509
2022-12-16,70044,70058,Blue,1,40687,41549,862
2022-10-24,70048,70052,Blue,1,51899,52109,210
2022-07-24,70050,70060,Blue,1,33791,34366,575
2022-10-03,70046,70054,Blue,1,63140,63572,432
2022-05-19,70053,70051,Blue,0,65589,65646,57
2022-07-20,70053,70043,Blue,0,33776,34391,615
2022-09-06,70046,70050,Blue,1,64714,64890,176
2022-01-04,70044,70056,Blue,1,50988,51710,722
2022-06-05,70049,70047,Blue,0,28773,28827,54
2022-10-03,70057,70838,Blue,0,19601,20798,1197
2022-09-22,70059,70047,Blue,0,47839,48461,622
2022-12-04,70044,70060,Blue,1,70680,71540,860
2022-02-01,70044,70050,Blue,1,23890,24228,338
2022-01-03,70052,70056,Blue,1,22428,22588,160
2022-12-30,70057,70051,Blue,0,36572,36829,257
2022-01-01,70042,70056,Blue,1,81158,81869,711
2022-12-26,70042,70048,Blue,1,71151,71458,307
2022-02-22,70052,70054,Blue,1,49521,49579,58
2022-11-25,70054,70056,Blue,1,80430,80476,46
2022-08-13,70057,70051,Blue,0,58471,58706,235
2022-09-25,70045,70043,Blue,0,48142,48236,94
2022-02-21,70059,70049,Blue,0,53533,54040,507
2022-05-30,70045,70041,Blue,0,64267,64502,235
2022-11-04,70045,70838,Blue,0,55875,56319,444
2022-03-06,70059,70039,Blue,0,34756,35828,1072
2022-08-28,70048,70054,Blue,1,38169,38469,300
2022-07-15,70042,70058,Blue,1,31175,32183,1008
2022-08-08,70059,70043,Blue,0,83286,84194,908
2022-03-14,70046,70056,Blue,1,84748,85322,574
2022-12-09,70057,70838,Blue,0,78262,79217,955
2022-11-25,70053,70039,Blue,0,50695,51425,730
2022-03-09,70049,70041,Blue,0,58635,59063,428
2022-06-29,70055,70039,Blue,0,28665,29620,955
2022-10-17,70057,70055,Blue,0,19604,19676,72
2022-11-19,70058,70060,Blue,1,31181,31240,59
2022-04-18,70051,70045,Blue,0,88498,88829,331
2022-08-18,70038,70058,Blue,1,75002,75994,992
2022-01-05,70043,70039,Blue,0,71986,72115,129
2022-02-25,70050,70060,Blue,1,82270,82821,551
2022-08-14,70040,70056,Blue,1,79168,80158,990
2022-06-25,70051,70838,Blue,0,67645,68734,1089
2022-07-16,70055,70041,Blue,0,31593,32431,838
2022-09-04,70057,70838,Blue,0,63105,64209,1104
2022-09-27,70040,70042,Blue,1,27354,27389,35
2022-08-13,70057,70039,Blue,0,49303,50267,964
2022-04-12,70040,70044,Blue,1,54908,55023,115
2022-06-26,70049,70045,Blue,0,66227,66428,201
2022-02-09,70038,70054,Blue,1,29969,30823,854
2022-10-16,70050,70060,Blue,1,84347,84896,549
2022-01-04,70041,70838,Blue,0,35278,35552,274
2022-04-21,70042,70052,Blue,1,82156,82755,599
2022-06-09,70059,70041,Blue,0,28458,29565,1107
2022-03-16,70054,70058,Blue,1,63653,63815,162
2022-06-01,70042,70044,Blue,1,45836,45865,29
2022-06-16,70042,70050,Blue,1,61816,62312,496
2022-07-09,70040,70058,Blue,1,63746,64736,990
2022-08-23,70048,70050,Blue,1,70351,70405,54
2022-08-08,70050,70052,Blue,1,38393,38522,129
2022-06-10,70050,70060,Blue,1,69119,69869,750
2022-03-02,70049,70838,Blue,0,54877,55509,632
2022-02-25,70053,70838,Blue,0,30259,31255,996
2022-02-25,70040,70054,Blue,1,21097,21886,789
2022-02-04,70048,70054,Blue,1,88264,88593,329
2022-03-17,70055,70043,Blue,0,30147,30858,711
2022-07-13,70050,70060,Blue,1,21784,22330,546
2022-08-09,70040,70056,Blue,1,44160,45086,926
2022-11-28,70045,70041,Blue,0,35054,35231,177
2022-01-10,70044,70056,Blue,1,25687,26370,683
2022-07-25,70055,70045,Blue,0,56535,57066,531
2022-06-21,70053,70045,Blue,0,79560,79986,426
2022-04-14,70055,70045,Blue,0,81914,82450,536
2022-07-06,70040,70048,Blue,1,28804,29270,466
2022-03-10,70052,70058,Blue,1,57792,58060,268
2022-07-14,70052,70054,Blue,1,44763,44840,77
2022-12-18,70052,70054,Blue,1,70684,70733,49
2022-06-16,70042,70058,Blue,1,74215,75196,981
2022-06-15,70051,70043,Blue,0,81561,82083,522
2022-01-27,70048,70058,Blue,1,27830,28554,724
2022-05-18,70057,70049,Blue,0,32432,32846,414
2022-07-25,70046,70052,Blue,1,57045,57384,339
2022-03-13,70045,70041,Blue,0,26107,26262,155
2022-07-12,70038,70044,Blue,1,78311,78515,204
2022-12-24,70040,70050,Blue,1,21737,22215,478
2022-12-16,70052,70056,Blue,1,49986,50126,140
2022-12-31,70045,70041,Blue,0,77626,77791,165
2022-01-04,70056,70058,Blue,1,70078,70153,75
2022-07-21,70042,70054,Blue,1,48440,49156,716
2022-11-07,70040,70052,Blue,1,64096,64812,716
2022-08-29,70049,70838,Blue,0,26427,27062,635
2022-06-18,70047,70039,Blue,0,32071,32530,459
2022-01-04,70042,70058,Blue,1,43090,43890,800
2022-07-22,70052,70058,Blue,1,45443,45720,277
2022-06-21,70058,70060,Blue,1,45405,45477,72
2022-10-04,70057,70047,Blue,0,22670,23194,524
2022-08-21,70038,70040,Blue,1,78016,78031,15
2022-12-13,70055,70045,Blue,0,45473,46042,569
2022-10-02,70048,70054,Blue,1,59586,59883,297
2022-05-16,70059,70047,Blue,0,62346,63022,676
2022-08-02,70038,70060,Blue,1,38460,39658,1198
2022-02-26,70053,70051,Blue,0,31684,31745,61
2022-03-09,70043,70039,Blue,0,72999,73108,109
2022-05-27,70042,70050,Blue,1,89349,89784,435
2022-04-05,70046,70058,Blue,1,47927,48548,621
2022-05-21,70056,70058,Blue,1,32221,32293,72
2022-02-01,70043,70039,Blue,0,59380,59479,99
2022-08-29,70055,70051,Blue,0,58398,58534,136
2022-11-20,70057,70041,Blue,0,60396,61239,843
2022-07-10,70049,70045,Blue,0,51099,51304,205
2022-11-01,70040,70042,Blue,1,65926,65960,34
2022-03-10,70050,70058,Blue,1,59820,60246,426
2022-08-17,70044,70058,Blue,1,33791,34586,795
2022-10-01,70038,70060,Blue,1,23021,24101,1080
2022-03-24,70055,70043,Blue,0,45684,46402,718
2022-05-18,70055,70049,Blue,0,27546,27842,296
2022-06-27,70052,70056,Blue,1,40315,40504,189
2022-07-04,70047,70838,Blue,0,70905,71406,501
2022-09-29,70059,70041,Blue,0,71237,72163,926
2022-07-11,70049,70039,Blue,0,53046,53608,562
2022-02-22,70046,70060,Blue,1,64426,65225,799
2022-11-14,70040,70046,Blue,1,65909,66167,258
2022-01-13,70057,70049,Blue,0,23754,24187,433
2022-04-15,70046,70052,Blue,1,54145,54487,342
2022-02-10,70046,70052,Blue,1,70257,70567,310
2022-05-08,70051,70049,Blue,0,73587,73692,105
2022-08-29,70042,70056,Blue,1,47261,47998,737
2022-12-18,70047,70045,Blue,0,87963,88057,94
2022-07-30,70052,70060,Blue,1,72569,72943,374
2022-04-02,70059,70051,Blue,0,86572,86891,319
2022-12-21,70046,70056,Blue,1,33450,33992,542
2022-05-27,70043,70039,Blue,0,65478,65592,114
2022-09-16,70056,70060,Blue,1,74159,74336,177
2022-03-21,70049,70047,Blue,0,28092,28148,56
2022-12-10,70047,70043,Blue,0,82921,83172,251
2022-11-24,70041,70838,Blue,0,53712,53830,118
2022-06-17,70047,70043,Blue,0,21610,21892,282
2022-05-14,70057,70055,Blue,0,36098,36170,72
2022-10-23,70054,70058,Blue,1,79428,79593,165
2022-05-21,70041,70838,Blue,0,79648,79785,137
2022-11-03,70045,70838,Blue,0,56490,56883,393
2022-02-28,70059,70055,Blue,0,86892,87034,142
2022-03-18,70040,70052,Blue,1,56951,57650,699
2022-11-18,70057,70053,Blue,0,26332,26489,157
2022-08-18,70038,70060,Blue,1,54019,55171,1152
2022-02-17,70059,70041,Blue,0,67873,68856,983
2022-06-21,70040,70052,Blue,1,36919,37673,754
2022-11-24,70046,70058,Blue,1,36742,37349,607
2022-04-12,70043,70838,Blue,0,85494,85677,183
2022-10-16,70040,70058,Blue,1,79772,80794,1022
2022-09-09,70057,70043,Blue,0,32735,33569,834
2022-01-31,70050,70060,Blue,1,65637,66964,1327
2022-03-30,70053,70039,Blue,0,30875,31665,790
2022-08-07,70044,70060,Blue,1,52906,53812,906
2022-03-16,70040,70060,Blue,1,58389,59529,1140
2022-04-05,70046,70058,Blue,1,60546,61217,671
2022-01-24,70052,70058,Blue,1,38148,38415,267
2022-08-24,70050,70056,Blue,1,20568,20869,301
2022-04-20,70046,70054,Blue,1,66573,67020,447
2022-03-28,70044,70048,Blue,1,62497,62753,256
2022-09-29,70057,70047,Blue,0,53617,54119,502
2022-11-10,70049,70045,Blue,0,61132,61343,211
2022-10-15,70038,70050,Blue,1,70155,70737,582
2022-05-25,70040,70046,Blue,1,58471,58754,283
2022-01-25,70052,70056,Blue,1,60337,60484,147
2022-10-15,70048,70058,Blue,1,67500,68015,515
2022-12-30,70048,70058,Blue,1,44202,44729,527
2022-11-10,70057,70039,Blue,0,24638,25639,1001
2022-11-26,70046,70050,Blue,1,48375,48552,177
2022-10-20,70038,70060,Blue,1,34908,35996,1088
2022-05-14,70059,70051,Blue,0,24604,24935,331
2022-04-08,70038,70058,Blue,1,42221,43456,1235
2022-01-24,70048,70050,Blue,1,68450,68509,59
2022-09-21,70044,70056,Blue,1,30602,31284,682
2022-02-19,70048,70056,Blue,1,85175,85565,390
2022-09-05,70042,70048,Blue,1,49538,49855,317
2022-07-20,70042,70048,Blue,1,64139,64453,314
2022-07-16,70051,70043,Blue,0,65770,66269,499
2022-09-05,70042,70060,Blue,1,43795,44750,955
2022-03-14,70057,70053,Blue,0,67634,67787,153
2022-01-21,70052,70054,Blue,1,73186,73240,54
2022-06-17,70051,70041,Blue,0,20618,21539,921
2022-08-09,70046,70060,Blue,1,53822,54600,778
2022-03-17,70048,70054,Blue,1,27741,28048,307
2022-07-09,70052,70056,Blue,1,66627,66772,145
2022-03-24,70042,70054,Blue,1,26190,26878,688
2022-01-07,70055,70041,Blue,0,88294,89033,739
2022-11-10,70057,70043,Blue,0,31067,31909,842
2022-04-15,70051,70041,Blue,0,22896,23513,617
2022-03-12,70049,70039,Blue,0,52411,52944,533
2022-10-18,70046,70052,Blue,1,21602,21946,344
2022-06-21,70050,70052,Blue,1,36069,36269,200
2022-04-14,70043,70039,Blue,0,39664,39773,109
2022-08-13,70045,70838,Blue,0,46740,47091,351
2022-05-24,70047,70838,Blue,0,46215,46758,543
2022-09-07,70051,70041,Blue,0,47426,48305,879
2022-07-11,70038,70056,Blue,1,62067,63119,1052
2022-01-20,70042,70060,Blue,1,33701,34868,1167
2022-09-26,70046,70060,Blue,1,57192,57936,744
2022-09-30,70042,70052,Blue,1,43199,43793,594
2022-04-12,70047,70041,Blue,0,54812,55144,332
2022-04-17,70040,70056,Blue,1,45493,46323,830
2022-01-24,70057,70039,Blue,0,35922,36884,962
2022-11-29,70055,70047,Blue,0,67279,67642,363
2022-03-27,70040,70042,Blue,1,24619,24658,39
2022-11-13,70045,70043,Blue,0,49182,49269,87
2022-04-05,70050,70052,Blue,1,63167,63277,110
2022-04-19,70055,70049,Blue,0,28950,29287,337
2022-03-22,70057,70053,Blue,0,51275,51426,151
2022-08-22,70052,70056,Blue,1,32757,32912,155
2022-01-10,70048,70052,Blue,1,68080,68338,258
2022-01-24,70049,70838,Blue,0,32586,33344,758
2022-04-11,70045,70041,Blue,0,80789,80951,162
2022-03-20,70051,70047,Blue,0,65553,65738,185
2022-09-28,70057,70047,Blue,0,53136,53626,490
2022-10-10,70057,70838,Blue,0,40394,41548,1154
2022-01-17,70047,70039,Blue,0,41208,41637,429
2022-10-26,70044,70048,Blue,1,53909,54143,234
2022-11-02,70039,70838,Blue,0,57755,57790,35
2022-08-04,70050,70056,Blue,1,49118,49428,310
2022-11-03,70051,70838,Blue,0,54940,55835,895
2022-01-24,70052,70054,Blue,1,68946,69001,55
2022-11-19,70052,70056,Blue,1,50893,51027,134
2022-02-13,70044,70050,Blue,1,28080,28425,345
2022-08-09,70042,70048,Blue,1,24078,24368,290
2022-04-17,70059,70041,Blue,0,79775,80719,944
2022-03-18,70056,70058,Blue,1,64668,64738,70
2022-01-22,70050,70054,Blue,1,26882,27090,208
2022-08-14,70042,70054,Blue,1,41801,42479,678
2022-11-20,70044,70046,Blue,1,41848,41950,102
2022-09-13,70053,70039,Blue,0,31742,32591,849
2022-08-14,70046,70048,Blue,1,82712,82799,87
2022-10-12,70051,70041,Blue,0,78129,78700,571
2022-04-17,70038,70046,Blue,1,58033,58406,373
2022-11-17,70057,70051,Blue,0,55173,55412,239
2022-07-23,70053,70051,Blue,0,26855,26906,51
2022-04-12,70055,70053,Blue,0,87064,87109,45
2022-10-27,70049,70043,Blue,0,82689,83015,326
2022-12-21,70038,70048,Blue,1,80736,81323,587
2022-02-16,70047,70045,Blue,0,73971,74097,126
2022-08-22,70056,70060,Blue,1,43014,43229,215
2022-08-20,70042,70046,Blue,1,62747,62947,200
2022-07-19,70050,70058,Blue,1,33024,33452,428
2022-03-15,70040,70056,Blue,1,88996,89753,757
2022-03-11,70055,70047,Blue,0,43415,43852,437
2022-11-11,70057,70055,Blue,0,43780,43850,70
2022-03-15,70044,70050,Blue,1,51017,51381,364
2022-02-21,70048,70052,Blue,1,72312,72529,217
2022-11-30,70038,70048,Blue,1,46539,47010,471
2022-01-17,70056,70060,Blue,1,82354,82528,174
2022-08-02,70046,70050,Blue,1,42631,42817,186
2022-02-23,70042,70050,Blue,1,77025,77520,495
2022-02-18,70044,70060,Blue,1,69165,70241,1076
2022-10-08,70051,70049,Blue,0,56074,56176,102
2022-06-28,70057,70041,Blue,0,20013,20922,909
2022-01-11,70038,70046,Blue,1,47596,47977,381
2022-11-03,70057,70049,Blue,0,65860,66245,385
2022-03-25,70050,70058,Blue,1,51841,52327,486
2022-02-27,70053,70051,Blue,0,45560,45615,55
2022-07-30,70040,70050,Blue,1,39439,39923,484
2022-10-07,70049,70838,Blue,0,41128,41743,615
2022-07-02,70039,70838,Blue,0,65968,66001,33
2022-06-14,70047,70838,Blue,0,27669,28232,563
2022-12-20,70059,70057,Blue,0,57750,57784,34
2022-11-04,70038,70052,Blue,1,39996,40727,731
2022-09-17,70051,70838,Blue,0,20551,21288,737
2022-11-18,70054,70060,Blue,1,76093,76382,289
2022-11-17,70038,70048,Blue,1,50228,50709,481
2022-12-28,70040,70054,Blue,1,83263,84035,772
2022-06-06,70044,70050,Blue,1,39920,40353,433
2022-02-27,70039,70838,Blue,0,61929,61964,35
2022-09-21,70054,70060,Blue,1,63736,64002,266
2022-09-13,70039,70838,Blue,0,58738,58850,112
2022-12-29,70049,70045,Blue,0,39015,39222,207
2022-01-27,70053,70039,Blue,0,46389,47270,881
2022-04-09,70051,70838,Blue,0,59837,60552,715
2022-12-30,70053,70039,Blue,0,57393,58121,728
2022-03-17,70055,70047,Blue,0,66092,66497,405
2022-05-19,70045,70039,Blue,0,47014,47311,297
2022-08-18,70059,70039,Blue,0,29300,30408,1108
2022-10-25,70053,70838,Blue,0,33381,34286,905
2022-03-23,70042,70048,Blue,1,29209,29538,329
2022-01-18,70049,70045,Blue,0,64332,64544,212
2022-09-08,70045,70041,Blue,0,65234,65418,184
2022-02-11,70059,70051,Blue,0,32952,33351,399
2022-03-21,70046,70058,Blue,1,35564,36579,1015
2022-08-13,70049,70838,Blue,0,53491,54120,629
2022-04-09,70055,70049,Blue,0,73165,73446,281
2022-10-07,70047,70039,Blue,0,28467,28892,425
2022-12-04,70057,70049,Blue,0,73886,74249,363
2022-08-23,70053,70049,Blue,0,70707,70906,199
2022-06-21,70048,70050,Blue,1,70630,70690,60
2022-05-19,70044,70050,Blue,1,33156,33556,400
2022-08-08,70038,70060,Blue,1,56413,57537,1124
2022-06-19,70038,70046,Blue,1,48847,49184,337
2022-11-13,70056,70058,Blue,1,34776,34846,70
2022-12-14,70052,70058,Blue,1,35207,35499,292
2022-02-06,70056,70060,Blue,1,87282,87451,169
2022-08-25,70045,70838,Blue,0,28087,28501,414
2022-05-19,70045,70039,Blue,0,21184,21487,303
2022-07-16,70047,70838,Blue,0,74150,74665,515
2022-01-24,70042,70052,Blue,1,24115,24829,714
2022-10-28,70048,70056,Blue,1,65364,65760,396
2022-10-12,70059,70838,Blue,0,30588,31788,1200
2022-08-16,70040,70050,Blue,1,41351,41889,538
2022-09-14,70059,70043,Blue,0,78672,79459,787
2022-01-18,70040,70044,Blue,1,57497,57647,150
2022-12-28,70057,70043,Blue,0,68694,69470,776
2022-05-21,70049,70045,Blue,0,71170,71447,277
2022-04-27,70050,70060,Blue,1,77844,78380,536
2022-07-16,70051,70047,Blue,0,35532,35737,205
2022-12-27,70042,70060,Blue,1,80292,81315,1023
2022-09-20,70042,70058,Blue,1,62866,63725,859
2022-11-07,70059,70053,Blue,0,35380,35706,326
2022-10-20,70050,70052,Blue,1,57008,57115,107
2022-08-20,70057,70053,Blue,0,55230,55385,155
2022-07-29,70049,70838,Blue,0,32758,33467,709
2022-04-26,70054,70056,Blue,1,25491,25537,46
2022-10-30,70051,70838,Blue,0,87816,88518,702
2022-03-08,70051,70039,Blue,0,65964,66603,639
2022-04-17,70040,70048,Blue,1,76998,77439,441
2022-03-12,70040,70056,Blue,1,73459,74267,808
2022-01-12,70045,70041,Blue,0,72327,72491,164
2022-12-31,70059,70043,Blue,0,68583,69587,1004
2022-08-30,70040,70046,Blue,1,70583,70822,239
2022-04-13,70038,70048,Blue,1,22145,22555,410
2022-01-26,70053,70039,Blue,0,62271,63059,788
2022-04-04,70056,70058,Blue,1,26071,26167,96
2022-02-10,70042,70046,Blue,1,65375,65545,170
2022-12-22,70040,70060,Blue,1,73472,74612,1140
2022-09-14,70059,70045,Blue,0,30978,31725,747
2022-05-20,70055,70045,Blue,0,54399,55004,605
2022-11-14,70051,70838,Blue,0,42508,43266,758
2022-07-14,70054,70056,Blue,1,41112,41160,48
2022-11-11,70048,70060,Blue,1,57655,58278,623
2022-04-20,70051,70041,Blue,0,51596,52185,589
2022-06-18,70054,70056,Blue,1,84667,84715,48
2022-11-28,70042,70046,Blue,1,54671,54854,183
2022-06-06,70047,70041,Blue,0,75854,76186,332
2022-01-04,70052,70054,Blue,1,87821,87868,47
2022-01-15,70057,70039,Blue,0,24873,25882,1009
2022-01-20,70042,70060,Blue,1,82173,83140,967
2022-08-01,70038,70048,Blue,1,63794,64269,475
2022-02-10,70059,70055,Blue,0,60190,60330,140
2022-04-22,70053,70047,Blue,0,31128,31439,311
2022-02-18,70042,70046,Blue,1,62388,62556,168
2022-07-31,70042,70044,Blue,1,48981,49007,26
2022-10-08,70059,70051,Blue,0,40589,40902,313
2022-04-02,70038,70054,Blue,1,50712,51606,894
2022-05-15,70053,70051,Blue,0,43475,43530,55
2022-10-14,70051,70039,Blue,0,54446,55136,690
2022-11-27,70038,70052,Blue,1,27677,28377,700
2022-01-17,70038,70060,Blue,1,36159,37616,1457
2022-02-08,70057,70053,Blue,0,27950,28176,226
2022-02-10,70050,70056,Blue,1,25628,25943,315
2022-10-27,70043,70041,Blue,0,81434,81461,27
2022-10-18,70059,70045,Blue,0,74355,75127,772
2022-12-27,70048,70058,Blue,1,27281,27781,500
2022-01-25,70055,70053,Blue,0,46282,46349,67
2022-07-06,70038,70058,Blue,1,87376,88413,1037
2022-03-24,70040,70060,Blue,1,22198,23385,1187
2022-12-13,70045,70043,Blue,0,81253,81339,86
2022-07-26,70055,70053,Blue,0,71427,71474,47
2022-02-16,70052,70060,Blue,1,27728,28078,350
2022-10-07,70051,70045,Blue,0,60351,60697,346
2022-07-01,70059,70051,Blue,0,70491,71007,516
2022-09-13,70038,70054,Blue,1,46094,46937,843
2022-01-16,70056,70058,Blue,1,40676,40744,68
2022-06-29,70047,70838,Blue,0,22327,22925,598
2022-01-10,70057,70053,Blue,0,50795,50958,163
2022-12-13,70049,70041,Blue,0,60393,60825,432
2022-04-25,70059,70057,Blue,0,23840,23875,35
2022-04-13,70044,70056,Blue,1,42694,43450,756
2022-08-25,70041,70039,Blue,0,25667,25699,32
2022-02-24,70040,70058,Blue,1,31840,32835,995
2022-04-10,70059,70047,Blue,0,22273,22835,562
2022-12-16,70041,70039,Blue,0,34461,34494,33
2022-03-30,70043,70039,Blue,0,83843,83960,117
2022-10-03,70044,70054,Blue,1,43450,44037,587
2022-09-07,70055,70838,Blue,0,79545,80403,858
2022-02-25,70058,70060,Blue,1,38229,38339,110
2022-07-05,70058,70060,Blue,1,41668,41740,72
2022-10-12,70045,70041,Blue,0,54866,55026,160
2022-05-21,70042,70060,Blue,1,82832,84017,1185
2022-09-10,70055,70043,Blue,0,27797,28505,708
2022-03-22,70051,70039,Blue,0,58631,59219,588
2022-11-11,70057,70047,Blue,0,64070,64548,478
2022-10-17,70052,70060,Blue,1,43067,43511,444
2022-03-27,70055,70041,Blue,0,30255,30978,723
2022-04-03,70049,70043,Blue,0,25108,25454,346
2022-12-13,70057,70053,Blue,0,33043,33208,165
2022-06-30,70044,70050,Blue,1,62683,63094,411
2022-03-07,70055,70045,Blue,0,69687,70210,523
2022-06-14,70046,70054,Blue,1,68353,68809,456
2022-07-18,70050,70056,Blue,1,33526,33849,323
2022-05-18,70055,70051,Blue,0,27546,27688,142
2022-03-01,70048,70052,Blue,1,20349,20571,222
2022-11-30,70040,70060,Blue,1,31989,32983,994
2022-03-12,70047,70045,Blue,0,26035,26143,108
2022-08-13,70038,70052,Blue,1,24974,25680,706
2022-01-04,70058,70060,Blue,1,70567,70639,72
2022-10-11,70049,70041,Blue,0,28972,29433,461
2022-02-26,70046,70058,Blue,1,27860,28476,616
2022-01-27,70043,70041,Blue,0,81922,81952,30
2022-12-22,70051,70047,Blue,0,68048,68254,206
2022-02-09,70049,70045,Blue,0,60712,60911,199
2022-03-07,70057,70043,Blue,0,22490,23364,874
2022-12-16,70055,70053,Blue,0,49575,49620,45
2022-04-14,70056,70060,Blue,1,88737,88943,206
2022-08-08,70053,70045,Blue,0,51224,51657,433
2022-10-05,70047,70039,Blue,0,58322,58719,397
2022-11-18,70057,70043,Blue,0,35548,36370,822
2022-10-31,70057,70047,Blue,0,54702,55183,481
2022-08-01,70049,70039,Blue,0,51466,51965,499
2022-06-20,70047,70039,Blue,0,84835,85277,442
2022-09-30,70042,70050,Blue,1,73773,74427,654
2022-04-17,70044,70056,Blue,1,53419,54096,677
2022-01-25,70041,70039,Blue,0,61182,61213,31
2022-08-24,70038,70042,Blue,1,26055,26147,92
2022-10-18,70049,70047,Blue,0,62360,62416,56
2022-09-27,70051,70047,Blue,0,84564,84791,227
2022-04-26,70050,70058,Blue,1,58418,58836,418
2022-09-25,70043,70039,Blue,0,77965,78061,96
2022-12-29,70046,70056,Blue,1,32050,32603,553
2022-01-24,70059,70838,Blue,0,63493,64614,1121
2022-07-02,70042,70050,Blue,1,48167,48628,461
2022-08-09,70049,70039,Blue,0,75385,75864,479
2022-09-30,70055,70043,Blue,0,61033,61798,765
2022-07-20,70046,70058,Blue,1,44039,44747,708
2022-02-17,70045,70039,Blue,0,31666,31952,286
2022-03-04,70059,70043,Blue,0,72134,73011,877
2022-03-02,70057,70049,Blue,0,75583,76032,449
2022-07-13,70045,70043,Blue,0,31425,31544,119
2022-02-12,70051,70838,Blue,0,46345,47104,759
2022-09-01,70045,70838,Blue,0,22652,23030,378
2022-03-04,70051,70045,Blue,0,54525,54839,314
2022-01-18,70046,70056,Blue,1,28933,29488,555
2022-09-20,70059,70838,Blue,0,58215,59317,1102
2022-09-13,70038,70046,Blue,1,56481,56844,363
2022-07-15,70048,70058,Blue,1,83866,84455,589
2022-07-17,70040,70052,Blue,1,62415,63063,648
2022-02-03,70059,70057,Blue,0,24866,24904,38
2022-02-02,70051,70047,Blue,0,82093,82285,192
2022-04-11,70047,70045,Blue,0,58424,58521,97
2022-01-14,70044,70050,Blue,1,25656,26025,369
2022-12-21,70058,70060,Blue,1,65961,66036,75
2022-07-12,70049,70045,Blue,0,32361,32570,209
2022-03-08,70059,70053,Blue,0,56299,56545,246
2022-11-06,70040,70058,Blue,1,23258,24647,1389
2022-01-07,70046,70048,Blue,1,20865,20953,88
2022-10-30,70053,70039,Blue,0,84914,85610,696
2022-11-28,70059,70053,Blue,0,71770,71987,217
2022-03-08,70059,70047,Blue,0,57196,57761,565
2022-06-25,70038,70050,Blue,1,61195,61859,664
2022-08-15,70052,70054,Blue,1,75549,75606,57
2022-09-04,70038,70046,Blue,1,47779,48104,325
2022-08-16,70051,70049,Blue,0,74763,74864,101
2022-10-27,70048,70054,Blue,1,21904,22214,310
2022-09-17,70048,70060,Blue,1,68515,69103,588
2022-05-18,70050,70058,Blue,1,57098,57530,432
2022-01-13,70038,70060,Blue,1,20661,21807,1146
2022-12-29,70053,70039,Blue,0,37841,38586,745
2022-08-08,70052,70054,Blue,1,66202,66262,60
2022-11-21,70055,70838,Blue,0,31891,32845,954
2022-12-07,70038,70040,Blue,1,67393,67406,13
2022-07-31,70051,70039,Blue,0,41195,41869,674
2022-10-16,70051,70039,Blue,0,44463,45109,646
2022-09-20,70057,70051,Blue,0,67660,67898,238
2022-09-21,70056,70058,Blue,1,46460,46538,78
2022-11-03,70059,70051,Blue,0,63434,63755,321
2022-07-06,70040,70054,Blue,1,61781,62670,889
2022-01-17,70044,70050,Blue,1,34172,34518,346
2022-09-25,70042,70056,Blue,1,72781,73593,812
2022-12-19,70040,70042,Blue,1,34802,34836,34
2022-01-04,70055,70838,Blue,0,44562,45583,1021
2022-01-01,70051,70049,Blue,0,39217,39319,102
2022-07-24,70042,70046,Blue,1,79854,80043,189
2022-08-20,70049,70838,Blue,0,38900,39548,648
2022-01-18,70044,70054,Blue,1,77623,78207,584
2022-09-29,70042,70056,Blue,1,74578,75352,774
2022-08-19,70042,70060,Blue,1,70680,71668,988
2022-12-13,70055,70051,Blue,0,66237,66443,206
2022-08-29,70048,70060,Blue,1,39385,40046,661
2022-11-14,70040,70048,Blue,1,70092,70492,400
2022-10-20,70042,70044,Blue,1,67533,67561,28
2022-03-27,70043,70041,Blue,0,56327,56356,29
2022-09-23,70046,70060,Blue,1,47068,47768,700
2022-08-21,70040,70060,Blue,1,57570,58633,1063
2022-11-11,70057,70041,Blue,0,70768,71592,824
2022-10-14,70038,70048,Blue,1,79682,80186,504
2022-01-04,70042,70052,Blue,1,68088,68648,560
2022-06-12,70048,70052,Blue,1,77053,77260,207
2022-10-03,70038,70054,Blue,1,57014,57837,823
2022-11-19,70047,70838,Blue,0,75739,76197,458
2022-07-25,70042,70058,Blue,1,76676,77503,827
2022-08-07,70055,70053,Blue,0,77794,77843,49
2022-10-21,70040,70058,Blue,1,82067,83070,1003
2022-12-04,70059,70838,Blue,0,52306,53463,1157
2022-04-02,70043,70041,Blue,0,31793,31822,29
2022-12-23,70055,70838,Blue,0,55424,56522,1098
2022-08-31,70053,70047,Blue,0,55897,56184,287
2022-08-20,70044,70060,Blue,1,61259,62152,893
2022-01-04,70038,70054,Blue,1,22758,23572,814
2022-07-24,70052,70056,Blue,1,72928,73071,143
2022-11-28,70044,70056,Blue,1,67612,68303,691
2022-03-16,70038,70050,Blue,1,26110,26617,507
2022-11-07,70040,70052,Blue,1,56361,56986,625
2022-04-18,70055,70043,Blue,0,64288,64885,597
2022-02-09,70046,70052,Blue,1,62333,62667,334
2022-07-10,70055,70045,Blue,0,51860,52423,563
2022-12-21,70039,70838,Blue,0,65811,65845,34
2022-09-11,70057,70039,Blue,0,46351,47280,929
2022-07-18,70049,70041,Blue,0,31427,31985,558
2022-11-20,70057,70047,Blue,0,72271,72745,474
2022-01-09,70051,70039,Blue,0,55833,56446,613
2022-05-17,70056,70058,Blue,1,53168,53239,71
2022-10-11,70051,70039,Blue,0,31820,32561,741
2022-03-04,70038,70058,Blue,1,50300,51494,1194
2022-11-29,70053,70049,Blue,0,22124,22328,204
2022-12-08,70050,70054,Blue,1,63100,63310,210
2022-07-11,70047,70045,Blue,0,33266,33367,101
2022-09-15,70053,70838,Blue,0,76100,76869,769
2022-01-14,70057,70045,Blue,0,58767,59400,633
2022-01-14,70040,70042,Blue,1,67107,67141,34
2022-12-27,70042,70044,Blue,1,58647,58681,34
2022-11-01,70053,70838,Blue,0,24610,25580,970
2022-03-03,70055,70045,Blue,0,57977,58482,505
2022-07-16,70038,70040,Blue,1,67446,67462,16
2022-12-16,70053,70039,Blue,0,54344,55122,778
2022-06-22,70044,70054,Blue,1,74957,75571,614
2022-12-03,70043,70838,Blue,0,77326,77505,179
2022-09-07,70057,70043,Blue,0,37144,38039,895
2022-12-02,70051,70049,Blue,0,21930,22038,108
2022-03-23,70038,70058,Blue,1,62247,63297,1050
2022-11-23,70051,70047,Blue,0,61511,61695,184
2022-04-09,70044,70046,Blue,1,56340,56446,106
2022-02-02,70049,70838,Blue,0,22293,23061,768
2022-04-08,70042,70046,Blue,1,23187,23371,184
2022-08-11,70047,70838,Blue,0,47945,48454,509
2022-04-06,70049,70838,Blue,0,60568,61173,605
2022-09-27,70055,70039,Blue,0,24247,25219,972
2022-07-29,70053,70047,Blue,0,75278,75553,275
2022-07-10,70038,70048,Blue,1,60849,61349,500
2022-08-30,70059,70049,Blue,0,52513,52967,454
2022-03-06,70047,70041,Blue,0,27543,27863,320
2022-01-15,70047,70041,Blue,0,69525,70113,588
2022-04-24,70038,70048,Blue,1,47769,48228,459
2022-08-15,70047,70041,Blue,0,58345,58704,359
2022-07-05,70052,70060,Blue,1,60369,60730,361
2022-12-11,70055,70049,Blue,0,43642,43913,271
2022-03-13,70058,70060,Blue,1,65116,65196,80
2022-12-19,70038,70050,Blue,1,25868,26442,574
2022-07-23,70055,70049,Blue,0,83699,83992,293
2022-10-13,70057,70049,Blue,0,74555,75029,474
2022-01-07,70046,70048,Blue,1,27970,28058,88
2022-10-03,70059,70057,Blue,0,57732,57767,35
2022-03-17,70038,70054,Blue,1,40691,41613,922
2022-02-28,70059,70047,Blue,0,44954,45509,555
2022-03-20,70050,70056,Blue,1,38315,38617,302
2022-08-09,70055,70051,Blue,0,23195,23343,148
2022-02-02,70046,70054,Blue,1,59314,59759,445
2022-09-18,70040,70044,Blue,1,43058,43160,102
2022-08-29,70038,70040,Blue,1,55988,56003,15
2022-02-05,70055,70045,Blue,0,70983,71504,521
2022-03-29,70044,70058,Blue,1,35932,36754,822
2022-06-22,70042,70050,Blue,1,60219,60771,552
2022-10-01,70040,70058,Blue,1,66979,67954,975
2022-06-17,70046,70058,Blue,1,35727,36510,783
2022-07-09,70051,70049,Blue,0,48535,48637,102
2022-03-10,70059,70838,Blue,0,87488,88492,1004
2022-03-19,70047,70838,Blue,0,39568,40118,550
2022-12-07,70038,70058,Blue,1,80605,81629,1024
2022-06-15,70054,70056,Blue,1,63497,63545,48
2022-08-09,70057,70045,Blue,0,32755,33393,638
2022-06-14,70048,70058,Blue,1,54936,55515,579
2022-01-09,70038,70050,Blue,1,42312,42832,520
2022-05-19,70040,70048,Blue,1,69258,69707,449
2022-02-04,70045,70043,Blue,0,29880,29978,98
2022-10-12,70047,70041,Blue,0,31600,32027,427
2022-10-17,70042,70050,Blue,1,21928,22324,396
2022-04-11,70038,70042,Blue,1,72007,72106,99
2022-04-19,70043,70041,Blue,0,20120,20151,31
2022-01-21,70038,70056,Blue,1,84246,85091,845
2022-01-31,70057,70051,Blue,0,45835,46109,274
2022-02-28,70050,70058,Blue,1,68268,68751,483
2022-12-06,70055,70838,Blue,0,25060,26118,1058
2022-05-19,70047,70838,Blue,0,55598,56282,684
2022-11-22,70057,70045,Blue,0,79906,80491,585
2022-04-24,70047,70039,Blue,0,49589,50042,453
2022-07-10,70059,70047,Blue,0,50597,51152,555
2022-12-07,70040,70060,Blue,1,23232,24378,1146
2022-03-15,70038,70058,Blue,1,79146,80136,990
2022-12-15,70040,70042,Blue,1,23635,23670,35
2022-10-11,70042,70054,Blue,1,55308,55955,647
2022-06-18,70057,70041,Blue,0,55348,56220,872
2022-03-17,70057,70053,Blue,0,33028,33179,151
2022-09-08,70051,70045,Blue,0,45694,46032,338
2022-02-11,70048,70056,Blue,1,59723,60103,380
2022-08-09,70046,70056,Blue,1,34059,34600,541
2022-04-14,70044,70054,Blue,1,55039,55672,633
2022-07-10,70054,70060,Blue,1,38562,38822,260
2022-10-24,70055,70045,Blue,0,65714,66283,569
2022-10-27,70040,70042,Blue,1,35356,35391,35
2022-06-16,70053,70047,Blue,0,33896,34241,345
2022-02-02,70040,70058,Blue,1,53808,55010,1202
2022-10-01,70055,70047,Blue,0,47339,47768,429
2022-03-01,70048,70060,Blue,1,31704,32369,665
2022-06-28,70043,70041,Blue,0,29906,29937,31
2022-11-21,70038,70048,Blue,1,61173,61783,610
2022-04-15,70038,70048,Blue,1,49253,49755,502
2022-07-21,70042,70048,Blue,1,50586,50894,308
2022-12-05,70038,70040,Blue,1,71593,71608,15
2022-02-08,70052,70058,Blue,1,54214,54489,275
2022-09-03,70042,70048,Blue,1,34113,34415,302
2022-10-30,70038,70054,Blue,1,58562,59398,836
2022-02-23,70038,70058,Blue,1,80395,81376,981
2022-03-05,70044,70058,Blue,1,36870,37636,766
2022-10-13,70050,70060,Blue,1,24296,24907,611
2022-12-03,70038,70048,Blue,1,54003,54437,434
2022-08-27,70054,70056,Blue,1,46122,46168,46
2022-01-06,70044,70060,Blue,1,32275,33220,945
2022-10-29,70040,70058,Blue,1,51311,52254,943
2022-03-11,70058,70060,Blue,1,30600,30799,199
2022-12-16,70055,70053,Blue,0,77717,77764,47
2022-04-22,70048,70050,Blue,1,71975,72038,63
2022-11-30,70040,70044,Blue,1,40371,40499,128
2022-10-11,70049,70043,Blue,0,42677,43033,356
2022-12-01,70048,70050,Blue,1,34505,34568,63
2022-04-11,70046,70050,Blue,1,61460,61645,185
2022-08-23,70047,70838,Blue,0,38053,38572,519
2022-08-12,70059,70043,Blue,0,45743,46608,865
2022-09-03,70053,70047,Blue,0,45158,45440,282
2022-04-29,70057,70047,Blue,0,67094,67858,764
2022-11-16,70055,70049,Blue,0,66749,67031,282
2022-10-10,70059,70039,Blue,0,75977,77032,1055
2022-08-10,70051,70838,Blue,0,47189,47986,797
2022-06-24,70040,70052,Blue,1,24411,25041,630
2022-04-07,70040,70054,Blue,1,64114,64912,798
2022-02-19,70047,70041,Blue,0,19090,19491,401
2022-03-07,70050,70060,Blue,1,43510,43985,475
2022-02-06,70038,70042,Blue,1,49392,49488,96
2022-02-05,70046,70060,Blue,1,20519,21340,821
2022-11-08,70046,70060,Blue,1,77700,78449,749
2022-12-15,70052,70058,Blue,1,87238,87475,237
2022-08-24,70043,70838,Blue,0,52586,52781,195
2022-08-07,70057,70047,Blue,0,36266,36761,495
2022-06-13,70055,70838,Blue,0,52728,53740,1012
2022-01-08,70053,70047,Blue,0,38780,39096,316
2022-06-14,70053,70045,Blue,0,62278,62698,420
2022-04-17,70059,70057,Blue,0,65715,65752,37
2022-09-11,70048,70056,Blue,1,35204,35601,397
2022-11-05,70047,70045,Blue,0,45519,45610,91
2022-02-05,70038,70054,Blue,1,49096,49891,795
2022-06-02,70049,70045,Blue,0,87228,87414,186
2022-12-07,70047,70039,Blue,0,84117,84499,382
2022-04-07,70059,70049,Blue,0,58118,58588,470
2022-01-15,70047,70039,Blue,0,49287,49697,410
2022-05-02,70050,70056,Blue,1,26434,26711,277
2022-04-12,70042,70054,Blue,1,63341,64039,698
2022-03-11,70047,70039,Blue,0,71745,72152,407
2022-12-23,70038,70056,Blue,1,55524,56544,1020
2022-11-04,70046,70052,Blue,1,26643,26977,334
2022-08-21,70049,70043,Blue,0,78744,79104,360
2022-10-29,70054,70060,Blue,1,30534,30784,250
2022-09-09,70050,70052,Blue,1,77553,77669,116
2022-07-04,70049,70047,Blue,0,30278,30336,58
2022-08-17,70040,70052,Blue,1,56589,57286,697
2022-09-11,70059,70053,Blue,0,37514,37743,229
2022-11-13,70047,70043,Blue,0,25447,25702,255
2022-10-03,70057,70838,Blue,0,75989,77133,1144
2022-11-12,70052,70056,Blue,1,86398,86550,152
2022-12-08,70048,70056,Blue,1,28302,28761,459
2022-11-27,70053,70047,Blue,0,27988,28260,272
2022-06-22,70042,70044,Blue,1,26687,26718,31
2022-05-16,70053,70051,Blue,0,51674,51738,64
2022-03-10,70040,70060,Blue,1,63201,64485,1284
2022-09-09,70053,70047,Blue,0,51742,52023,281
2022-12-09,70046,70054,Blue,1,43906,44376,470
2022-02-12,70059,70051,Blue,0,43812,44123,311
2022-07-22,70047,70041,Blue,0,57061,57539,478
2022-06-12,70050,70052,Blue,1,68459,68580,121
2022-05-02,70052,70058,Blue,1,51571,51813,242
2022-06-05,70045,70039,Blue,0,82899,83186,287
2022-12-07,70039,70838,Blue,0,39040,39077,37
2022-09-28,70044,70060,Blue,1,71703,72566,863
2022-06-17,70040,70060,Blue,1,69935,70967,1032
2022-04-12,70059,70049,Blue,0,70993,71503,510
2022-07-31,70053,70047,Blue,0,65451,65789,338
2022-08-28,70044,70046,Blue,1,66383,66484,101
2022-08-27,70053,70041,Blue,0,26829,27491,662
2022-10-29,70059,70049,Blue,0,31396,31865,469
2022-12-08,70055,70049,Blue,0,73997,74269,272
2022-10-15,70044,70046,Blue,1,28793,28897,104
2022-02-23,70048,70054,Blue,1,73580,73884,304
2022-09-23,70049,70045,Blue,0,22113,22334,221
2022-10-11,70040,70050,Blue,1,67085,67648,563
2022-01-26,70059,70057,Blue,0,25475,25510,35
2022-01-28,70042,70058,Blue,1,21142,22012,870
2022-04-29,70054,70058,Blue,1,29446,29608,162
2022-04-19,70051,70047,Blue,0,62899,63107,208
2022-03-25,70040,70054,Blue,1,44917,45637,720
2022-06-13,70049,70047,Blue,0,55340,55409,69
2022-11-10,70038,70052,Blue,1,72611,73312,701
2022-02-25,70055,70045,Blue,0,28057,28645,588
2022-08-28,70040,70056,Blue,1,23831,24627,796
2022-10-07,70059,70045,Blue,0,79919,80592,673
2022-05-07,70050,70056,Blue,1,72049,72344,295
2022-08-10,70057,70043,Blue,0,57062,57978,916
2022-10-04,70055,70041,Blue,0,83088,83828,740
2022-08-20,70051,70047,Blue,0,60916,61105,189
2022-04-09,70056,70060,Blue,1,39356,39581,225
2022-04-19,70050,70056,Blue,1,67983,68269,286
2022-01-31,70040,70042,Blue,1,30232,30269,37
2022-09-19,70051,70041,Blue,0,28161,28842,681
2022-06-14,70055,70051,Blue,0,69258,69397,139
2022-11-30,70051,70043,Blue,0,26191,26690,499
2022-02-15,70055,70838,Blue,0,25941,26979,1038
2022-07-10,70040,70060,Blue,1,73213,74319,1106
2022-06-14,70042,70054,Blue,1,62444,63152,708
2022-12-20,70053,70051,Blue,0,74488,74586,98
2022-12-19,70040,70048,Blue,1,31568,31975,407
2022-10-27,70057,70041,Blue,0,55504,56319,815
2022-12-19,70048,70058,Blue,1,22311,22817,506
2022-07-15,70059,70053,Blue,0,30135,30362,227
2022-06-10,70038,70052,Blue,1,27251,27992,741
2022-03-16,70051,70045,Blue,0,39672,40022,350
2022-02-06,70057,70043,Blue,0,56067,56866,799
2022-12-03,70038,70052,Blue,1,84634,85399,765
2022-03-07,70057,70051,Blue,0,21398,21655,257
2022-03-10,70043,70838,Blue,0,76326,76501,175
2022-02-03,70038,70040,Blue,1,67933,67949,16
2022-06-17,70038,70040,Blue,1,30256,30275,19
2022-03-14,70048,70056,Blue,1,56748,57137,389
2022-08-04,70045,70039,Blue,0,43988,44237,249
2022-03-28,70040,70060,Blue,1,24315,25517,1202
2022-01-03,70052,70054,Blue,1,87891,87945,54
2022-05-06,70057,70051,Blue,0,40002,40256,254
2022-09-24,70042,70052,Blue,1,48148,48718,570
2022-10-09,70048,70050,Blue,1,72088,72146,58
2022-08-19,70048,70054,Blue,1,56607,56947,340
2022-06-27,70052,70054,Blue,1,35111,35191,80
2022-07-21,70051,70045,Blue,0,79801,80156,355
2022-01-12,70044,70050,Blue,1,60969,61336,367
2022-07-11,70051,70045,Blue,0,28855,29189,334
2022-12-01,70044,70046,Blue,1,39036,39141,105
2022-06-01,70047,70838,Blue,0,20435,20977,542
2022-11-29,70048,70058,Blue,1,36983,37521,538
2022-04-17,70038,70058,Blue,1,64515,65544,1029
2022-02-14,70042,70044,Blue,1,90607,90635,28
2022-11-15,70051,70039,Blue,0,65849,66479,630
2022-08-25,70053,70043,Blue,0,24542,25174,632
2022-03-29,70055,70053,Blue,0,20061,20107,46
2022-02-11,70038,70054,Blue,1,64302,65121,819
2022-08-06,70050,70054,Blue,1,55134,55369,235
2022-01-11,70040,70060,Blue,1,57181,58552,1371
2022-11-02,70055,70053,Blue,0,38660,38740,80
2022-01-08,70053,70045,Blue,0,41920,42375,455
2022-12-17,70057,70053,Blue,0,33111,33272,161
2022-01-01,70041,70039,Blue,0,41087,41117,30
2022-10-19,70055,70047,Blue,0,84379,84761,382
2022-09-13,70038,70054,Blue,1,31328,32304,976
2022-04-20,70042,70052,Blue,1,39737,40295,558
2022-06-29,70050,70052,Blue,1,63272,63392,120
2022-06-20,70045,70838,Blue,0,63889,64267,378
2022-12-26,70052,70058,Blue,1,61600,61880,280
2022-07-22,70049,70838,Blue,0,63908,64546,638
2022-10-11,70042,70050,Blue,1,72215,72631,416
2022-04-10,70055,70051,Blue,0,46458,46599,141
2022-07-14,70058,70060,Blue,1,76756,76813,57
2022-05-07,70055,70049,Blue,0,40399,40685,286
2022-07-21,70042,70044,Blue,1,33663,33697,34
2022-07-11,70045,70039,Blue,0,79075,79315,240
2022-06-17,70044,70048,Blue,1,38076,38359,283
2022-12-05,70059,70045,Blue,0,30477,31190,713
2022-12-27,70048,70060,Blue,1,65573,66150,577
2022-08-30,70040,70046,Blue,1,36804,37057,253
2022-04-17,70044,70060,Blue,1,58854,59792,938
2022-07-02,70049,70039,Blue,0,25262,25805,543
2022-01-04,70057,70051,Blue,0,24656,24942,286
2022-08-28,70051,70045,Blue,0,87660,87995,335
2022-01-31,70057,70049,Blue,0,33140,33617,477
2022-09-25,70053,70045,Blue,0,88501,88961,460
2022-10-18,70058,70060,Blue,1,81661,81725,64
2022-11-26,70042,70046,Blue,1,55723,55901,178
2022-10-27,70053,70045,Blue,0,56273,56732,459
2022-10-31,70038,70054,Blue,1,40421,41294,873
2022-04-04,70049,70047,Blue,0,32562,32616,54
2022-02-14,70044,70060,Blue,1,32911,33817,906
2022-10-27,70045,70041,Blue,0,58552,58810,258
2022-02-17,70042,70044,Blue,1,22897,22929,32
2022-04-24,70044,70056,Blue,1,29510,30275,765
2022-06-19,70059,70039,Blue,0,62356,63416,1060
2022-02-05,70040,70054,Blue,1,30783,31534,751
2022-08-07,70055,70045,Blue,0,70761,71318,557
2022-12-17,70055,70043,Blue,0,62900,63587,687
2022-07-27,70057,70045,Blue,0,31897,32534,637
2022-06-16,70040,70046,Blue,1,73206,73689,483
2022-01-20,70040,70050,Blue,1,28358,28916,558
2022-12-04,70049,70043,Blue,0,86892,87223,331
2022-01-26,70040,70060,Blue,1,60640,61780,1140
2022-05-01,70057,70055,Blue,0,84995,85064,69
2022-09-21,70042,70046,Blue,1,48812,48982,170
2022-05-25,70041,70039,Blue,0,35129,35164,35
2022-11-25,70043,70838,Blue,0,76218,76387,169
2022-08-23,70046,70056,Blue,1,45961,46498,537
2022-04-04,70040,70060,Blue,1,77054,78153,1099
2022-07-05,70038,70060,Blue,1,57622,58938,1316
2022-10-11,70054,70058,Blue,1,55991,56139,148
2022-12-26,70053,70043,Blue,0,60054,60633,579
2022-03-26,70050,70054,Blue,1,76643,76893,250
2022-01-16,70055,70838,Blue,0,62652,63606,954
2022-04-04,70043,70041,Blue,0,45820,45849,29
2022-08-08,70055,70043,Blue,0,66197,66848,651
2022-03-16,70045,70838,Blue,0,81362,81718,356
2022-03-04,70057,70041,Blue,0,71068,71930,862
2022-08-16,70038,70052,Blue,1,44685,45390,705
2022-08-22,70059,70047,Blue,0,53667,54267,600
2022-05-13,70053,70047,Blue,0,31677,31971,294
2022-07-08,70042,70058,Blue,1,21248,22184,936
2022-04-16,70040,70052,Blue,1,31314,31953,639
2022-06-09,70053,70838,Blue,0,19103,20039,936
2022-09-01,70045,70838,Blue,0,66792,67166,374
2022-09-12,70044,70054,Blue,1,37855,38517,662
2022-07-30,70057,70039,Blue,0,22900,23857,957
2022-02-24,70046,70048,Blue,1,83560,83654,94
2022-10-11,70051,70838,Blue,0,85356,86092,736
2022-08-08,70053,70047,Blue,0,27873,28166,293
2022-11-22,70049,70041,Blue,0,37417,37856,439
2022-04-05,70038,70044,Blue,1,71946,72133,187
2022-07-05,70054,70056,Blue,1,34874,34921,47
2022-07-10,70055,70039,Blue,0,45434,46295,861
2022-12-04,70053,70041,Blue,0,65490,66183,693
2022-12-24,70042,70060,Blue,1,80729,81727,998
2022-03-03,70042,70048,Blue,1,35262,35609,347
2022-06-09,70059,70049,Blue,0,31765,32268,503
2022-06-08,70040,70048,Blue,1,85310,85776,466
2022-08-23,70057,70049,Blue,0,85978,86340,362
2022-01-22,70040,70048,Blue,1,80653,81028,375
2022-06-23,70055,70047,Blue,0,58770,59138,368
2022-06-09,70038,70040,Blue,1,65863,65882,19
2022-09-23,70049,70041,Blue,0,50461,51064,603
2022-12-14,70044,70060,Blue,1,39714,40710,996
2022-01-07,70059,70049,Blue,0,55608,56184,576
2022-03-24,70043,70041,Blue,0,58963,58991,28
2022-07-05,70051,70838,Blue,0,31592,32379,787
2022-08-08,70050,70052,Blue,1,60315,60430,115
2022-07-10,70042,70048,Blue,1,71163,71519,356
2022-06-30,70059,70053,Blue,0,35942,36161,219
2022-11-21,70046,70048,Blue,1,33835,33918,83
2022-12-03,70057,70047,Blue,0,79943,80457,514
2022-01-03,70039,70838,Blue,0,60527,60565,38
2022-04-11,70042,70060,Blue,1,80439,81364,925
2022-01-03,70051,70049,Blue,0,79804,79908,104
2022-01-27,70040,70052,Blue,1,53423,54112,689
2022-11-29,70038,70054,Blue,1,53357,54212,855
2022-11-26,70055,70039,Blue,0,67211,68035,824
2022-04-18,70059,70838,Blue,0,21795,23117,1322
2022-10-10,70057,70051,Blue,0,22230,22462,232
2022-11-01,70038,70058,Blue,1,55693,56674,981
2022-04-30,70055,70051,Blue,0,41629,41781,152
2022-07-04,70057,70043,Blue,0,82704,83509,805
2022-06-23,70056,70058,Blue,1,37693,37766,73
2022-07-08,70046,70048,Blue,1,36343,36439,96
2022-11-24,70059,70051,Blue,0,43455,43770,315
2022-11-05,70042,70058,Blue,1,39567,40461,894
2022-02-05,70042,70052,Blue,1,88356,88993,637
2022-11-03,70042,70052,Blue,1,48809,49420,611
2022-01-26,70040,70046,Blue,1,67661,67919,258
2022-01-10,70053,70049,Blue,0,59583,59777,194
2022-10-05,70045,70043,Blue,0,56237,56334,97
2022-12-20,70042,70050,Blue,1,21341,21748,407
2022-11-29,70046,70058,Blue,1,38819,39470,651
2022-04-07,70048,70060,Blue,1,85840,86449,609
2022-10-12,70038,70044,Blue,1,57620,57841,221
2022-01-01,70040,70048,Blue,1,89168,89556,388
2022-08-30,70038,70042,Blue,1,76760,76853,93
2022-06-23,70059,70041,Blue,0,24261,25321,1060
2022-12-01,70038,70050,Blue,1,58307,58924,617
2022-12-25,70050,70054,Blue,1,29019,29233,214
2022-07-23,70038,70044,Blue,1,83510,83697,187
2022-02-23,70054,70056,Blue,1,48894,48941,47
2022-05-30,70044,70052,Blue,1,80357,80989,632
2022-08-27,70046,70052,Blue,1,64102,64442,340
2022-05-24,70047,70043,Blue,0,42532,42915,383
2022-04-11,70042,70054,Blue,1,68775,69418,643
2022-04-23,70059,70057,Blue,0,70276,70312,36
2022-07-30,70046,70060,Blue,1,33274,33984,710
2022-10-20,70057,70043,Blue,0,41331,42141,810
2022-07-12,70049,70047,Blue,0,48342,48397,55
2022-04-24,70046,70048,Blue,1,39380,39477,97
2022-06-06,70045,70838,Blue,0,89193,89756,563
2022-10-12,70055,70053,Blue,0,50589,50634,45
2022-10-13,70043,70039,Blue,0,33134,33240,106
2022-08-13,70049,70043,Blue,0,60019,60364,345
2022-11-05,70048,70050,Blue,1,36601,36656,55
2022-11-04,70038,70040,Blue,1,72644,72659,15
2022-01-12,70057,70039,Blue,0,32120,33121,1001
2022-02-01,70057,70043,Blue,0,27642,28479,837
2022-04-23,70057,70041,Blue,0,59043,59928,885
2022-01-06,70046,70058,Blue,1,49854,50476,622
2022-06-21,70052,70060,Blue,1,72925,73341,416
2022-04-29,70055,70049,Blue,0,40722,41216,494
2022-07-24,70042,70052,Blue,1,52233,52765,532
2022-11-07,70044,70054,Blue,1,82990,83597,607
2022-08-26,70052,70060,Blue,1,45946,46322,376
2022-03-15,70050,70054,Blue,1,62899,63092,193
2022-02-18,70046,70048,Blue,1,24437,24533,96
2022-09-19,70046,70052,Blue,1,64377,64723,346
2022-01-06,70057,70043,Blue,0,72213,73026,813
2022-08-03,70058,70060,Blue,1,89130,89189,59
2022-10-04,70059,70057,Blue,0,24260,24296,36
2022-08-16,70046,70052,Blue,1,32086,32429,343
2022-04-11,70050,70056,Blue,1,44790,45101,311
2022-08-01,70053,70049,Blue,0,74062,74257,195
2022-08-10,70049,70045,Blue,0,66020,66198,178
2022-01-12,70051,70838,Blue,0,59138,59891,753
2022-02-17,70042,70060,Blue,1,62097,63096,999
2022-04-23,70055,70045,Blue,0,29408,29908,500
2022-02-06,70041,70838,Blue,0,50244,50368,124
2022-07-03,70050,70056,Blue,1,32953,33304,351
2022-02-07,70049,70043,Blue,0,53071,53436,365
2022-04-13,70053,70047,Blue,0,65261,65540,279
2022-09-23,70053,70049,Blue,0,63263,63453,190
2022-03-22,70049,70043,Blue,0,21718,22104,386
2022-08-09,70044,70056,Blue,1,80967,81643,676
2022-01-15,70048,70054,Blue,1,80146,80466,320
2022-08-09,70038,70048,Blue,1,59305,59801,496
2022-06-14,70039,70838,Blue,0,21734,21763,29
2022-08-26,70059,70838,Blue,0,30326,31506,1180
2022-02-10,70040,70048,Blue,1,67998,68401,403
2022-01-21,70043,70041,Blue,0,23432,23462,30
2022-10-24,70059,70049,Blue,0,61338,61795,457
2022-04-06,70048,70050,Blue,1,34949,35003,54
2022-03-11,70040,70054,Blue,1,58650,59451,801
2022-02-24,70055,70047,Blue,0,54811,55192,381
2022-08-15,70055,70049,Blue,0,57919,58210,291
2022-12-30,70059,70053,Blue,0,45507,45746,239
2022-09-08,70045,70041,Blue,0,35342,35504,162
2022-11-29,70055,70045,Blue,0,31895,32417,522
2022-12-08,70042,70046,Blue,1,73345,73526,181
2022-08-25,70038,70050,Blue,1,69501,70073,572
2022-04-23,70052,70054,Blue,1,76322,76382,60
2022-08-17,70057,70041,Blue,0,80299,81115,816
2022-12-07,70056,70060,Blue,1,48548,48804,256
2022-12-08,70042,70060,Blue,1,24947,25945,998
2022-07-05,70048,70056,Blue,1,45389,45784,395
2022-01-26,70051,70838,Blue,0,84364,85034,670
2022-01-10,70057,70047,Blue,0,63715,64219,504
2022-03-21,70046,70058,Blue,1,67142,67880,738
2022-07-25,70042,70058,Blue,1,75009,75841,832
2022-02-02,70038,70044,Blue,1,80834,81032,198
2022-01-27,70057,70041,Blue,0,81943,82835,892
2022-09-29,70046,70052,Blue,1,35226,35573,347
2022-03-24,70050,70054,Blue,1,59274,59528,254
2022-10-03,70048,70052,Blue,1,33688,33915,227
2022-04-20,70049,70047,Blue,0,52631,52688,57
2022-07-28,70039,70838,Blue,0,25299,25333,34
2022-10-18,70038,70046,Blue,1,60131,60466,335
2022-08-30,70038,70040,Blue,1,77323,77345,22
2022-04-10,70051,70041,Blue,0,45684,46277,593
2022-05-22,70045,70838,Blue,0,44620,45137,517
2022-09-05,70044,70060,Blue,1,36506,37379,873
2022-01-12,70047,70838,Blue,0,73220,73689,469
2022-07-18,70041,70838,Blue,0,38012,38139,127
2022-01-11,70038,70052,Blue,1,37345,38074,729
2022-07-29,70049,70045,Blue,0,65881,66082,201
2022-11-25,70053,70047,Blue,0,51802,52087,285
2022-07-10,70051,70049,Blue,0,87659,87762,103
2022-09-12,70038,70040,Blue,1,57734,57748,14
2022-01-17,70054,70060,Blue,1,75919,76204,285
2022-10-30,70057,70838,Blue,0,53920,54983,1063
2022-06-11,70054,70060,Blue,1,39349,39674,325
2022-01-06,70054,70058,Blue,1,31130,31307,177
2022-01-28,70059,70049,Blue,0,50715,51168,453
2022-04-08,70038,70042,Blue,1,60732,60826,94
2022-08-28,70049,70045,Blue,0,65677,65888,211
2022-04-09,70044,70058,Blue,1,42286,43007,721
2022-12-05,70045,70838,Blue,0,74002,74304,302
2022-01-03,70046,70048,Blue,1,70131,70215,84
2022-04-24,70057,70049,Blue,0,59320,59901,581
2022-10-07,70052,70054,Blue,1,46994,47072,78
2022-03-29,70051,70047,Blue,0,75829,76016,187
2022-07-23,70044,70056,Blue,1,60692,61423,731
2022-03-29,70042,70044,Blue,1,77727,77764,37
2022-08-29,70050,70056,Blue,1,60362,60681,319
2022-12-23,70046,70060,Blue,1,79367,80217,850
2022-07-17,70053,70051,Blue,0,63283,63328,45
2022-01-23,70043,70041,Blue,0,27348,27378,30
2022-07-13,70054,70056,Blue,1,89001,89047,46
2022-12-08,70050,70052,Blue,1,58396,58612,216
2022-10-13,70042,70050,Blue,1,43181,43607,426
2022-12-27,70044,70058,Blue,1,83046,83897,851
2022-03-24,70055,70041,Blue,0,42866,43680,814
2022-08-08,70047,70041,Blue,0,32054,32423,369
2022-10-05,70053,70047,Blue,0,55358,55649,291
2022-06-29,70055,70053,Blue,0,86710,86755,45
2022-01-03,70038,70060,Blue,1,64165,65311,1146
2022-09-05,70056,70060,Blue,1,48294,48467,173
2022-05-04,70058,70060,Blue,1,76980,77048,68
2022-03-19,70040,70056,Blue,1,63196,64169,973
2022-02-07,70048,70058,Blue,1,38533,39133,600
2022-12-01,70038,70040,Blue,1,23946,23963,17
2022-06-21,70052,70060,Blue,1,62909,63290,381
2022-03-02,70053,70043,Blue,0,45776,46408,632
2022-10-17,70046,70050,Blue,1,57064,57241,177
2022-02-23,70053,70043,Blue,0,37865,38501,636
2022-12-09,70044,70056,Blue,1,51611,52370,759
2022-06-22,70042,70050,Blue,1,43892,44366,474
2022-01-17,70056,70060,Blue,1,89134,89304,170
2022-07-23,70044,70054,Blue,1,64973,65578,605
2022-10-19,70042,70046,Blue,1,28704,28877,173
2022-11-10,70044,70048,Blue,1,32989,33226,237
2022-09-15,70049,70838,Blue,0,84797,85441,644
2022-01-24,70046,70060,Blue,1,23125,23881,756
2022-01-20,70049,70041,Blue,0,32242,32692,450
2022-01-03,70040,70058,Blue,1,69272,70293,1021
2022-09-14,70053,70049,Blue,0,70958,71151,193
2022-10-09,70059,70047,Blue,0,25403,26014,611
2022-06-10,70057,70039,Blue,0,62442,63432,990
2022-08-07,70048,70052,Blue,1,35177,35367,190
2022-09-21,70049,70043,Blue,0,62464,63000,536
2022-02-19,70059,70057,Blue,0,35255,35290,35
2022-06-29,70055,70039,Blue,0,38908,39855,947
2022-01-24,70042,70052,Blue,1,53223,53800,577
2022-10-06,70055,70045,Blue,0,81281,81823,542
2022-09-10,70057,70045,Blue,0,50370,51030,660
2022-01-19,70038,70060,Blue,1,39196,40369,1173
2022-11-05,70057,70045,Blue,0,29891,30504,613
2022-07-14,70048,70060,Blue,1,26599,27495,896
2022-04-01,70044,70060,Blue,1,86187,87092,905
2022-01-06,70038,70046,Blue,1,31456,31789,333
2022-06-15,70054,70056,Blue,1,45072,45120,48
2022-10-16,70053,70047,Blue,0,65441,65719,278
2022-03-04,70044,70058,Blue,1,57980,58788,808
2022-02-01,70050,70052,Blue,1,35069,35218,149
2022-06-12,70043,70838,Blue,0,27967,28159,192
2022-04-11,70039,70838,Blue,0,71046,71079,33
2022-03-21,70048,70054,Blue,1,25716,26048,332
2022-10-11,70049,70041,Blue,0,88598,89090,492
2022-08-25,70057,70047,Blue,0,20501,20996,495
2022-03-15,70042,70052,Blue,1,87409,88122,713
2022-07-11,70040,70048,Blue,1,49820,50241,421
2022-09-06,70048,70060,Blue,1,47106,47708,602
2022-12-11,70059,70043,Blue,0,66795,67676,881
2022-01-22,70055,70049,Blue,0,86699,86987,288
2022-10-05,70059,70057,Blue,0,71773,71810,37
2022-01-31,70057,70047,Blue,0,39697,40228,531
2022-06-15,70053,70043,Blue,0,57174,57824,650
2022-03-22,70038,70050,Blue,1,70022,70667,645
2022-12-20,70046,70050,Blue,1,26520,26697,177
2022-08-06,70053,70047,Blue,0,43547,43918,371
2022-09-25,70059,70057,Blue,0,64632,64668,36
2022-10-17,70055,70838,Blue,0,44256,45239,983
2022-01-18,70053,70039,Blue,0,61350,62065,715
2022-09-10,70046,70052,Blue,1,82594,82946,352
2022-04-22,70058,70060,Blue,1,79174,79243,69
2022-02-03,70050,70052,Blue,1,64778,64919,141
2022-02-01,70042,70056,Blue,1,65969,66667,698
2022-12-22,70050,70052,Blue,1,22951,23139,188
2022-01-19,70038,70056,Blue,1,29062,29979,917
2022-04-06,70042,70044,Blue,1,20535,20569,34
2022-11-26,70038,70046,Blue,1,59892,60226,334
2022-11-10,70038,70040,Blue,1,39885,39902,17
2022-04-25,70054,70058,Blue,1,31096,31256,160
2022-09-19,70042,70050,Blue,1,53813,54210,397
2022-03-18,70044,70056,Blue,1,47761,48496,735
2022-10-20,70042,70046,Blue,1,58782,58964,182
2022-07-11,70040,70056,Blue,1,65430,66371,941
2022-12-05,70041,70039,Blue,0,56322,56363,41
2022-10-02,70049,70045,Blue,0,53804,53993,189
2022-10-27,70048,70058,Blue,1,26081,26575,494
2022-01-20,70044,70048,Blue,1,21266,21562,296
2022-02-19,70054,70058,Blue,1,47835,47991,156
2022-02-14,70038,70052,Blue,1,89771,91153,1382
2022-09-23,70040,70044,Blue,1,59356,59475,119
2022-08-26,70053,70039,Blue,0,48655,49436,781
2022-10-25,70047,70041,Blue,0,35799,36192,393
2022-01-20,70053,70051,Blue,0,86617,86682,65
2022-08-20,70058,70060,Blue,1,68482,68546,64
2022-04-20,70051,70043,Blue,0,57562,58015,453
2022-04-22,70059,70045,Blue,0,34693,35392,699
2022-08-12,70050,70054,Blue,1,76877,77091,214
2022-09-26,70046,70048,Blue,1,45135,45218,83
2022-04-12,70044,70054,Blue,1,31041,31631,590
2022-12-28,70053,70047,Blue,0,72282,72572,290
2022-11-02,70047,70045,Blue,0,53246,53357,111
2022-09-17,70057,70041,Blue,0,21686,22584,898
2022-04-24,70046,70052,Blue,1,25703,26096,393
2022-12-05,70053,70051,Blue,0,69430,69485,55
2022-06-29,70057,70055,Blue,0,77441,77511,70
2022-04-11,70042,70052,Blue,1,53883,54445,562
2022-11-25,70044,70058,Blue,1,27534,28305,771
2022-09-29,70040,70052,Blue,1,57667,58343,676
2022-02-25,70044,70058,Blue,1,29292,30149,857
2022-04-16,70044,70056,Blue,1,23911,24618,707
2022-07-26,70047,70039,Blue,0,84179,84715,536
2022-07-30,70059,70047,Blue,0,52456,53025,569
2022-09-19,70054,70056,Blue,1,51201,51248,47
2022-11-01,70055,70838,Blue,0,44914,45877,963
2022-12-14,70052,70060,Blue,1,30953,31299,346
2022-06-29,70059,70045,Blue,0,65199,65934,735
2022-07-10,70041,70838,Blue,0,65086,65210,124
2022-11-05,70042,70060,Blue,1,57942,59216,1274
2022-02-13,70049,70041,Blue,0,37374,37838,464
2022-04-24,70045,70041,Blue,0,84496,84659,163
2022-10-07,70049,70043,Blue,0,44660,45011,351
2022-12-03,70039,70838,Blue,0,70762,70799,37
2022-12-09,70055,70039,Blue,0,55541,56459,918
2022-12-27,70044,70046,Blue,1,35985,36094,109
2022-12-08,70046,70052,Blue,1,24517,24909,392
2022-05-14,70059,70049,Blue,0,63616,64096,480
2022-11-09,70049,70043,Blue,0,81707,82050,343
2022-07-17,70048,70050,Blue,1,60186,60243,57
2022-02-21,70047,70838,Blue,0,82149,82658,509
2022-04-01,70040,70058,Blue,1,36860,37910,1050
2022-10-13,70051,70047,Blue,0,29757,29954,197
2022-07-20,70050,70058,Blue,1,52529,52952,423
2022-12-02,70051,70039,Blue,0,42440,43061,621
2022-07-07,70053,70043,Blue,0,78736,79351,615
2022-08-15,70048,70060,Blue,1,68932,69578,646
2022-11-26,70055,70053,Blue,0,29564,29609,45
2022-04-07,70038,70058,Blue,1,36198,37300,1102
2022-07-05,70051,70041,Blue,0,68477,69057,580
2022-06-30,70044,70058,Blue,1,64349,65192,843
2022-09-02,70047,70043,Blue,0,56802,57052,250
2022-07-24,70046,70048,Blue,1,27372,27459,87
2022-02-11,70049,70047,Blue,0,20078,20135,57
2022-06-11,70038,70048,Blue,1,46455,46953,498
2022-04-15,70038,70046,Blue,1,58651,59014,363
2022-03-31,70055,70049,Blue,0,22628,22955,327
2022-01-27,70056,70058,Blue,1,32153,32225,72
2022-03-01,70052,70058,Blue,1,27731,27988,257
2022-03-30,70044,70048,Blue,1,60084,60332,248
2022-07-02,70043,70039,Blue,0,55018,55135,117
2022-02-04,70042,70054,Blue,1,62625,63526,901
2022-03-18,70042,70056,Blue,1,37995,38725,730
2022-03-09,70046,70048,Blue,1,26435,26526,91
2022-02-15,70053,70047,Blue,0,29636,29916,280
2022-04-04,70038,70052,Blue,1,51609,52320,711
2022-04-22,70053,70039,Blue,0,31128,31928,800
2022-11-17,70054,70056,Blue,1,55784,55832,48
2022-12-06,70049,70041,Blue,0,38652,39106,454
2022-02-09,70046,70056,Blue,1,27943,28524,581
2022-12-27,70055,70051,Blue,0,61470,61618,148
2022-03-11,70048,70058,Blue,1,24842,25403,561
2022-01-05,70059,70053,Blue,0,40933,41201,268
2022-02-10,70051,70045,Blue,0,32090,32425,335
2022-12-15,70059,70051,Blue,0,79345,79661,316
2022-11-08,70051,70043,Blue,0,63684,64160,476
2022-01-25,70046,70050,Blue,1,81363,81591,228
2022-12-29,70059,70057,Blue,0,81793,81827,34
2022-10-18,70053,70047,Blue,0,45570,45877,307
2022-05-05,70050,70058,Blue,1,25222,25649,427
2022-07-12,70053,70049,Blue,0,60810,61034,224
2022-02-23,70050,70056,Blue,1,67706,68005,299
2022-10-27,70055,70039,Blue,0,80112,80910,798
2022-02-05,70051,70838,Blue,0,32890,33684,794
2022-10-20,70038,70058,Blue,1,42162,43161,999
2022-01-23,70053,70045,Blue,0,76788,77199,411
2022-10-19,70051,70838,Blue,0,49226,49967,741
2022-05-01,70055,70051,Blue,0,61784,61944,160
2022-07-18,70045,70043,Blue,0,53490,53588,98
2022-01-11,70056,70058,Blue,1,23806,23887,81
2022-03-28,70055,70041,Blue,0,72796,73532,736
2022-07-11,70042,70058,Blue,1,37023,38241,1218
2022-10-24,70059,70047,Blue,0,62423,62973,550
2022-09-04,70040,70056,Blue,1,65129,65969,840
2022-09-03,70038,70046,Blue,1,51265,51643,378
2022-09-26,70044,70048,Blue,1,50497,50732,235
2022-04-18,70044,70054,Blue,1,43818,44395,577
2022-11-14,70051,70043,Blue,0,32907,33393,486
2022-02-26,70045,70039,Blue,0,25094,25357,263
2022-03-16,70040,70052,Blue,1,71982,72653,671
2022-11-15,70042,70060,Blue,1,34603,35538,935
2022-02-26,70045,70039,Blue,0,31099,31361,262
2022-08-31,70053,70047,Blue,0,50204,50487,283
2022-11-17,70059,70057,Blue,0,47729,47766,37
2022-10-08,70059,70041,Blue,0,24900,25847,947
2022-01-26,70053,70043,Blue,0,27844,28487,643
2022-10-17,70055,70047,Blue,0,61323,61673,350
2022-01-18,70057,70045,Blue,0,68536,69144,608
2022-09-27,70057,70043,Blue,0,59371,60132,761
2022-03-11,70042,70060,Blue,1,42228,43309,1081
2022-05-18,70059,70043,Blue,0,30560,31539,979
2022-09-30,70052,70060,Blue,1,55821,56180,359
2022-02-11,70042,70044,Blue,1,57140,57171,31
2022-10-21,70054,70060,Blue,1,70360,70634,274
2022-11-17,70038,70042,Blue,1,45077,45171,94
2022-02-03,70040,70048,Blue,1,35710,36084,374
2022-12-24,70038,70046,Blue,1,21008,21353,345
2022-12-09,70050,70054,Blue,1,68038,68275,237
2022-09-03,70048,70052,Blue,1,76626,76848,222
2022-08-22,70052,70060,Blue,1,44429,44801,372
2022-07-26,70051,70043,Blue,0,27661,28257,596
2022-10-03,70049,70045,Blue,0,58284,58471,187
2022-04-03,70043,70039,Blue,0,60656,60764,108
2022-10-16,70043,70041,Blue,0,70438,70466,28
2022-11-29,70059,70047,Blue,0,27496,28092,596
2022-01-22,70046,70056,Blue,1,68088,68645,557
2022-07-20,70059,70041,Blue,0,55270,56374,1104
2022-09-27,70038,70060,Blue,1,53363,54515,1152
2022-04-03,70055,70043,Blue,0,34941,35616,675
2022-03-12,70044,70052,Blue,1,55278,55780,502
2022-01-19,70046,70060,Blue,1,65350,66185,835
2022-12-27,70038,70058,Blue,1,69854,70869,1015
2022-07-30,70040,70044,Blue,1,30791,30895,104
2022-02-08,70040,70058,Blue,1,57840,58803,963
2022-02-22,70041,70039,Blue,0,65524,65559,35
2022-12-28,70045,70041,Blue,0,77739,77906,167
2022-02-05,70055,70039,Blue,0,56967,57878,911
2022-08-24,70046,70060,Blue,1,38335,39323,988
2022-08-31,70052,70060,Blue,1,87626,87958,332
2022-09-08,70059,70041,Blue,0,42620,43667,1047
2022-11-02,70052,70056,Blue,1,35412,35556,144
2022-12-07,70042,70050,Blue,1,25009,25413,404
2022-10-24,70042,70054,Blue,1,67158,67855,697
2022-11-10,70057,70055,Blue,0,60939,61007,68
2022-06-29,70051,70041,Blue,0,66165,66744,579
2022-09-27,70049,70045,Blue,0,32346,32587,241
2022-08-04,70045,70041,Blue,0,78165,78482,317
2022-02-26,70054,70060,Blue,1,77527,77803,276
2022-10-03,70059,70838,Blue,0,59775,60943,1168
2022-02-19,70058,70060,Blue,1,76595,76662,67
2022-02-07,70055,70047,Blue,0,26857,27254,397
2022-02-24,70056,70058,Blue,1,64103,64178,75
2022-04-17,70038,70056,Blue,1,87317,88275,958
2022-08-05,70041,70039,Blue,0,59784,59814,30
2022-08-08,70046,70058,Blue,1,80019,80619,600
2022-09-22,70043,70041,Blue,0,56593,56621,28
2022-03-05,70053,70043,Blue,0,74320,74851,531
2022-03-08,70040,70048,Blue,1,45875,46347,472
2022-07-13,70047,70039,Blue,0,28868,29319,451
2022-08-24,70049,70043,Blue,0,37973,38340,367
2022-07-05,70051,70047,Blue,0,29182,29424,242
2022-10-23,70048,70056,Blue,1,52599,53015,416
2022-11-01,70048,70056,Blue,1,79873,80287,414
2022-07-03,70053,70051,Blue,0,24100,24156,56
2022-05-26,70040,70042,Blue,1,42135,42167,32
2022-04-11,70056,70058,Blue,1,28853,28936,83
2022-01-03,70055,70047,Blue,0,23909,24373,464
2022-08-08,70044,70052,Blue,1,81623,82115,492
2022-03-28,70043,70039,Blue,0,25509,25620,111
2022-02-27,70057,70055,Blue,0,77126,77195,69
2022-09-28,70052,70060,Blue,1,34491,34848,357
2022-04-04,70059,70045,Blue,0,59602,60290,688
2022-01-05,70059,70049,Blue,0,19519,20057,538
2022-12-07,70044,70056,Blue,1,32130,32789,659
2022-04-14,70057,70047,Blue,0,76746,77219,473
2022-09-07,70049,70047,Blue,0,88670,88725,55
2022-08-14,70056,70060,Blue,1,53652,53831,179
2022-10-08,70040,70060,Blue,1,78038,79081,1043
2022-03-10,70041,70838,Blue,0,23938,24136,198
2022-06-10,70042,70048,Blue,1,70081,70433,352
2022-09-28,70045,70043,Blue,0,50730,50826,96
2022-07-28,70044,70058,Blue,1,22448,23192,744
2022-06-18,70051,70041,Blue,0,29228,29839,611
2022-10-25,70053,70838,Blue,0,24123,25000,877
2022-02-16,70057,70049,Blue,0,43313,43690,377
2022-11-23,70055,70051,Blue,0,54078,54209,131
2022-05-19,70055,70045,Blue,0,53786,54488,702
2022-07-18,70043,70039,Blue,0,37927,38047,120
2022-09-07,70044,70056,Blue,1,89321,89991,670
2022-04-24,70053,70045,Blue,0,55192,55644,452
2022-12-30,70059,70045,Blue,0,33526,34176,650
2022-02-02,70038,70044,Blue,1,58171,58335,164
2022-07-12,70058,70060,Blue,1,53560,53623,63
2022-12-25,70052,70058,Blue,1,77666,77914,248
2022-12-23,70054,70060,Blue,1,26146,26458,312
2022-09-11,70048,70052,Blue,1,67192,67405,213
2022-03-08,70038,70040,Blue,1,49213,49232,19
2022-08-25,70051,70045,Blue,0,38827,39193,366
2022-02-02,70042,70058,Blue,1,62871,63899,1028
2022-08-02,70044,70046,Blue,1,75999,76122,123
2022-12-20,70040,70058,Blue,1,30126,31073,947
2022-11-15,70053,70039,Blue,0,60158,61128,970
2022-11-16,70038,70052,Blue,1,73647,74334,687
2022-12-25,70038,70048,Blue,1,72122,72567,445
2022-02-03,70050,70054,Blue,1,89036,89250,214
2022-02-27,70041,70838,Blue,0,37241,37369,128
2022-06-14,70051,70047,Blue,0,58184,58386,202
2022-01-07,70046,70058,Blue,1,50672,51461,789
2022-06-16,70044,70048,Blue,1,30635,30911,276
2022-01-26,70049,70838,Blue,0,46683,47326,643
2022-12-29,70046,70050,Blue,1,24827,25012,185
2022-05-25,70038,70040,Blue,1,39676,39691,15
2022-04-03,70046,70060,Blue,1,78383,79126,743
2022-03-11,70059,70039,Blue,0,50243,51386,1143
2022-02-25,70059,70049,Blue,0,70540,71032,492
2022-09-18,70046,70060,Blue,1,56239,56957,718
2022-08-05,70044,70056,Blue,1,48908,49601,693
2022-09-18,70038,70048,Blue,1,73220,73712,492
2022-11-06,70045,70041,Blue,0,77763,77948,185
2022-04-22,70053,70039,Blue,0,67770,68522,752
2022-01-16,70050,70056,Blue,1,52204,52509,305
2022-07-12,70059,70039,Blue,0,65814,66815,1001
2022-04-12,70040,70060,Blue,1,49300,50401,1101
2022-03-14,70044,70060,Blue,1,68797,69663,866
2022-08-10,70051,70043,Blue,0,29671,30195,524
2022-09-27,70044,70060,Blue,1,51809,52709,900
2022-11-09,70055,70043,Blue,0,80007,80660,653
2022-10-23,70054,70060,Blue,1,36257,36500,243
2022-09-24,70052,70060,Blue,1,34286,34638,352
2022-01-03,70041,70838,Blue,0,52490,52596,106
2022-08-20,70051,70041,Blue,0,54979,55570,591
2022-12-10,70042,70046,Blue,1,46550,46724,174
2022-03-10,70049,70047,Blue,0,54380,54433,53
2022-03-30,70059,70055,Blue,0,61396,61536,140
2022-02-28,70055,70047,Blue,0,34264,34623,359
2022-08-01,70050,70056,Blue,1,48938,49277,339
2022-10-05,70044,70052,Blue,1,85920,86429,509
2022-08-03,70038,70060,Blue,1,65046,66153,1107
2022-01-23,70050,70058,Blue,1,61303,61682,379
2022-11-30,70050,70058,Blue,1,29123,29505,382
2022-03-05,70040,70050,Blue,1,68595,69106,511
2022-01-05,70038,70054,Blue,1,40692,41532,840
2022-04-10,70045,70039,Blue,0,62199,62459,260
2022-07-04,70047,70045,Blue,0,37940,38057,117
2022-07-15,70046,70048,Blue,1,63516,63598,82
2022-07-27,70052,70056,Blue,1,50044,50204,160
2022-02-01,70052,70054,Blue,1,59401,59461,60
2022-04-06,70038,70046,Blue,1,28748,29042,294
2022-02-20,70040,70042,Blue,1,72132,72163,31
2022-04-05,70044,70048,Blue,1,23841,24084,243
2022-06-13,70053,70051,Blue,0,26364,26424,60
2022-04-03,70058,70060,Blue,1,80139,80200,61
2022-08-06,70047,70041,Blue,0,63353,63671,318
2022-12-14,70055,70049,Blue,0,69327,69614,287
2022-01-05,70052,70058,Blue,1,39592,39868,276
2022-03-16,70059,70049,Blue,0,29356,29853,497
2022-10-08,70043,70041,Blue,0,72789,72818,29
2022-01-12,70053,70045,Blue,0,31179,31718,539
2022-01-18,70041,70039,Blue,0,44921,44957,36
2022-10-20,70047,70039,Blue,0,39733,40164,431
2022-01-15,70059,70838,Blue,0,68635,70279,1644
2022-08-26,70054,70056,Blue,1,27492,27542,50
2022-11-15,70044,70052,Blue,1,70901,71377,476
2022-12-06,70042,70048,Blue,1,60030,60384,354
2022-03-16,70053,70039,Blue,0,65551,66271,720
2022-07-21,70038,70056,Blue,1,70861,72451,1590
2022-11-08,70057,70053,Blue,0,81262,81407,145
2022-12-30,70048,70058,Blue,1,69496,70115,619
2022-10-30,70049,70045,Blue,0,86147,86349,202
2022-11-18,70051,70039,Blue,0,29976,30638,662
2022-10-23,70042,70056,Blue,1,82647,83397,750
2022-02-06,70057,70053,Blue,0,58234,58407,173
2022-12-05,70041,70838,Blue,0,39027,39160,133
2022-06-30,70052,70054,Blue,1,78133,78187,54
2022-03-25,70048,70052,Blue,1,21416,21623,207
2022-07-09,70046,70060,Blue,1,54350,55085,735
2022-02-09,70050,70058,Blue,1,85072,85524,452
2022-06-24,70042,70058,Blue,1,62074,63019,945
2022-12-11,70044,70052,Blue,1,59351,59904,553
2022-11-18,70048,70054,Blue,1,68491,68853,362
2022-07-28,70040,70042,Blue,1,81246,81276,30
2022-01-28,70050,70058,Blue,1,65541,65967,426
2022-10-02,70053,70045,Blue,0,50328,50774,446
2022-10-13,70059,70057,Blue,0,28898,28939,41
2022-07-12,70054,70058,Blue,1,71956,72120,164
2022-04-04,70057,70055,Blue,0,77251,77320,69
2022-02-14,70049,70045,Blue,0,75021,75240,219
2022-08-16,70057,70039,Blue,0,46084,47028,944
2022-02-02,70059,70055,Blue,0,68346,68495,149
2022-08-27,70055,70043,Blue,0,41296,41968,672
2022-02-06,70038,70044,Blue,1,74234,74393,159
2022-08-01,70040,70042,Blue,1,59174,59204,30
2022-01-02,70048,70052,Blue,1,73631,73839,208
2022-05-28,70043,70041,Blue,0,87241,87269,28
2022-12-06,70042,70058,Blue,1,65514,66439,925
2022-07-14,70050,70058,Blue,1,22519,22918,399
2022-07-20,70039,70838,Blue,0,61431,61466,35
2022-02-03,70042,70056,Blue,1,54778,55557,779
2022-03-02,70053,70051,Blue,0,34436,34497,61
2022-07-01,70044,70048,Blue,1,51991,52293,302
2022-01-18,70044,70048,Blue,1,63407,63703,296
2022-12-02,70038,70052,Blue,1,90239,91385,1146
2022-09-15,70059,70039,Blue,0,28047,29190,1143
2022-03-07,70038,70052,Blue,1,70519,71240,721
2022-11-30,70057,70051,Blue,0,70330,70873,543
2022-04-09,70039,70838,Blue,0,84221,84255,34
2022-06-10,70049,70039,Blue,0,56492,57022,530
2022-12-27,70046,70058,Blue,1,31778,32427,649
2022-11-04,70044,70048,Blue,1,71837,72156,319
2022-03-16,70038,70058,Blue,1,37334,38447,1113
2022-08-15,70053,70039,Blue,0,59583,60350,767
2022-02-08,70040,70054,Blue,1,39621,40399,778
2022-10-14,70038,70060,Blue,1,56735,57830,1095
2022-02-04,70038,70046,Blue,1,74185,74486,301
2022-01-19,70044,70054,Blue,1,23366,24003,637
2022-01-22,70046,70050,Blue,1,68909,69119,210
2022-10-18,70038,70060,Blue,1,56750,57847,1097
2022-07-20,70040,70042,Blue,1,46273,46311,38
2022-02-03,70038,70048,Blue,1,24559,25034,475
2022-02-23,70038,70044,Blue,1,28152,28330,178
2022-04-08,70044,70048,Blue,1,58833,59067,234
2022-10-11,70047,70045,Blue,0,32888,32987,99
2022-06-15,70050,70054,Blue,1,59872,60092,220
2022-09-02,70038,70058,Blue,1,42966,43956,990
2022-11-30,70053,70047,Blue,0,39515,40236,721
2022-03-03,70047,70045,Blue,0,87547,87667,120
2022-12-15,70038,70044,Blue,1,23574,23752,178
2022-05-20,70040,70048,Blue,1,60598,61077,479
2022-06-26,70038,70056,Blue,1,51038,51994,956
2022-06-16,70039,70838,Blue,0,32342,32375,33
2022-09-03,70051,70049,Blue,0,38242,38342,100
2022-02-09,70059,70055,Blue,0,69084,69246,162
2022-07-24,70051,70049,Blue,0,52057,52165,108
2022-03-19,70038,70060,Blue,1,83766,84909,1143
2022-01-27,70057,70049,Blue,0,57279,57652,373
2022-11-08,70041,70838,Blue,0,40707,40827,120
2022-03-06,70051,70838,Blue,0,62287,62965,678
2022-03-03,70047,70043,Blue,0,28522,28837,315
2022-07-22,70054,70060,Blue,1,22616,22854,238
2022-09-04,70049,70043,Blue,0,51626,51979,353
2022-03-08,70038,70052,Blue,1,52211,52958,747
2022-12-25,70055,70039,Blue,0,50228,51047,819
2022-10-23,70045,70039,Blue,0,67572,67823,251
2022-01-06,70042,70054,Blue,1,20855,21623,768
2022-01-19,70046,70056,Blue,1,63215,63758,543
2022-12-16,70040,70056,Blue,1,65938,66778,840
2022-07-23,70052,70056,Blue,1,62281,62441,160
2022-02-14,70055,70045,Blue,0,51742,52258,516
2022-02-22,70051,70838,Blue,0,64486,65286,800
2022-04-08,70049,70047,Blue,0,57387,57441,54
2022-03-03,70054,70058,Blue,1,75689,75870,181
2022-01-13,70041,70838,Blue,0,51682,51805,123
2022-09-28,70041,70838,Blue,0,29233,29370,137
2022-12-05,70044,70056,Blue,1,42266,42947,681
2022-09-02,70047,70039,Blue,0,41199,41617,418
2022-09-24,70048,70058,Blue,1,58320,58817,497
2022-09-15,70038,70042,Blue,1,53358,53464,106
2022-05-21,70039,70838,Blue,0,61045,61081,36
2022-06-29,70040,70054,Blue,1,76327,77096,769
2022-07-01,70049,70039,Blue,0,36384,36899,515
2022-04-04,70055,70053,Blue,0,63071,63118,47
2022-08-20,70038,70050,Blue,1,71239,71807,568
2022-08-25,70046,70058,Blue,1,53758,54510,752
2022-11-19,70048,70052,Blue,1,37712,37910,198
2022-10-26,70045,70039,Blue,0,31335,31615,280
2022-03-19,70053,70051,Blue,0,19793,19900,107
2022-11-03,70042,70048,Blue,1,54681,55040,359
2022-06-23,70053,70041,Blue,0,64731,65406,675
2022-04-07,70038,70054,Blue,1,30551,31347,796
2022-12-14,70042,70046,Blue,1,83731,83915,184
2022-12-17,70040,70050,Blue,1,76170,76686,516
2022-11-22,70042,70048,Blue,1,76868,77157,289
2022-09-09,70054,70056,Blue,1,85525,85571,46
2022-03-10,70059,70838,Blue,0,29667,30878,1211
2022-08-18,70046,70054,Blue,1,26866,27358,492
2022-03-23,70054,70060,Blue,1,54889,55155,266
2022-03-13,70045,70043,Blue,0,54037,54124,87
2022-06-18,70055,70043,Blue,0,52138,52869,731
2022-01-28,70044,70054,Blue,1,48878,49444,566
2022-12-13,70059,70838,Blue,0,80024,81081,1057
2022-07-08,70054,70058,Blue,1,52226,52385,159
2022-07-17,70053,70039,Blue,0,60576,61358,782
2022-04-08,70058,70060,Blue,1,32605,32676,71
2022-11-29,70054,70058,Blue,1,56050,56194,144
2022-09-23,70053,70049,Blue,0,82376,82556,180
2022-03-09,70038,70040,Blue,1,72595,72611,16
2022-03-25,70052,70056,Blue,1,24176,24371,195
2022-02-09,70045,70041,Blue,0,57918,58089,171
2022-11-05,70059,70043,Blue,0,26065,26938,873
2022-02-28,70052,70058,Blue,1,63973,64239,266
2022-06-10,70042,70044,Blue,1,56483,56515,32
2022-03-10,70057,70043,Blue,0,71607,72407,800
2022-04-11,70046,70060,Blue,1,62973,63843,870
2022-12-11,70050,70052,Blue,1,54992,55108,116
2022-01-01,70059,70049,Blue,0,52754,53238,484
2022-12-10,70047,70838,Blue,0,70282,70725,443
2022-03-10,70052,70054,Blue,1,28606,28660,54
2022-05-15,70056,70058,Blue,1,86126,86199,73
2022-07-23,70053,70051,Blue,0,51707,51768,61
2022-03-16,70057,70045,Blue,0,55480,56130,650
2022-08-14,70040,70060,Blue,1,72680,73786,1106
2022-12-16,70046,70048,Blue,1,23829,23915,86
2022-08-25,70046,70060,Blue,1,51762,52519,757
2022-03-30,70052,70060,Blue,1,35303,35666,363
2022-08-04,70059,70051,Blue,0,31474,31837,363
2022-02-18,70042,70054,Blue,1,25205,25914,709
2022-12-01,70049,70043,Blue,0,75863,76180,317
2022-08-30,70038,70048,Blue,1,69487,69967,480
2022-08-21,70042,70050,Blue,1,79873,80303,430
2022-09-02,70040,70046,Blue,1,57147,57399,252
2022-12-27,70042,70044,Blue,1,25721,25760,39
2022-02-03,70038,70056,Blue,1,31532,32561,1029
2022-09-29,70045,70041,Blue,0,61655,61834,179
2022-01-10,70049,70041,Blue,0,45712,46110,398
2022-09-23,70059,70043,Blue,0,44566,45502,936
2022-12-09,70056,70058,Blue,1,35231,35303,72
2022-04-21,70059,70057,Blue,0,43249,43288,39
2022-02-17,70049,70043,Blue,0,51768,52225,457
2022-12-05,70051,70045,Blue,0,78698,79029,331
2022-04-08,70038,70048,Blue,1,86545,87024,479
2022-03-22,70059,70055,Blue,0,70609,70750,141
2022-02-21,70042,70058,Blue,1,22503,23381,878
2022-08-21,70042,70056,Blue,1,35613,36344,731
2022-11-30,70044,70054,Blue,1,78118,78706,588
2022-10-18,70059,70055,Blue,0,86531,86678,147
2022-04-03,70052,70058,Blue,1,57682,57921,239
2022-02-16,70058,70060,Blue,1,67579,67885,306
2022-08-11,70038,70048,Blue,1,56506,56986,480
2022-11-30,70046,70052,Blue,1,54003,54396,393
2022-09-24,70044,70058,Blue,1,58008,58817,809
2022-10-28,70038,70044,Blue,1,71098,71288,190
2022-09-05,70059,70041,Blue,0,27733,28815,1082
2022-03-01,70042,70046,Blue,1,24436,24623,187
2022-01-10,70053,70049,Blue,0,19099,19294,195
2022-07-08,70049,70045,Blue,0,48870,49081,211
2022-10-21,70055,70043,Blue,0,52746,53560,814
2022-08-15,70059,70047,Blue,0,79456,80019,563
2022-04-21,70046,70054,Blue,1,66775,67170,395
2022-06-15,70053,70045,Blue,0,75153,75572,419
2022-01-20,70046,70056,Blue,1,40279,41045,766
2022-08-23,70052,70054,Blue,1,25674,25749,75
2022-02-20,70057,70043,Blue,0,23921,24648,727
2022-02-02,70054,70056,Blue,1,23750,23801,51
2022-08-30,70042,70052,Blue,1,79052,79625,573
2022-02-18,70049,70043,Blue,0,66411,66816,405
2022-12-19,70044,70058,Blue,1,64065,64932,867
2022-01-11,70038,70054,Blue,1,55327,56199,872
2022-11-07,70053,70049,Blue,0,62181,62527,346
2022-08-21,70056,70060,Blue,1,72562,72777,215
2022-07-29,70038,70058,Blue,1,22830,23909,1079
2022-09-27,70042,70046,Blue,1,37256,37448,192
2022-12-31,70051,70047,Blue,0,58753,58951,198
2022-06-25,70041,70039,Blue,0,67268,67302,34
2022-09-24,70050,70052,Blue,1,87935,88039,104
2022-08-17,70042,70050,Blue,1,60494,60929,435
2022-03-25,70042,70054,Blue,1,59385,60149,764
2022-11-18,70040,70058,Blue,1,64886,65908,1022
2022-06-30,70059,70043,Blue,0,24674,25586,912
2022-12-08,70042,70046,Blue,1,79580,79742,162
2022-08-18,70046,70054,Blue,1,75838,76291,453
2022-07-21,70046,70048,Blue,1,83648,83728,80
2022-11-23,70058,70060,Blue,1,53919,53978,59
2022-04-13,70044,70054,Blue,1,47271,47912,641
2022-12-07,70044,70050,Blue,1,59120,59503,383
2022-12-10,70053,70047,Blue,0,59243,59527,284
2022-02-11,70038,70050,Blue,1,41925,42535,610
2022-06-29,70042,70056,Blue,1,29629,30424,795
2022-06-28,70042,70060,Blue,1,68138,69293,1155
2022-08-15,70046,70048,Blue,1,21928,22014,86
2022-04-06,70053,70049,Blue,0,22291,22487,196
2022-04-02,70040,70048,Blue,1,60493,60900,407
2022-10-15,70046,70054,Blue,1,88628,89088,460
2022-05-21,70055,70049,Blue,0,34280,34558,278
2022-09-28,70046,70058,Blue,1,69981,70613,632
2022-01-07,70058,70060,Blue,1,67987,68169,182
2022-06-24,70051,70043,Blue,0,22643,23230,587
2022-08-06,70059,70838,Blue,0,27084,28175,1091
2022-02-21,70047,70039,Blue,0,56360,56858,498
2022-07-04,70040,70058,Blue,1,32440,33467,1027
2022-10-17,70056,70058,Blue,1,45825,45900,75
2022-01-26,70040,70046,Blue,1,64702,64966,264
2022-02-04,70055,70039,Blue,0,29295,30154,859
2022-04-13,70053,70047,Blue,0,58988,59325,337
2022-05-20,70059,70049,Blue,0,51670,52122,452
2022-02-13,70053,70047,Blue,0,62818,63129,311
2022-08-31,70053,70049,Blue,0,71505,71697,192
2022-02-10,70051,70043,Blue,0,50177,50764,587
2022-12-20,70059,70041,Blue,0,65228,66124,896
2022-12-16,70040,70054,Blue,1,28812,29574,762
2022-03-28,70059,70049,Blue,0,27566,28146,580
2022-11-24,70058,70060,Blue,1,84704,84765,61
2022-03-07,70054,70056,Blue,1,85193,85241,48
2022-05-18,70055,70049,Blue,0,64268,64586,318
2022-12-27,70044,70056,Blue,1,61295,61955,660
2022-06-13,70059,70047,Blue,0,26656,27241,585
2022-11-08,70054,70058,Blue,1,72418,72568,150
2022-12-23,70045,70041,Blue,0,86323,86477,154
2022-12-10,70038,70040,Blue,1,68535,68551,16
2022-06-22,70042,70046,Blue,1,35607,35843,236
2022-04-07,70040,70056,Blue,1,41999,42906,907
2022-11-21,70055,70051,Blue,0,33983,34124,141
2022-01-11,70057,70049,Blue,0,46171,46606,435
2022-01-13,70038,70046,Blue,1,55964,56304,340
2022-06-28,70050,70060,Blue,1,84012,84554,542
2022-02-15,70046,70056,Blue,1,22482,23002,520
2022-12-17,70043,70039,Blue,0,30140,30261,121
2022-07-25,70059,70039,Blue,0,52132,53208,1076
2022-07-23,70042,70050,Blue,1,66281,66711,430
2022-01-21,70051,70045,Blue,0,83866,84248,382
2022-10-04,70043,70039,Blue,0,64371,64482,111
2022-03-15,70044,70060,Blue,1,27744,28726,982
2022-05-18,70044,70056,Blue,1,66078,66967,889
2022-04-22,70046,70056,Blue,1,25307,25862,555
2022-11-30,70048,70050,Blue,1,68991,69048,57
2022-01-07,70055,70045,Blue,0,25659,26230,571
2022-11-18,70057,70838,Blue,0,31373,32462,1089
2022-09-01,70052,70058,Blue,1,29903,30142,239
2022-04-27,70052,70058,Blue,1,31696,31939,243
2022-11-10,70042,70054,Blue,1,66055,66703,648
2022-02-10,70053,70045,Blue,0,59583,60076,493
2022-02-03,70038,70046,Blue,1,76338,76657,319
2022-12-16,70059,70047,Blue,0,71238,71792,554
2022-01-27,70047,70039,Blue,0,69046,69429,383
2022-04-28,70059,70049,Blue,0,24675,25157,482
2022-12-24,70057,70047,Blue,0,65491,66076,585
2022-01-19,70046,70056,Blue,1,60147,60678,531
2022-12-26,70044,70048,Blue,1,45818,46035,217
2022-05-06,70055,70049,Blue,0,50739,51118,379
2022-04-22,70055,70041,Blue,0,30763,31586,823
2022-09-14,70050,70060,Blue,1,52356,52897,541
2022-02-17,70055,70045,Blue,0,52305,52844,539
2022-06-16,70057,70043,Blue,0,33049,33853,804
2022-05-21,70052,70060,Blue,1,74332,74823,491
2022-04-20,70057,70039,Blue,0,70056,71064,1008
2022-02-03,70048,70056,Blue,1,60574,61036,462
2022-03-25,70052,70058,Blue,1,55392,55666,274
2022-04-08,70046,70054,Blue,1,75601,76032,431
2022-11-26,70044,70060,Blue,1,63893,64831,938
2022-07-18,70059,70045,Blue,0,77480,78150,670
2022-01-03,70055,70053,Blue,0,66983,67032,49
2022-02-22,70051,70043,Blue,0,51567,52102,535
2022-07-12,70059,70043,Blue,0,60909,61744,835
2022-06-21,70048,70058,Blue,1,48919,49413,494
2022-03-03,70057,70051,Blue,0,71065,71296,231
2022-04-13,70059,70055,Blue,0,32969,33114,145
2022-06-16,70057,70043,Blue,0,72690,73507,817
2022-03-21,70053,70041,Blue,0,38938,39579,641
2022-06-19,70048,70060,Blue,1,66708,67336,628
2022-04-22,70042,70056,Blue,1,57884,58651,767
2022-09-08,70052,70060,Blue,1,71522,71894,372
2022-12-14,70042,70058,Blue,1,29125,29952,827
2022-11-13,70044,70052,Blue,1,70216,70722,506
2022-03-30,70057,70047,Blue,0,45574,46108,534
2022-08-14,70055,70047,Blue,0,61041,61398,357
2022-11-18,70041,70039,Blue,0,69305,69339,34
2022-04-20,70059,70055,Blue,0,42683,42854,171
2022-07-27,70047,70838,Blue,0,54128,54752,624
2022-09-24,70048,70060,Blue,1,69059,69682,623
2022-11-15,70045,70041,Blue,0,33355,33536,181
2022-06-15,70040,70054,Blue,1,62313,63156,843
2022-02-19,70053,70838,Blue,0,55981,56812,831
2022-11-09,70038,70050,Blue,1,24389,24986,597
2022-05-19,70040,70056,Blue,1,32126,33065,939
2022-07-23,70059,70055,Blue,0,71354,71509,155
2022-07-21,70057,70051,Blue,0,51036,51292,256
2022-05-05,70049,70047,Blue,0,47720,47766,46
2022-12-05,70046,70056,Blue,1,45493,46021,528
2022-08-17,70052,70058,Blue,1,31873,32144,271
2022-01-02,70043,70838,Blue,0,46176,47056,880
2022-09-06,70051,70047,Blue,0,67550,67737,187
2022-04-23,70055,70039,Blue,0,29408,30202,794
2022-03-08,70038,70042,Blue,1,59547,59657,110
2022-11-13,70042,70050,Blue,1,58729,59144,415
2022-08-16,70051,70043,Blue,0,59776,60291,515
2022-11-09,70038,70050,Blue,1,60677,61250,573
2022-06-09,70038,70046,Blue,1,73527,73857,330
2022-08-14,70044,70050,Blue,1,66907,67255,348
2022-03-14,70052,70060,Blue,1,79960,80318,358
2022-08-24,70038,70046,Blue,1,54914,55278,364
2022-09-02,70053,70045,Blue,0,41865,42279,414
2022-10-12,70047,70043,Blue,0,32859,33163,304
2022-08-05,70057,70045,Blue,0,39581,40197,616
2022-03-12,70044,70048,Blue,1,60099,60345,246
2022-05-05,70052,70054,Blue,1,25681,25730,49
2022-02-28,70038,70044,Blue,1,32347,32709,362
2022-02-16,70055,70053,Blue,0,73928,73976,48
2022-03-08,70054,70058,Blue,1,56167,56347,180
2022-01-20,70040,70048,Blue,1,56035,56443,408
2022-02-19,70038,70048,Blue,1,67455,67920,465
2022-05-18,70059,70838,Blue,0,30847,32185,1338
2022-01-21,70044,70056,Blue,1,24218,24921,703
2022-07-12,70050,70060,Blue,1,48472,49006,534
2022-07-31,70059,70049,Blue,0,24902,25370,468
2022-10-04,70053,70047,Blue,0,30417,30769,352
2022-06-21,70038,70054,Blue,1,63015,63966,951
2022-09-13,70045,70039,Blue,0,63790,64048,258
2022-06-24,70038,70054,Blue,1,53279,54364,1085
2022-12-20,70057,70041,Blue,0,64729,65570,841
2022-09-22,70040,70046,Blue,1,85871,86138,267
2022-11-14,70042,70056,Blue,1,40052,40878,826
2022-07-28,70057,70838,Blue,0,38006,39008,1002
2022-03-05,70038,70060,Blue,1,42606,43628,1022
2022-08-04,70044,70052,Blue,1,66279,66737,458
2022-04-14,70049,70045,Blue,0,26005,26301,296
2022-12-31,70059,70047,Blue,0,83386,83932,546
2022-09-15,70053,70047,Blue,0,84550,84857,307
2022-04-19,70049,70047,Blue,0,56220,56277,57
2022-02-17,70059,70043,Blue,0,57502,58395,893
2022-03-20,70055,70045,Blue,0,56079,56629,550
2022-08-22,70044,70046,Blue,1,50112,50219,107
2022-01-05,70053,70047,Blue,0,41815,42098,283
2022-08-04,70059,70047,Blue,0,20836,21427,591
2022-04-05,70049,70838,Blue,0,72017,72626,609
2022-03-13,70047,70041,Blue,0,46924,47246,322
2022-07-22,70053,70838,Blue,0,28365,29305,940
2022-01-02,70050,70052,Blue,1,89714,89822,108
2022-08-18,70059,70041,Blue,0,64100,65097,997
2022-08-22,70038,70052,Blue,1,73773,74473,700
2022-11-10,70038,70052,Blue,1,68631,69334,703
2022-09-02,70052,70054,Blue,1,65038,65096,58
2022-08-18,70050,70056,Blue,1,31419,31725,306
2022-07-26,70048,70060,Blue,1,65813,66402,589
2022-12-28,70042,70050,Blue,1,47108,47498,390
2022-01-03,70047,70039,Blue,0,70012,70551,539
2022-01-18,70047,70838,Blue,0,49855,50384,529
2022-11-18,70047,70043,Blue,0,44130,44505,375
2022-06-20,70047,70041,Blue,0,38065,38413,348
2022-08-12,70040,70048,Blue,1,32830,33228,398
2022-02-09,70059,70051,Blue,0,56295,56644,349
2022-02-28,70042,70056,Blue,1,34922,35697,775
2022-03-15,70046,70048,Blue,1,77945,78043,98
2022-07-12,70059,70043,Blue,0,46819,47684,865
2022-06-26,70038,70056,Blue,1,31582,32495,913
2022-08-17,70040,70060,Blue,1,56589,57701,1112
2022-02-28,70057,70051,Blue,0,23734,23976,242
2022-06-09,70057,70045,Blue,0,54876,55488,612
2022-09-28,70049,70045,Blue,0,75408,75615,207
2022-02-22,70045,70838,Blue,0,31595,31991,396
2022-01-15,70038,70056,Blue,1,72731,73598,867
2022-10-08,70055,70043,Blue,0,58039,58683,644
2022-12-23,70046,70056,Blue,1,26601,27178,577
2022-07-20,70042,70056,Blue,1,42453,43332,879
2022-03-09,70049,70045,Blue,0,26933,27173,240
2022-06-24,70059,70057,Blue,0,19536,19576,40
2022-03-24,70054,70058,Blue,1,28990,29137,147
2022-08-26,70040,70056,Blue,1,74589,75424,835
2022-07-22,70049,70039,Blue,0,66164,66686,522
2022-02-01,70055,70039,Blue,0,31941,32805,864
2022-08-30,70053,70041,Blue,0,75091,75755,664
2022-04-20,70047,70043,Blue,0,73226,73495,269
2022-12-16,70049,70045,Blue,0,41586,41874,288
2022-02-27,70044,70050,Blue,1,79313,79646,333
2022-03-16,70057,70041,Blue,0,64469,65256,787
2022-10-22,70042,70054,Blue,1,78130,78814,684
2022-12-19,70043,70041,Blue,0,38251,38280,29
2022-03-03,70053,70045,Blue,0,33544,33969,425
2022-06-21,70038,70046,Blue,1,76357,76706,349
2022-09-19,70055,70045,Blue,0,33650,34217,567
2022-05-12,70053,70051,Blue,0,80073,80125,52
2022-04-16,70038,70050,Blue,1,53412,53992,580
2022-10-28,70046,70050,Blue,1,62973,63165,192
2022-12-22,70042,70052,Blue,1,28100,28705,605
2022-07-30,70038,70042,Blue,1,72351,72462,111
2022-04-19,70053,70043,Blue,0,37361,38055,694
2022-11-22,70053,70045,Blue,0,45427,45894,467
2022-01-15,70052,70060,Blue,1,23739,24090,351
2022-07-09,70054,70056,Blue,1,48879,48925,46
2022-02-21,70054,70060,Blue,1,81511,81776,265
2022-06-04,70045,70838,Blue,0,21016,21397,381
2022-01-26,70057,70045,Blue,0,54862,55532,670
2022-04-06,70038,70042,Blue,1,54847,54946,99
2022-10-06,70059,70053,Blue,0,40586,40816,230
2022-03-15,70046,70052,Blue,1,40037,40391,354
2022-11-24,70041,70039,Blue,0,42572,42613,41
2022-10-22,70055,70051,Blue,0,67227,67373,146
2022-06-12,70042,70056,Blue,1,50645,51420,775
2022-11-30,70044,70058,Blue,1,62966,63753,787
2022-01-01,70048,70056,Blue,1,49363,49743,380
2022-07-20,70048,70058,Blue,1,32071,32612,541
2022-04-19,70057,70045,Blue,0,76712,77374,662
2022-05-20,70052,70058,Blue,1,55408,55754,346
2022-11-27,70053,70045,Blue,0,70325,70771,446
2022-07-23,70046,70058,Blue,1,46252,46861,609
2022-02-19,70057,70838,Blue,0,57934,58961,1027
2022-04-16,70049,70838,Blue,0,42271,42950,679
2022-09-23,70059,70043,Blue,0,34770,35704,934
2022-10-05,70048,70058,Blue,1,67962,68502,540
2022-01-06,70053,70043,Blue,0,76330,76939,609
2022-04-05,70040,70048,Blue,1,55393,55812,419
2022-08-15,70038,70050,Blue,1,49893,50482,589
2022-03-08,70051,70045,Blue,0,31831,32144,313
2022-08-31,70050,70060,Blue,1,45215,45725,510
2022-04-01,70042,70052,Blue,1,64662,65303,641
2022-05-09,70057,70049,Blue,0,28109,28509,400
2022-01-28,70038,70060,Blue,1,27611,28897,1286
2022-10-28,70046,70050,Blue,1,33621,33810,189
2022-12-30,70053,70051,Blue,0,63110,63160,50
2022-12-09,70053,70838,Blue,0,42885,43795,910
2022-10-14,70040,70044,Blue,1,73218,73334,116
2022-11-18,70051,70043,Blue,0,43815,44505,690
2022-07-05,70052,70056,Blue,1,37958,38134,176
2022-04-20,70055,70045,Blue,0,52292,52841,549
2022-04-21,70057,70041,Blue,0,49829,50682,853
2022-09-19,70050,70058,Blue,1,32252,32653,401
2022-12-22,70038,70046,Blue,1,28668,29029,361
2022-03-10,70042,70050,Blue,1,32225,32683,458
2022-02-04,70057,70043,Blue,0,72807,73636,829
2022-07-21,70046,70058,Blue,1,35007,35659,652
2022-04-21,70042,70054,Blue,1,73648,74296,648
2022-02-11,70040,70046,Blue,1,61420,61689,269
2022-12-25,70049,70045,Blue,0,65342,65548,206
2022-11-06,70059,70047,Blue,0,30077,30627,550
2022-06-02,70043,70838,Blue,0,55807,56012,205
2022-12-24,70047,70043,Blue,0,77032,77264,232
2022-03-09,70049,70039,Blue,0,20169,20709,540
2022-10-15,70045,70041,Blue,0,48357,48523,166
2022-11-12,70052,70054,Blue,1,57436,57490,54
2022-12-28,70059,70047,Blue,0,33339,33889,550
2022-09-23,70053,70047,Blue,0,70952,71233,281
2022-10-13,70058,70060,Blue,1,60999,61065,66
2022-09-01,70042,70058,Blue,1,82839,83783,944
2022-12-06,70038,70060,Blue,1,32792,33925,1133
2022-03-25,70048,70054,Blue,1,52436,52871,435
2022-08-24,70059,70053,Blue,0,63338,63571,233
2022-02-28,70045,70043,Blue,0,45163,45256,93
2022-02-04,70038,70046,Blue,1,39737,40117,380
2022-11-14,70053,70045,Blue,0,60052,60513,461
2022-12-23,70059,70039,Blue,0,54437,55508,1071
2022-11-05,70044,70052,Blue,1,67339,67847,508
2022-06-24,70059,70055,Blue,0,22576,22717,141
2022-09-28,70054,70056,Blue,1,63252,63299,47
2022-08-04,70038,70054,Blue,1,61706,62518,812
2022-01-04,70047,70039,Blue,0,58099,58489,390
2022-10-01,70048,70056,Blue,1,73361,73739,378
2022-11-10,70059,70041,Blue,0,48876,49859,983
2022-06-14,70041,70039,Blue,0,67859,67895,36
2022-02-22,70044,70052,Blue,1,25980,26467,487
2022-04-12,70055,70039,Blue,0,28048,28890,842
2022-05-02,70054,70060,Blue,1,80034,80331,297
2022-03-21,70050,70052,Blue,1,71142,71248,106
2022-08-27,70050,70052,Blue,1,40508,40626,118
2022-03-08,70044,70056,Blue,1,68175,68876,701
2022-08-17,70049,70045,Blue,0,40940,41141,201
2022-07-04,70038,70060,Blue,1,84053,85299,1246
2022-11-10,70055,70051,Blue,0,28188,28340,152
2022-11-09,70057,70045,Blue,0,48466,49110,644
2022-06-13,70040,70058,Blue,1,68003,68990,987
2022-10-13,70044,70052,Blue,1,80403,80900,497
2022-11-19,70055,70047,Blue,0,45625,45977,352
2022-04-11,70038,70050,Blue,1,34163,34718,555
2022-06-14,70057,70051,Blue,0,74442,74689,247
2022-04-19,70057,70047,Blue,0,44427,44891,464
2022-02-09,70051,70047,Blue,0,54560,54755,195
2022-12-29,70042,70052,Blue,1,30811,31337,526
2022-08-31,70055,70039,Blue,0,54559,55390,831
2022-09-26,70049,70047,Blue,0,49910,49995,85
2022-02-23,70051,70039,Blue,0,44784,45556,772
2022-12-05,70045,70039,Blue,0,25527,25803,276
2022-03-28,70040,70060,Blue,1,30934,32049,1115
2022-11-19,70057,70055,Blue,0,30394,30462,68
2022-10-17,70047,70043,Blue,0,45323,45554,231
2022-01-10,70052,70058,Blue,1,54804,55047,243
2022-06-27,70042,70054,Blue,1,64869,65660,791
2022-11-30,70052,70054,Blue,1,67008,67068,60
2022-07-08,70049,70045,Blue,0,76028,76220,192
2022-03-14,70057,70047,Blue,0,33662,34191,529
2022-01-01,70051,70039,Blue,0,22659,23290,631
2022-10-18,70052,70054,Blue,1,23881,23927,46
2022-07-16,70042,70056,Blue,1,33564,34285,721
2022-01-23,70043,70838,Blue,0,41092,41313,221
2022-08-01,70057,70051,Blue,0,44791,45031,240
2022-09-14,70044,70060,Blue,1,23954,24938,984
2022-03-10,70055,70838,Blue,0,41120,42082,962
2022-03-09,70049,70045,Blue,0,61080,61292,212
2022-07-04,70038,70052,Blue,1,84612,85548,936
2022-09-26,70053,70039,Blue,0,45051,45824,773
2022-03-08,70055,70047,Blue,0,39455,39920,465
2022-08-16,70042,70054,Blue,1,27138,27818,680
2022-08-08,70040,70050,Blue,1,36466,37013,547
2022-04-16,70045,70838,Blue,0,57577,57937,360
2022-10-09,70049,70045,Blue,0,71781,71967,186
2022-09-30,70048,70060,Blue,1,53265,53864,599
2022-08-04,70047,70043,Blue,0,44305,44593,288
2022-02-06,70040,70042,Blue,1,26472,26504,32
2022-01-11,70052,70054,Blue,1,24157,24221,64
2022-05-23,70043,70039,Blue,0,52404,52515,111
2022-08-01,70046,70056,Blue,1,88614,89179,565
2022-03-03,70051,70041,Blue,0,88504,89121,617
2022-04-13,70042,70056,Blue,1,55775,56584,809
2022-09-24,70057,70043,Blue,0,42825,43646,821
2022-11-09,70038,70046,Blue,1,36738,37048,310
2022-01-28,70038,70054,Blue,1,49748,50528,780
2022-12-01,70049,70047,Blue,0,31927,31985,58
2022-12-12,70055,70047,Blue,0,53717,54093,376
2022-08-11,70049,70045,Blue,0,86209,86387,178
2022-04-19,70038,70040,Blue,1,68589,68603,14
2022-10-02,70045,70039,Blue,0,75090,75324,234
2022-01-02,70049,70041,Blue,0,37355,37762,407
2022-03-03,70050,70056,Blue,1,59301,59660,359
2022-09-26,70052,70054,Blue,1,49052,49107,55
2022-03-10,70055,70039,Blue,0,26876,27814,938
2022-07-12,70050,70056,Blue,1,68702,69015,313
2022-12-20,70044,70056,Blue,1,83412,84097,685
2022-07-09,70053,70041,Blue,0,85154,85815,661
2022-09-20,70051,70049,Blue,0,57014,57115,101
2022-03-21,70044,70056,Blue,1,54996,55679,683
2022-10-08,70046,70050,Blue,1,29494,29678,184
2022-11-09,70044,70048,Blue,1,26634,26880,246
2022-03-04,70055,70047,Blue,0,44178,44589,411
2022-05-18,70048,70060,Blue,1,35325,35968,643
2022-03-21,70042,70054,Blue,1,80438,81246,808
2022-08-26,70057,70049,Blue,0,25589,25964,375
2022-09-10,70049,70838,Blue,0,46484,47092,608
2022-04-22,70042,70058,Blue,1,79365,80237,872
2022-10-19,70057,70039,Blue,0,62548,63451,903
2022-12-06,70050,70052,Blue,1,49844,49961,117
2022-01-23,70057,70041,Blue,0,62545,63419,874
2022-12-01,70042,70054,Blue,1,28295,28954,659
2022-07-25,70055,70039,Blue,0,55870,56728,858
2022-02-13,70057,70051,Blue,0,58232,58484,252
2022-03-09,70055,70051,Blue,0,28668,28843,175
2022-06-12,70054,70058,Blue,1,27090,27251,161
2022-01-03,70049,70041,Blue,0,50323,50759,436
2022-02-16,70048,70050,Blue,1,77959,78020,61
2022-11-04,70049,70047,Blue,0,63055,63112,57
2022-05-15,70053,70051,Blue,0,35674,35729,55
2022-03-01,70040,70060,Blue,1,22198,23385,1187
2022-06-01,70040,70050,Blue,1,60372,60914,542
2022-11-08,70055,70045,Blue,0,26146,26726,580
2022-07-12,70059,70041,Blue,0,84198,85128,930
2022-01-26,70055,70838,Blue,0,30623,31655,1032
2022-04-03,70042,70050,Blue,1,45765,46217,452
2022-09-22,70041,70039,Blue,0,45803,45835,32
2022-12-29,70055,70838,Blue,0,33640,34663,1023
2022-12-22,70059,70039,Blue,0,34664,35694,1030
2022-02-24,70040,70050,Blue,1,35728,36276,548
2022-03-17,70053,70039,Blue,0,71269,72015,746
2022-01-22,70049,70043,Blue,0,80365,80720,355
2022-02-28,70059,70838,Blue,0,73750,74862,1112
2022-03-14,70049,70039,Blue,0,27730,28197,467
2022-09-11,70039,70838,Blue,0,87404,87439,35
2022-03-02,70051,70043,Blue,0,70849,71313,464
2022-11-14,70040,70056,Blue,1,74240,75107,867
2022-01-24,70041,70039,Blue,0,55464,55506,42
2022-03-15,70041,70039,Blue,0,67137,67170,33
2022-08-02,70059,70041,Blue,0,39163,40158,995
2022-02-26,70055,70047,Blue,0,75316,75719,403
2022-12-01,70045,70041,Blue,0,72514,72680,166
2022-01-14,70039,70838,Blue,0,66948,67003,55
2022-03-16,70059,70047,Blue,0,55997,56551,554
2022-06-01,70046,70048,Blue,1,26169,26279,110
2022-01-27,70053,70838,Blue,0,25431,26315,884
2022-10-17,70055,70053,Blue,0,26550,26597,47
2022-12-21,70042,70048,Blue,1,62575,62888,313
2022-07-31,70059,70838,Blue,0,77595,78706,1111
2022-04-14,70049,70043,Blue,0,77685,78037,352
2022-06-14,70044,70058,Blue,1,55060,56095,1035
2022-09-20,70044,70054,Blue,1,53207,53792,585
2022-01-02,70059,70049,Blue,0,82218,82730,512
2022-02-02,70049,70039,Blue,0,59181,59826,645
2022-08-08,70040,70056,Blue,1,60884,61717,833
2022-12-30,70059,70043,Blue,0,80593,81402,809
2022-12-19,70042,70060,Blue,1,79844,80832,988
2022-12-11,70043,70039,Blue,0,59685,59792,107
2022-03-08,70055,70043,Blue,0,22600,23325,725
2022-01-06,70053,70838,Blue,0,74028,74854,826
2022-08-15,70047,70039,Blue,0,70402,70793,391
2022-01-04,70050,70054,Blue,1,42634,42854,220
2022-09-06,70042,70050,Blue,1,65429,65868,439
2022-06-26,70055,70039,Blue,0,44330,45174,844
2022-01-27,70051,70047,Blue,0,49079,49272,193
2022-05-23,70049,70041,Blue,0,56801,57355,554
2022-02-27,70057,70053,Blue,0,82289,82464,175
2022-01-03,70047,70838,Blue,0,60996,61844,848
2022-12-30,70057,70047,Blue,0,54579,55079,500
2022-08-28,70044,70050,Blue,1,47111,47457,346
2022-10-09,70040,70054,Blue,1,67812,68570,758
2022-03-03,70051,70045,Blue,0,59424,59772,348
2022-05-18,70042,70060,Blue,1,83453,84550,1097
2022-04-06,70040,70052,Blue,1,67710,68348,638
2022-11-28,70059,70047,Blue,0,46836,47419,583
2022-01-06,70057,70055,Blue,0,69187,69258,71
2022-09-14,70054,70056,Blue,1,23909,23957,48
2022-03-09,70050,70054,Blue,1,66192,66410,218
2022-10-18,70046,70048,Blue,1,70451,70530,79
2022-04-05,70053,70043,Blue,0,54145,54783,638
2022-04-24,70040,70052,Blue,1,54853,55526,673
2022-08-23,70044,70052,Blue,1,39014,39526,512
2022-03-31,70038,70040,Blue,1,48068,48081,13
2022-10-11,70059,70055,Blue,0,67700,67848,148
2022-07-07,70049,70043,Blue,0,35461,35875,414
2022-01-14,70047,70043,Blue,0,66489,66767,278
2022-09-29,70055,70053,Blue,0,62671,62717,46
2022-08-01,70059,70057,Blue,0,29302,29338,36
2022-03-02,70040,70048,Blue,1,20808,21254,446
2022-05-18,70045,70043,Blue,0,28774,28929,155
2022-03-25,70042,70048,Blue,1,84408,84717,309
2022-04-17,70044,70046,Blue,1,67990,68101,111
2022-01-05,70057,70043,Blue,0,41020,41863,843
2022-09-06,70042,70052,Blue,1,38970,39583,613
2022-02-28,70038,70044,Blue,1,23975,24192,217
2022-02-05,70054,70060,Blue,1,22046,22338,292
2022-05-31,70045,70039,Blue,0,78959,79214,255
2022-12-24,70043,70838,Blue,0,34449,34661,212
2022-01-09,70057,70838,Blue,0,34073,35115,1042
2022-03-03,70040,70060,Blue,1,33315,34386,1071
2022-04-18,70042,70060,Blue,1,56389,57473,1084
2022-11-28,70057,70055,Blue,0,30097,30167,70
2022-09-28,70059,70051,Blue,0,54614,54915,301
2022-06-19,70057,70043,Blue,0,79001,79815,814
2022-07-19,70040,70058,Blue,1,81843,82878,1035
2022-07-17,70058,70060,Blue,1,33360,33425,65
2022-02-25,70044,70048,Blue,1,77206,77446,240
2022-01-06,70047,70041,Blue,0,23194,23561,367
2022-04-12,70054,70056,Blue,1,24482,24528,46
2022-05-19,70047,70041,Blue,0,23076,23595,519
2022-12-27,70045,70039,Blue,0,50607,50864,257
2022-02-02,70044,70060,Blue,1,61598,63029,1431
2022-06-20,70050,70056,Blue,1,56708,57043,335
2022-03-28,70040,70048,Blue,1,27825,28237,412
2022-10-15,70038,70052,Blue,1,84608,85450,842
2022-10-18,70040,70044,Blue,1,69557,69676,119
2022-06-24,70044,70060,Blue,1,70753,71731,978
2022-03-12,70038,70048,Blue,1,59890,60345,455
2022-10-24,70048,70050,Blue,1,34256,34319,63
2022-07-05,70045,70043,Blue,0,32214,32313,99
2022-11-02,70057,70053,Blue,0,26443,26611,168
2022-01-09,70057,70838,Blue,0,68506,69895,1389
2022-03-03,70055,70049,Blue,0,53787,54078,291
2022-07-15,70038,70050,Blue,1,34486,35173,687
2022-05-23,70050,70052,Blue,1,20734,20890,156
2022-03-29,70049,70838,Blue,0,57379,58001,622
2022-12-28,70057,70047,Blue,0,85596,86070,474
2022-04-19,70054,70056,Blue,1,66988,67034,46
2022-01-10,70044,70054,Blue,1,91070,91757,687
2022-03-28,70038,70056,Blue,1,49215,50144,929
2022-09-19,70044,70058,Blue,1,43788,44703,915
2022-09-08,70051,70041,Blue,0,56553,57146,593
2022-06-24,70050,70054,Blue,1,83143,83381,238
2022-12-11,70042,70048,Blue,1,27808,28111,303
2022-01-26,70057,70051,Blue,0,55715,55959,244
2022-09-12,70050,70052,Blue,1,61909,62015,106
2022-07-14,70053,70041,Blue,0,27901,28632,731
2022-09-13,70050,70056,Blue,1,81850,82261,411
2022-09-16,70048,70058,Blue,1,36985,37547,562
2022-07-14,70047,70039,Blue,0,63596,64022,426
2022-02-05,70042,70046,Blue,1,88356,88537,181
2022-08-17,70048,70052,Blue,1,87189,87456,267
2022-06-29,70055,70051,Blue,0,62905,63038,133
2022-10-29,70059,70041,Blue,0,25459,26402,943
2022-04-16,70053,70049,Blue,0,53265,53495,230
2022-08-19,70050,70054,Blue,1,36373,36602,229
2022-04-19,70044,70052,Blue,1,32846,33334,488
2022-03-29,70051,70047,Blue,0,63263,63481,218
2022-12-08,70044,70052,Blue,1,36881,37405,524
2022-05-27,70043,70041,Blue,0,73750,73778,28
2022-01-25,70048,70054,Blue,1,59236,59570,334
2022-09-27,70038,70054,Blue,1,45360,46182,822
2022-02-28,70050,70058,Blue,1,55200,55608,408
2022-04-16,70038,70046,Blue,1,80589,80926,337
2022-03-29,70054,70060,Blue,1,61660,61932,272
2022-12-22,70038,70042,Blue,1,30367,30469,102
2022-01-11,70040,70052,Blue,1,67676,68285,609
2022-08-02,70039,70838,Blue,0,42157,42190,33
2022-12-12,70042,70052,Blue,1,60858,61418,560
2022-08-21,70048,70052,Blue,1,53726,53939,213
2022-10-25,70040,70050,Blue,1,55493,56056,563
2022-01-13,70041,70838,Blue,0,31954,32082,128
2022-01-27,70047,70041,Blue,0,54184,54533,349
2022-06-05,70041,70838,Blue,0,58119,58236,117
2022-06-29,70043,70838,Blue,0,31900,32115,215
2022-10-14,70055,70053,Blue,0,31354,31401,47
2022-09-16,70038,70042,Blue,1,54544,54677,133
2022-11-17,70057,70838,Blue,0,55473,56510,1037
2022-03-17,70051,70049,Blue,0,38517,38619,102
2022-03-07,70051,70047,Blue,0,81564,81763,199
2022-09-19,70040,70058,Blue,1,25843,26748,905
2022-11-26,70052,70060,Blue,1,55845,56198,353
2022-06-07,70050,70052,Blue,1,75767,75958,191
2022-02-07,70040,70046,Blue,1,79268,79509,241
2022-07-15,70038,70050,Blue,1,36426,37009,583
2022-10-09,70053,70051,Blue,0,62304,62356,52
2022-11-01,70059,70049,Blue,0,69674,70144,470
2022-12-25,70038,70054,Blue,1,72617,73415,798
2022-02-25,70042,70046,Blue,1,78699,78878,179
2022-04-06,70055,70039,Blue,0,50418,51210,792
2022-05-19,70042,70050,Blue,1,86354,86842,488
2022-10-24,70045,70041,Blue,0,74077,74255,178
2022-06-30,70043,70838,Blue,0,31971,32200,229
2022-01-21,70050,70052,Blue,1,25724,25858,134
2022-02-19,70057,70045,Blue,0,66032,66685,653
2022-05-29,70047,70043,Blue,0,86380,86682,302
2022-01-05,70038,70054,Blue,1,66435,67209,774
2022-04-08,70044,70054,Blue,1,57126,57759,633
2022-10-08,70057,70043,Blue,0,74140,74890,750
2022-11-09,70059,70053,Blue,0,61875,62106,231
2022-02-10,70059,70039,Blue,0,25768,26955,1187
2022-11-16,70044,70048,Blue,1,31774,32007,233
2022-10-08,70046,70054,Blue,1,54359,54789,430
2022-03-04,70038,70052,Blue,1,58927,59613,686
2022-08-07,70055,70053,Blue,0,47532,47577,45
2022-08-26,70059,70055,Blue,0,39517,39660,143
2022-09-02,70040,70056,Blue,1,25300,26106,806
2022-02-01,70059,70047,Blue,0,55092,55662,570
2022-12-02,70057,70049,Blue,0,88195,88585,390
2022-12-19,70044,70052,Blue,1,28970,29462,492
2022-10-19,70041,70838,Blue,0,45136,45249,113
2022-01-17,70048,70056,Blue,1,40577,40968,391
2022-07-15,70046,70052,Blue,1,23219,23568,349
2022-01-20,70051,70043,Blue,0,55781,56350,569
2022-01-07,70050,70058,Blue,1,22454,22880,426
2022-12-24,70048,70058,Blue,1,54992,55482,490
2022-01-22,70046,70056,Blue,1,73752,74275,523
2022-06-17,70059,70049,Blue,0,32362,32915,553
2022-08-17,70040,70044,Blue,1,69025,69136,111
2022-11-06,70057,70043,Blue,0,45272,46065,793
2022-09-18,70038,70058,Blue,1,64858,66009,1151
2022-03-18,70053,70039,Blue,0,60155,60915,760
2022-11-14,70049,70047,Blue,0,50448,50503,55
2022-06-28,70049,70041,Blue,0,66823,67389,566
2022-06-09,70057,70039,Blue,0,50325,51359,1034
2022-04-24,70059,70051,Blue,0,70026,70339,313
2022-08-19,70053,70838,Blue,0,70976,71794,818
2022-03-11,70051,70043,Blue,0,85520,85993,473
2022-01-17,70038,70054,Blue,1,30736,31594,858
2022-08-19,70038,70050,Blue,1,61319,61895,576
2022-08-03,70042,70060,Blue,1,70659,71620,961
2022-08-15,70048,70060,Blue,1,33251,33946,695
2022-09-20,70059,70055,Blue,0,54075,54231,156
2022-04-04,70044,70050,Blue,1,57713,58058,345
2022-11-27,70054,70060,Blue,1,80591,80868,277
2022-10-02,70048,70052,Blue,1,65580,65779,199
2022-10-27,70053,70041,Blue,0,39883,40525,642
2022-06-29,70059,70041,Blue,0,56776,57760,984
2022-04-12,70051,70047,Blue,0,50563,50755,192
2022-04-12,70044,70050,Blue,1,38075,38424,349
2022-08-27,70059,70053,Blue,0,54079,54312,233
2022-10-24,70055,70838,Blue,0,63605,64467,862
2022-10-03,70059,70047,Blue,0,22577,23157,580
2022-07-13,70040,70042,Blue,1,74238,74271,33
2022-02-11,70044,70058,Blue,1,22365,23094,729
2022-09-12,70043,70039,Blue,0,36974,37107,133
2022-09-16,70052,70060,Blue,1,74353,74691,338
2022-10-31,70043,70039,Blue,0,75373,75479,106
2022-08-04,70040,70050,Blue,1,47290,47885,595
2022-10-20,70038,70048,Blue,1,49878,50315,437
2022-06-10,70057,70039,Blue,0,23460,24465,1005
2022-10-03,70048,70058,Blue,1,35355,35835,480
2022-01-04,70055,70049,Blue,0,72813,73126,313
2022-06-12,70051,70047,Blue,0,58547,58744,197
2022-10-03,70040,70056,Blue,1,63161,64033,872
2022-12-18,70053,70049,Blue,0,37125,37324,199
2022-05-04,70057,70055,Blue,0,30228,30304,76
2022-09-19,70051,70041,Blue,0,73236,73761,525
2022-08-22,70055,70041,Blue,0,49746,50564,818
2022-10-30,70048,70052,Blue,1,75797,75990,193
2022-08-28,70057,70043,Blue,0,78333,79090,757
2022-01-03,70045,70039,Blue,0,71842,72082,240
2022-09-26,70057,70838,Blue,0,88170,89980,1810
2022-03-18,70057,70053,Blue,0,42755,42941,186
2022-03-06,70042,70048,Blue,1,82479,82766,287
2022-08-16,70059,70039,Blue,0,56256,57320,1064
2022-04-29,70057,70053,Blue,0,47198,47358,160
2022-03-05,70038,70042,Blue,1,74618,74736,118
2022-02-02,70057,70049,Blue,0,76748,77244,496
2022-11-15,70045,70838,Blue,0,37893,38251,358
2022-07-07,70046,70048,Blue,1,24427,24506,79
2022-07-08,70038,70054,Blue,1,54142,55009,867
2022-03-15,70043,70041,Blue,0,80433,80468,35
2022-07-02,70044,70052,Blue,1,66606,67163,557
2022-08-10,70047,70838,Blue,0,23632,24149,517
2022-12-11,70046,70052,Blue,1,60017,60376,359
2022-11-12,70040,70060,Blue,1,59424,60591,1167
2022-12-31,70042,70044,Blue,1,56871,56898,27
2022-12-05,70040,70052,Blue,1,76352,76990,638
2022-05-31,70041,70039,Blue,0,49320,49349,29
2022-03-08,70053,70047,Blue,0,38455,38781,326
2022-09-01,70059,70051,Blue,0,84299,84616,317
2022-07-19,70055,70045,Blue,0,72437,72935,498
2022-03-11,70040,70046,Blue,1,30151,30393,242
2022-04-13,70044,70058,Blue,1,68823,69618,795
2022-12-16,70059,70045,Blue,0,66020,66705,685
2022-02-11,70038,70060,Blue,1,34160,35297,1137
2022-01-21,70050,70056,Blue,1,38528,38841,313
2022-09-15,70040,70052,Blue,1,19977,20637,660
2022-03-22,70049,70043,Blue,0,35219,35933,714
2022-11-12,70055,70041,Blue,0,25642,26415,773
2022-07-26,70055,70043,Blue,0,33254,33954,700
2022-03-24,70050,70060,Blue,1,88863,89338,475
2022-05-16,70057,70053,Blue,0,66998,67151,153
2022-12-30,70042,70060,Blue,1,74741,75695,954
2022-03-03,70053,70045,Blue,0,38411,38920,509
2022-11-12,70047,70041,Blue,0,29999,30338,339
2022-10-03,70049,70838,Blue,0,41608,42212,604
2022-09-19,70057,70041,Blue,0,43785,44673,888
2022-04-11,70043,70838,Blue,0,21877,22082,205
2022-11-18,70055,70838,Blue,0,41410,43592,2182
2022-04-29,70059,70057,Blue,0,70072,70106,34
2022-07-15,70049,70039,Blue,0,81333,81858,525
2022-11-08,70055,70047,Blue,0,30208,30614,406
2022-04-11,70048,70050,Blue,1,20911,20975,64
2022-05-01,70049,70047,Blue,0,49907,49974,67
2022-03-16,70049,70838,Blue,0,34335,35088,753
2022-11-01,70051,70047,Blue,0,21262,21519,257
2022-12-18,70043,70039,Blue,0,68210,68314,104
2022-10-05,70050,70054,Blue,1,82130,82387,257
2022-07-27,70059,70057,Blue,0,87504,87538,34
2022-03-12,70046,70052,Blue,1,25332,25640,308
2022-01-20,70044,70054,Blue,1,32268,32884,616
2022-10-03,70057,70051,Blue,0,81262,81488,226
2022-03-21,70046,70058,Blue,1,63196,63864,668
2022-02-10,70055,70051,Blue,0,61566,61717,151
2022-04-04,70051,70043,Blue,0,67852,68342,490
2022-10-05,70041,70838,Blue,0,45837,45966,129
2022-11-28,70044,70054,Blue,1,71820,72427,607
2022-04-05,70045,70041,Blue,0,29548,29728,180
2022-04-12,70052,70060,Blue,1,40452,40795,343
2022-03-12,70042,70046,Blue,1,84773,84965,192
2022-07-14,70049,70041,Blue,0,36528,37065,537
2022-04-24,70055,70045,Blue,0,50784,51419,635
2022-09-14,70048,70050,Blue,1,30947,31003,56
2022-09-17,70057,70045,Blue,0,33633,34243,610
2022-05-13,70059,70047,Blue,0,54053,54820,767
2022-11-10,70055,70047,Blue,0,49102,49494,392
2022-04-21,70045,70039,Blue,0,53289,53545,256
2022-03-22,70051,70838,Blue,0,22475,23305,830
2022-12-28,70047,70045,Blue,0,63965,64067,102
2022-03-20,70046,70048,Blue,1,54930,55033,103
2022-12-19,70056,70058,Blue,1,80039,80118,79
2022-11-23,70042,70048,Blue,1,50931,51251,320
2022-10-23,70054,70058,Blue,1,70159,70307,148
2022-10-04,70049,70047,Blue,0,35946,36002,56
2022-12-07,70056,70058,Blue,1,62983,63058,75
2022-02-07,70040,70050,Blue,1,23416,23908,492
2022-02-07,70052,70058,Blue,1,71875,72528,653
2022-11-02,70042,70046,Blue,1,21356,21540,184
2022-09-30,70051,70047,Blue,0,27565,27794,229
2022-07-23,70048,70058,Blue,1,47420,47929,509
2022-11-20,70048,70056,Blue,1,75279,75747,468
2022-02-25,70055,70045,Blue,0,33194,33762,568
2022-01-21,70049,70047,Blue,0,84025,84096,71
2022-07-23,70050,70054,Blue,1,22961,23180,219
2022-03-21,70038,70040,Blue,1,31155,31170,15
2022-10-22,70041,70039,Blue,0,74493,74525,32
2022-10-01,70053,70049,Blue,0,25104,25319,215
2022-04-02,70047,70045,Blue,0,87159,87253,94
2022-10-11,70038,70058,Blue,1,83351,84324,973
2022-01-23,70042,70058,Blue,1,55572,56472,900
2022-02-02,70040,70042,Blue,1,33115,33152,37
2022-03-14,70051,70043,Blue,0,80407,80898,491
2022-08-26,70057,70043,Blue,0,36559,37382,823
2022-09-03,70042,70056,Blue,1,82320,83078,758
2022-12-09,70048,70052,Blue,1,44605,44891,286
2022-07-19,70040,70054,Blue,1,85769,86487,718
2022-01-27,70049,70039,Blue,0,24000,24563,563
2022-03-28,70059,70045,Blue,0,23665,24396,731
2022-12-31,70059,70043,Blue,0,21545,22420,875
2022-09-13,70049,70838,Blue,0,82693,83264,571
2022-03-13,70044,70054,Blue,1,56101,56703,602
2022-05-28,70046,70048,Blue,1,49841,49925,84
2022-12-09,70059,70039,Blue,0,41346,42461,1115
2022-03-14,70055,70047,Blue,0,70698,71071,373
2022-04-21,70049,70045,Blue,0,44839,45053,214
2022-11-08,70040,70054,Blue,1,65707,66651,944
2022-11-18,70038,70048,Blue,1,32352,32768,416
2022-02-13,70052,70060,Blue,1,82398,82846,448
2022-09-01,70042,70060,Blue,1,30823,31743,920
2022-08-01,70052,70056,Blue,1,60454,60753,299
2022-10-23,70053,70039,Blue,0,62316,63111,795
2022-02-22,70051,70043,Blue,0,52212,52770,558
2022-10-28,70057,70041,Blue,0,22690,23629,939
2022-03-13,70051,70045,Blue,0,25236,25580,344
2022-05-18,70057,70049,Blue,0,18938,19448,510
2022-04-20,70044,70046,Blue,1,25181,25292,111
2022-05-17,70052,70058,Blue,1,52609,52862,253
2022-04-17,70045,70838,Blue,0,45458,45832,374
2022-03-10,70055,70047,Blue,0,58573,58956,383
2022-07-14,70055,70039,Blue,0,24450,25367,917
2022-11-15,70052,70058,Blue,1,44301,44553,252
2022-08-13,70059,70053,Blue,0,38414,38654,240
2022-10-12,70046,70060,Blue,1,60064,60798,734
2022-04-25,70055,70047,Blue,0,61955,62532,577
2022-11-08,70053,70049,Blue,0,55902,56112,210
2022-08-09,70046,70048,Blue,1,20669,20758,89
2022-06-21,70052,70056,Blue,1,70974,71142,168
2022-10-10,70044,70056,Blue,1,58297,59012,715
2022-06-26,70053,70838,Blue,0,77307,78216,909
2022-06-22,70038,70046,Blue,1,25543,25934,391
2022-09-08,70052,70054,Blue,1,42443,42507,64
2022-02-19,70042,70056,Blue,1,28733,29501,768
2022-10-13,70038,70040,Blue,1,23525,23540,15
2022-06-29,70057,70053,Blue,0,44912,45074,162
2022-03-01,70059,70051,Blue,0,65606,65947,341
2022-01-11,70053,70041,Blue,0,52378,53067,689
2022-02-19,70059,70057,Blue,0,39109,39144,35
2022-12-09,70051,70047,Blue,0,26363,26570,207
2022-06-21,70053,70049,Blue,0,81800,82003,203
2022-04-03,70040,70052,Blue,1,37088,37724,636
2022-08-14,70044,70048,Blue,1,69044,69269,225
2022-03-27,70046,70060,Blue,1,48149,48910,761
2022-10-05,70056,70058,Blue,1,40979,41048,69
2022-04-20,70049,70039,Blue,0,77176,77683,507
2022-07-08,70052,70054,Blue,1,33627,33695,68
2022-08-28,70057,70047,Blue,0,75526,75991,465
2022-08-03,70059,70838,Blue,0,82590,83718,1128
2022-12-27,70050,70054,Blue,1,85035,85257,222
2022-01-31,70044,70050,Blue,1,67906,68249,343
2022-04-01,70050,70058,Blue,1,40226,40651,425
2022-05-13,70050,70058,Blue,1,41613,42003,390
2022-08-24,70049,70838,Blue,0,29856,30636,780
2022-08-02,70056,70060,Blue,1,59634,59814,180
2022-10-07,70052,70058,Blue,1,53277,53547,270
2022-12-16,70059,70041,Blue,0,23964,25057,1093
2022-06-09,70038,70052,Blue,1,69186,70146,960
2022-02-27,70059,70039,Blue,0,57615,58676,1061
2022-07-20,70046,70050,Blue,1,52841,53042,201
2022-09-09,70043,70838,Blue,0,21338,21554,216
2022-08-05,70038,70046,Blue,1,30273,30601,328
2022-12-28,70053,70051,Blue,0,26079,26139,60
2022-04-05,70051,70047,Blue,0,18829,19038,209
2022-02-19,70047,70043,Blue,0,64980,65241,261
2022-10-25,70038,70044,Blue,1,63084,63271,187
2022-03-29,70041,70039,Blue,0,53091,53123,32
2022-08-17,70057,70047,Blue,0,61417,61884,467
2022-09-22,70048,70060,Blue,1,53852,54480,628
2022-01-19,70059,70057,Blue,0,55712,55747,35
2022-01-18,70055,70045,Blue,0,50907,51438,531
2022-11-12,70056,70058,Blue,1,27238,27314,76
2022-01-07,70042,70048,Blue,1,32200,32503,303
2022-09-02,70057,70043,Blue,0,59880,60685,805
2022-01-03,70048,70058,Blue,1,65405,65928,523
2022-02-24,70057,70055,Blue,0,57672,57744,72
2022-12-19,70040,70046,Blue,1,45188,45503,315
2022-01-02,70049,70041,Blue,0,74879,75259,380
2022-07-31,70038,70054,Blue,1,63966,64788,822
2022-10-16,70039,70838,Blue,0,46297,46345,48
2022-12-24,70055,70051,Blue,0,66191,66331,140
2022-07-19,70040,70050,Blue,1,47755,48251,496
2022-07-04,70059,70049,Blue,0,54493,54942,449
2022-07-17,70057,70053,Blue,0,44809,44974,165
2022-01-25,70038,70050,Blue,1,86537,87110,573
2022-05-20,70044,70052,Blue,1,39490,40145,655
2022-11-18,70054,70060,Blue,1,26022,26274,252
2022-09-06,70045,70041,Blue,0,72973,73262,289
2022-12-11,70050,70058,Blue,1,31348,31732,384
2022-11-23,70042,70054,Blue,1,41139,41824,685
2022-11-01,70050,70056,Blue,1,22092,22400,308
2022-03-17,70057,70043,Blue,0,30649,31515,866
2022-10-15,70038,70046,Blue,1,77297,77665,368
2022-11-10,70045,70039,Blue,0,76077,76310,233
2022-01-11,70046,70054,Blue,1,78916,79309,393
2022-04-05,70055,70041,Blue,0,48380,49086,706
2022-07-14,70051,70049,Blue,0,60575,60680,105
2022-12-26,70050,70056,Blue,1,46159,46449,290
2022-09-30,70052,70054,Blue,1,62508,62563,55
2022-03-14,70046,70048,Blue,1,39952,40027,75
2022-08-18,70038,70044,Blue,1,35847,36044,197
2022-10-11,70046,70048,Blue,1,64197,64270,73
2022-12-29,70054,70058,Blue,1,63239,63406,167
2022-12-13,70040,70050,Blue,1,27371,27845,474
2022-07-14,70051,70838,Blue,0,30512,31391,879
2022-04-19,70040,70048,Blue,1,57819,58258,439
2022-10-05,70038,70060,Blue,1,29254,30321,1067
2022-12-23,70058,70060,Blue,1,32272,32339,67
2022-10-05,70042,70050,Blue,1,59823,60252,429
2022-12-19,70049,70838,Blue,0,30771,31649,878
2022-03-10,70047,70041,Blue,0,58374,58680,306
2022-04-22,70053,70838,Blue,0,25735,26702,967
2022-11-03,70052,70058,Blue,1,66127,66392,265
2022-03-22,70040,70058,Blue,1,65312,66269,957
2022-10-12,70040,70044,Blue,1,72140,72255,115
2022-11-01,70046,70054,Blue,1,77918,78319,401
2022-12-16,70038,70058,Blue,1,85692,86831,1139
2022-12-23,70051,70043,Blue,0,44030,44578,548
2022-03-16,70055,70051,Blue,0,38841,38990,149
2022-10-07,70057,70041,Blue,0,20915,21763,848
2022-03-11,70038,70042,Blue,1,52155,52243,88
2022-10-11,70052,70056,Blue,1,39653,39826,173
2022-12-12,70047,70043,Blue,0,62981,63211,230
2022-05-21,70038,70050,Blue,1,70302,71014,712
2022-08-18,70053,70045,Blue,0,69471,69908,437
2022-06-21,70057,70045,Blue,0,22241,22901,660
2022-11-13,70053,70838,Blue,0,21900,22956,1056
2022-03-06,70054,70060,Blue,1,41320,41616,296
2022-01-13,70050,70060,Blue,1,32468,33007,539
2022-04-06,70048,70058,Blue,1,45899,46422,523
2022-09-18,70038,70048,Blue,1,33917,34352,435
2022-04-28,70059,70057,Blue,0,77766,77802,36
2022-03-14,70039,70838,Blue,0,28075,28108,33
2022-02-16,70053,70838,Blue,0,65257,66102,845
2022-08-02,70052,70056,Blue,1,22142,22307,165
2022-06-21,70050,70058,Blue,1,60159,60560,401
2022-10-10,70059,70039,Blue,0,66018,67122,1104
2022-07-05,70042,70056,Blue,1,66252,67046,794
2022-09-15,70059,70039,Blue,0,48367,49327,960
2022-01-15,70044,70046,Blue,1,21218,21346,128
2022-09-13,70044,70054,Blue,1,33754,34493,739
2022-04-08,70050,70058,Blue,1,59629,60041,412
2022-03-29,70042,70058,Blue,1,61462,62253,791
2022-12-16,70059,70051,Blue,0,52515,52828,313
2022-01-13,70053,70039,Blue,0,49506,50341,835
2022-02-01,70055,70838,Blue,0,83082,84088,1006
2022-08-09,70038,70044,Blue,1,21362,21524,162
2022-04-07,70042,70050,Blue,1,40296,40753,457
2022-08-16,70053,70041,Blue,0,67547,68191,644
2022-05-17,70055,70051,Blue,0,70217,70380,163
2022-07-06,70056,70060,Blue,1,42142,42362,220
2022-07-11,70038,70046,Blue,1,47175,47510,335
2022-10-19,70048,70052,Blue,1,75183,75382,199
2022-01-27,70051,70049,Blue,0,27221,27326,105
2022-11-22,70059,70041,Blue,0,25833,26839,1006
2022-09-25,70048,70054,Blue,1,51598,51911,313
2022-09-10,70044,70058,Blue,1,25182,26308,1126
2022-01-06,70049,70047,Blue,0,60685,60739,54
2022-11-01,70038,70046,Blue,1,73152,73489,337
2022-04-13,70044,70054,Blue,1,48293,48875,582
2022-03-10,70038,70052,Blue,1,51193,52021,828
2022-10-11,70055,70039,Blue,0,24029,24886,857
2022-02-20,70044,70048,Blue,1,24011,24276,265
2022-01-12,70053,70049,Blue,0,22493,22706,213
2022-07-25,70050,70052,Blue,1,37275,37416,141
2022-01-18,70047,70039,Blue,0,80055,80428,373
2022-10-20,70042,70044,Blue,1,63415,63447,32
2022-02-25,70044,70060,Blue,1,38207,39266,1059
2022-02-04,70049,70838,Blue,0,28684,29427,743
2022-11-28,70059,70045,Blue,0,37084,37854,770
2022-07-01,70053,70051,Blue,0,19815,19881,66
2022-03-09,70042,70050,Blue,1,77009,77391,382
2022-01-27,70053,70051,Blue,0,40831,40896,65
2022-02-17,70059,70057,Blue,0,56633,56672,39
2022-06-01,70040,70048,Blue,1,45138,45584,446
2022-01-18,70053,70039,Blue,0,65583,66360,777
2022-09-09,70050,70054,Blue,1,65638,66094,456
2022-06-14,70042,70054,Blue,1,31889,32593,704
2022-08-23,70057,70838,Blue,0,52118,53328,1210
2022-11-28,70047,70838,Blue,0,22362,22870,508
2022-06-22,70046,70060,Blue,1,51022,51888,866
2022-07-26,70038,70052,Blue,1,83628,84381,753
2022-01-17,70049,70043,Blue,0,45971,46321,350
2022-08-27,70042,70044,Blue,1,70304,70336,32
2022-05-23,70047,70041,Blue,0,56478,56907,429
2022-07-19,70055,70053,Blue,0,56851,56903,52
2022-08-29,70059,70053,Blue,0,32656,32883,227
2022-08-17,70059,70838,Blue,0,34877,36109,1232
2022-11-14,70059,70838,Blue,0,68133,69260,1127
2022-06-12,70038,70044,Blue,1,46152,46335,183
2022-11-23,70055,70041,Blue,0,42028,42805,777
2022-04-23,70042,70048,Blue,1,32490,32802,312
2022-09-16,70044,70058,Blue,1,31860,32693,833
2022-12-21,70040,70054,Blue,1,80857,81706,849
2022-06-22,70057,70049,Blue,0,77130,77520,390
2022-11-30,70049,70838,Blue,0,52194,52873,679
2022-08-26,70042,70048,Blue,1,49999,50299,300
2022-02-13,70051,70043,Blue,0,41235,41781,546
2022-02-25,70047,70039,Blue,0,65678,66109,431
2022-11-26,70049,70041,Blue,0,67531,67953,422
2022-01-20,70053,70045,Blue,0,74629,75061,432
2022-03-15,70050,70052,Blue,1,54967,55088,121
2022-12-30,70046,70056,Blue,1,76165,76673,508
2022-11-01,70040,70046,Blue,1,55752,56010,258
2022-03-04,70056,70060,Blue,1,84673,84841,168
2022-09-26,70044,70058,Blue,1,87562,88277,715
2022-02-18,70055,70049,Blue,0,53787,54119,332
2022-10-25,70040,70050,Blue,1,32553,33060,507
2022-11-18,70040,70058,Blue,1,52973,53880,907
2022-03-16,70038,70058,Blue,1,86533,87535,1002
2022-02-08,70046,70050,Blue,1,72356,72542,186
2022-08-07,70053,70838,Blue,0,58486,59380,894
2022-12-13,70046,70056,Blue,1,33581,34109,528
2022-01-12,70054,70058,Blue,1,68410,68574,164
2022-08-30,70059,70838,Blue,0,66194,67334,1140
2022-03-21,70059,70053,Blue,0,59000,59239,239
2022-09-13,70042,70048,Blue,1,23582,23885,303
2022-01-15,70054,70056,Blue,1,35927,35974,47
2022-02-19,70043,70041,Blue,0,38843,38870,27
2022-10-22,70057,70043,Blue,0,73051,73802,751
2022-09-27,70050,70054,Blue,1,87084,87280,196
2022-02-18,70052,70056,Blue,1,61794,61932,138
2022-03-06,70046,70052,Blue,1,29700,30047,347
2022-02-26,70059,70057,Blue,0,36272,36307,35
2022-09-28,70047,70041,Blue,0,38144,38492,348
2022-04-11,70059,70055,Blue,0,73756,73901,145
2022-09-09,70045,70039,Blue,0,41490,41749,259
2022-11-09,70053,70051,Blue,0,23231,23289,58
2022-06-28,70059,70047,Blue,0,34884,35569,685
2022-06-13,70055,70043,Blue,0,40008,40778,770
2022-01-04,70041,70039,Blue,0,79990,80026,36
2022-11-05,70052,70058,Blue,1,38537,38793,256
2022-10-02,70051,70045,Blue,0,74159,74500,341
2022-10-23,70048,70050,Blue,1,82213,82273,60
2022-06-01,70043,70039,Blue,0,55446,55565,119
2022-01-26,70042,70046,Blue,1,64211,64400,189
2022-03-20,70044,70060,Blue,1,65839,66781,942
2022-12-02,70042,70052,Blue,1,23220,23807,587
2022-08-26,70047,70838,Blue,0,27931,28461,530
2022-03-10,70038,70060,Blue,1,65847,67169,1322
2022-01-12,70055,70051,Blue,0,70686,70813,127
2022-06-14,70040,70048,Blue,1,50868,51336,468
2022-12-03,70059,70043,Blue,0,43924,44816,892
2022-01-11,70045,70043,Blue,0,57662,57749,87
2022-02-13,70057,70053,Blue,0,76052,76211,159
2022-03-02,70048,70058,Blue,1,54959,55525,566
2022-02-24,70038,70050,Blue,1,43517,44072,555
2022-12-03,70054,70056,Blue,1,86455,86503,48
2022-03-23,70038,70048,Blue,1,64336,64843,507
2022-03-21,70049,70045,Blue,0,23314,23558,244
2022-06-26,70042,70060,Blue,1,45817,46776,959
2022-09-17,70041,70039,Blue,0,75699,75729,30
2022-04-14,70051,70041,Blue,0,67880,68491,611
2022-01-09,70043,70039,Blue,0,55829,55937,108
2022-08-17,70038,70058,Blue,1,85720,86806,1086
2022-12-22,70038,70046,Blue,1,40849,41211,362
2022-04-03,70048,70058,Blue,1,65546,66055,509
2022-07-23,70040,70046,Blue,1,64825,65078,253
2022-03-30,70042,70046,Blue,1,55500,55689,189
2022-09-01,70040,70054,Blue,1,60296,61077,781
2022-09-10,70057,70838,Blue,0,47667,48821,1154
2022-10-15,70042,70060,Blue,1,21171,22161,990
2022-06-01,70043,70039,Blue,0,40246,40365,119
2022-09-28,70040,70058,Blue,1,35424,36325,901
2022-03-14,70038,70048,Blue,1,84341,84846,505
2022-02-09,70059,70039,Blue,0,84610,85631,1021
2022-03-03,70042,70044,Blue,1,21480,21516,36
2022-04-10,70052,70060,Blue,1,70650,71009,359
2022-10-03,70044,70054,Blue,1,41073,41614,541
2022-02-23,70050,70060,Blue,1,46629,47125,496
2022-09-08,70042,70050,Blue,1,27035,27444,409
2022-04-12,70053,70039,Blue,0,56873,57647,774
2022-09-08,70048,70054,Blue,1,56541,56847,306
2022-07-21,70053,70051,Blue,0,21656,21715,59
2022-12-10,70049,70041,Blue,0,72379,72801,422
2022-06-20,70040,70054,Blue,1,60611,61519,908
2022-03-01,70045,70838,Blue,0,51217,51576,359
2022-02-02,70048,70054,Blue,1,74610,74963,353
2022-04-17,70059,70049,Blue,0,87316,87799,483
2022-04-08,70052,70054,Blue,1,26201,26254,53
2022-03-01,70053,70039,Blue,0,67067,67880,813
2022-03-07,70049,70041,Blue,0,56169,56559,390
2022-12-24,70043,70039,Blue,0,74437,74545,108
2022-04-26,70053,70047,Blue,0,88603,88968,365
2022-11-08,70049,70043,Blue,0,63027,63377,350
2022-04-18,70038,70056,Blue,1,22741,23683,942
2022-02-04,70041,70838,Blue,0,30920,31156,236
2022-03-14,70059,70051,Blue,0,50727,51067,340
2022-08-08,70038,70050,Blue,1,59974,60601,627
2022-09-10,70052,70056,Blue,1,66188,66337,149
2022-12-30,70059,70047,Blue,0,61194,61781,587
2022-11-07,70048,70060,Blue,1,24703,25286,583
2022-11-10,70038,70050,Blue,1,25568,26144,576
2022-08-19,70049,70045,Blue,0,66783,66997,214
2022-09-27,70038,70056,Blue,1,90225,91374,1149
2022-04-20,70057,70053,Blue,0,23163,23323,160
2022-01-30,70055,70045,Blue,0,84751,85667,916
2022-12-02,70038,70044,Blue,1,71045,71213,168
2022-07-11,70051,70039,Blue,0,58296,58972,676
2022-02-22,70055,70045,Blue,0,72805,73350,545
2022-07-21,70055,70049,Blue,0,65312,65585,273
2022-11-27,70055,70053,Blue,0,77784,77830,46
2022-08-29,70051,70043,Blue,0,54111,54635,524
2022-01-11,70056,70058,Blue,1,67747,67836,89
2022-09-25,70043,70838,Blue,0,45608,45787,179
2022-03-11,70059,70043,Blue,0,36375,37305,930
2022-02-15,70042,70060,Blue,1,33696,34718,1022
2022-06-21,70042,70044,Blue,1,40594,40624,30
2022-06-14,70053,70039,Blue,0,20562,21368,806
2022-09-19,70040,70058,Blue,1,85089,86046,957
2022-04-23,70059,70838,Blue,0,76184,77509,1325
2022-04-06,70049,70039,Blue,0,50722,51210,488
2022-11-01,70041,70838,Blue,0,39079,39200,121
2022-04-13,70054,70056,Blue,1,23614,23661,47
2022-06-21,70045,70043,Blue,0,59129,59247,118
2022-02-14,70051,70047,Blue,0,42525,42723,198
2022-01-12,70039,70838,Blue,0,28411,28446,35
2022-11-16,70044,70050,Blue,1,22410,22821,411
2022-11-06,70059,70053,Blue,0,87314,87537,223
2022-06-01,70047,70838,Blue,0,50581,51084,503
2022-04-13,70051,70043,Blue,0,63838,64331,493
2022-02-15,70050,70060,Blue,1,53084,53783,699
2022-02-25,70047,70043,Blue,0,53228,53462,234
2022-09-19,70038,70042,Blue,1,31293,31404,111
2022-12-27,70050,70060,Blue,1,73091,73595,504
2022-02-25,70050,70054,Blue,1,82576,82816,240
2022-02-13,70038,70060,Blue,1,27864,28992,1128
2022-10-18,70048,70054,Blue,1,67902,68256,354
2022-03-06,70038,70044,Blue,1,30787,30955,168
2022-08-13,70055,70045,Blue,0,22992,23491,499
2022-11-01,70053,70045,Blue,0,24610,25177,567
2022-03-14,70055,70043,Blue,0,46798,47441,643
2022-07-20,70057,70041,Blue,0,28961,29851,890
2022-09-14,70046,70050,Blue,1,82212,82409,197
2022-06-10,70042,70060,Blue,1,55239,56665,1426
2022-03-28,70038,70050,Blue,1,85402,85914,512
2022-01-19,70038,70060,Blue,1,73511,74590,1079
2022-04-24,70057,70041,Blue,0,26302,27104,802
2022-02-04,70038,70056,Blue,1,56275,57197,922
2022-12-13,70055,70051,Blue,0,55819,55948,129
2022-04-21,70057,70053,Blue,0,31530,31692,162
2022-08-29,70051,70039,Blue,0,28521,29217,696
2022-07-02,70046,70054,Blue,1,29465,29887,422
2022-03-09,70053,70838,Blue,0,67800,68638,838
2022-05-26,70040,70044,Blue,1,58969,59098,129
2022-03-16,70044,70058,Blue,1,63420,64235,815
2022-10-03,70051,70039,Blue,0,63556,64277,721
2022-04-14,70055,70043,Blue,0,56784,57474,690
2022-11-29,70059,70053,Blue,0,23297,23532,235
2022-01-07,70040,70058,Blue,1,70055,71167,1112
2022-02-01,70059,70055,Blue,0,29657,29823,166
2022-09-29,70040,70058,Blue,1,60215,61158,943
2022-06-10,70059,70838,Blue,0,55406,56583,1177
2022-03-21,70053,70041,Blue,0,24255,25005,750
2022-02-23,70057,70053,Blue,0,41606,41783,177
2022-04-14,70057,70055,Blue,0,43286,43354,68
2022-06-16,70040,70058,Blue,1,63528,64774,1246
2022-02-18,70059,70055,Blue,0,77776,77921,145
2022-11-01,70047,70838,Blue,0,35564,36080,516
2022-07-13,70051,70045,Blue,0,31789,32139,350
2022-01-04,70052,70056,Blue,1,86272,86444,172
2022-05-25,70047,70838,Blue,0,66508,67048,540
2022-04-13,70059,70043,Blue,0,20592,21420,828
2022-06-12,70055,70838,Blue,0,64285,65182,897
2022-03-02,70057,70039,Blue,0,50308,51239,931
2022-01-31,70040,70048,Blue,1,55441,55832,391
2022-07-04,70044,70056,Blue,1,60630,61302,672
2022-04-08,70049,70838,Blue,0,61272,61916,644
2022-07-04,70049,70047,Blue,0,85504,85560,56
2022-09-02,70053,70039,Blue,0,35999,36855,856
2022-10-23,70051,70039,Blue,0,60141,60800,659
2022-12-02,70059,70057,Blue,0,38902,38937,35
2022-06-28,70048,70052,Blue,1,23864,24103,239
2022-12-07,70043,70039,Blue,0,75305,75409,104
2022-03-04,70057,70043,Blue,0,53190,54090,900
2022-08-19,70051,70045,Blue,0,41864,42244,380
2022-04-27,70059,70047,Blue,0,23836,24443,607
2022-10-25,70050,70056,Blue,1,51964,52253,289
2022-06-08,70040,70048,Blue,1,21971,22410,439
2022-06-10,70057,70045,Blue,0,47774,48451,677
2022-11-29,70048,70050,Blue,1,45027,45083,56
2022-09-22,70045,70039,Blue,0,49606,49885,279
2022-06-19,70038,70052,Blue,1,54792,55526,734
2022-06-16,70057,70838,Blue,0,63585,64607,1022
2022-12-09,70049,70039,Blue,0,32442,32940,498
2022-01-19,70042,70054,Blue,1,68379,69068,689
2022-03-21,70055,70053,Blue,0,56181,56226,45
2022-02-21,70048,70058,Blue,1,73877,74363,486
2022-07-21,70057,70055,Blue,0,79500,79571,71
2022-12-03,70049,70047,Blue,0,55230,55286,56
2022-07-20,70046,70048,Blue,1,65145,65219,74
2022-04-17,70045,70039,Blue,0,79764,80017,253
2022-03-31,70044,70046,Blue,1,23577,23680,103
2022-02-18,70047,70838,Blue,0,84060,84530,470
2022-11-20,70047,70045,Blue,0,45106,45196,90
2022-03-27,70042,70056,Blue,1,54418,55187,769
2022-09-02,70038,70042,Blue,1,42966,43074,108
2022-10-21,70055,70053,Blue,0,39370,39416,46
2022-02-16,70040,70056,Blue,1,25608,26484,876
2022-12-17,70046,70050,Blue,1,76511,76686,175
2022-03-27,70059,70049,Blue,0,24752,25225,473
2022-04-23,70057,70041,Blue,0,61717,62575,858
2022-10-08,70044,70050,Blue,1,86671,87029,358
2022-10-22,70044,70056,Blue,1,36319,36947,628
2022-02-17,70042,70058,Blue,1,64520,65414,894
2022-09-18,70046,70056,Blue,1,64499,65021,522
2022-01-01,70053,70051,Blue,0,67760,67827,67
2022-10-13,70047,70838,Blue,0,44528,45028,500
2022-12-29,70058,70060,Blue,1,79581,79650,69
2022-03-15,70040,70048,Blue,1,45517,45939,422
2022-03-21,70038,70060,Blue,1,64632,65807,1175
2022-11-02,70040,70058,Blue,1,48434,49343,909
2022-03-09,70046,70060,Blue,1,58143,59050,907
2022-01-12,70040,70046,Blue,1,30010,30316,306
2022-05-31,70048,70050,Blue,1,28190,28249,59
2022-05-23,70044,70050,Blue,1,81895,82273,378
2022-02-11,70042,70052,Blue,1,33683,34240,557
2022-07-28,70052,70056,Blue,1,72453,72626,173
2022-07-18,70042,70050,Blue,1,48454,48886,432
2022-08-12,70045,70041,Blue,0,68491,68656,165
2022-06-09,70045,70838,Blue,0,81342,81675,333
2022-08-19,70056,70058,Blue,1,27107,27184,77
2022-07-04,70057,70039,Blue,0,61776,62754,978
2022-07-16,70040,70048,Blue,1,53005,53473,468
2022-07-07,70039,70838,Blue,0,43996,44033,37
2022-01-16,70047,70043,Blue,0,86138,86383,245
2022-07-21,70046,70058,Blue,1,68355,68987,632
2022-11-19,70044,70052,Blue,1,31097,31591,494
2022-03-21,70046,70048,Blue,1,66775,66865,90
2022-03-21,70048,70052,Blue,1,42952,43172,220
2022-01-21,70044,70048,Blue,1,23477,23722,245
2022-03-24,70040,70050,Blue,1,43145,43630,485
2022-02-01,70057,70049,Blue,0,77883,78290,407
2022-09-24,70038,70050,Blue,1,47489,48052,563
2022-10-17,70059,70055,Blue,0,59299,59440,141
2022-11-24,70053,70039,Blue,0,56808,57558,750
2022-12-01,70047,70045,Blue,0,64681,64782,101
2022-02-14,70048,70050,Blue,1,36730,36793,63
2022-01-29,70059,70047,Blue,0,36008,36845,837
2022-09-19,70040,70048,Blue,1,39613,40041,428
2022-03-04,70056,70060,Blue,1,42611,42802,191
2022-04-19,70059,70055,Blue,0,26078,26233,155
2022-09-23,70047,70041,Blue,0,33478,33810,332
2022-10-18,70053,70051,Blue,0,60041,60092,51
2022-09-15,70051,70049,Blue,0,79865,79967,102
2022-04-04,70053,70049,Blue,0,29066,29273,207
2022-07-16,70040,70050,Blue,1,54600,55094,494
2022-07-09,70042,70048,Blue,1,37916,38243,327
2022-12-07,70057,70047,Blue,0,68187,68655,468
2022-08-30,70038,70056,Blue,1,71581,72484,903
2022-02-07,70040,70054,Blue,1,59893,60621,728
2022-10-06,70053,70051,Blue,0,77200,77251,51
2022-02-11,70044,70052,Blue,1,28401,28918,517
2022-06-03,70048,70052,Blue,1,34918,35240,322
2022-03-11,70054,70056,Blue,1,35515,35561,46
2022-11-07,70056,70060,Blue,1,27073,27255,182
2022-12-29,70044,70056,Blue,1,30645,31333,688
2022-07-26,70046,70056,Blue,1,87699,88177,478
2022-10-20,70050,70054,Blue,1,34224,34478,254
2022-01-05,70054,70060,Blue,1,31012,31284,272
2022-06-14,70039,70838,Blue,0,54536,54570,34
2022-02-07,70055,70051,Blue,0,42267,42415,148
2022-06-15,70044,70058,Blue,1,62833,63657,824
2022-01-14,70045,70838,Blue,0,24983,25312,329
2022-04-30,70057,70055,Blue,0,48829,48902,73
2022-07-05,70045,70838,Blue,0,23828,24242,414
2022-06-26,70044,70048,Blue,1,85728,86033,305
2022-10-14,70042,70044,Blue,1,24216,24244,28
2022-06-20,70048,70052,Blue,1,71693,71918,225
2022-02-23,70044,70058,Blue,1,64566,65400,834
2022-07-15,70059,70051,Blue,0,60763,61083,320
2022-07-24,70040,70050,Blue,1,76996,77586,590
2022-06-28,70042,70052,Blue,1,30834,31382,548
2022-11-05,70052,70058,Blue,1,69761,70014,253
2022-02-11,70053,70838,Blue,0,24518,25353,835
2022-03-02,70040,70060,Blue,1,66044,67305,1261
2022-02-05,70044,70050,Blue,1,83411,83748,337
2022-08-23,70042,70052,Blue,1,33454,34057,603
2022-05-20,70057,70047,Blue,0,23132,23607,475
2022-10-21,70049,70043,Blue,0,27757,28135,378
2022-02-03,70051,70039,Blue,0,84062,84741,679
2022-04-18,70053,70041,Blue,0,55963,56636,673
2022-08-07,70042,70060,Blue,1,50098,51099,1001
2022-12-18,70057,70055,Blue,0,50133,50201,68
2022-09-04,70043,70041,Blue,0,83125,83154,29
2022-12-14,70057,70043,Blue,0,54156,54964,808
2022-03-29,70057,70043,Blue,0,61771,62535,764
2022-10-13,70057,70055,Blue,0,27331,27400,69
2022-07-17,70050,70054,Blue,1,53843,54073,230
2022-03-22,70045,70039,Blue,0,63866,64142,276
2022-09-08,70057,70047,Blue,0,25188,25705,517
2022-11-29,70038,70056,Blue,1,55249,56096,847
2022-08-02,70047,70041,Blue,0,59888,60210,322
2022-04-22,70044,70046,Blue,1,61271,61388,117
2022-04-06,70048,70050,Blue,1,35690,35750,60
2022-12-29,70054,70058,Blue,1,71006,71170,164
2022-02-16,70040,70050,Blue,1,60526,61017,491
2022-05-18,70040,70054,Blue,1,44264,45163,899
2022-09-06,70056,70058,Blue,1,71725,71803,78
2022-07-06,70049,70838,Blue,0,62748,63357,609
2022-07-07,70059,70057,Blue,0,73334,73369,35
2022-12-20,70055,70039,Blue,0,67919,68712,793
2022-04-15,70041,70838,Blue,0,82113,82229,116
2022-04-11,70050,70060,Blue,1,80871,81364,493
2022-09-28,70043,70041,Blue,0,69727,69756,29
2022-07-09,70059,70043,Blue,0,25470,26446,976
2022-01-04,70055,70039,Blue,0,23273,24191,918
2022-04-04,70050,70060,Blue,1,28564,29110,546
2022-03-04,70052,70054,Blue,1,55123,55181,58
2022-07-21,70045,70041,Blue,0,42365,42553,188
2022-08-25,70056,70060,Blue,1,53826,54015,189
2022-04-07,70040,70044,Blue,1,34215,34329,114
2022-10-26,70046,70050,Blue,1,56055,56264,209
2022-12-19,70045,70043,Blue,0,59192,59290,98
2022-06-29,70040,70054,Blue,1,45632,46459,827
2022-02-27,70057,70043,Blue,0,53370,54176,806
2022-04-20,70040,70042,Blue,1,55478,55511,33
2022-09-24,70040,70050,Blue,1,33553,34089,536
2022-07-27,70045,70043,Blue,0,66783,66882,99
2022-03-01,70040,70042,Blue,1,54078,54112,34
2022-06-15,70049,70838,Blue,0,57417,58070,653
2022-08-04,70051,70043,Blue,0,24768,25279,511
2022-08-05,70044,70048,Blue,1,91437,91682,245
2022-07-10,70040,70056,Blue,1,65658,66504,846
2022-12-09,70042,70046,Blue,1,65555,65730,175
2022-04-04,70055,70043,Blue,0,58257,58928,671
2022-02-18,70057,70838,Blue,0,80121,81109,988
2022-03-31,70046,70060,Blue,1,22487,23343,856
2022-12-23,70045,70838,Blue,0,24132,24462,330
2022-01-20,70038,70054,Blue,1,41092,41994,902
2022-06-04,70047,70838,Blue,0,20253,20801,548
2022-03-11,70058,70060,Blue,1,31253,31425,172
2022-01-14,70047,70043,Blue,0,60782,61018,236
2022-04-20,70044,70056,Blue,1,24461,25164,703
2022-05-20,70051,70045,Blue,0,50121,50538,417
2022-11-02,70059,70055,Blue,0,47296,47434,138
2022-11-19,70038,70058,Blue,1,21129,22177,1048
2022-06-13,70040,70044,Blue,1,69855,69985,130
2022-03-02,70049,70047,Blue,0,47122,47176,54
2022-11-02,70057,70049,Blue,0,44275,44645,370
2022-05-23,70042,70050,Blue,1,33105,33599,494
2022-07-04,70044,70052,Blue,1,64293,64741,448
2022-02-21,70052,70058,Blue,1,52154,52388,234
2022-08-12,70046,70060,Blue,1,39500,40309,809
2022-09-02,70046,70056,Blue,1,33604,34094,490
2022-06-30,70038,70060,Blue,1,62973,64165,1192
2022-11-06,70046,70054,Blue,1,75281,75708,427
2022-01-06,70046,70052,Blue,1,60268,60619,351
2022-06-21,70045,70043,Blue,0,23336,23444,108
2022-04-04,70039,70838,Blue,0,21342,21375,33
2022-02-01,70057,70055,Blue,0,60276,60347,71
2022-10-15,70044,70060,Blue,1,58164,59043,879
2022-08-18,70051,70838,Blue,0,33488,34294,806
2022-01-09,70038,70048,Blue,1,64510,64924,414
2022-01-12,70051,70039,Blue,0,79937,80626,689
2022-01-30,70049,70838,Blue,0,74366,75185,819
2022-09-11,70042,70046,Blue,1,84754,84923,169
2022-01-11,70059,70051,Blue,0,32364,32707,343
2022-10-19,70056,70060,Blue,1,75592,75762,170
2022-01-25,70052,70060,Blue,1,83371,83718,347
2022-05-24,70050,70052,Blue,1,36571,36803,232
2022-11-08,70040,70046,Blue,1,67169,67739,570
2022-08-05,70046,70054,Blue,1,61870,62314,444
2022-03-13,70050,70058,Blue,1,74293,74700,407
2022-02-07,70051,70047,Blue,0,48011,48234,223
2022-03-27,70038,70040,Blue,1,58036,58051,15
2022-10-07,70042,70044,Blue,1,24625,24663,38
2022-05-11,70054,70060,Blue,1,78546,78852,306
2022-10-26,70048,70054,Blue,1,85486,85793,307
2022-09-29,70059,70047,Blue,0,56180,56798,618
2022-03-07,70055,70053,Blue,0,69254,69313,59
2022-02-17,70057,70047,Blue,0,52601,53130,529
2022-12-08,70044,70048,Blue,1,26544,26794,250
2022-06-28,70057,70051,Blue,0,85105,85350,245
2022-04-17,70048,70054,Blue,1,47521,47811,290
2022-03-12,70055,70053,Blue,0,68875,68924,49
2022-11-02,70040,70046,Blue,1,71659,71907,248
2022-01-07,70055,70838,Blue,0,56549,57657,1108
2022-10-09,70052,70060,Blue,1,54415,54752,337
2022-06-26,70055,70047,Blue,0,56264,56733,469
2022-05-26,70041,70838,Blue,0,86425,86558,133
2022-03-07,70056,70058,Blue,1,45002,45071,69
2022-01-13,70049,70838,Blue,0,64955,65623,668
2022-08-02,70042,70044,Blue,1,61866,61893,27
2022-11-03,70043,70838,Blue,0,43560,43852,292
2022-02-09,70046,70048,Blue,1,29165,29242,77
2022-10-22,70038,70046,Blue,1,44767,45138,371
2022-12-15,70048,70058,Blue,1,83232,83797,565
2022-10-02,70055,70047,Blue,0,48612,48996,384
2022-02-16,70038,70056,Blue,1,35354,36306,952
2022-09-06,70059,70039,Blue,0,28041,29120,1079
2022-11-10,70038,70050,Blue,1,89113,89676,563
2022-04-15,70042,70044,Blue,1,64489,64523,34
2022-11-22,70047,70039,Blue,0,64447,64816,369
2022-09-29,70048,70056,Blue,1,44786,45171,385
2022-06-20,70059,70053,Blue,0,27206,27481,275
2022-06-03,70045,70041,Blue,0,85550,85759,209
2022-04-20,70050,70058,Blue,1,54723,55136,413
2022-03-25,70042,70048,Blue,1,28295,28629,334
2022-06-25,70040,70056,Blue,1,32982,33813,831
2022-11-24,70053,70049,Blue,0,27225,27427,202
2022-08-12,70057,70043,Blue,0,71966,72722,756
2022-02-24,70045,70041,Blue,0,24160,24377,217
2022-05-19,70041,70838,Blue,0,61311,61423,112
2022-12-02,70038,70042,Blue,1,79668,79760,92
2022-06-29,70042,70058,Blue,1,61381,62297,916
2022-02-18,70049,70039,Blue,0,53045,53587,542
2022-01-19,70038,70058,Blue,1,27247,28325,1078
2022-07-05,70055,70039,Blue,0,73506,74287,781
2022-02-14,70041,70838,Blue,0,77667,77811,144
2022-04-15,70042,70056,Blue,1,78149,79027,878
2022-03-14,70046,70060,Blue,1,70272,70996,724
2022-03-24,70057,70045,Blue,0,25831,26485,654
2022-09-20,70044,70050,Blue,1,83557,83875,318
2022-03-10,70040,70058,Blue,1,66804,67805,1001
2022-04-21,70057,70838,Blue,0,54270,57996,3726
2022-01-28,70048,70050,Blue,1,79102,79161,59
2022-06-21,70057,70055,Blue,0,72418,72491,73
2022-06-02,70044,70052,Blue,1,53840,54483,643
2022-05-10,70059,70047,Blue,0,22567,23143,576
2022-10-09,70057,70053,Blue,0,76583,76737,154
2022-12-26,70048,70050,Blue,1,83662,83719,57
2022-04-07,70057,70041,Blue,0,74459,75362,903
2022-01-20,70044,70050,Blue,1,26220,26583,363
2022-05-19,70050,70052,Blue,1,31736,31855,119
2022-08-09,70040,70044,Blue,1,40666,40794,128
2022-12-03,70039,70838,Blue,0,41692,41734,42
2022-12-02,70039,70838,Blue,0,54335,54371,36
2022-07-28,70049,70838,Blue,0,79325,79905,580
2022-04-15,70045,70039,Blue,0,61386,61734,348
2022-04-16,70038,70046,Blue,1,54518,54855,337
2022-08-26,70038,70054,Blue,1,57281,58134,853
2022-12-03,70040,70042,Blue,1,39423,39452,29
2022-10-20,70055,70045,Blue,0,62653,63207,554
2022-10-12,70042,70054,Blue,1,62499,63228,729
2022-08-22,70042,70056,Blue,1,73442,74183,741
2022-03-23,70047,70045,Blue,0,30843,30946,103
2022-02-03,70057,70051,Blue,0,60095,60400,305
2022-09-02,70047,70041,Blue,0,43825,44154,329
2022-09-26,70049,70039,Blue,0,31074,31653,579
2022-11-28,70052,70058,Blue,1,88148,88409,261
2022-08-16,70059,70057,Blue,0,55815,55851,36
2022-01-14,70046,70050,Blue,1,53754,53938,184
2022-05-19,70042,70060,Blue,1,37844,38906,1062
2022-06-26,70059,70047,Blue,0,41475,42046,571
2022-10-21,70052,70058,Blue,1,60909,61164,255
2022-02-26,70040,70046,Blue,1,51358,51641,283
2022-06-18,70044,70054,Blue,1,25841,26477,636
2022-08-02,70052,70058,Blue,1,49409,49674,265
2022-04-02,70055,70039,Blue,0,66673,67522,849
2022-08-23,70040,70060,Blue,1,63179,64442,1263
2022-06-10,70050,70054,Blue,1,79326,79545,219
2022-04-24,70053,70047,Blue,0,65438,65743,305
2022-05-28,70049,70045,Blue,0,36305,36508,203
2022-02-26,70038,70060,Blue,1,28031,29026,995
2022-08-09,70041,70838,Blue,0,48270,48392,122
2022-02-11,70051,70838,Blue,0,72974,73721,747
2022-07-17,70050,70056,Blue,1,78660,78960,300
2022-09-30,70053,70047,Blue,0,80816,81133,317
2022-04-05,70040,70044,Blue,1,32112,32222,110
2022-09-25,70040,70044,Blue,1,72696,72811,115
2022-06-28,70042,70056,Blue,1,47800,48608,808
2022-09-10,70053,70041,Blue,0,25080,25763,683
2022-10-30,70043,70039,Blue,0,48339,48454,115
2022-09-23,70044,70050,Blue,1,63686,64040,354
2022-12-09,70055,70053,Blue,0,72430,72475,45
2022-08-15,70045,70838,Blue,0,78417,78846,429
2022-02-16,70055,70049,Blue,0,27743,28047,304
2022-05-20,70057,70049,Blue,0,87633,88015,382
2022-10-20,70059,70051,Blue,0,67662,67969,307
2022-03-03,70042,70048,Blue,1,78345,78700,355
2022-01-25,70042,70044,Blue,1,34596,34626,30
2022-11-19,70040,70042,Blue,1,34608,34647,39
2022-12-12,70057,70039,Blue,0,28968,29995,1027
2022-12-01,70053,70049,Blue,0,26713,26929,216
2022-01-26,70057,70045,Blue,0,24032,24697,665
2022-03-29,70040,70044,Blue,1,21602,21721,119
2022-10-31,70055,70049,Blue,0,85152,85422,270
2022-10-28,70053,70838,Blue,0,50664,51461,797
2022-11-20,70055,70051,Blue,0,83182,83319,137
2022-07-20,70042,70050,Blue,1,46927,47352,425
2022-12-28,70042,70046,Blue,1,30372,30535,163
2022-02-15,70040,70052,Blue,1,63506,64210,704
2022-12-30,70053,70049,Blue,0,59086,59287,201
2022-08-20,70059,70045,Blue,0,54075,54791,716
2022-10-12,70051,70039,Blue,0,58130,58771,641
2022-08-07,70057,70043,Blue,0,73893,74642,749
2022-12-20,70044,70060,Blue,1,27592,28643,1051
2022-06-24,70042,70058,Blue,1,67633,68800,1167
2022-01-03,70040,70052,Blue,1,84310,84918,608
2022-04-07,70059,70053,Blue,0,60799,61047,248
2022-03-14,70042,70058,Blue,1,52095,53022,927
2022-01-05,70038,70050,Blue,1,80310,80835,525
2022-03-22,70041,70039,Blue,0,79297,79330,33
2022-10-19,70059,70045,Blue,0,67747,68420,673
2022-06-02,70042,70048,Blue,1,38037,38423,386
2022-08-03,70055,70049,Blue,0,51154,51454,300
2022-09-30,70045,70041,Blue,0,56212,56379,167
2022-02-10,70053,70043,Blue,0,55841,56498,657
2022-08-18,70042,70056,Blue,1,68895,69654,759
2022-12-28,70059,70043,Blue,0,26103,27009,906
2022-09-03,70055,70047,Blue,0,63432,63813,381
2022-05-22,70049,70041,Blue,0,48746,49238,492
2022-04-01,70054,70056,Blue,1,24296,24381,85
2022-08-06,70055,70041,Blue,0,60763,61516,753
2022-10-23,70054,70060,Blue,1,52408,52667,259
2022-10-26,70048,70052,Blue,1,54189,54391,202
2022-03-23,70046,70056,Blue,1,37709,38425,716
2022-07-20,70044,70046,Blue,1,23657,23764,107
2022-06-16,70053,70838,Blue,0,65865,66833,968
2022-09-22,70042,70046,Blue,1,62551,62731,180
2022-12-06,70050,70054,Blue,1,58897,59097,200
2022-12-22,70055,70047,Blue,0,54371,54746,375
2022-02-01,70039,70838,Blue,0,54950,54987,37
2022-12-24,70049,70045,Blue,0,63216,63414,198
2022-09-16,70046,70054,Blue,1,37108,37545,437
2022-02-20,70042,70046,Blue,1,65726,65890,164
2022-07-08,70040,70060,Blue,1,46779,47837,1058
2022-07-13,70045,70838,Blue,0,24211,24617,406
2022-03-11,70057,70838,Blue,0,39334,40532,1198
2022-08-04,70059,70055,Blue,0,76927,77071,144
2022-07-26,70051,70043,Blue,0,69216,69694,478
2022-02-21,70044,70052,Blue,1,87562,88055,493
2022-02-14,70057,70053,Blue,0,73870,74037,167
2022-01-20,70055,70049,Blue,0,19374,19704,330
2022-10-18,70047,70838,Blue,0,33287,33830,543
2022-08-09,70050,70058,Blue,1,71135,71552,417
2022-10-14,70050,70060,Blue,1,58772,59309,537
2022-09-25,70042,70058,Blue,1,54980,55865,885
2022-09-13,70046,70052,Blue,1,67771,68158,387
2022-01-16,70048,70056,Blue,1,67774,68161,387
2022-12-05,70046,70056,Blue,1,79228,79750,522
2022-05-21,70049,70838,Blue,0,79607,80386,779
2022-02-10,70049,70045,Blue,0,60066,60260,194
2022-10-31,70049,70838,Blue,0,25037,25909,872
2022-03-31,70059,70047,Blue,0,46626,47153,527
2022-10-17,70040,70044,Blue,1,73780,73894,114
2022-01-01,70059,70051,Blue,0,55997,56351,354
2022-01-12,70049,70043,Blue,0,39144,39483,339
2022-09-09,70052,70054,Blue,1,26617,26674,57
2022-03-17,70055,70053,Blue,0,55609,55655,46
2022-11-04,70038,70058,Blue,1,31173,33169,1996
2022-09-15,70059,70051,Blue,0,31821,32185,364
2022-12-21,70053,70039,Blue,0,19733,20496,763
2022-05-21,70047,70041,Blue,0,25431,25866,435
2022-12-19,70055,70045,Blue,0,32118,32920,802
2022-01-10,70047,70838,Blue,0,49296,49777,481
2022-09-28,70053,70047,Blue,0,50692,51013,321
2022-01-24,70045,70041,Blue,0,43973,44149,176
2022-03-10,70040,70054,Blue,1,86190,86939,749
2022-03-31,70059,70053,Blue,0,23052,23269,217
2022-03-12,70042,70048,Blue,1,33030,33332,302
2022-07-21,70057,70043,Blue,0,35160,36046,886
2022-07-14,70040,70052,Blue,1,28216,28893,677
2022-06-15,70042,70046,Blue,1,29189,29392,203
2022-11-16,70059,70057,Blue,0,60071,60106,35
2022-02-01,70055,70838,Blue,0,76242,77260,1018
2022-03-31,70059,70041,Blue,0,38113,39449,1336
2022-01-01,70040,70046,Blue,1,70502,70750,248
2022-11-07,70051,70039,Blue,0,30787,31757,970
2022-09-17,70055,70045,Blue,0,59654,60204,550
2022-02-08,70053,70047,Blue,0,69362,69647,285
2022-08-24,70038,70046,Blue,1,74817,75137,320
2022-10-12,70045,70043,Blue,0,49638,49719,81
2022-10-16,70049,70047,Blue,0,75965,76027,62
2022-03-04,70043,70039,Blue,0,81522,81638,116
2022-08-06,70044,70058,Blue,1,77599,78463,864
2022-02-08,70055,70045,Blue,0,60077,60617,540
2022-03-08,70044,70058,Blue,1,32606,33418,812
2022-01-04,70059,70051,Blue,0,34138,34507,369
2022-02-18,70049,70041,Blue,0,63690,64132,442
2022-06-15,70057,70051,Blue,0,66578,66841,263
2022-03-30,70049,70039,Blue,0,53775,54328,553
2022-09-21,70047,70039,Blue,0,69733,70126,393
2022-11-28,70057,70045,Blue,0,59863,60510,647
2022-07-06,70053,70838,Blue,0,58245,59086,841
2022-04-16,70050,70054,Blue,1,20428,20653,225
2022-02-04,70042,70058,Blue,1,52467,53419,952
2022-08-21,70038,70060,Blue,1,66163,67321,1158
2022-03-17,70046,70056,Blue,1,84054,84553,499
2022-03-28,70040,70060,Blue,1,75909,76943,1034
2022-02-18,70042,70052,Blue,1,62388,62938,550
2022-04-21,70042,70060,Blue,1,30991,31966,975
2022-05-20,70042,70046,Blue,1,60683,60890,207
2022-12-01,70053,70838,Blue,0,55670,56578,908
2022-07-08,70053,70043,Blue,0,83864,84459,595
2022-09-19,70044,70048,Blue,1,22692,22947,255
2022-06-20,70040,70054,Blue,1,29041,29814,773
2022-07-28,70045,70838,Blue,0,19244,19603,359
2022-11-07,70055,70047,Blue,0,62803,63184,381
2022-03-25,70048,70056,Blue,1,37321,37874,553
2022-02-10,70040,70056,Blue,1,24428,25255,827
2022-12-20,70059,70057,Blue,0,78735,78770,35
2022-12-08,70051,70047,Blue,0,67931,68130,199
2022-01-06,70044,70056,Blue,1,34060,34867,807
2022-09-27,70055,70051,Blue,0,57003,57136,133
2022-11-09,70042,70044,Blue,1,27924,27951,27
2022-09-21,70039,70838,Blue,0,60044,60077,33
2022-11-09,70041,70039,Blue,0,66514,66546,32
2022-04-07,70053,70051,Blue,0,44122,44171,49
2022-10-25,70038,70058,Blue,1,75186,76221,1035
2022-04-11,70040,70054,Blue,1,58740,59497,757
2022-10-21,70049,70047,Blue,0,42704,42769,65
2022-01-26,70047,70043,Blue,0,61115,61339,224
2022-09-28,70059,70051,Blue,0,54393,54698,305
2022-01-05,70038,70052,Blue,1,61328,62061,733
2022-12-19,70038,70052,Blue,1,63808,64565,757
2022-05-19,70053,70049,Blue,0,41296,41516,220
2022-10-20,70038,70040,Blue,1,24177,24196,19
2022-02-14,70059,70053,Blue,0,55697,55938,241
2022-02-12,70047,70039,Blue,0,69789,70200,411
2022-12-28,70042,70056,Blue,1,55745,56494,749
2022-06-28,70038,70060,Blue,1,29002,30187,1185
2022-05-18,70038,70056,Blue,1,82257,83358,1101
2022-09-23,70055,70039,Blue,0,66977,67827,850
2022-07-23,70059,70051,Blue,0,61227,61563,336
2022-12-11,70046,70058,Blue,1,51918,52574,656
2022-02-03,70052,70054,Blue,1,25974,26034,60
2022-08-19,70049,70047,Blue,0,51976,52031,55
2022-03-11,70054,70056,Blue,1,49091,49141,50
2022-07-10,70042,70060,Blue,1,72747,73784,1037
2022-01-11,70055,70043,Blue,0,47354,48018,664
2022-08-27,70038,70044,Blue,1,57194,57379,185
2022-06-22,70059,70039,Blue,0,34394,35472,1078
2022-10-26,70040,70046,Blue,1,58192,58475,283
2022-11-24,70059,70049,Blue,0,46291,46727,436
2022-01-24,70049,70045,Blue,0,52341,52532,191
2022-10-21,70045,70838,Blue,0,75413,75741,328
2022-04-01,70051,70039,Blue,0,35651,36291,640
2022-08-11,70059,70055,Blue,0,35894,36046,152
2022-04-14,70052,70060,Blue,1,51577,51944,367
2022-02-02,70043,70838,Blue,0,64497,64690,193
2022-05-25,70038,70048,Blue,1,48104,48582,478
2022-10-26,70048,70052,Blue,1,78163,78382,219
2022-11-12,70042,70046,Blue,1,25112,25284,172
2022-02-13,70050,70058,Blue,1,52686,53110,424
2022-06-14,70038,70048,Blue,1,55926,56360,434
2022-02-19,70052,70060,Blue,1,33166,33514,348
2022-02-10,70040,70050,Blue,1,30630,31124,494
2022-12-03,70053,70838,Blue,0,88567,89598,1031
2022-12-27,70048,70052,Blue,1,29080,29314,234
2022-08-09,70042,70048,Blue,1,76432,76724,292
2022-06-22,70051,70047,Blue,0,66570,66774,204
2022-06-23,70059,70049,Blue,0,21743,22282,539
2022-03-23,70048,70052,Blue,1,57950,58154,204
2022-12-29,70050,70052,Blue,1,87602,87712,110
2022-01-02,70047,70041,Blue,0,51225,51581,356
2022-03-08,70038,70044,Blue,1,80827,80997,170
2022-10-19,70044,70054,Blue,1,63320,63950,630
2022-04-03,70059,70047,Blue,0,57073,57622,549
2022-03-29,70055,70047,Blue,0,70818,71212,394
2022-12-19,70051,70041,Blue,0,25420,26025,605
2022-07-08,70042,70044,Blue,1,63057,63088,31
2022-02-17,70053,70039,Blue,0,57191,58026,835
2022-09-25,70059,70049,Blue,0,83828,84430,602
2022-11-18,70047,70039,Blue,0,29848,30280,432
2022-08-17,70042,70046,Blue,1,77629,77810,181
2022-04-23,70059,70051,Blue,0,35713,36049,336
2022-12-26,70040,70050,Blue,1,37756,38232,476
2022-03-25,70046,70050,Blue,1,78980,79165,185
2022-11-29,70057,70049,Blue,0,20507,20919,412
2022-01-21,70057,70053,Blue,0,46716,46870,154
2022-10-10,70051,70043,Blue,0,51840,52317,477
2022-10-06,70057,70051,Blue,0,52153,52447,294
2022-06-20,70038,70042,Blue,1,60504,60648,144
2022-01-14,70044,70056,Blue,1,62466,63210,744
2022-07-29,70057,70049,Blue,0,53204,53621,417
2022-01-02,70042,70052,Blue,1,89265,89822,557
2022-11-11,70059,70057,Blue,0,44716,44750,34
2022-12-16,70043,70039,Blue,0,51435,51539,104
2022-10-16,70059,70051,Blue,0,58156,58492,336
2022-12-26,70055,70838,Blue,0,61071,61974,903
2022-10-15,70042,70050,Blue,1,52514,52918,404
2022-12-31,70047,70041,Blue,0,61240,61579,339
2022-12-30,70042,70054,Blue,1,24843,25528,685
2022-03-28,70057,70045,Blue,0,28851,29644,793
2022-01-12,70044,70060,Blue,1,58863,59888,1025
2022-07-08,70044,70060,Blue,1,40710,41616,906
2022-09-16,70040,70048,Blue,1,84985,85469,484
2022-01-11,70042,70052,Blue,1,30706,31302,596
2022-01-08,70047,70039,Blue,0,38522,38898,376
2022-05-01,70050,70054,Blue,1,56557,56773,216
2022-06-26,70045,70039,Blue,0,76396,76665,269
2022-06-16,70049,70047,Blue,0,52042,52096,54
2022-09-04,70038,70044,Blue,1,59106,59288,182
2022-01-29,70042,70048,Blue,1,33220,33712,492
2022-02-27,70046,70060,Blue,1,72442,73155,713
2022-08-01,70038,70040,Blue,1,63064,63082,18
2022-03-22,70042,70060,Blue,1,45949,46985,1036
2022-12-16,70055,70041,Blue,0,55809,56603,794
2022-09-08,70047,70045,Blue,0,46944,47042,98
2022-01-12,70042,70058,Blue,1,57575,58443,868
2022-04-05,70044,70054,Blue,1,53304,53863,559
2022-10-19,70054,70058,Blue,1,41454,41615,161
2022-11-03,70042,70056,Blue,1,27556,28315,759
2022-12-08,70050,70054,Blue,1,49242,49453,211
2022-02-25,70048,70060,Blue,1,60104,60932,828
2022-03-31,70056,70058,Blue,1,62554,62660,106
2022-07-10,70051,70047,Blue,0,31971,32154,183
2022-12-29,70055,70041,Blue,0,72298,73006,708
2022-04-25,70059,70047,Blue,0,56176,56783,607
2022-10-10,70040,70046,Blue,1,57678,57980,302
2022-04-08,70046,70058,Blue,1,78973,79619,646
2022-12-23,70053,70041,Blue,0,53699,54458,759
2022-03-09,70042,70060,Blue,1,55761,56730,969
2022-02-25,70044,70048,Blue,1,65445,65680,235
2022-02-20,70045,70043,Blue,0,63777,63886,109
2022-03-23,70049,70041,Blue,0,84500,84916,416
2022-10-22,70050,70054,Blue,1,39423,39623,200
2022-02-01,70048,70060,Blue,1,50830,51482,652
2022-07-31,70059,70043,Blue,0,36871,37733,862
2022-01-12,70054,70060,Blue,1,85672,85945,273
2022-02-24,70057,70051,Blue,0,29820,30087,267
2022-01-19,70055,70051,Blue,0,29860,30056,196
2022-09-18,70038,70052,Blue,1,67794,68499,705
2022-09-06,70038,70056,Blue,1,71516,72509,993
2022-08-23,70053,70045,Blue,0,30365,30829,464
2022-03-23,70054,70056,Blue,1,59283,59340,57
2022-04-17,70050,70056,Blue,1,57063,57362,299
2022-01-14,70040,70044,Blue,1,67395,67507,112
2022-01-02,70051,70045,Blue,0,39912,40258,346
2022-01-20,70056,70058,Blue,1,53186,53260,74
2022-09-30,70038,70044,Blue,1,47115,47279,164
2022-01-04,70050,70058,Blue,1,44809,45221,412
2022-11-25,70046,70058,Blue,1,86890,87485,595
2022-03-09,70040,70052,Blue,1,24025,24693,668
2022-06-25,70048,70060,Blue,1,25508,26113,605
2022-11-15,70050,70058,Blue,1,39141,39656,515
2022-09-02,70045,70043,Blue,0,80829,80923,94
2022-09-18,70052,70054,Blue,1,63656,63708,52
2022-09-23,70048,70060,Blue,1,50998,51567,569
2022-11-20,70038,70044,Blue,1,61814,62012,198
2022-04-19,70049,70039,Blue,0,31122,31686,564
2022-02-10,70054,70058,Blue,1,70694,70846,152
2022-02-20,70051,70045,Blue,0,76880,77226,346
2022-01-12,70059,70051,Blue,0,62297,62686,389
2022-12-12,70055,70051,Blue,0,75048,75186,138
2022-04-03,70038,70060,Blue,1,56409,57588,1179
2022-06-22,70047,70041,Blue,0,55065,55430,365
2022-08-20,70049,70039,Blue,0,63753,64304,551
2022-06-22,70059,70053,Blue,0,72833,73067,234
2022-09-23,70053,70838,Blue,0,32352,33284,932
2022-02-16,70051,70039,Blue,0,77061,77802,741
2022-07-08,70055,70043,Blue,0,22039,22721,682
2022-03-01,70045,70043,Blue,0,24207,24310,103
2022-02-18,70057,70043,Blue,0,76112,76951,839
2022-06-25,70050,70052,Blue,1,65649,65761,112
2022-01-22,70040,70052,Blue,1,30277,30932,655
2022-07-07,70057,70047,Blue,0,60099,60566,467
2022-11-21,70048,70058,Blue,1,44088,44614,526
2022-06-27,70038,70060,Blue,1,55486,56810,1324
2022-03-08,70059,70057,Blue,0,52524,52559,35
2022-05-24,70040,70044,Blue,1,34364,34475,111
2022-11-08,70049,70041,Blue,0,51980,52388,408
2022-10-15,70055,70053,Blue,0,19727,19775,48
2022-04-13,70043,70039,Blue,0,76396,76507,111
2022-01-05,70059,70838,Blue,0,26077,27279,1202
2022-10-16,70049,70838,Blue,0,57047,57698,651
2022-01-07,70057,70053,Blue,0,40691,40881,190
2022-11-28,70038,70060,Blue,1,41619,43011,1392
2022-08-20,70056,70058,Blue,1,75431,75507,76
2022-10-17,70056,70060,Blue,1,63773,64010,237
2022-05-20,70059,70055,Blue,0,70514,70668,154
2022-03-10,70053,70041,Blue,0,30860,31578,718
2022-10-12,70050,70054,Blue,1,81204,81420,216
2022-01-28,70044,70050,Blue,1,30155,30515,360
2022-12-16,70050,70054,Blue,1,49832,50038,206
2022-04-18,70046,70050,Blue,1,44583,44810,227
2022-07-26,70050,70058,Blue,1,29345,29816,471
2022-07-21,70054,70056,Blue,1,30592,30644,52
2022-08-13,70053,70045,Blue,0,75405,75813,408
2022-01-05,70048,70056,Blue,1,64576,64972,396
2022-03-10,70052,70058,Blue,1,60623,60874,251
2022-01-05,70049,70039,Blue,0,26396,26916,520
2022-03-19,70048,70050,Blue,1,79200,79257,57
2022-02-03,70042,70048,Blue,1,52592,52910,318
2022-04-17,70046,70050,Blue,1,80130,80321,191
2022-09-26,70048,70056,Blue,1,65070,65479,409
2022-05-12,70050,70056,Blue,1,37455,37790,335
2022-11-13,70051,70039,Blue,0,35146,35769,623
2022-11-27,70042,70044,Blue,1,50072,50099,27
2022-09-25,70042,70058,Blue,1,37880,38702,822
2022-11-04,70038,70042,Blue,1,20073,20178,105
2022-04-22,70045,70838,Blue,0,59165,59504,339
2022-10-13,70057,70047,Blue,0,29811,30329,518
2022-05-19,70051,70838,Blue,0,24943,25845,902
2022-05-11,70055,70053,Blue,0,53230,53275,45
2022-06-20,70044,70060,Blue,1,78141,79066,925
2022-05-07,70049,70047,Blue,0,83365,83412,47
2022-03-22,70055,70039,Blue,0,23900,24763,863
2022-12-14,70043,70041,Blue,0,67450,67477,27
2022-07-14,70053,70051,Blue,0,33382,33447,65
2022-04-08,70046,70054,Blue,1,61727,62181,454
2022-03-29,70040,70058,Blue,1,29402,30346,944
2022-08-03,70044,70052,Blue,1,34234,34704,470
2022-11-03,70049,70039,Blue,0,43780,44322,542
2022-01-14,70048,70060,Blue,1,34302,34937,635
2022-11-18,70054,70058,Blue,1,47448,47600,152
2022-11-23,70057,70047,Blue,0,36891,37421,530
2022-01-24,70053,70051,Blue,0,81506,81569,63
2022-09-11,70050,70058,Blue,1,29813,30193,380
2022-08-23,70051,70838,Blue,0,68920,69643,723
2022-12-25,70038,70044,Blue,1,39015,39193,178
2022-05-30,70049,70041,Blue,0,64014,64502,488
2022-05-19,70042,70046,Blue,1,42789,43024,235
2022-08-19,70055,70047,Blue,0,49072,49466,394
2022-01-27,70059,70047,Blue,0,59597,60132,535
2022-12-17,70040,70046,Blue,1,47547,47808,261
2022-09-10,70057,70041,Blue,0,26816,27718,902
2022-07-29,70052,70056,Blue,1,28438,28583,145
2022-04-04,70055,70838,Blue,0,71173,72073,900
2022-01-01,70042,70044,Blue,1,57647,57676,29
2022-10-29,70059,70045,Blue,0,20176,20913,737
2022-07-27,70053,70047,Blue,0,65841,66211,370
2022-12-01,70049,70039,Blue,0,30550,31109,559
2022-07-25,70051,70838,Blue,0,66020,66852,832
2022-03-09,70053,70838,Blue,0,43498,44348,850
2022-02-24,70048,70052,Blue,1,36741,37121,380
2022-12-31,70058,70060,Blue,1,69387,69461,74
2022-07-29,70059,70047,Blue,0,69018,69599,581
2022-12-17,70055,70045,Blue,0,72613,73122,509
2022-11-13,70057,70055,Blue,0,55053,55121,68
2022-03-16,70059,70838,Blue,0,51553,52684,1131
2022-01-19,70042,70058,Blue,1,40260,41173,913
2022-09-26,70051,70047,Blue,0,85309,85552,243
2022-01-17,70051,70039,Blue,0,81972,82607,635
2022-02-03,70045,70838,Blue,0,27480,27898,418
2022-06-09,70048,70060,Blue,1,72020,72778,758
2022-01-06,70049,70043,Blue,0,59834,60169,335
2022-06-16,70055,70051,Blue,0,27152,27291,139
2022-06-29,70053,70051,Blue,0,59018,59078,60
2022-12-16,70056,70060,Blue,1,39606,39789,183
2022-10-25,70057,70041,Blue,0,61807,62646,839
2022-02-10,70038,70040,Blue,1,26955,26982,27
2022-05-30,70044,70050,Blue,1,83364,83759,395
2022-04-14,70051,70047,Blue,0,79849,80087,238
2022-08-20,70040,70042,Blue,1,58910,58942,32
2022-02-16,70050,70052,Blue,1,37936,38087,151
2022-08-08,70051,70049,Blue,0,32629,32732,103
2022-08-14,70048,70058,Blue,1,87837,88402,565
2022-07-18,70053,70039,Blue,0,71013,71751,738
2022-07-25,70044,70058,Blue,1,89297,90038,741
2022-11-10,70054,70060,Blue,1,33630,33911,281
2022-10-30,70048,70052,Blue,1,52082,52290,208
2022-10-13,70057,70053,Blue,0,58789,58943,154
2022-09-17,70057,70053,Blue,0,82403,82555,152
2022-04-18,70044,70052,Blue,1,34158,34714,556
2022-08-09,70042,70046,Blue,1,70187,70356,169
2022-02-25,70059,70838,Blue,0,81206,82413,1207
2022-03-05,70049,70039,Blue,0,79593,80056,463
2022-08-14,70059,70045,Blue,0,45291,46024,733
2022-12-30,70048,70056,Blue,1,58265,58664,399
2022-05-24,70045,70041,Blue,0,61388,61573,185
2022-01-26,70048,70058,Blue,1,64246,64763,517
2022-01-15,70048,70052,Blue,1,50148,50362,214
2022-07-14,70046,70052,Blue,1,56732,57074,342
2022-06-24,70057,70047,Blue,0,28675,29144,469
2022-12-06,70040,70052,Blue,1,78374,79022,648
2022-05-28,70042,70050,Blue,1,25608,26090,482
2022-10-26,70040,70058,Blue,1,72602,73549,947
2022-09-08,70057,70047,Blue,0,59875,60363,488
2022-06-22,70044,70056,Blue,1,62705,63530,825
2022-01-14,70038,70046,Blue,1,83715,84093,378
2022-11-23,70057,70041,Blue,0,55173,56015,842
2022-01-21,70043,70039,Blue,0,51652,51774,122
2022-04-20,70044,70046,Blue,1,62093,62210,117
2022-10-31,70055,70838,Blue,0,19760,20874,1114
2022-06-23,70044,70050,Blue,1,57794,58211,417
2022-03-07,70057,70047,Blue,0,21053,21557,504
2022-01-19,70038,70052,Blue,1,81495,82303,808
2022-06-20,70040,70048,Blue,1,59938,60349,411
2022-01-08,70038,70046,Blue,1,65832,66161,329
2022-01-26,70042,70052,Blue,1,45397,45972,575
2022-08-11,70048,70056,Blue,1,59868,60284,416
2022-11-09,70050,70060,Blue,1,28736,29240,504
2022-10-11,70040,70054,Blue,1,42254,42988,734
2022-10-14,70042,70048,Blue,1,34591,34875,284
2022-02-23,70056,70058,Blue,1,25960,26044,84
2022-09-21,70050,70058,Blue,1,55526,55981,455
2022-05-24,70047,70043,Blue,0,74044,74372,328
2022-08-10,70049,70043,Blue,0,44814,45165,351
2022-07-01,70054,70056,Blue,1,70489,70536,47
2022-04-25,70051,70049,Blue,0,83884,83992,108
2022-06-19,70053,70041,Blue,0,57885,58582,697
2022-04-20,70042,70046,Blue,1,55841,56027,186
2022-05-19,70045,70838,Blue,0,58179,58580,401
2022-07-24,70042,70058,Blue,1,65980,66898,918
2022-07-24,70053,70043,Blue,0,49261,49857,596
2022-09-28,70050,70052,Blue,1,33063,33184,121
2022-06-29,70059,70047,Blue,0,58414,58989,575
2022-12-19,70059,70043,Blue,0,60826,61734,908
2022-01-26,70057,70053,Blue,0,22501,22676,175
2022-06-23,70045,70838,Blue,0,25988,26390,402
2022-04-05,70048,70052,Blue,1,60185,60395,210
2022-07-03,70042,70046,Blue,1,79243,79470,227
2022-11-10,70038,70054,Blue,1,42441,43209,768
2022-06-12,70046,70058,Blue,1,67596,68200,604
2022-08-16,70038,70050,Blue,1,66920,67472,552
2022-04-01,70048,70060,Blue,1,31691,32290,599
2022-09-19,70038,70052,Blue,1,44090,44783,693
2022-03-03,70051,70047,Blue,0,69500,69693,193
2022-01-15,70054,70056,Blue,1,80821,80869,48
2022-03-11,70042,70044,Blue,1,35830,35866,36
2022-07-17,70053,70045,Blue,0,45012,45494,482
2022-07-16,70042,70060,Blue,1,65536,66530,994
2022-10-26,70045,70039,Blue,0,28720,28972,252
2022-09-29,70045,70043,Blue,0,21691,21809,118
2022-06-21,70042,70056,Blue,1,33044,33954,910
2022-01-03,70040,70054,Blue,1,50357,51049,692
2022-04-09,70038,70042,Blue,1,79930,80031,101
2022-08-27,70057,70051,Blue,0,85774,86024,250
2022-07-03,70047,70838,Blue,0,62025,62539,514
2022-02-24,70053,70041,Blue,0,84944,85648,704
2022-08-09,70047,70041,Blue,0,38062,38375,313
2022-08-10,70053,70838,Blue,0,75625,76398,773
2022-10-11,70053,70039,Blue,0,75627,76410,783
2022-09-30,70040,70054,Blue,1,61789,62563,774
2022-04-13,70049,70838,Blue,0,48158,48751,593
2022-11-08,70040,70060,Blue,1,67503,68819,1316
2022-10-24,70051,70838,Blue,0,41129,41872,743
2022-03-04,70059,70043,Blue,0,32363,33302,939
2022-01-19,70055,70838,Blue,0,49997,51101,1104
2022-03-29,70049,70043,Blue,0,66612,66971,359
2022-06-17,70046,70058,Blue,1,31983,32887,904
2022-10-19,70042,70058,Blue,1,60379,61286,907
2022-01-15,70048,70054,Blue,1,44367,44660,293
2022-02-13,70059,70057,Blue,0,46277,46312,35
2022-07-31,70057,70053,Blue,0,23130,23279,149
2022-08-04,70057,70051,Blue,0,34000,34341,341
2022-03-03,70044,70056,Blue,1,78424,79182,758
2022-06-03,70038,70050,Blue,1,90410,91463,1053
2022-12-29,70057,70838,Blue,0,59716,60745,1029
2022-03-31,70049,70039,Blue,0,25954,26505,551
2022-01-06,70042,70058,Blue,1,23188,23996,808
2022-08-29,70047,70838,Blue,0,21523,22098,575
2022-03-08,70052,70058,Blue,1,59138,59391,253
2022-07-09,70057,70041,Blue,0,26608,27459,851
2022-10-02,70055,70043,Blue,0,41661,42308,647
2022-01-04,70038,70046,Blue,1,35307,35623,316
2022-09-25,70038,70052,Blue,1,73154,73868,714
2022-03-30,70040,70042,Blue,1,30613,30646,33
2022-12-14,70039,70838,Blue,0,34253,34286,33
2022-02-14,70042,70048,Blue,1,70053,70339,286
2022-08-13,70048,70058,Blue,1,42257,42792,535
2022-04-11,70057,70838,Blue,0,43279,44294,1015
2022-07-18,70051,70039,Blue,0,26760,27522,762
2022-06-03,70048,70050,Blue,1,23973,24047,74
2022-01-24,70053,70838,Blue,0,86582,87408,826
2022-11-08,70038,70058,Blue,1,24103,25195,1092
2022-12-21,70038,70042,Blue,1,79606,79710,104
2022-10-19,70057,70043,Blue,0,65282,66085,803
2022-02-16,70055,70045,Blue,0,68662,69175,513
2022-01-02,70040,70050,Blue,1,27032,27513,481
2022-07-31,70038,70052,Blue,1,56445,57243,798
2022-02-06,70055,70043,Blue,0,32612,33374,762
2022-12-18,70050,70054,Blue,1,87003,87201,198
2022-07-26,70050,70058,Blue,1,70897,71333,436
2022-01-06,70055,70838,Blue,0,43352,44741,1389
2022-07-24,70042,70048,Blue,1,72197,72619,422
2022-07-12,70052,70054,Blue,1,65851,65905,54
2022-01-11,70053,70049,Blue,0,34144,34344,200
2022-09-02,70052,70058,Blue,1,86631,86967,336
2022-04-25,70055,70051,Blue,0,63627,63772,145
2022-08-26,70048,70050,Blue,1,76868,76927,59
2022-06-09,70049,70043,Blue,0,78299,78682,383
2022-01-26,70042,70044,Blue,1,62387,62414,27
2022-01-21,70038,70044,Blue,1,33856,34006,150
2022-06-15,70055,70838,Blue,0,27779,28763,984
2022-06-29,70047,70039,Blue,0,35029,35459,430
2022-03-23,70038,70060,Blue,1,25157,26443,1286
2022-01-07,70046,70058,Blue,1,30024,30702,678
2022-07-29,70055,70041,Blue,0,24869,25691,822
2022-10-06,70048,70054,Blue,1,38352,38689,337
2022-01-25,70051,70039,Blue,0,81580,82269,689
2022-03-22,70048,70052,Blue,1,22304,22570,266
2022-06-06,70038,70050,Blue,1,56035,56710,675
2022-12-30,70042,70058,Blue,1,77194,77964,770
2022-02-26,70041,70039,Blue,0,50189,50219,30
2022-01-29,70044,70046,Blue,1,25251,25360,109
2022-02-10,70040,70046,Blue,1,56577,56830,253
2022-11-03,70038,70060,Blue,1,26896,27971,1075
2022-11-30,70057,70045,Blue,0,48167,48853,686
2022-07-25,70053,70051,Blue,0,38694,38754,60
2022-01-03,70053,70047,Blue,0,86556,86834,278
2022-11-09,70038,70054,Blue,1,29846,30670,824
2022-07-07,70047,70043,Blue,0,63007,63280,273
2022-06-15,70057,70045,Blue,0,57904,58581,677
2022-12-08,70040,70050,Blue,1,31159,31722,563
2022-01-24,70038,70040,Blue,1,20344,20361,17
2022-04-07,70057,70047,Blue,0,23133,23594,461
2022-05-30,70047,70041,Blue,0,55728,56105,377
2022-06-23,70043,70838,Blue,0,44180,44371,191
2022-11-04,70059,70055,Blue,0,52694,52848,154
2022-11-08,70057,70043,Blue,0,61969,62848,879
2022-12-29,70057,70838,Blue,0,21183,22483,1300
2022-04-17,70050,70056,Blue,1,69962,70285,323
2022-12-17,70038,70060,Blue,1,47472,48614,1142
2022-01-21,70055,70041,Blue,0,21796,22615,819
2022-10-02,70045,70039,Blue,0,85397,85651,254
2022-01-06,70051,70043,Blue,0,32110,32590,480
2022-06-28,70057,70041,Blue,0,31487,32389,902
2022-12-19,70059,70043,Blue,0,25886,26786,900
2022-03-30,70057,70043,Blue,0,56968,57745,777
2022-01-07,70051,70047,Blue,0,56776,56975,199
2022-06-27,70055,70047,Blue,0,38709,39086,377
2022-09-04,70046,70054,Blue,1,71362,71815,453
2022-06-09,70057,70053,Blue,0,23134,23290,156
2022-03-27,70040,70060,Blue,1,47299,48382,1083
2022-08-27,70042,70048,Blue,1,60070,60431,361
2022-08-30,70047,70041,Blue,0,23191,23582,391
2022-11-25,70058,70060,Blue,1,37691,37751,60
2022-10-15,70049,70047,Blue,0,68082,68136,54
2022-08-04,70038,70052,Blue,1,25317,25976,659
2022-03-05,70051,70041,Blue,0,83540,84102,562
2022-06-21,70051,70045,Blue,0,74793,75131,338
2022-01-23,70055,70838,Blue,0,49699,50674,975
2022-09-03,70047,70838,Blue,0,72490,72967,477
2022-10-14,70044,70052,Blue,1,23780,24282,502
2022-03-24,70040,70054,Blue,1,21641,22450,809
2022-03-14,70046,70058,Blue,1,27598,28248,650
2022-07-31,70047,70045,Blue,0,84411,84508,97
2022-06-19,70040,70048,Blue,1,55937,56369,432
2022-04-13,70059,70041,Blue,0,57793,58718,925
2022-11-18,70044,70056,Blue,1,54185,54895,710
2022-04-13,70047,70043,Blue,0,53975,54257,282
2022-08-21,70055,70045,Blue,0,49703,50216,513
2022-09-01,70055,70053,Blue,0,60266,60317,51
2022-03-10,70044,70050,Blue,1,61373,61756,383
2022-02-03,70040,70046,Blue,1,69066,69356,290
2022-03-30,70049,70838,Blue,0,54071,54764,693
2022-02-12,70044,70048,Blue,1,73618,73854,236
2022-07-18,70055,70045,Blue,0,31261,31841,580
2022-02-23,70046,70058,Blue,1,86965,87610,645
2022-09-23,70045,70039,Blue,0,62338,62581,243
2022-07-04,70041,70838,Blue,0,28089,28214,125
2022-07-11,70057,70838,Blue,0,73415,74357,942
2022-01-27,70051,70047,Blue,0,69464,69668,204
2022-09-06,70049,70838,Blue,0,30688,31368,680
2022-02-22,70057,70047,Blue,0,59966,60481,515
2022-12-01,70046,70060,Blue,1,63120,63906,786
2022-08-30,70040,70056,Blue,1,87429,88180,751
2022-10-07,70059,70053,Blue,0,44760,44989,229
2022-11-16,70053,70838,Blue,0,29486,30425,939
2022-01-22,70057,70045,Blue,0,54756,55433,677
2022-01-21,70043,70041,Blue,0,59821,59852,31
2022-08-18,70046,70058,Blue,1,21526,22283,757
2022-07-07,70055,70045,Blue,0,41933,42489,556
2022-04-19,70044,70058,Blue,1,75454,76336,882
2022-03-29,70042,70050,Blue,1,23807,24267,460
2022-06-27,70039,70838,Blue,0,23003,23040,37
2022-08-27,70046,70048,Blue,1,73945,74026,81
2022-11-01,70040,70060,Blue,1,23416,24548,1132
2022-03-20,70057,70055,Blue,0,53914,53982,68
2022-02-15,70050,70052,Blue,1,36811,37032,221
2022-09-18,70053,70838,Blue,0,60581,61627,1046
2022-12-14,70055,70053,Blue,0,43077,43122,45
2022-06-10,70055,70039,Blue,0,83663,84515,852
2022-12-30,70046,70060,Blue,1,25080,25889,809
2022-09-25,70043,70838,Blue,0,56362,56608,246
2022-11-10,70059,70838,Blue,0,50961,52129,1168
2022-08-14,70038,70054,Blue,1,39674,40533,859
2022-02-17,70059,70039,Blue,0,57502,58545,1043
2022-06-20,70051,70045,Blue,0,30039,30371,332
2022-02-15,70040,70048,Blue,1,45923,46393,470
2022-06-15,70048,70060,Blue,1,36498,37229,731
2022-04-01,70046,70054,Blue,1,67717,68108,391
2022-08-05,70055,70049,Blue,0,32008,32291,283
2022-11-07,70058,70060,Blue,1,89265,89328,63
2022-07-30,70047,70045,Blue,0,42297,42406,109
2022-04-26,70049,70047,Blue,0,29896,29952,56
2022-06-29,70044,70058,Blue,1,27954,28804,850
2022-11-14,70046,70058,Blue,1,31121,31733,612
2022-10-16,70047,70041,Blue,0,57155,57527,372
2022-10-01,70057,70043,Blue,0,86614,87386,772
2022-07-06,70059,70045,Blue,0,82813,83505,692
2022-10-07,70046,70058,Blue,1,31983,32670,687
2022-09-18,70049,70043,Blue,0,55491,55835,344
2022-12-19,70040,70050,Blue,1,41744,42321,577
2022-03-02,70042,70048,Blue,1,50452,50759,307
2022-06-18,70059,70039,Blue,0,64874,65870,996
2022-10-23,70038,70050,Blue,1,48841,49435,594
2022-10-23,70050,70060,Blue,1,65170,65688,518
2022-12-10,70059,70057,Blue,0,70814,70849,35
2022-10-26,70050,70054,Blue,1,60224,60438,214
2022-08-15,70059,70053,Blue,0,23838,24060,222
2022-03-15,70049,70045,Blue,0,22531,22836,305
2022-01-28,70051,70047,Blue,0,39696,39893,197
2022-01-31,70056,70058,Blue,1,73745,73817,72
2022-06-13,70050,70054,Blue,1,72083,72300,217
2022-09-11,70050,70052,Blue,1,59777,59888,111
2022-12-04,70053,70041,Blue,0,82486,83151,665
2022-07-19,70053,70043,Blue,0,54405,55005,600
2022-04-12,70044,70048,Blue,1,88515,88727,212
2022-11-06,70050,70058,Blue,1,61909,62319,410
2022-04-07,70050,70058,Blue,1,25810,26224,414
2022-03-15,70053,70041,Blue,0,20127,20768,641
2022-11-23,70049,70039,Blue,0,35777,36261,484
2022-04-17,70049,70039,Blue,0,88757,89824,1067
2022-02-20,70044,70052,Blue,1,79317,79926,609
2022-01-14,70055,70051,Blue,0,27445,27581,136
2022-12-15,70046,70060,Blue,1,36711,37505,794
2022-12-05,70039,70838,Blue,0,49359,49389,30
2022-12-29,70057,70039,Blue,0,34714,35634,920
2022-02-07,70051,70049,Blue,0,65367,65471,104
2022-03-29,70055,70049,Blue,0,25409,25693,284
2022-11-17,70043,70039,Blue,0,65873,66100,227
2022-07-08,70046,70056,Blue,1,67805,68392,587
2022-10-12,70053,70043,Blue,0,28754,29408,654
2022-07-17,70054,70058,Blue,1,32432,32602,170
2022-03-16,70055,70041,Blue,0,62791,63523,732
2022-09-16,70044,70056,Blue,1,69249,70027,778
2022-01-17,70059,70047,Blue,0,88250,88811,561
2022-08-19,70044,70054,Blue,1,36685,37332,647
2022-06-25,70046,70048,Blue,1,50191,50299,108
2022-02-13,70045,70043,Blue,0,73476,73579,103
2022-03-09,70050,70054,Blue,1,63803,64017,214
2022-07-09,70040,70054,Blue,1,39434,40210,776
2022-03-11,70054,70058,Blue,1,85956,86121,165
2022-02-06,70046,70060,Blue,1,35045,35710,665
2022-06-14,70044,70050,Blue,1,67576,67966,390
2022-08-10,70057,70043,Blue,0,76520,77258,738
2022-08-09,70044,70058,Blue,1,76961,77711,750
2022-01-23,70046,70052,Blue,1,42713,43065,352
2022-07-08,70059,70051,Blue,0,87704,88010,306
2022-02-25,70055,70045,Blue,0,30159,30757,598
2022-02-14,70059,70045,Blue,0,80597,81521,924
2022-03-21,70055,70049,Blue,0,44022,44404,382
2022-04-04,70042,70056,Blue,1,86140,86890,750
2022-04-24,70039,70838,Blue,0,28939,28978,39
2022-11-24,70050,70056,Blue,1,64036,64335,299
2022-01-03,70051,70838,Blue,0,65150,66554,1404
2022-06-29,70045,70039,Blue,0,28866,29159,293
2022-04-06,70055,70045,Blue,0,38841,39395,554
2022-02-23,70048,70058,Blue,1,34114,34647,533
2022-02-07,70052,70060,Blue,1,88500,88864,364
2022-07-13,70053,70051,Blue,0,64660,64719,59
2022-01-07,70052,70058,Blue,1,62742,63031,289
2022-04-17,70051,70049,Blue,0,41294,41394,100
2022-05-06,70059,70051,Blue,0,48317,48658,341
2022-04-18,70046,70056,Blue,1,65936,66409,473
2022-09-16,70040,70052,Blue,1,59548,60204,656
2022-10-12,70038,70044,Blue,1,58570,58805,235
2022-09-08,70038,70054,Blue,1,76275,77063,788
2022-08-26,70044,70058,Blue,1,62947,63776,829
2022-07-05,70053,70049,Blue,0,73057,73256,199
2022-12-05,70040,70044,Blue,1,70105,70232,127
2022-09-30,70045,70043,Blue,0,51790,51888,98
2022-10-10,70049,70047,Blue,0,40099,40152,53
2022-12-28,70049,70041,Blue,0,58970,59403,433
2022-12-01,70042,70046,Blue,1,72861,73036,175
2022-09-17,70057,70043,Blue,0,30933,31702,769
2022-01-25,70059,70047,Blue,0,58120,58725,605
2022-04-01,70042,70050,Blue,1,38632,39074,442
2022-09-27,70044,70056,Blue,1,44905,45603,698
2022-03-15,70046,70056,Blue,1,54711,55270,559
2022-08-23,70059,70838,Blue,0,59651,60785,1134
2022-08-22,70059,70045,Blue,0,68210,69584,1374
2022-12-27,70048,70052,Blue,1,25966,26189,223
2022-06-28,70040,70058,Blue,1,72870,73888,1018
2022-09-16,70057,70041,Blue,0,58087,58936,849
2022-03-20,70045,70043,Blue,0,63166,63269,103
2022-05-20,70040,70054,Blue,1,80968,81702,734
2022-11-22,70059,70838,Blue,0,53779,54962,1183
2022-12-11,70057,70045,Blue,0,66876,67532,656
2022-02-23,70048,70052,Blue,1,55557,55763,206
2022-01-26,70045,70041,Blue,0,35025,35232,207
2022-06-12,70051,70039,Blue,0,58096,58766,670
2022-04-09,70053,70045,Blue,0,70540,70967,427
2022-05-23,70041,70838,Blue,0,21076,21207,131
2022-04-26,70057,70047,Blue,0,29384,29952,568
2022-01-21,70046,70058,Blue,1,89603,90185,582
2022-04-04,70042,70052,Blue,1,33131,33668,537
2022-03-15,70048,70056,Blue,1,74552,75002,450
2022-02-25,70049,70047,Blue,0,48722,48779,57
2022-12-02,70039,70838,Blue,0,79688,79717,29
2022-07-02,70040,70050,Blue,1,79995,80503,508
2022-11-03,70040,70046,Blue,1,24964,25224,260
2022-05-01,70049,70047,Blue,0,22092,22130,38
2022-07-04,70042,70044,Blue,1,82748,82786,38
2022-03-31,70053,70041,Blue,0,24243,24927,684
2022-12-07,70043,70039,Blue,0,27492,27641,149
2022-07-01,70057,70051,Blue,0,53521,53772,251
2022-05-11,70050,70054,Blue,1,51028,51239,211
2022-12-25,70044,70058,Blue,1,83325,84123,798
2022-03-24,70044,70056,Blue,1,29846,30534,688
2022-11-11,70040,70044,Blue,1,80750,80856,106
2022-04-04,70038,70056,Blue,1,38634,39636,1002
2022-09-06,70046,70048,Blue,1,30501,30592,91
2022-11-07,70057,70043,Blue,0,63854,64691,837
2022-11-09,70047,70041,Blue,0,40585,40968,383
2022-01-25,70044,70060,Blue,1,86763,87652,889
2022-08-17,70057,70039,Blue,0,41492,42636,1144
2022-04-04,70038,70050,Blue,1,42472,43081,609
2022-06-10,70055,70041,Blue,0,57698,58497,799
2022-06-10,70056,70058,Blue,1,32106,32182,76
2022-03-09,70053,70039,Blue,0,54829,55615,786
2022-09-06,70050,70056,Blue,1,80547,80881,334
2022-04-07,70043,70041,Blue,0,54158,54187,29
2022-10-23,70044,70058,Blue,1,42520,43269,749
2022-03-15,70055,70051,Blue,0,29273,29417,144
2022-02-14,70048,70060,Blue,1,62457,63248,791
2022-03-28,70055,70047,Blue,0,50415,50778,363
2022-06-19,70055,70051,Blue,0,30337,30498,161
2022-06-24,70042,70046,Blue,1,26097,26273,176
2022-02-11,70040,70058,Blue,1,32146,33122,976
2022-02-21,70044,70050,Blue,1,80138,80470,332
2022-04-03,70059,70053,Blue,0,74897,75122,225
2022-11-17,70056,70060,Blue,1,39795,39967,172
2022-05-20,70039,70838,Blue,0,62606,62640,34
2022-10-04,70054,70058,Blue,1,51678,51835,157
2022-01-19,70050,70054,Blue,1,33476,33684,208
2022-01-07,70051,70043,Blue,0,83876,84445,569
2022-05-01,70054,70056,Blue,1,73384,73430,46
2022-09-09,70055,70049,Blue,0,72428,72698,270
2022-01-14,70057,70051,Blue,0,45042,45272,230
2022-03-29,70057,70838,Blue,0,56677,57696,1019
2022-12-20,70042,70058,Blue,1,39408,40302,894
2022-03-14,70059,70055,Blue,0,78924,79064,140
2022-10-09,70042,70054,Blue,1,65283,65974,691
2022-02-13,70055,70051,Blue,0,37047,37178,131
2022-07-14,70040,70060,Blue,1,47176,48373,1197
2022-12-22,70057,70838,Blue,0,22960,24086,1126
2022-03-14,70042,70058,Blue,1,28873,29652,779
2022-03-03,70059,70051,Blue,0,61999,62306,307
2022-08-11,70038,70050,Blue,1,34917,35447,530
2022-01-26,70038,70050,Blue,1,51194,51815,621
2022-08-30,70057,70039,Blue,0,69205,70088,883
2022-03-25,70042,70056,Blue,1,45955,46746,791
2022-01-08,70053,70039,Blue,0,46786,47527,741
2022-04-08,70055,70043,Blue,0,21885,22642,757
2022-12-31,70051,70041,Blue,0,87923,88558,635
2022-04-13,70044,70060,Blue,1,22053,23065,1012
2022-07-02,70039,70838,Blue,0,21297,21331,34
2022-11-09,70038,70050,Blue,1,81223,81851,628
2022-09-14,70053,70045,Blue,0,66509,66927,418
2022-10-05,70038,70042,Blue,1,31106,31211,105
2022-09-24,70040,70060,Blue,1,55116,56143,1027
2022-06-24,70044,70060,Blue,1,50645,51616,971
2022-02-02,70038,70058,Blue,1,86554,87520,966
2022-12-31,70042,70058,Blue,1,53583,54488,905
2022-09-08,70042,70052,Blue,1,51545,52114,569
2022-08-17,70040,70048,Blue,1,44723,45205,482
2022-02-16,70046,70056,Blue,1,23419,23984,565
2022-09-07,70057,70043,Blue,0,41058,42613,1555
2022-09-09,70051,70047,Blue,0,56038,56235,197
2022-02-27,70040,70054,Blue,1,88276,89045,769
2022-12-13,70059,70051,Blue,0,26258,26602,344
2022-01-25,70049,70043,Blue,0,67252,67557,305
2022-07-17,70044,70048,Blue,1,72841,73097,256
2022-08-31,70052,70058,Blue,1,62893,63162,269
2022-08-15,70050,70052,Blue,1,82395,82531,136
2022-03-07,70056,70060,Blue,1,31488,31679,191
2022-09-17,70057,70041,Blue,0,22906,23828,922
2022-03-24,70041,70838,Blue,0,58457,58575,118
2022-02-19,70048,70056,Blue,1,42629,42991,362
2022-07-12,70038,70046,Blue,1,39449,39852,403
2022-03-20,70055,70051,Blue,0,53041,53181,140
2022-12-28,70046,70056,Blue,1,34449,34953,504
2022-08-14,70049,70043,Blue,0,64085,64464,379
2022-06-13,70056,70058,Blue,1,40833,40904,71
2022-11-13,70051,70039,Blue,0,32765,33382,617
2022-09-17,70059,70057,Blue,0,57852,57887,35
2022-04-14,70054,70058,Blue,1,33759,33910,151
2022-09-24,70046,70052,Blue,1,39193,39501,308
2022-04-18,70041,70039,Blue,0,75393,75424,31
2022-04-21,70047,70043,Blue,0,44953,45208,255
2022-09-17,70038,70048,Blue,1,40377,40855,478
2022-02-13,70049,70838,Blue,0,71595,72227,632
2022-10-22,70059,70041,Blue,0,51373,52310,937
2022-04-18,70039,70838,Blue,0,20234,20334,100
2022-07-20,70045,70838,Blue,0,54491,54978,487
2022-09-10,70042,70048,Blue,1,44375,44703,328
2022-04-03,70038,70046,Blue,1,79705,80034,329
2022-09-06,70040,70052,Blue,1,27868,28539,671
2022-03-24,70044,70056,Blue,1,42095,42807,712
2022-10-03,70052,70054,Blue,1,32767,32827,60
2022-06-19,70040,70044,Blue,1,82410,82517,107
2022-03-29,70042,70050,Blue,1,31610,32052,442
2022-07-15,70041,70039,Blue,0,70080,70118,38
2022-11-29,70038,70052,Blue,1,28659,29408,749
2022-07-03,70059,70043,Blue,0,60900,61809,909
2022-06-28,70047,70838,Blue,0,59628,60132,504
2022-11-30,70042,70060,Blue,1,53284,54423,1139
2022-02-24,70051,70045,Blue,0,30707,31069,362
2022-01-14,70038,70040,Blue,1,83715,83730,15
2022-05-10,70053,70047,Blue,0,36005,36305,300
2022-01-23,70054,70058,Blue,1,80536,80698,162
2022-09-16,70055,70838,Blue,0,61629,62521,892
2022-10-17,70059,70043,Blue,0,61395,62221,826
2022-03-31,70042,70050,Blue,1,63897,64356,459
2022-05-04,70055,70053,Blue,0,51138,51183,45
2022-03-31,70040,70056,Blue,1,59636,60505,869
2022-03-25,70041,70039,Blue,0,35235,35269,34
2022-10-20,70052,70058,Blue,1,77452,77694,242
2022-07-07,70038,70042,Blue,1,59757,59898,141
2022-07-28,70046,70056,Blue,1,36625,37179,554
2022-02-10,70046,70052,Blue,1,82489,82808,319
2022-07-27,70047,70838,Blue,0,52614,53136,522
2022-01-26,70052,70058,Blue,1,48438,48696,258
2022-12-11,70048,70058,Blue,1,68814,69362,548
2022-01-05,70047,70838,Blue,0,65953,66471,518
2022-05-19,70040,70048,Blue,1,30105,30540,435
2022-09-05,70058,70060,Blue,1,71433,71492,59
2022-07-19,70038,70040,Blue,1,75923,75939,16
2022-11-21,70046,70060,Blue,1,77979,78898,919
2022-06-24,70046,70052,Blue,1,68224,68588,364
2022-08-02,70046,70060,Blue,1,26504,27320,816
2022-09-14,70042,70048,Blue,1,28359,28666,307
2022-03-11,70038,70050,Blue,1,34754,35282,528
2022-10-01,70052,70060,Blue,1,20701,21054,353
2022-06-22,70038,70046,Blue,1,64091,64443,352
2022-06-22,70053,70051,Blue,0,19828,19894,66
2022-11-07,70044,70054,Blue,1,79114,79735,621
2022-04-02,70059,70838,Blue,0,48140,49278,1138
2022-07-04,70049,70039,Blue,0,75293,75848,555
2022-11-29,70057,70838,Blue,0,21736,22833,1097
2022-02-10,70055,70049,Blue,0,66368,66637,269
2022-08-01,70047,70043,Blue,0,60969,61221,252
2022-07-07,70042,70048,Blue,1,41240,41592,352
2022-07-14,70051,70045,Blue,0,32195,32752,557
2022-08-14,70053,70047,Blue,0,57349,57640,291
2022-03-31,70057,70047,Blue,0,25826,26312,486
2022-09-14,70038,70052,Blue,1,34446,35122,676
2022-03-01,70052,70058,Blue,1,40320,40555,235
2022-02-12,70057,70051,Blue,0,60143,60413,270
2022-03-29,70051,70047,Blue,0,68205,68389,184
2022-09-28,70055,70043,Blue,0,79004,79624,620
2022-04-05,70046,70052,Blue,1,60860,61201,341
2022-02-11,70042,70050,Blue,1,26519,26924,405
2022-11-08,70055,70045,Blue,0,59192,59741,549
2022-11-11,70054,70056,Blue,1,81005,81053,48
2022-12-08,70038,70060,Blue,1,76236,77348,1112
2022-08-18,70048,70054,Blue,1,56914,57251,337
2022-12-28,70038,70052,Blue,1,57015,57781,766
2022-01-04,70049,70838,Blue,0,26776,27403,627
2022-03-19,70059,70043,Blue,0,80375,81207,832
2022-08-28,70055,70041,Blue,0,62683,63439,756
2022-02-16,70041,70039,Blue,0,40337,40371,34
2022-11-26,70047,70039,Blue,0,31530,31931,401
2022-06-25,70046,70054,Blue,1,25364,25825,461
2022-01-19,70045,70838,Blue,0,86430,86725,295
2022-06-12,70041,70039,Blue,0,74300,74332,32
2022-08-23,70040,70060,Blue,1,36455,37605,1150
2022-07-01,70047,70041,Blue,0,88505,88892,387
2022-03-16,70044,70054,Blue,1,28073,28683,610
2022-02-08,70057,70043,Blue,0,19953,20772,819
2022-01-19,70038,70042,Blue,1,24269,24360,91
2022-02-10,70053,70043,Blue,0,51507,52179,672
2022-02-05,70050,70056,Blue,1,37338,37668,330
2022-11-08,70042,70058,Blue,1,24576,25894,1318
2022-03-23,70040,70048,Blue,1,25534,25933,399
2022-03-09,70045,70041,Blue,0,44658,44836,178
2022-04-01,70050,70056,Blue,1,49317,49630,313
2022-05-06,70055,70049,Blue,0,22770,23067,297
2022-07-28,70041,70039,Blue,0,28609,28638,29
2022-01-17,70046,70058,Blue,1,38138,38796,658
2022-02-20,70046,70058,Blue,1,72423,73012,589
2022-04-01,70040,70042,Blue,1,23113,23147,34
2022-03-31,70053,70838,Blue,0,29624,30456,832
2022-12-09,70046,70056,Blue,1,83721,84259,538
2022-06-23,70057,70838,Blue,0,73878,74920,1042
2022-06-28,70038,70050,Blue,1,53926,54570,644
2022-12-14,70044,70054,Blue,1,53244,53851,607
2022-10-23,70038,70050,Blue,1,75851,76409,558
2022-01-10,70057,70838,Blue,0,58463,59469,1006
2022-09-13,70051,70049,Blue,0,79228,79330,102
2022-03-24,70042,70054,Blue,1,24140,24821,681
2022-07-02,70057,70838,Blue,0,44438,45525,1087
2022-02-24,70040,70052,Blue,1,69981,70672,691
2022-04-22,70040,70052,Blue,1,39073,39717,644
2022-04-05,70044,70056,Blue,1,44378,45057,679
2022-07-19,70040,70052,Blue,1,24554,25247,693
2022-11-16,70038,70042,Blue,1,30254,30350,96
2022-01-07,70053,70045,Blue,0,26695,27189,494
2022-09-14,70042,70060,Blue,1,38617,39762,1145
2022-05-21,70042,70044,Blue,1,25891,25920,29
2022-10-17,70051,70045,Blue,0,65362,65694,332
2022-01-08,70042,70056,Blue,1,79540,80315,775
2022-08-27,70044,70054,Blue,1,26511,27098,587
2022-12-23,70050,70052,Blue,1,33853,34013,160
2022-03-19,70044,70056,Blue,1,66063,66773,710
2022-04-09,70044,70054,Blue,1,54718,55285,567
2022-03-07,70042,70058,Blue,1,30989,31949,960
2022-08-24,70057,70045,Blue,0,59078,59768,690
2022-12-31,70057,70049,Blue,0,44434,44835,401
2022-04-10,70059,70043,Blue,0,23056,23981,925
2022-04-18,70046,70050,Blue,1,78004,78305,301
2022-06-06,70038,70040,Blue,1,24314,24329,15
2022-06-14,70044,70056,Blue,1,71674,72391,717
2022-10-26,70052,70060,Blue,1,49415,49779,364
2022-10-27,70044,70054,Blue,1,86910,87462,552
2022-07-19,70048,70060,Blue,1,30844,31502,658
2022-05-07,70055,70047,Blue,0,50005,50375,370
2022-02-16,70040,70048,Blue,1,21613,21974,361
2022-10-31,70051,70043,Blue,0,54987,55482,495
2022-06-18,70056,70058,Blue,1,64215,64285,70
2022-06-24,70051,70039,Blue,0,24848,25554,706
2022-11-04,70047,70045,Blue,0,59258,59369,111
2022-01-04,70057,70051,Blue,0,20330,20610,280
2022-04-02,70057,70043,Blue,0,76536,77296,760
2022-11-25,70059,70057,Blue,0,42642,42680,38
2022-08-22,70050,70058,Blue,1,55650,56108,458
2022-11-15,70045,70838,Blue,0,53283,53651,368
2022-08-19,70040,70058,Blue,1,24564,25572,1008
2022-07-07,70053,70043,Blue,0,24558,25200,642
2022-06-22,70042,70052,Blue,1,32546,33165,619
2022-11-01,70053,70041,Blue,0,72501,73122,621
2022-04-15,70046,70052,Blue,1,22479,22789,310
2022-04-23,70042,70060,Blue,1,54661,55654,993
2022-11-03,70059,70051,Blue,0,43188,43524,336
2022-08-04,70042,70052,Blue,1,39612,40225,613
2022-10-16,70057,70838,Blue,0,65787,66785,998
2022-08-28,70056,70060,Blue,1,38055,38237,182
2022-01-28,70053,70051,Blue,0,40113,40173,60
2022-12-01,70044,70056,Blue,1,51104,51814,710
2022-03-25,70048,70052,Blue,1,82483,82697,214
2022-04-10,70059,70043,Blue,0,79029,79598,569
2022-11-03,70057,70047,Blue,0,80730,81210,480
2022-04-12,70040,70054,Blue,1,33306,34110,804
2022-12-29,70042,70046,Blue,1,30434,30603,169
2022-09-16,70042,70044,Blue,1,87543,87578,35
2022-03-06,70059,70047,Blue,0,53837,54404,567
2022-03-07,70038,70048,Blue,1,28511,29020,509
2022-10-30,70038,70040,Blue,1,58046,58062,16
2022-03-28,70057,70041,Blue,0,61282,62197,915
2022-03-20,70042,70052,Blue,1,75982,76585,603
2022-04-05,70054,70056,Blue,1,23913,23960,47
2022-02-18,70038,70042,Blue,1,59921,60031,110
2022-04-06,70047,70045,Blue,0,47235,47325,90
2022-02-14,70042,70056,Blue,1,37048,37913,865
2022-07-03,70047,70043,Blue,0,59289,59541,252
2022-02-04,70044,70048,Blue,1,24246,24509,263
2022-04-21,70051,70045,Blue,0,60547,60907,360
2022-10-03,70049,70045,Blue,0,55133,55320,187
2022-09-26,70043,70041,Blue,0,77342,77369,27
2022-07-25,70038,70060,Blue,1,84126,85255,1129
2022-01-31,70059,70045,Blue,0,62399,63128,729
2022-12-18,70053,70047,Blue,0,45452,45742,290
2022-08-22,70051,70045,Blue,0,37360,37709,349
2022-10-24,70048,70060,Blue,1,30352,30966,614
2022-02-07,70050,70054,Blue,1,61343,61572,229
2022-01-16,70047,70043,Blue,0,35435,35713,278
2022-06-21,70046,70060,Blue,1,26328,27238,910
2022-07-03,70046,70054,Blue,1,73585,74062,477
2022-11-08,70041,70039,Blue,0,59244,59286,42
2022-04-17,70051,70838,Blue,0,52582,53346,764
2022-01-24,70053,70838,Blue,0,21605,22556,951
2022-06-05,70039,70838,Blue,0,58204,58236,32
2022-11-16,70057,70838,Blue,0,55184,56212,1028
2022-07-25,70043,70039,Blue,0,34086,34200,114
2022-02-01,70038,70040,Blue,1,49353,49369,16
2022-09-24,70046,70048,Blue,1,67294,67382,88
2022-10-11,70043,70041,Blue,0,79005,79033,28
2022-01-10,70057,70055,Blue,0,67245,67314,69
2022-12-30,70058,70060,Blue,1,68971,69164,193
2022-01-25,70048,70056,Blue,1,69113,69505,392
2022-01-05,70038,70058,Blue,1,24266,25338,1072
2022-12-10,70057,70049,Blue,0,43913,44306,393
2022-10-16,70059,70053,Blue,0,32412,32638,226
2022-03-17,70059,70045,Blue,0,30868,31654,786
2022-11-29,70039,70838,Blue,0,66641,66679,38
2022-12-30,70038,70048,Blue,1,59273,59732,459
2022-04-13,70042,70046,Blue,1,54958,55136,178
2022-02-24,70055,70041,Blue,0,33433,34262,829
2022-04-13,70044,70054,Blue,1,26270,26871,601
2022-08-25,70048,70054,Blue,1,51637,51926,289
2022-06-14,70057,70053,Blue,0,63875,64029,154
2022-04-21,70049,70039,Blue,0,66071,66555,484
2022-12-05,70040,70052,Blue,1,45173,45832,659
2022-11-01,70044,70060,Blue,1,28773,29759,986
2022-09-07,70040,70048,Blue,1,83417,83792,375
2022-04-05,70049,70045,Blue,0,29593,29800,207
2022-03-28,70057,70043,Blue,0,82965,83834,869
2022-02-23,70038,70044,Blue,1,65533,65764,231
2022-07-17,70059,70838,Blue,0,65719,66816,1097
2022-08-07,70059,70041,Blue,0,84729,85576,847
2022-07-31,70049,70838,Blue,0,78105,78706,601
2022-10-03,70045,70041,Blue,0,72597,72767,170
2022-11-05,70057,70053,Blue,0,39676,39834,158
2022-07-22,70057,70047,Blue,0,85065,85555,490
2022-10-01,70054,70056,Blue,1,60357,60407,50
2022-03-10,70039,70838,Blue,0,29971,30008,37
2022-10-14,70038,70056,Blue,1,57621,58592,971
2022-12-20,70053,70039,Blue,0,20675,21410,735
2022-10-25,70041,70039,Blue,0,66555,66589,34
2022-04-21,70039,70838,Blue,0,26981,27022,41
2022-10-18,70056,70060,Blue,1,45351,45531,180
2022-01-24,70044,70050,Blue,1,88867,89277,410
2022-09-23,70038,70048,Blue,1,35298,35728,430
2022-01-18,70050,70058,Blue,1,22471,22891,420
2022-08-19,70042,70044,Blue,1,30942,30973,31
2022-08-29,70049,70045,Blue,0,32812,33016,204
2022-01-10,70053,70838,Blue,0,55063,55912,849
2022-06-27,70051,70838,Blue,0,54142,54942,800
2022-09-21,70040,70054,Blue,1,40184,40958,774
2022-12-24,70052,70056,Blue,1,26071,26205,134
2022-03-04,70042,70046,Blue,1,82181,82350,169
2022-03-07,70059,70055,Blue,0,62299,62444,145
2022-07-24,70055,70041,Blue,0,32598,33318,720
2022-09-03,70052,70060,Blue,1,28827,29176,349
2022-06-17,70040,70050,Blue,1,69935,70430,495
2022-12-25,70058,70060,Blue,1,88368,88435,67
2022-03-01,70048,70054,Blue,1,62903,63251,348
2022-10-21,70042,70050,Blue,1,35007,35415,408
2022-06-15,70058,70060,Blue,1,43743,43811,68
2022-06-03,70038,70050,Blue,1,67514,68216,702
2022-06-12,70044,70054,Blue,1,75538,76138,600
2022-10-12,70053,70041,Blue,0,30874,31602,728
2022-02-23,70046,70048,Blue,1,31528,31622,94
2022-05-19,70040,70050,Blue,1,66908,67543,635
2022-04-08,70055,70051,Blue,0,30765,30910,145
2022-01-21,70040,70058,Blue,1,40219,41141,922
2022-10-23,70042,70046,Blue,1,66838,67017,179
2022-12-12,70059,70041,Blue,0,63429,64321,892
2022-12-31,70049,70047,Blue,0,65811,65863,52
2022-10-04,70059,70043,Blue,0,74895,75774,879
2022-07-04,70048,70060,Blue,1,87422,88166,744
2022-07-28,70040,70048,Blue,1,38535,38948,413
2022-11-06,70046,70050,Blue,1,34254,34422,168
2022-11-03,70047,70838,Blue,0,80835,81306,471
2022-08-05,70040,70056,Blue,1,33420,34278,858
2022-03-02,70052,70060,Blue,1,60225,61091,866
2022-11-30,70053,70041,Blue,0,63675,64295,620
2022-12-21,70049,70039,Blue,0,54584,55059,475
2022-08-10,70052,70058,Blue,1,81388,81636,248
2022-09-13,70042,70046,Blue,1,24682,24865,183
2022-01-26,70044,70048,Blue,1,22963,23218,255
2022-09-18,70044,70046,Blue,1,52842,52940,98
2022-07-13,70050,70058,Blue,1,30243,30664,421
2022-05-23,70045,70043,Blue,0,47511,47624,113
2022-11-01,70057,70838,Blue,0,51040,52094,1054
2022-04-11,70053,70047,Blue,0,88414,88697,283
2022-12-30,70050,70052,Blue,1,54944,55066,122
2022-02-26,70057,70053,Blue,0,37959,38109,150
2022-03-07,70053,70051,Blue,0,62168,62225,57
2022-01-12,70046,70060,Blue,1,66571,67278,707
2022-06-02,70047,70045,Blue,0,21945,22049,104
2022-07-26,70044,70046,Blue,1,27342,27451,109
2022-12-23,70047,70043,Blue,0,21854,22140,286
2022-06-01,70046,70050,Blue,1,53097,53314,217
2022-04-19,70038,70060,Blue,1,28188,29432,1244
2022-10-02,70059,70039,Blue,0,26961,27973,1012
2022-11-02,70044,70050,Blue,1,36693,37031,338
2022-04-08,70047,70039,Blue,0,50346,50747,401
2022-10-05,70055,70838,Blue,0,47013,47931,918
2022-10-05,70057,70055,Blue,0,56724,56793,69
2022-04-05,70059,70055,Blue,0,23359,23515,156
2022-09-21,70050,70058,Blue,1,63483,63896,413
2022-09-28,70040,70048,Blue,1,54221,54564,343
2022-07-08,70038,70048,Blue,1,64793,65341,548
2022-03-28,70040,70054,Blue,1,54103,54852,749
2022-10-21,70052,70054,Blue,1,33649,33707,58
2022-05-29,70049,70039,Blue,0,55640,56199,559
2022-09-16,70046,70052,Blue,1,70472,70822,350
2022-04-11,70042,70058,Blue,1,42596,43507,911
2022-10-18,70044,70060,Blue,1,35118,35984,866
2022-11-17,70048,70052,Blue,1,31372,31589,217
2022-04-15,70040,70042,Blue,1,38802,38837,35
2022-08-21,70048,70056,Blue,1,58549,58929,380
2022-09-06,70057,70838,Blue,0,24654,25752,1098
2022-06-20,70059,70039,Blue,0,38510,39628,1118
2022-01-14,70057,70039,Blue,0,33927,34944,1017
2022-09-09,70048,70050,Blue,1,60752,60808,56
2022-02-05,70042,70060,Blue,1,68682,69617,935
2022-01-18,70051,70045,Blue,0,48531,48870,339
2022-06-13,70038,70040,Blue,1,61628,61648,20
2022-12-22,70049,70039,Blue,0,59946,60468,522
2022-01-15,70059,70043,Blue,0,37333,38171,838
2022-12-21,70045,70043,Blue,0,21864,21967,103
2022-08-11,70048,70060,Blue,1,78768,79340,572
2022-07-25,70057,70041,Blue,0,60253,61164,911
2022-09-04,70054,70056,Blue,1,76682,76729,47
2022-11-21,70053,70043,Blue,0,66274,66836,562
2022-05-07,70053,70051,Blue,0,83818,83889,71
2022-10-04,70050,70056,Blue,1,81951,82361,410
2022-12-19,70043,70838,Blue,0,34208,34455,247
2022-03-16,70053,70043,Blue,0,74016,74596,580
2022-01-24,70057,70055,Blue,0,48753,48822,69
2022-10-13,70038,70050,Blue,1,51791,52348,557
2022-09-06,70044,70058,Blue,1,72474,73303,829
2022-12-01,70041,70838,Blue,0,74771,74890,119
2022-01-25,70051,70045,Blue,0,83200,83583,383
2022-07-27,70055,70051,Blue,0,78573,78711,138
2022-03-18,70059,70051,Blue,0,26839,27177,338
2022-06-25,70059,70049,Blue,0,74354,74816,462
2022-08-14,70051,70049,Blue,0,76903,77008,105
2022-02-18,70051,70047,Blue,0,53679,53877,198
2022-04-11,70046,70048,Blue,1,68007,68083,76
2022-06-17,70054,70058,Blue,1,33884,34055,171
2022-06-02,70047,70045,Blue,0,72801,72896,95
2022-06-05,70040,70052,Blue,1,50179,50956,777
2022-03-30,70046,70056,Blue,1,62011,62589,578
2022-03-24,70050,70060,Blue,1,77603,78086,483
2022-04-03,70052,70054,Blue,1,57682,57732,50
2022-01-08,70057,70051,Blue,0,31468,31710,242
2022-01-25,70054,70060,Blue,1,53742,54080,338
2022-09-29,70059,70055,Blue,0,24255,24404,149
2022-01-22,70044,70056,Blue,1,62273,62955,682
2022-03-16,70057,70053,Blue,0,81266,81416,150
2022-03-23,70042,70044,Blue,1,59364,59395,31
2022-06-21,70038,70056,Blue,1,36854,37923,1069
2022-12-02,70038,70050,Blue,1,36732,37277,545
2022-03-11,70040,70060,Blue,1,58102,59199,1097
2022-09-06,70046,70048,Blue,1,44045,44128,83
2022-11-18,70042,70052,Blue,1,63314,63955,641
2022-12-05,70040,70050,Blue,1,33252,33772,520
2022-04-19,70056,70060,Blue,1,65613,65805,192
2022-05-08,70058,70060,Blue,1,82686,82758,72
2022-11-14,70050,70058,Blue,1,40526,40990,464
2022-06-16,70057,70049,Blue,0,53194,53583,389
2022-01-13,70044,70056,Blue,1,86279,86938,659
2022-01-07,70042,70050,Blue,1,27165,27578,413
2022-11-14,70042,70054,Blue,1,26004,26600,596
2022-01-23,70044,70052,Blue,1,69603,70110,507
2022-10-04,70057,70045,Blue,0,50498,51089,591
2022-10-11,70055,70049,Blue,0,78332,78604,272
2022-02-28,70045,70039,Blue,0,45688,45924,236
2022-12-25,70055,70051,Blue,0,88431,88572,141
2022-03-02,70040,70052,Blue,1,80431,81091,660
2022-11-07,70044,70056,Blue,1,67301,67990,689
2022-02-02,70040,70050,Blue,1,64609,65097,488
2022-07-19,70044,70052,Blue,1,33238,33786,548
2022-07-05,70046,70058,Blue,1,29365,30031,666
2022-07-27,70046,70060,Blue,1,39184,40186,1002
2022-01-07,70055,70047,Blue,0,20450,20883,433
2022-02-17,70044,70054,Blue,1,52659,53255,596
2022-10-26,70054,70060,Blue,1,74093,74365,272
2022-02-13,70059,70043,Blue,0,56539,57406,867
2022-12-09,70038,70048,Blue,1,21380,21826,446
2022-12-23,70051,70049,Blue,0,25924,26071,147
2022-03-27,70042,70046,Blue,1,23225,23419,194
2022-01-02,70053,70041,Blue,0,68688,69330,642
2022-04-06,70057,70049,Blue,0,34786,35202,416
2022-12-18,70042,70060,Blue,1,38504,39475,971
2022-07-04,70055,70049,Blue,0,70756,71025,269
2022-05-19,70040,70056,Blue,1,43706,44663,957
2022-02-13,70059,70049,Blue,0,77593,78049,456
2022-08-01,70048,70060,Blue,1,81663,82236,573
2022-04-24,70046,70060,Blue,1,55743,56472,729
2022-01-20,70051,70838,Blue,0,26773,27591,818
2022-09-15,70051,70043,Blue,0,80997,81472,475
2022-04-13,70044,70058,Blue,1,54263,55108,845
2022-09-15,70055,70041,Blue,0,42504,43960,1456
2022-02-25,70040,70046,Blue,1,74221,74498,277
2022-03-26,70048,70058,Blue,1,31211,31704,493
2022-02-15,70052,70058,Blue,1,60627,60881,254
2022-07-08,70053,70039,Blue,0,57457,58224,767
2022-06-13,70038,70048,Blue,1,24921,25419,498
2022-04-21,70040,70050,Blue,1,85448,85899,451
2022-03-04,70042,70058,Blue,1,63287,64145,858
2022-12-31,70059,70057,Blue,0,77411,77446,35
2022-06-27,70038,70056,Blue,1,83535,84542,1007
2022-05-03,70052,70058,Blue,1,82720,82981,261
2022-07-19,70057,70838,Blue,0,86799,87725,926
2022-11-04,70042,70054,Blue,1,41559,42236,677
2022-03-25,70053,70051,Blue,0,27544,27600,56
2022-01-03,70040,70044,Blue,1,79864,79980,116
2022-01-11,70059,70047,Blue,0,59592,60121,529
2022-07-14,70045,70039,Blue,0,27559,27862,303
2022-02-28,70045,70043,Blue,0,52313,52404,91
2022-08-24,70051,70041,Blue,0,60326,61020,694
2022-09-02,70057,70041,Blue,0,60922,61837,915
2022-09-20,70059,70838,Blue,0,49393,50567,1174
2022-10-06,70048,70058,Blue,1,72164,72682,518
2022-12-19,70058,70060,Blue,1,56047,56225,178
2022-10-05,70041,70838,Blue,0,33343,33478,135
2022-02-10,70038,70060,Blue,1,80875,82043,1168
2022-04-03,70050,70056,Blue,1,73165,73442,277
2022-09-29,70050,70060,Blue,1,48947,49451,504
2022-04-19,70038,70060,Blue,1,31451,32688,1237
2022-11-25,70047,70043,Blue,0,67145,67371,226
2022-02-14,70048,70060,Blue,1,88315,88908,593
2022-08-10,70042,70048,Blue,1,35112,35458,346
2022-02-28,70048,70054,Blue,1,68737,69065,328
2022-01-27,70044,70052,Blue,1,67626,68207,581
2022-04-15,70040,70046,Blue,1,78294,78552,258
2022-06-12,70038,70042,Blue,1,41647,41736,89
2022-11-18,70044,70060,Blue,1,49747,50750,1003
2022-12-09,70046,70054,Blue,1,41218,41698,480
2022-08-22,70053,70043,Blue,0,22272,22883,611
2022-08-11,70046,70060,Blue,1,78655,79340,685
2022-02-13,70055,70041,Blue,0,48636,49402,766
2022-07-21,70051,70039,Blue,0,18789,19480,691
2022-03-07,70044,70050,Blue,1,25379,25721,342
2022-06-15,70049,70043,Blue,0,31144,31532,388
2022-02-05,70046,70054,Blue,1,87749,88170,421
2022-04-17,70051,70047,Blue,0,83335,83525,190
2022-03-26,70059,70039,Blue,0,88294,89467,1173
2022-08-05,70059,70838,Blue,0,19513,20766,1253
2022-04-06,70038,70040,Blue,1,27554,27569,15
2022-11-21,70059,70051,Blue,0,56187,56541,354
2022-06-22,70043,70041,Blue,0,29228,29258,30
2022-06-12,70043,70838,Blue,0,47743,47925,182
2022-08-26,70055,70049,Blue,0,22346,22623,277
2022-10-01,70040,70058,Blue,1,59443,60515,1072
2022-12-05,70038,70058,Blue,1,22990,24018,1028
2022-02-22,70038,70040,Blue,1,49749,49767,18
2022-06-13,70051,70045,Blue,0,60875,61241,366
2022-03-08,70042,70060,Blue,1,43099,44018,919
2022-12-14,70043,70838,Blue,0,23570,23986,416
2022-12-05,70056,70058,Blue,1,62170,62247,77
2022-12-04,70055,70047,Blue,0,33505,33872,367
2022-02-15,70044,70060,Blue,1,81061,82004,943
2022-09-19,70045,70838,Blue,0,42995,43364,369
2022-03-24,70040,70046,Blue,1,49274,49552,278
2022-12-07,70046,70052,Blue,1,69353,69687,334
2022-11-01,70057,70043,Blue,0,23506,24365,859
2022-10-05,70053,70045,Blue,0,57985,58410,425
2022-01-12,70045,70838,Blue,0,84302,84635,333
2022-07-06,70040,70042,Blue,1,77961,77992,31
2022-07-27,70048,70058,Blue,1,80906,81455,549
2022-03-22,70040,70050,Blue,1,75266,75829,563
2022-03-18,70057,70041,Blue,0,55255,56102,847
2022-04-28,70056,70060,Blue,1,58775,58972,197
2022-09-29,70057,70049,Blue,0,33576,33987,411
2022-12-08,70044,70048,Blue,1,78598,78844,246
2022-08-11,70057,70055,Blue,0,21512,21581,69
2022-12-15,70046,70048,Blue,1,63705,63779,74
2022-07-29,70048,70060,Blue,1,48891,49520,629
2022-06-06,70049,70838,Blue,0,25616,26249,633
2022-09-24,70038,70042,Blue,1,28598,28688,90
2022-11-08,70038,70058,Blue,1,70823,71739,916
2022-04-17,70044,70054,Blue,1,79314,80003,689
2022-03-17,70043,70039,Blue,0,28707,28807,100
2022-11-27,70057,70041,Blue,0,36801,37616,815
2022-12-12,70042,70044,Blue,1,30124,30153,29
2022-04-17,70059,70045,Blue,0,38837,40621,1784
2022-07-18,70045,70041,Blue,0,31733,31985,252
2022-06-14,70042,70058,Blue,1,70670,71584,914
2022-09-04,70045,70838,Blue,0,80960,81285,325
2022-06-14,70054,70056,Blue,1,36771,36819,48
2022-02-13,70048,70050,Blue,1,47361,47422,61
2022-11-13,70038,70040,Blue,1,50473,50487,14
2022-12-23,70046,70050,Blue,1,43615,43803,188
2022-11-11,70039,70838,Blue,0,46324,46354,30
2022-04-19,70055,70838,Blue,0,53790,54701,911
2022-02-24,70059,70055,Blue,0,86893,87052,159
2022-09-17,70038,70046,Blue,1,29107,29433,326
2022-12-28,70049,70043,Blue,0,28405,28715,310
2022-03-15,70046,70054,Blue,1,55192,55657,465
2022-03-22,70055,70039,Blue,0,25443,26338,895
2022-12-15,70043,70039,Blue,0,23992,24104,112
2022-04-18,70040,70060,Blue,1,29102,30183,1081
2022-09-08,70051,70049,Blue,0,35797,35942,145
2022-09-24,70042,70054,Blue,1,47632,48310,678
2022-11-19,70046,70058,Blue,1,72702,73364,662
2022-02-08,70054,70056,Blue,1,26592,26639,47
2022-07-08,70054,70060,Blue,1,85174,85435,261
2022-08-30,70059,70053,Blue,0,33080,33317,237
2022-03-28,70056,70060,Blue,1,42967,43154,187
2022-05-19,70044,70058,Blue,1,88009,88923,914
2022-08-16,70038,70058,Blue,1,88226,89175,949
2022-03-04,70049,70838,Blue,0,22074,22706,632
2022-10-13,70053,70041,Blue,0,67005,67770,765
2022-10-18,70044,70050,Blue,1,35497,35817,320
2022-01-25,70040,70054,Blue,1,31856,32688,832
2022-12-15,70054,70056,Blue,1,30279,30326,47
2022-04-16,70048,70060,Blue,1,44758,45353,595
2022-08-22,70053,70047,Blue,0,79468,79741,273
2022-03-31,70050,70056,Blue,1,67625,67931,306
2022-03-25,70050,70060,Blue,1,21033,21590,557
2022-10-13,70059,70045,Blue,0,51494,52159,665
2022-03-05,70051,70039,Blue,0,47440,48113,673
2022-09-14,70045,70043,Blue,0,27575,27688,113
2022-03-22,70041,70039,Blue,0,38587,38624,37
2022-02-28,70048,70058,Blue,1,62560,63065,505
2022-01-21,70044,70060,Blue,1,25273,26280,1007
2022-11-04,70050,70056,Blue,1,24354,24716,362
2022-02-17,70044,70060,Blue,1,64601,65560,959
2022-07-29,70050,70054,Blue,1,27102,27345,243
2022-03-04,70055,70053,Blue,0,42252,42321,69
2022-03-30,70045,70039,Blue,0,70845,71085,240
2022-11-28,70038,70048,Blue,1,77324,77807,483
2022-08-10,70050,70058,Blue,1,37922,38322,400
2022-12-26,70040,70048,Blue,1,77542,77933,391
2022-08-23,70040,70050,Blue,1,32148,32660,512
2022-09-28,70044,70048,Blue,1,57828,58068,240
2022-11-29,70057,70047,Blue,0,26745,27245,500
2022-07-23,70052,70058,Blue,1,44968,45220,252
2022-08-16,70049,70047,Blue,0,23924,23982,58
2022-12-03,70053,70041,Blue,0,41395,42106,711
2022-11-03,70051,70047,Blue,0,50771,51327,556
2022-01-09,70051,70043,Blue,0,70939,71395,456
2022-01-02,70054,70060,Blue,1,73459,73706,247
2022-11-29,70048,70054,Blue,1,55495,55813,318
2022-02-06,70038,70050,Blue,1,64010,64590,580
2022-07-01,70053,70041,Blue,0,62772,63443,671
2022-08-23,70048,70052,Blue,1,67344,67550,206
2022-12-29,70042,70044,Blue,1,30181,30219,38
2022-09-15,70042,70052,Blue,1,31712,32347,635
2022-06-25,70040,70060,Blue,1,44397,45483,1086
2022-05-07,70059,70057,Blue,0,53413,53448,35
2022-05-18,70045,70043,Blue,0,28439,28586,147
2022-09-15,70046,70056,Blue,1,48033,48636,603
2022-08-08,70055,70043,Blue,0,25708,26390,682
2022-05-02,70057,70049,Blue,0,23492,23899,407
2022-03-01,70046,70050,Blue,1,73361,73562,201
2022-04-07,70040,70046,Blue,1,89221,89454,233
2022-02-13,70040,70042,Blue,1,77533,77564,31
2022-03-29,70044,70046,Blue,1,59756,59862,106
2022-11-23,70048,70056,Blue,1,37210,37620,410
2022-11-20,70051,70041,Blue,0,38409,38945,536
2022-08-07,70053,70045,Blue,0,75166,75599,433
2022-10-25,70042,70058,Blue,1,74848,75652,804
2022-02-03,70038,70058,Blue,1,52453,53475,1022
2022-07-24,70051,70045,Blue,0,62911,63259,348
2022-04-14,70038,70050,Blue,1,83706,84287,581
2022-12-03,70042,70056,Blue,1,23336,24085,749
2022-06-29,70057,70043,Blue,0,83664,84406,742
2022-02-15,70044,70048,Blue,1,54106,54363,257
2022-12-05,70059,70051,Blue,0,27081,27394,313
2022-02-08,70047,70838,Blue,0,38785,39524,739
2022-01-21,70058,70060,Blue,1,68990,69163,173
2022-12-06,70038,70060,Blue,1,39852,40981,1129
2022-10-10,70038,70058,Blue,1,44891,45974,1083
2022-08-01,70047,70838,Blue,0,61935,62432,497
2022-01-02,70042,70058,Blue,1,24717,25559,842
2022-01-24,70047,70045,Blue,0,36468,36559,91
2022-01-14,70059,70049,Blue,0,84007,84451,444
2022-08-25,70044,70050,Blue,1,75023,75380,357
2022-01-17,70055,70043,Blue,0,46693,47411,718
2022-03-23,70058,70060,Blue,1,58488,58624,136
2022-06-09,70038,70060,Blue,1,58767,60740,1973
2022-01-23,70048,70054,Blue,1,47756,48054,298
2022-01-05,70055,70838,Blue,0,27150,28075,925
2022-02-24,70038,70052,Blue,1,69434,70251,817
2022-09-26,70055,70053,Blue,0,45467,45514,47
2022-03-17,70057,70045,Blue,0,66824,67435,611
2022-03-09,70059,70055,Blue,0,27554,27706,152
2022-09-08,70038,70046,Blue,1,23608,23908,300
2022-12-08,70059,70047,Blue,0,48957,49508,551
2022-04-05,70049,70838,Blue,0,27746,28337,591
2022-06-20,70053,70049,Blue,0,23282,23483,201
2022-03-16,70040,70046,Blue,1,89220,89453,233
2022-11-14,70051,70041,Blue,0,72132,72714,582
2022-04-06,70059,70838,Blue,0,39253,40588,1335
2022-12-29,70051,70041,Blue,0,85190,85752,562
2022-09-01,70040,70042,Blue,1,72893,72929,36
2022-02-03,70059,70039,Blue,0,50242,51258,1016
2022-05-18,70056,70060,Blue,1,50710,50879,169
2022-02-15,70041,70838,Blue,0,55232,55371,139
2022-03-19,70038,70050,Blue,1,23652,24232,580
2022-06-21,70052,70060,Blue,1,57050,57466,416
2022-01-21,70049,70045,Blue,0,61340,61772,432
2022-09-18,70057,70045,Blue,0,72819,73528,709
2022-11-04,70051,70838,Blue,0,38574,39367,793
2022-03-10,70059,70045,Blue,0,69975,70677,702
2022-06-17,70053,70039,Blue,0,51027,51795,768
2022-01-03,70040,70042,Blue,1,23432,23472,40
2022-06-09,70044,70046,Blue,1,53587,53713,126
2022-03-05,70057,70045,Blue,0,61175,61835,660
2022-08-03,70052,70054,Blue,1,61321,61383,62
2022-03-07,70057,70049,Blue,0,55188,55567,379
2022-09-11,70053,70039,Blue,0,69221,69953,732
2022-12-28,70038,70060,Blue,1,62093,63249,1156
2022-09-06,70053,70051,Blue,0,54339,54391,52
2022-11-25,70055,70053,Blue,0,30340,30390,50
2022-10-28,70059,70051,Blue,0,87408,87715,307
2022-03-08,70046,70050,Blue,1,22155,22357,202
2022-07-08,70049,70838,Blue,0,67599,68231,632
2022-05-16,70052,70060,Blue,1,69239,69583,344
2022-07-29,70038,70054,Blue,1,22830,23705,875
2022-12-18,70056,70060,Blue,1,31697,31861,164
2022-11-04,70053,70043,Blue,0,20978,21629,651
2022-08-26,70055,70053,Blue,0,70755,70804,49
2022-01-05,70054,70056,Blue,1,70304,70351,47
2022-03-18,70057,70045,Blue,0,60573,61239,666
2022-08-25,70057,70047,Blue,0,31907,32384,477
2022-06-09,70049,70045,Blue,0,50913,51147,234
2022-12-30,70048,70052,Blue,1,89786,90014,228
2022-11-24,70059,70053,Blue,0,30857,31078,221
2022-11-30,70038,70050,Blue,1,77887,78457,570
2022-07-02,70042,70056,Blue,1,38439,39215,776
2022-10-28,70052,70054,Blue,1,73457,73508,51
2022-12-12,70059,70049,Blue,0,57199,57675,476
2022-02-02,70048,70052,Blue,1,82648,82852,204
2022-03-08,70049,70043,Blue,0,31965,32288,323
2022-07-15,70053,70838,Blue,0,26396,27472,1076
2022-11-21,70051,70041,Blue,0,25360,25951,591
2022-03-26,70044,70058,Blue,1,37972,38798,826
2022-11-22,70043,70041,Blue,0,62455,62482,27
2022-09-06,70043,70041,Blue,0,66216,66251,35
2022-02-10,70053,70047,Blue,0,30854,31148,294
2022-10-21,70050,70058,Blue,1,77346,77741,395
2022-04-06,70052,70058,Blue,1,83412,83679,267
2022-01-06,70038,70058,Blue,1,80299,81267,968
2022-10-27,70042,70058,Blue,1,45314,46206,892
2022-01-25,70047,70039,Blue,0,25194,25633,439
2022-11-22,70059,70057,Blue,0,45136,45174,38
2022-11-08,70056,70058,Blue,1,75130,75206,76
2022-01-08,70038,70054,Blue,1,21027,21791,764
2022-11-17,70049,70838,Blue,0,50914,51486,572
2022-10-14,70055,70039,Blue,0,49575,50384,809
2022-08-29,70055,70043,Blue,0,73530,74153,623
2022-08-23,70055,70045,Blue,0,63809,64334,525
2022-07-18,70059,70057,Blue,0,39016,39053,37
2022-01-12,70057,70838,Blue,0,56373,57433,1060
2022-06-07,70050,70052,Blue,1,37224,37467,243
2022-11-24,70057,70047,Blue,0,83076,83553,477
2022-09-21,70042,70050,Blue,1,36589,37027,438
2022-06-16,70038,70042,Blue,1,58414,58511,97
2022-03-01,70059,70049,Blue,0,69082,69569,487
2022-03-26,70042,70044,Blue,1,61657,61683,26
2022-01-18,70057,70047,Blue,0,55155,55622,467
2022-04-06,70038,70054,Blue,1,27859,28768,909
2022-08-08,70059,70055,Blue,0,73870,74008,138
2022-02-10,70053,70045,Blue,0,77462,77897,435
2022-01-24,70059,70053,Blue,0,35295,35559,264
2022-12-31,70053,70043,Blue,0,44107,44749,642
2022-10-20,70045,70043,Blue,0,80142,80255,113
2022-10-25,70042,70060,Blue,1,72215,73174,959
2022-10-01,70052,70060,Blue,1,81380,81761,381
2022-03-08,70049,70039,Blue,0,67270,67773,503
2022-12-30,70042,70052,Blue,1,51409,51981,572
2022-01-26,70058,70060,Blue,1,22898,23145,247
2022-07-01,70045,70838,Blue,0,54954,55385,431
2022-01-18,70044,70050,Blue,1,26922,27478,556
2022-09-19,70044,70060,Blue,1,30307,31282,975
2022-09-13,70054,70060,Blue,1,84649,84911,262
2022-02-21,70054,70056,Blue,1,60066,60113,47
2022-12-02,70038,70058,Blue,1,33613,34669,1056
2022-07-28,70047,70041,Blue,0,81082,81426,344
2022-12-31,70057,70041,Blue,0,80199,81033,834
2022-10-07,70038,70056,Blue,1,78383,79307,924
2022-06-30,70046,70060,Blue,1,38133,39152,1019
2022-03-21,70057,70043,Blue,0,76706,77493,787
2022-11-22,70059,70053,Blue,0,28355,28596,241
2022-03-04,70053,70041,Blue,0,34431,35135,704
2022-02-19,70038,70060,Blue,1,45847,46908,1061
2022-03-14,70057,70051,Blue,0,20327,20590,263
2022-03-31,70045,70039,Blue,0,39112,39405,293
2022-09-26,70038,70050,Blue,1,56062,56733,671
2022-01-20,70049,70838,Blue,0,45470,46054,584
2022-12-29,70057,70053,Blue,0,42012,42265,253
2022-03-18,70058,70060,Blue,1,69446,69516,70
2022-07-31,70042,70044,Blue,1,75437,75464,27
2022-08-27,70055,70043,Blue,0,41831,42510,679
2022-09-09,70048,70060,Blue,1,29068,29651,583
2022-08-10,70051,70047,Blue,0,40566,40759,193
2022-02-05,70043,70039,Blue,0,35516,35618,102
2022-08-22,70052,70056,Blue,1,68062,68262,200
2022-01-19,70059,70838,Blue,0,56594,57691,1097
2022-02-23,70044,70048,Blue,1,57157,57437,280
2022-12-16,70038,70044,Blue,1,66992,67170,178
2022-12-29,70049,70039,Blue,0,60397,60916,519
2022-07-26,70038,70046,Blue,1,71052,71395,343
2022-12-29,70042,70050,Blue,1,44709,45152,443
2022-08-07,70041,70838,Blue,0,68276,68387,111
2022-01-26,70057,70055,Blue,0,67237,67305,68
2022-08-27,70059,70045,Blue,0,87580,88476,896
2022-09-14,70059,70049,Blue,0,63972,64452,480
2022-08-07,70051,70041,Blue,0,37912,38507,595
2022-07-13,70049,70043,Blue,0,61983,62357,374
2022-01-15,70059,70051,Blue,0,22156,22489,333
2022-06-14,70042,70048,Blue,1,34024,34363,339
2022-10-12,70055,70047,Blue,0,74535,74964,429
2022-04-20,70056,70060,Blue,1,54436,54629,193
2022-09-24,70044,70050,Blue,1,85799,86193,394
2022-09-19,70042,70046,Blue,1,26107,26274,167
2022-05-23,70044,70052,Blue,1,75846,76506,660
2022-08-10,70057,70041,Blue,0,30214,31144,930
2022-06-24,70056,70060,Blue,1,72101,72283,182
2022-02-17,70055,70051,Blue,0,58600,58745,145
2022-02-01,70038,70058,Blue,1,58136,59281,1145
2022-02-23,70038,70040,Blue,1,58583,58603,20
2022-06-14,70038,70056,Blue,1,32665,33598,933
2022-07-16,70049,70045,Blue,0,71308,71507,199
2022-12-27,70038,70040,Blue,1,59550,59565,15
2022-10-14,70048,70056,Blue,1,89664,90067,403
2022-08-13,70057,70047,Blue,0,38489,38987,498
2022-12-25,70044,70056,Blue,1,70652,71318,666
2022-08-25,70042,70050,Blue,1,67648,68074,426
2022-02-26,70059,70055,Blue,0,55697,55838,141
2022-03-24,70038,70042,Blue,1,25186,25281,95
2022-08-22,70057,70051,Blue,0,76874,77141,267
2022-12-19,70046,70052,Blue,1,24269,24608,339
2022-08-30,70055,70039,Blue,0,44902,45774,872
2022-12-15,70059,70049,Blue,0,27499,28032,533
2022-10-20,70042,70050,Blue,1,89470,90070,600
2022-06-11,70048,70056,Blue,1,60056,60474,418
2022-08-19,70046,70056,Blue,1,83818,84382,564
2022-01-28,70038,70058,Blue,1,65225,66188,963
2022-04-18,70059,70051,Blue,0,67155,67473,318
2022-04-05,70059,70045,Blue,0,69494,70172,678
2022-02-07,70044,70046,Blue,1,57573,57684,111
2022-03-31,70051,70039,Blue,0,26490,27216,726
2022-08-20,70055,70047,Blue,0,28884,29266,382
2022-04-13,70056,70058,Blue,1,29161,29230,69
2022-10-13,70052,70060,Blue,1,64253,64631,378
2022-10-30,70052,70054,Blue,1,60549,60606,57
2022-03-19,70055,70041,Blue,0,48849,49632,783
2022-06-03,70047,70039,Blue,0,57880,58362,482
2022-03-16,70050,70060,Blue,1,27258,27843,585
2022-08-01,70053,70045,Blue,0,41322,41732,410
2022-08-04,70038,70052,Blue,1,42999,43792,793
2022-10-29,70054,70056,Blue,1,64694,64742,48
2022-10-11,70051,70041,Blue,0,53927,54481,554
2022-09-08,70045,70041,Blue,0,82016,82204,188
2022-12-14,70057,70051,Blue,0,46892,47143,251
2022-04-20,70050,70052,Blue,1,34279,34442,163
2022-07-16,70055,70047,Blue,0,64082,64450,368
2022-07-26,70038,70060,Blue,1,65884,67075,1191
2022-10-01,70042,70048,Blue,1,55730,56029,299
2022-07-02,70038,70060,Blue,1,73394,74623,1229
2022-10-02,70045,70043,Blue,0,77268,77380,112
2022-08-27,70057,70039,Blue,0,75867,76824,957
2022-04-28,70054,70060,Blue,1,56601,56867,266
2022-11-23,70048,70058,Blue,1,20603,21129,526
2022-10-29,70042,70046,Blue,1,31457,31633,176
2022-06-22,70044,70058,Blue,1,39711,40668,957
2022-07-02,70045,70043,Blue,0,64014,64126,112
2022-09-08,70053,70039,Blue,0,74781,75506,725
2022-12-05,70051,70049,Blue,0,31715,31819,104
2022-03-29,70048,70050,Blue,1,60791,60851,60
2022-09-18,70051,70043,Blue,0,84123,84615,492
2022-07-26,70038,70042,Blue,1,54386,54507,121
2022-08-20,70045,70838,Blue,0,63996,64392,396
2022-08-16,70059,70051,Blue,0,21469,21807,338
2022-10-17,70048,70058,Blue,1,26793,27368,575
2022-12-23,70043,70041,Blue,0,77411,77439,28
2022-10-29,70059,70047,Blue,0,53535,54114,579
2022-01-19,70057,70051,Blue,0,26146,26463,317
2022-01-22,70050,70060,Blue,1,71259,71751,492
2022-10-16,70046,70056,Blue,1,45397,45939,542
2022-06-28,70038,70050,Blue,1,77293,77871,578
2022-11-15,70040,70052,Blue,1,45686,46345,659
2022-05-21,70047,70039,Blue,0,69230,69748,518
2022-01-15,70042,70048,Blue,1,62494,62976,482
2022-06-10,70050,70054,Blue,1,69495,69720,225
2022-02-22,70040,70052,Blue,1,61123,61762,639
2022-03-18,70057,70045,Blue,0,48261,48861,600
2022-08-15,70057,70043,Blue,0,48933,49834,901
2022-03-26,70050,70060,Blue,1,50843,51515,672
2022-12-04,70057,70049,Blue,0,84685,85086,401
2022-07-05,70049,70045,Blue,0,39430,39646,216
2022-03-02,70046,70048,Blue,1,65946,66029,83
2022-04-13,70053,70838,Blue,0,66756,67592,836
2022-09-11,70052,70054,Blue,1,61018,61069,51
2022-01-28,70059,70041,Blue,0,48194,49129,935
2022-11-23,70057,70045,Blue,0,74971,75599,628
2022-06-24,70053,70045,Blue,0,27059,27498,439
2022-02-26,70057,70055,Blue,0,22900,22970,70
2022-10-15,70046,70052,Blue,1,35391,35735,344
2022-01-13,70044,70046,Blue,1,63986,64167,181
2022-09-08,70044,70054,Blue,1,39082,39697,615
2022-02-08,70042,70056,Blue,1,51782,52554,772
2022-07-13,70048,70058,Blue,1,75737,76266,529
2022-06-09,70040,70048,Blue,1,46490,46896,406
2022-02-25,70040,70046,Blue,1,41579,41848,269
2022-02-14,70044,70054,Blue,1,89392,89945,553
2022-08-26,70050,70058,Blue,1,25344,25738,394
2022-01-19,70057,70039,Blue,0,45032,46012,980
2022-10-20,70046,70050,Blue,1,45911,46093,182
2022-03-23,70053,70045,Blue,0,58651,59084,433
2022-04-04,70054,70060,Blue,1,81100,81362,262
2022-12-31,70044,70052,Blue,1,24503,24994,491
2022-08-25,70043,70838,Blue,0,20948,21175,227
2022-10-03,70050,70056,Blue,1,33781,34216,435
2022-07-27,70042,70056,Blue,1,54248,55071,823
2022-08-03,70055,70047,Blue,0,38788,39200,412
2022-05-19,70050,70056,Blue,1,60587,60891,304
2022-06-09,70040,70058,Blue,1,64890,66339,1449
2022-10-05,70050,70060,Blue,1,83296,83952,656
2022-12-03,70038,70060,Blue,1,31274,32288,1014
2022-01-19,70057,70838,Blue,0,27632,28665,1033
2022-02-18,70040,70046,Blue,1,63818,64068,250
2022-02-28,70038,70040,Blue,1,19808,19826,18
2022-09-15,70038,70040,Blue,1,81986,82002,16
2022-07-14,70039,70838,Blue,0,67462,67497,35
2022-03-06,70042,70060,Blue,1,77602,78569,967
2022-03-02,70040,70056,Blue,1,67091,68032,941
2022-04-12,70047,70041,Blue,0,41182,41542,360
2022-12-02,70052,70054,Blue,1,31419,31473,54
2022-08-25,70054,70060,Blue,1,42351,42620,269
2022-09-17,70044,70048,Blue,1,48256,48511,255
2022-06-15,70049,70045,Blue,0,62906,63132,226
2022-10-03,70042,70058,Blue,1,87898,88703,805
2022-07-25,70044,70058,Blue,1,62151,62960,809
2022-01-26,70044,70052,Blue,1,64282,64833,551
2022-02-19,70059,70051,Blue,0,41746,42079,333
2022-11-03,70053,70043,Blue,0,83394,83946,552
2022-03-01,70042,70052,Blue,1,66733,67352,619
2022-10-11,70044,70056,Blue,1,85151,85892,741
2022-07-22,70038,70060,Blue,1,88106,89335,1229
2022-03-23,70059,70053,Blue,0,85758,85976,218
2022-06-15,70054,70056,Blue,1,73435,73483,48
2022-12-11,70055,70045,Blue,0,46466,46963,497
2022-01-02,70048,70058,Blue,1,46246,46708,462
2022-12-24,70042,70050,Blue,1,56270,56711,441
2022-02-11,70045,70041,Blue,0,24745,24941,196
2022-03-18,70059,70041,Blue,0,60795,61663,868
2022-01-18,70051,70838,Blue,0,49096,49832,736
2022-07-03,70059,70045,Blue,0,51135,51858,723
2022-02-03,70042,70048,Blue,1,33709,34043,334
2022-07-19,70050,70052,Blue,1,73224,73338,114
2022-01-24,70042,70044,Blue,1,76999,77026,27
2022-09-03,70042,70058,Blue,1,79417,80302,885
2022-06-11,70053,70043,Blue,0,63595,64251,656
2022-04-02,70049,70047,Blue,0,29712,29767,55
2022-02-01,70059,70057,Blue,0,22019,22056,37
2022-07-10,70040,70046,Blue,1,58111,58423,312
2022-01-19,70050,70056,Blue,1,52185,52545,360
2022-08-09,70048,70054,Blue,1,43630,43961,331
2022-04-22,70054,70060,Blue,1,37005,37332,327
2022-04-19,70053,70049,Blue,0,55068,55252,184
2022-12-04,70044,70052,Blue,1,53063,53553,490
2022-03-31,70042,70044,Blue,1,87261,87288,27
2022-02-01,70041,70039,Blue,0,25355,25397,42
2022-02-19,70055,70039,Blue,0,38051,38961,910
2022-08-28,70038,70042,Blue,1,55326,55418,92
2022-05-18,70045,70041,Blue,0,29684,29897,213
2022-01-12,70040,70050,Blue,1,53416,54010,594
2022-12-14,70038,70056,Blue,1,67755,68657,902
2022-08-15,70047,70041,Blue,0,77596,77904,308
2022-04-21,70053,70039,Blue,0,74034,74810,776
2022-04-22,70045,70838,Blue,0,19169,19535,366
2022-01-13,70052,70060,Blue,1,34665,35161,496
2022-12-15,70040,70056,Blue,1,85862,86718,856
2022-08-28,70055,70053,Blue,0,56741,56786,45
2022-07-27,70057,70055,Blue,0,52669,52738,69
2022-06-16,70051,70045,Blue,0,57938,58289,351
2022-11-07,70042,70052,Blue,1,27344,28109,765
2022-08-02,70043,70041,Blue,0,71623,71650,27
2022-08-07,70042,70056,Blue,1,37185,37949,764
2022-12-18,70047,70041,Blue,0,61684,62019,335
2022-10-11,70053,70041,Blue,0,28341,29086,745
2022-03-22,70042,70060,Blue,1,36520,37455,935
2022-11-09,70045,70043,Blue,0,24493,24579,86
2022-07-03,70059,70041,Blue,0,64114,65061,947
2022-04-18,70038,70046,Blue,1,60432,60855,423
2022-10-06,70038,70040,Blue,1,62803,62820,17
2022-04-02,70055,70041,Blue,0,73702,74458,756
2022-05-19,70038,70048,Blue,1,58044,58615,571
2022-03-15,70038,70046,Blue,1,59257,59613,356
2022-11-20,70053,70838,Blue,0,70346,71158,812
2022-07-21,70040,70044,Blue,1,35048,35161,113
2022-10-11,70038,70044,Blue,1,33674,33852,178
2022-06-10,70055,70051,Blue,0,25673,25822,149
2022-01-13,70046,70050,Blue,1,57187,57380,193
2022-06-13,70057,70041,Blue,0,21045,21962,917
2022-11-17,70051,70049,Blue,0,18862,18975,113
2022-01-02,70049,70047,Blue,0,52322,52377,55
2022-08-02,70048,70052,Blue,1,48251,48456,205
2022-07-22,70053,70039,Blue,0,61975,62904,929
2022-09-12,70050,70054,Blue,1,50312,50522,210
2022-05-19,70041,70039,Blue,0,31204,31239,35
2022-09-28,70040,70050,Blue,1,64658,65135,477
2022-11-12,70059,70045,Blue,0,46509,47185,676
2022-02-18,70045,70039,Blue,0,63712,64004,292
2022-09-11,70054,70058,Blue,1,79925,80083,158
2022-01-03,70045,70838,Blue,0,59293,59947,654
2022-01-08,70039,70838,Blue,0,47580,47616,36
2022-01-18,70044,70046,Blue,1,65445,65553,108
2022-06-24,70042,70056,Blue,1,54209,55121,912
2022-02-28,70044,70060,Blue,1,71184,72232,1048
2022-12-28,70054,70060,Blue,1,77331,77595,264
2022-04-19,70048,70050,Blue,1,78578,78633,55
2022-06-16,70044,70054,Blue,1,76903,77551,648
2022-11-30,70040,70042,Blue,1,76284,76318,34
2022-09-20,70040,70046,Blue,1,48325,48578,253
2022-08-15,70046,70048,Blue,1,29789,29874,85
2022-11-29,70043,70039,Blue,0,35899,36027,128
2022-04-11,70052,70058,Blue,1,31325,31579,254
2022-09-07,70046,70050,Blue,1,40495,40819,324
2022-02-18,70059,70047,Blue,0,60500,61132,632
2022-05-07,70059,70057,Blue,0,27624,27664,40
2022-10-14,70048,70058,Blue,1,66684,67214,530
2022-01-04,70040,70048,Blue,1,26801,27244,443
2022-12-19,70059,70049,Blue,0,67600,68074,474
2022-03-09,70052,70058,Blue,1,22550,22845,295
2022-03-17,70045,70043,Blue,0,63092,63217,125
2022-11-26,70056,70058,Blue,1,80176,80247,71
2022-11-25,70046,70050,Blue,1,74001,74183,182
2022-01-24,70052,70054,Blue,1,66006,66059,53
2022-01-27,70038,70058,Blue,1,80689,81590,901
2022-07-27,70040,70056,Blue,1,59206,60123,917
2022-11-05,70046,70058,Blue,1,70645,71370,725
2022-07-04,70059,70838,Blue,0,60793,61973,1180
2022-08-19,70056,70058,Blue,1,63968,64045,77
2022-12-29,70046,70054,Blue,1,73842,74281,439
2022-02-27,70057,70051,Blue,0,24803,25051,248
2022-08-25,70044,70058,Blue,1,56100,56888,788
2022-03-30,70057,70047,Blue,0,73823,74349,526
2022-11-19,70040,70048,Blue,1,58353,58778,425
2022-09-12,70057,70055,Blue,0,22230,22300,70
2022-03-18,70055,70045,Blue,0,40618,41186,568
2022-01-07,70038,70054,Blue,1,42415,43274,859
2022-10-31,70054,70056,Blue,1,83226,83273,47
2022-03-14,70057,70838,Blue,0,60280,61286,1006
2022-07-23,70051,70039,Blue,0,72959,73700,741
2022-02-18,70041,70039,Blue,0,25011,25045,34
2022-01-27,70057,70047,Blue,0,59368,59877,509
2022-12-21,70057,70047,Blue,0,65135,65613,478
2022-12-19,70055,70045,Blue,0,44257,44845,588
2022-02-21,70042,70058,Blue,1,31414,32291,877
2022-04-08,70047,70043,Blue,0,81849,82087,238
2022-03-19,70057,70051,Blue,0,33630,33882,252
2022-01-28,70041,70838,Blue,0,23131,23296,165
2022-09-25,70051,70838,Blue,0,60776,61515,739
2022-12-09,70049,70838,Blue,0,75853,76404,551
2022-11-04,70055,70047,Blue,0,26793,27186,393
2022-09-22,70038,70048,Blue,1,21814,22230,416
2022-12-07,70046,70058,Blue,1,76219,76891,672
2022-08-18,70040,70058,Blue,1,45955,46948,993
2022-12-25,70057,70055,Blue,0,47422,47491,69
2022-07-17,70046,70056,Blue,1,45544,46069,525
2022-09-23,70044,70052,Blue,1,36503,37019,516
2022-01-08,70042,70054,Blue,1,56813,57465,652
2022-03-04,70057,70838,Blue,0,76720,77865,1145
2022-12-21,70040,70048,Blue,1,71097,71490,393
2022-09-17,70051,70047,Blue,0,22506,22697,191
2022-09-25,70045,70043,Blue,0,78454,78546,92
2022-03-09,70047,70041,Blue,0,41099,41432,333
2022-05-25,70043,70838,Blue,0,65367,65568,201
2022-03-05,70059,70051,Blue,0,87382,87692,310
2022-12-27,70053,70838,Blue,0,59393,60282,889
2022-08-11,70038,70044,Blue,1,36507,36692,185
2022-04-21,70046,70050,Blue,1,43342,43520,178
2022-10-29,70057,70049,Blue,0,67650,68029,379
2022-11-17,70055,70039,Blue,0,23220,24156,936
2022-11-20,70049,70041,Blue,0,34618,35064,446
2022-12-03,70044,70058,Blue,1,40683,41644,961
2022-01-20,70049,70039,Blue,0,62857,63435,578
2022-11-20,70046,70050,Blue,1,87702,87906,204
2022-09-06,70051,70047,Blue,0,34283,34484,201
2022-11-25,70043,70041,Blue,0,64834,64863,29
2022-10-14,70042,70046,Blue,1,48373,48547,174
2022-01-08,70044,70054,Blue,1,85763,86359,596
2022-08-15,70055,70838,Blue,0,47212,48184,972
2022-12-09,70040,70042,Blue,1,33393,33431,38
2022-10-27,70053,70041,Blue,0,88392,89047,655
2022-05-19,70053,70041,Blue,0,22694,23595,901
2022-09-02,70038,70046,Blue,1,55249,55627,378
2022-01-13,70055,70041,Blue,0,25638,26462,824
2022-04-20,70059,70053,Blue,0,21327,21551,224
2022-02-21,70055,70053,Blue,0,67391,67449,58
2022-09-28,70038,70046,Blue,1,74781,75117,336
2022-04-07,70042,70060,Blue,1,40296,41324,1028
2022-08-10,70046,70052,Blue,1,29763,30087,324
2022-11-22,70040,70058,Blue,1,74254,75202,948
2022-12-15,70044,70054,Blue,1,88625,89233,608
2022-02-14,70044,70054,Blue,1,78825,79425,600
2022-08-02,70042,70050,Blue,1,75918,76364,446
2022-12-02,70047,70041,Blue,0,40117,40414,297
2022-11-12,70043,70041,Blue,0,77491,77520,29
2022-04-01,70059,70047,Blue,0,31162,31762,600
2022-12-15,70046,70060,Blue,1,30260,31061,801
2022-11-04,70046,70058,Blue,1,69257,70056,799
2022-01-15,70051,70041,Blue,0,81311,81878,567
2022-04-21,70050,70052,Blue,1,55818,55932,114
2022-02-22,70051,70049,Blue,0,72997,73104,107
2022-04-22,70048,70052,Blue,1,20800,21048,248
2022-03-10,70052,70054,Blue,1,53283,53338,55
2022-12-11,70055,70051,Blue,0,54551,54685,134
2022-12-16,70046,70050,Blue,1,48647,48830,183
2022-10-14,70040,70052,Blue,1,38507,39201,694
2022-06-15,70047,70045,Blue,0,59921,60034,113
2022-10-19,70039,70838,Blue,0,63142,63174,32
2022-04-15,70047,70838,Blue,0,52163,52806,643
2022-09-16,70044,70056,Blue,1,25904,26604,700
2022-01-22,70050,70054,Blue,1,64226,64424,198
2022-08-26,70040,70052,Blue,1,43134,43792,658
2022-12-15,70042,70056,Blue,1,32539,33338,799
2022-01-27,70051,70041,Blue,0,62727,63370,643
2022-04-04,70059,70838,Blue,0,66824,67890,1066
2022-06-12,70056,70060,Blue,1,57461,57660,199
2022-07-22,70040,70054,Blue,1,66030,66977,947
2022-07-30,70046,70056,Blue,1,31611,32126,515
2022-02-14,70055,70045,Blue,0,66314,66835,521
2022-12-22,70059,70057,Blue,0,65112,65149,37
2022-04-17,70055,70049,Blue,0,31819,32086,267
2022-02-07,70050,70052,Blue,1,30514,30663,149
2022-10-03,70038,70052,Blue,1,33192,33915,723
2022-10-14,70040,70046,Blue,1,43574,43830,256
2022-11-04,70048,70050,Blue,1,85107,85166,59
2022-02-20,70045,70043,Blue,0,22351,22455,104
2022-01-20,70054,70056,Blue,1,26639,26687,48
2022-03-23,70059,70838,Blue,0,69077,70181,1104
2022-11-10,70057,70043,Blue,0,49652,50463,811
2022-10-11,70047,70041,Blue,0,65030,65339,309
2022-03-20,70047,70045,Blue,0,46130,46232,102
2022-04-02,70059,70051,Blue,0,28699,29009,310
2022-08-12,70046,70048,Blue,1,25165,25248,83
2022-06-10,70038,70044,Blue,1,52840,53053,213
2022-03-30,70046,70052,Blue,1,29679,29987,308
2022-09-28,70045,70838,Blue,0,62938,63306,368
2022-09-23,70050,70058,Blue,1,59646,60034,388
2022-03-09,70040,70058,Blue,1,75937,76896,959
2022-12-02,70059,70051,Blue,0,41632,41998,366
2022-07-15,70052,70058,Blue,1,34956,35208,252
2022-12-20,70055,70045,Blue,0,85793,86286,493
2022-05-19,70043,70041,Blue,0,37526,37556,30
2022-04-23,70043,70041,Blue,0,88446,88473,27
2022-07-22,70046,70060,Blue,1,47607,48356,749
2022-04-05,70050,70056,Blue,1,51443,51758,315
2022-10-12,70049,70039,Blue,0,46206,46683,477
2022-09-23,70041,70838,Blue,0,30367,30494,127
2022-02-18,70054,70058,Blue,1,24975,25158,183
2022-01-01,70051,70043,Blue,0,28133,28586,453
2022-04-10,70047,70041,Blue,0,26880,27236,356
2022-07-27,70045,70043,Blue,0,51718,51816,98
2022-07-04,70040,70042,Blue,1,46470,46503,33
2022-02-05,70040,70046,Blue,1,27547,27800,253
2022-09-27,70042,70048,Blue,1,46909,47194,285
2022-01-13,70042,70052,Blue,1,62098,62672,574
2022-10-19,70040,70060,Blue,1,29977,31049,1072
2022-09-18,70042,70056,Blue,1,77072,77859,787
2022-06-22,70045,70039,Blue,0,63560,63843,283
2022-12-04,70059,70049,Blue,0,29715,30278,563
2022-10-06,70049,70838,Blue,0,64809,65494,685
2022-01-08,70040,70056,Blue,1,39436,40236,800
2022-02-07,70057,70045,Blue,0,70626,71238,612
2022-02-07,70044,70056,Blue,1,21746,22382,636
2022-03-15,70046,70050,Blue,1,32823,33021,198
2022-11-17,70055,70051,Blue,0,29555,29700,145
2022-08-19,70044,70054,Blue,1,47121,47714,593
2022-04-10,70049,70039,Blue,0,38670,39180,510
2022-09-10,70044,70046,Blue,1,34166,34270,104
2022-01-22,70047,70045,Blue,0,37921,38023,102
2022-11-20,70055,70043,Blue,0,66966,67646,680
2022-11-15,70057,70041,Blue,0,28419,29380,961
2022-02-14,70040,70044,Blue,1,64726,64838,112
2022-04-01,70055,70053,Blue,0,22623,22681,58
2022-11-11,70041,70838,Blue,0,75357,75477,120
2022-04-15,70050,70054,Blue,1,61708,61926,218
2022-11-04,70044,70046,Blue,1,66702,66817,115
2022-12-25,70055,70045,Blue,0,41653,42271,618
2022-02-10,70044,70052,Blue,1,54569,55078,509
2022-09-22,70055,70045,Blue,0,29499,30130,631
2022-07-27,70040,70054,Blue,1,23802,24666,864
2022-04-23,70058,70060,Blue,1,59955,60026,71
2022-02-23,70055,70838,Blue,0,20772,21770,998
2022-11-23,70047,70043,Blue,0,84054,84291,237
2022-03-28,70046,70052,Blue,1,50085,50411,326
2022-10-10,70055,70041,Blue,0,54279,55049,770
2022-02-01,70038,70046,Blue,1,25738,26076,338
2022-08-09,70059,70053,Blue,0,70699,70944,245
2022-08-24,70047,70039,Blue,0,29112,29552,440
2022-03-29,70047,70045,Blue,0,50333,50437,104
2022-06-08,70041,70039,Blue,0,27687,27727,40
2022-06-18,70038,70060,Blue,1,37240,38515,1275
2022-01-04,70057,70049,Blue,0,62668,63033,365
2022-02-06,70048,70050,Blue,1,30482,30542,60
2022-02-05,70048,70054,Blue,1,57707,58000,293
2022-12-27,70057,70055,Blue,0,37224,37295,71
2022-04-05,70050,70052,Blue,1,85066,85182,116
2022-11-23,70047,70838,Blue,0,28507,29024,517
2022-07-25,70038,70052,Blue,1,45510,46237,727
2022-06-16,70041,70838,Blue,0,71030,71182,152
2022-03-15,70056,70060,Blue,1,64866,65052,186
2022-04-05,70046,70048,Blue,1,57809,57914,105
2022-12-07,70042,70044,Blue,1,47793,47823,30
2022-08-23,70057,70049,Blue,0,28478,28877,399
2022-01-11,70056,70060,Blue,1,33207,33614,407
2022-12-29,70040,70052,Blue,1,42060,44028,1968
2022-04-16,70059,70049,Blue,0,42193,42640,447
2022-04-18,70057,70041,Blue,0,40557,41463,906
2022-01-02,70046,70054,Blue,1,48305,48733,428
2022-04-20,70055,70039,Blue,0,84806,85636,830
2022-03-17,70052,70060,Blue,1,26802,27182,380
2022-02-16,70059,70047,Blue,0,21321,21927,606
2022-02-19,70040,70058,Blue,1,34196,35163,967
2022-07-13,70055,70043,Blue,0,19729,20511,782
2022-07-14,70053,70838,Blue,0,55513,56442,929
2022-07-21,70050,70060,Blue,1,47291,47812,521
2022-01-17,70048,70052,Blue,1,72303,72523,220
2022-03-31,70038,70060,Blue,1,59535,60723,1188
2022-03-29,70051,70049,Blue,0,34549,34657,108
2022-02-28,70053,70043,Blue,0,66397,67074,677
2022-07-14,70045,70043,Blue,0,30967,31087,120
2022-04-12,70038,70060,Blue,1,72973,74085,1112
2022-06-18,70050,70052,Blue,1,61283,61391,108
2022-09-29,70058,70060,Blue,1,79505,79569,64
2022-02-12,70048,70052,Blue,1,86983,87196,213
2022-10-14,70050,70058,Blue,1,20647,21086,439
2022-09-28,70050,70056,Blue,1,83283,83589,306
2022-11-15,70046,70056,Blue,1,68830,69334,504
2022-07-11,70050,70052,Blue,1,32160,32282,122
2022-07-02,70049,70838,Blue,0,39432,40024,592
2022-01-25,70048,70054,Blue,1,48204,48510,306
2022-06-01,70049,70039,Blue,0,78227,78736,509
2022-11-23,70053,70838,Blue,0,57139,57994,855
2022-07-24,70051,70838,Blue,0,24205,24975,770
2022-04-19,70051,70045,Blue,0,53486,53870,384
2022-01-03,70038,70042,Blue,1,49847,49936,89
2022-09-02,70038,70050,Blue,1,65877,66543,666
2022-12-23,70045,70838,Blue,0,64387,64737,350
2022-02-12,70042,70050,Blue,1,39529,39939,410
2022-07-26,70059,70041,Blue,0,20834,21808,974
2022-08-30,70055,70047,Blue,0,59423,59779,356
2022-08-25,70039,70838,Blue,0,50733,50766,33
2022-12-01,70051,70838,Blue,0,67195,67917,722
2022-10-01,70040,70044,Blue,1,44829,44953,124
2022-12-14,70040,70050,Blue,1,54971,55452,481
2022-08-04,70042,70060,Blue,1,45370,46432,1062
2022-04-15,70040,70048,Blue,1,68010,68437,427
2022-05-03,70055,70049,Blue,0,24476,24780,304
2022-07-21,70040,70046,Blue,1,44674,44963,289
2022-07-14,70051,70049,Blue,0,74179,74280,101
2022-09-18,70057,70055,Blue,0,64709,64779,70
2022-08-25,70048,70052,Blue,1,36967,37242,275
2022-01-13,70044,70058,Blue,1,62498,63367,869
2022-04-17,70050,70052,Blue,1,55409,55515,106
2022-02-02,70042,70054,Blue,1,24530,25270,740
2022-12-19,70057,70039,Blue,0,33323,34656,1333
2022-09-30,70038,70058,Blue,1,30259,31280,1021
2022-08-03,70051,70045,Blue,0,31351,31707,356
2022-11-10,70051,70049,Blue,0,82774,82877,103
2022-03-23,70047,70045,Blue,0,31522,31625,103
2022-10-09,70059,70043,Blue,0,82216,83098,882
2022-06-13,70042,70060,Blue,1,31303,32340,1037
2022-07-04,70054,70056,Blue,1,59810,59865,55
2022-10-25,70042,70046,Blue,1,73795,73962,167
2022-07-06,70043,70041,Blue,0,62338,62366,28
2022-03-15,70038,70060,Blue,1,66737,67918,1181
2022-10-05,70057,70039,Blue,0,59847,60757,910
2022-08-27,70046,70050,Blue,1,34344,34528,184
2022-01-20,70046,70058,Blue,1,26373,27052,679
2022-12-28,70040,70044,Blue,1,26161,26280,119
2022-07-28,70051,70039,Blue,0,60458,61156,698
2022-07-21,70053,70043,Blue,0,22013,22606,593
2022-02-18,70042,70058,Blue,1,21305,22221,916
2022-08-04,70038,70056,Blue,1,76322,77281,959
2022-02-14,70044,70050,Blue,1,72668,73049,381
2022-12-08,70038,70042,Blue,1,21026,21145,119
2022-04-19,70049,70047,Blue,0,65505,65559,54
2022-02-08,70046,70058,Blue,1,64526,65171,645
2022-04-03,70050,70058,Blue,1,59772,60190,418
2022-12-26,70045,70041,Blue,0,57859,58028,169
2022-07-07,70051,70049,Blue,0,53803,53906,103
2022-08-19,70050,70058,Blue,1,80857,81291,434
2022-04-14,70042,70056,Blue,1,78784,79584,800
2022-12-16,70049,70047,Blue,0,54611,54670,59
2022-04-19,70049,70039,Blue,0,81715,82199,484
2022-03-14,70047,70045,Blue,0,32041,32123,82
2022-10-10,70050,70056,Blue,1,34616,34921,305
2022-07-30,70051,70043,Blue,0,37197,37712,515
2022-02-27,70055,70838,Blue,0,56168,57061,893
2022-10-29,70047,70041,Blue,0,39605,39937,332
2022-08-29,70054,70060,Blue,1,49669,49938,269
2022-02-27,70047,70045,Blue,0,24415,24503,88
2022-03-10,70053,70043,Blue,0,26978,27650,672
2022-11-06,70038,70042,Blue,1,69916,70007,91
2022-11-03,70055,70041,Blue,0,69859,70629,770
2022-03-11,70052,70056,Blue,1,43675,43801,126
2022-09-03,70059,70049,Blue,0,78438,78887,449
2022-11-29,70048,70050,Blue,1,49783,49839,56
2022-09-30,70039,70838,Blue,0,80309,80343,34
2022-09-05,70041,70039,Blue,0,52148,52182,34
2022-11-01,70050,70060,Blue,1,35512,36020,508
2022-10-08,70059,70049,Blue,0,77216,77666,450
2022-09-10,70052,70056,Blue,1,33629,33767,138
2022-02-02,70057,70041,Blue,0,72679,73604,925
2022-02-25,70046,70052,Blue,1,85820,86181,361
2022-10-31,70049,70039,Blue,0,49336,49822,486
2022-10-04,70057,70055,Blue,0,85078,85145,67
2022-11-24,70055,70039,Blue,0,37032,37818,786
2022-06-13,70044,70048,Blue,1,85607,85881,274
2022-01-05,70057,70041,Blue,0,62985,63865,880
2022-02-03,70057,70838,Blue,0,32738,33845,1107
2022-09-28,70051,70049,Blue,0,63794,63907,113
2022-01-29,70045,70838,Blue,0,37893,38363,470
2022-08-21,70052,70054,Blue,1,80500,80580,80
2022-06-14,70059,70057,Blue,0,68489,68526,37
2022-10-01,70045,70838,Blue,0,30563,30920,357
2022-03-11,70057,70043,Blue,0,26160,27038,878
2022-03-10,70038,70060,Blue,1,74069,75235,1166
2022-04-06,70057,70049,Blue,0,47205,47596,391
2022-01-10,70052,70054,Blue,1,71318,71371,53
2022-06-29,70057,70051,Blue,0,43291,43568,277
2022-12-18,70059,70838,Blue,0,61936,62979,1043
2022-03-22,70057,70043,Blue,0,42826,43700,874
2022-06-29,70047,70045,Blue,0,22974,23090,116
2022-10-15,70047,70043,Blue,0,87157,87410,253
2022-01-10,70044,70046,Blue,1,61049,61163,114
2022-03-02,70054,70056,Blue,1,36665,36713,48
2022-06-06,70040,70052,Blue,1,37936,38791,855
2022-12-06,70044,70054,Blue,1,75006,75553,547
2022-03-08,70044,70052,Blue,1,24814,25365,551
2022-06-30,70053,70039,Blue,0,70492,71292,800
2022-10-17,70048,70060,Blue,1,21481,22400,919
2022-12-27,70040,70058,Blue,1,47032,47980,948
2022-03-01,70038,70056,Blue,1,56831,57791,960
2022-12-07,70057,70049,Blue,0,62550,62953,403
2022-12-04,70038,70044,Blue,1,76443,76630,187
2022-04-03,70044,70046,Blue,1,23947,24058,111
2022-01-11,70042,70048,Blue,1,60279,60671,392
2022-06-01,70047,70838,Blue,0,82083,82699,616
2022-01-03,70044,70046,Blue,1,22055,22159,104
2022-08-09,70038,70042,Blue,1,43708,43821,113
2022-02-24,70053,70039,Blue,0,28121,29119,998
2022-12-28,70049,70838,Blue,0,34117,34712,595
2022-12-03,70057,70047,Blue,0,86629,87128,499
2022-06-27,70053,70047,Blue,0,73331,73654,323
2022-08-05,70040,70060,Blue,1,60884,62045,1161
2022-10-05,70048,70054,Blue,1,42268,42591,323
2022-09-20,70055,70045,Blue,0,37642,38217,575
2022-07-29,70057,70045,Blue,0,64408,65081,673
2022-09-07,70059,70057,Blue,0,35894,35930,36
2022-09-06,70040,70058,Blue,1,60450,61374,924
2022-06-12,70047,70039,Blue,0,75059,75485,426
2022-07-26,70059,70041,Blue,0,67640,68532,892
2022-08-10,70051,70041,Blue,0,75707,76256,549
2022-11-21,70040,70054,Blue,1,46743,47535,792
2022-07-08,70051,70043,Blue,0,57421,57914,493
2022-07-25,70059,70838,Blue,0,77631,78772,1141
2022-11-17,70057,70838,Blue,0,58594,59604,1010
2022-06-30,70041,70838,Blue,0,79971,80102,131
2022-01-29,70053,70838,Blue,0,30579,31956,1377
2022-01-16,70050,70056,Blue,1,39036,39312,276
2022-10-09,70057,70838,Blue,0,43538,44600,1062
2022-09-08,70038,70042,Blue,1,24585,24684,99
2022-03-17,70041,70039,Blue,0,28575,28608,33
2022-11-15,70043,70041,Blue,0,64586,64615,29
2022-08-07,70045,70838,Blue,0,58995,59380,385
2022-07-26,70052,70060,Blue,1,34139,34569,430
2022-02-16,70059,70045,Blue,0,36378,37160,782
2022-04-08,70045,70041,Blue,0,60681,60865,184
2022-02-23,70042,70050,Blue,1,63027,63452,425
2022-04-01,70054,70058,Blue,1,60120,60279,159
2022-07-29,70044,70060,Blue,1,58078,59098,1020
2022-11-29,70049,70045,Blue,0,34848,35046,198
2022-04-20,70042,70046,Blue,1,74203,74385,182
2022-09-27,70051,70049,Blue,0,50398,50519,121
2022-06-02,70044,70052,Blue,1,74673,75300,627
2022-04-24,70058,70060,Blue,1,59925,60000,75
2022-01-03,70054,70058,Blue,1,38671,38870,199
2022-09-07,70051,70047,Blue,0,56653,56847,194
2022-06-09,70053,70838,Blue,0,80314,81193,879
2022-08-14,70053,70051,Blue,0,49241,49303,62
2022-04-22,70059,70838,Blue,0,76038,77173,1135
2022-01-19,70055,70053,Blue,0,39679,39740,61
2022-06-30,70042,70056,Blue,1,21562,22361,799
2022-02-18,70055,70838,Blue,0,19711,20819,1108
2022-03-24,70038,70042,Blue,1,35384,35485,101
2022-02-01,70059,70051,Blue,0,48765,49207,442
2022-10-18,70047,70045,Blue,0,84053,84146,93
2022-11-20,70045,70043,Blue,0,86265,86356,91
2022-12-18,70059,70051,Blue,0,45194,45503,309
2022-05-06,70056,70060,Blue,1,61908,62084,176
2022-10-09,70057,70051,Blue,0,53914,54165,251
2022-10-07,70055,70049,Blue,0,67276,67555,279
2022-09-09,70044,70056,Blue,1,49028,49713,685
2022-02-14,70051,70039,Blue,0,55449,56064,615
2022-10-20,70055,70045,Blue,0,37637,38134,497
2022-05-23,70038,70042,Blue,1,80407,80510,103
2022-06-13,70056,70060,Blue,1,25429,25619,190
2022-11-25,70047,70039,Blue,0,37557,37973,416
2022-12-01,70054,70058,Blue,1,27784,27946,162
2022-10-07,70048,70060,Blue,1,42556,43165,609
2022-03-29,70057,70053,Blue,0,51624,51774,150
2022-11-06,70039,70838,Blue,0,60250,60285,35
2022-07-10,70046,70060,Blue,1,31193,31923,730
2022-03-28,70055,70041,Blue,0,67737,68456,719
2022-07-28,70057,70838,Blue,0,60843,61882,1039
2022-04-01,70051,70043,Blue,0,75250,75759,509
2022-07-04,70046,70050,Blue,1,39769,39969,200
2022-06-17,70048,70050,Blue,1,80919,80977,58
2022-03-27,70046,70056,Blue,1,68125,68650,525
2022-03-19,70059,70053,Blue,0,31932,32146,214
2022-06-27,70059,70055,Blue,0,24675,24824,149
2022-06-22,70042,70044,Blue,1,25689,25722,33
2022-12-31,70057,70039,Blue,0,59141,60052,911
2022-11-23,70045,70039,Blue,0,74534,74759,225
2022-03-29,70055,70041,Blue,0,79655,80466,811
2022-08-03,70051,70047,Blue,0,73189,73382,193
2022-04-10,70046,70048,Blue,1,61684,61765,81
2022-05-21,70059,70838,Blue,0,53126,54441,1315
2022-01-20,70051,70838,Blue,0,53957,54926,969
2022-10-16,70052,70054,Blue,1,29988,30039,51
2022-12-09,70042,70056,Blue,1,49414,50197,783
2022-04-11,70052,70054,Blue,1,46628,46682,54
2022-10-22,70038,70054,Blue,1,28034,28832,798
2022-08-08,70053,70045,Blue,0,45572,46023,451
2022-12-22,70054,70056,Blue,1,35459,35505,46
2022-01-14,70055,70049,Blue,0,22228,22580,352
2022-10-24,70042,70052,Blue,1,40078,40753,675
2022-02-09,70047,70045,Blue,0,71569,71660,91
2022-10-07,70045,70838,Blue,0,51300,51665,365
2022-10-22,70057,70047,Blue,0,40645,41106,461
2022-06-04,70046,70050,Blue,1,22251,22475,224
2022-03-27,70038,70056,Blue,1,24548,25475,927
2022-02-27,70059,70053,Blue,0,42796,43032,236
2022-03-21,70053,70041,Blue,0,83729,84376,647
2022-03-01,70059,70838,Blue,0,22039,23290,1251
2022-01-12,70051,70838,Blue,0,82665,83317,652
2022-03-04,70044,70050,Blue,1,51025,51375,350
2022-05-06,70059,70053,Blue,0,21314,21549,235
2022-04-17,70051,70049,Blue,0,72584,72692,108
2022-05-18,70044,70048,Blue,1,30183,30537,354
2022-05-10,70057,70049,Blue,0,85956,86348,392
2022-01-08,70053,70047,Blue,0,54913,55222,309
2022-08-16,70054,70060,Blue,1,66613,66895,282
2022-10-25,70042,70054,Blue,1,77968,78585,617
2022-02-12,70043,70039,Blue,0,59333,59447,114
2022-07-13,70038,70044,Blue,1,48821,49000,179
2022-01-20,70057,70045,Blue,0,50811,51452,641
2022-07-04,70051,70049,Blue,0,65359,65468,109
2022-07-28,70049,70047,Blue,0,80983,81042,59
2022-03-20,70059,70049,Blue,0,27760,28211,451
2022-12-12,70047,70838,Blue,0,50608,51086,478
2022-06-29,70042,70060,Blue,1,85068,86086,1018
2022-11-09,70059,70053,Blue,0,29329,29601,272
2022-06-21,70055,70043,Blue,0,22757,23444,687
2022-06-16,70042,70058,Blue,1,65822,66811,989
2022-11-17,70040,70050,Blue,1,27791,28294,503
2022-06-04,70044,70048,Blue,1,49059,49319,260
2022-04-18,70049,70039,Blue,0,39854,40442,588
2022-05-23,70047,70043,Blue,0,66514,66942,428
2022-08-02,70048,70050,Blue,1,49167,49226,59
2022-02-13,70040,70048,Blue,1,65131,65502,371
2022-02-09,70059,70049,Blue,0,63797,64292,495
2022-01-27,70055,70053,Blue,0,54102,54153,51
2022-01-31,70047,70041,Blue,0,72757,73099,342
2022-08-28,70043,70838,Blue,0,77421,77607,186
2022-04-11,70038,70058,Blue,1,21549,22529,980
2022-08-17,70050,70056,Blue,1,65445,65752,307
2022-08-08,70057,70039,Blue,0,85083,85979,896
2022-01-10,70057,70838,Blue,0,60592,61633,1041
2022-07-30,70048,70058,Blue,1,46909,47419,510
2022-09-03,70046,70058,Blue,1,48958,49538,580
2022-03-26,70050,70060,Blue,1,83725,84226,501
2022-08-30,70059,70041,Blue,0,19519,20586,1067
2022-12-19,70047,70838,Blue,0,29042,29607,565
2022-06-09,70049,70047,Blue,0,19381,19444,63
2022-07-13,70047,70043,Blue,0,40739,41034,295
2022-07-03,70059,70053,Blue,0,50045,50275,230
2022-08-03,70040,70060,Blue,1,52439,53536,1097
2022-03-01,70046,70056,Blue,1,26098,26587,489
2022-09-22,70049,70043,Blue,0,55340,55677,337
2022-02-16,70048,70050,Blue,1,20340,20400,60
2022-08-25,70047,70045,Blue,0,35042,35152,110
2022-04-12,70042,70056,Blue,1,83972,84768,796
2022-10-13,70048,70052,Blue,1,76912,77126,214
2022-10-20,70038,70044,Blue,1,57558,57816,258
2022-09-19,70046,70048,Blue,1,73603,73685,82
2022-12-16,70059,70049,Blue,0,28157,28668,511
2022-06-13,70041,70039,Blue,0,61253,61290,37
2022-08-12,70040,70056,Blue,1,24634,25508,874
2022-03-13,70040,70046,Blue,1,64579,64839,260
2022-07-30,70042,70046,Blue,1,75703,75879,176
2022-12-20,70058,70060,Blue,1,53934,54051,117
2022-09-12,70041,70838,Blue,0,35299,35420,121
2022-08-07,70053,70838,Blue,0,39109,39994,885
2022-08-29,70038,70046,Blue,1,30680,31033,353
2022-10-12,70040,70060,Blue,1,62782,63866,1084
2022-01-14,70048,70052,Blue,1,77366,77569,203
2022-03-09,70057,70051,Blue,0,73379,73620,241
2022-04-06,70050,70056,Blue,1,43167,43489,322
2022-01-28,70040,70048,Blue,1,43563,43945,382
2022-07-29,70055,70051,Blue,0,62189,62324,135
2022-10-05,70054,70060,Blue,1,59551,59824,273
2022-08-04,70038,70060,Blue,1,68973,70182,1209
2022-02-20,70048,70060,Blue,1,58019,58584,565
2022-11-16,70041,70039,Blue,0,49294,49329,35
2022-05-28,70040,70048,Blue,1,83185,83634,449
2022-03-11,70040,70058,Blue,1,33027,34042,1015
2022-10-13,70046,70050,Blue,1,26310,26466,156
2022-04-08,70051,70049,Blue,0,54548,54652,104
2022-03-01,70040,70058,Blue,1,54078,55035,957
2022-10-03,70039,70838,Blue,0,60502,60540,38
2022-06-19,70059,70051,Blue,0,83780,84125,345
2022-09-29,70047,70838,Blue,0,58814,59320,506
2022-02-14,70053,70838,Blue,0,29383,30289,906
2022-02-07,70059,70838,Blue,0,44955,46020,1065
2022-10-28,70047,70045,Blue,0,37676,37776,100
2022-02-27,70057,70049,Blue,0,76054,76451,397
2022-05-29,70042,70050,Blue,1,87511,88042,531
2022-10-04,70044,70060,Blue,1,55370,56290,920
2022-08-30,70049,70047,Blue,0,24752,24813,61
2022-12-19,70040,70048,Blue,1,47759,48276,517
2022-03-24,70038,70048,Blue,1,20902,21393,491
2022-09-04,70044,70058,Blue,1,23972,24838,866
2022-04-14,70053,70838,Blue,0,45372,46381,1009
2022-07-20,70038,70056,Blue,1,68340,69598,1258
2022-01-27,70051,70838,Blue,0,65099,65877,778
2022-02-13,70051,70838,Blue,0,46717,47523,806
2022-04-04,70040,70042,Blue,1,60819,60851,32
2022-08-17,70044,70052,Blue,1,78757,79215,458
2022-03-31,70056,70060,Blue,1,54375,54551,176
2022-06-13,70038,70044,Blue,1,32132,32315,183
2022-08-12,70048,70060,Blue,1,22441,23042,601
2022-02-04,70046,70060,Blue,1,67104,68233,1129
2022-09-08,70055,70049,Blue,0,41367,41693,326
2022-10-29,70038,70040,Blue,1,27488,27503,15
2022-03-13,70057,70041,Blue,0,83854,84722,868
2022-07-04,70038,70060,Blue,1,23649,24818,1169
2022-08-01,70038,70054,Blue,1,65346,66170,824
2022-08-25,70044,70054,Blue,1,50464,51063,599
2022-01-21,70057,70055,Blue,0,29743,29812,69
2022-07-31,70047,70041,Blue,0,79543,79863,320
2022-06-21,70040,70060,Blue,1,47352,48456,1104
2022-11-05,70046,70058,Blue,1,62504,63182,678
2022-01-31,70053,70039,Blue,0,48859,49625,766
2022-06-25,70057,70043,Blue,0,52181,53006,825
2022-09-30,70051,70045,Blue,0,63801,64167,366
2022-05-11,70051,70049,Blue,0,76996,77106,110
2022-03-21,70046,70050,Blue,1,64508,64716,208
2022-03-09,70046,70050,Blue,1,39933,40101,168
2022-03-08,70048,70056,Blue,1,60338,60718,380
2022-06-20,70059,70838,Blue,0,88316,89805,1489
2022-12-10,70050,70056,Blue,1,58004,58300,296
2022-08-06,70054,70058,Blue,1,45623,45770,147
2022-09-03,70042,70048,Blue,1,60586,60930,344
2022-11-16,70057,70055,Blue,0,67177,67245,68
2022-06-21,70038,70044,Blue,1,78974,79159,185
2022-12-30,70041,70039,Blue,0,26970,27000,30
2022-03-01,70038,70042,Blue,1,45796,45911,115
2022-11-09,70042,70044,Blue,1,76878,76905,27
2022-10-04,70038,70048,Blue,1,56478,56984,506
2022-09-08,70051,70047,Blue,0,63252,63454,202
2022-09-21,70051,70043,Blue,0,42173,42730,557
2022-03-19,70051,70039,Blue,0,47428,48090,662
2022-06-27,70059,70053,Blue,0,86461,86679,218
2022-10-24,70044,70060,Blue,1,44204,45070,866
2022-06-24,70048,70050,Blue,1,61755,61811,56
2022-02-25,70038,70056,Blue,1,42553,43585,1032
2022-08-25,70057,70053,Blue,0,71846,71994,148
2022-12-23,70053,70039,Blue,0,23580,24371,791
2022-09-20,70055,70049,Blue,0,25722,26024,302
2022-02-16,70042,70052,Blue,1,31639,32219,580
2022-04-14,70053,70047,Blue,0,26930,27233,303
2022-04-06,70051,70049,Blue,0,48000,48101,101
2022-01-18,70039,70838,Blue,0,89411,89458,47
2022-02-07,70055,70047,Blue,0,26265,26690,425
2022-06-19,70055,70053,Blue,0,65355,65406,51
2022-03-22,70052,70058,Blue,1,70869,71141,272
2022-07-28,70049,70838,Blue,0,83351,83987,636
2022-03-14,70047,70043,Blue,0,58690,58926,236
2022-03-01,70059,70053,Blue,0,79453,79678,225
2022-01-24,70044,70054,Blue,1,41363,41895,532
2022-07-15,70041,70039,Blue,0,78516,78549,33
2022-12-21,70051,70039,Blue,0,36171,36884,713
2022-01-26,70057,70055,Blue,0,29449,29517,68
2022-06-25,70052,70058,Blue,1,64334,64595,261
2022-02-19,70055,70041,Blue,0,49971,50762,791
2022-08-17,70042,70044,Blue,1,72298,72327,29
2022-04-14,70048,70060,Blue,1,57619,58355,736
2022-09-06,70038,70058,Blue,1,32378,33367,989
2022-02-11,70040,70056,Blue,1,29117,29933,816
2022-06-26,70055,70053,Blue,0,81747,81796,49
2022-06-22,70038,70042,Blue,1,22344,22433,89
2022-08-11,70055,70043,Blue,0,87601,88224,623
2022-12-31,70057,70041,Blue,0,56916,57765,849
2022-04-04,70044,70056,Blue,1,54774,55463,689
2022-09-26,70045,70041,Blue,0,79288,79458,170
2022-09-25,70042,70056,Blue,1,75441,76230,789
2022-03-12,70054,70058,Blue,1,27782,27931,149
2022-08-31,70053,70051,Blue,0,53796,53856,60
2022-02-09,70038,70054,Blue,1,82145,83061,916
2022-04-01,70040,70060,Blue,1,61422,62552,1130
2022-05-18,70047,70039,Blue,0,27230,27853,623
2022-02-26,70042,70044,Blue,1,70339,70370,31
2022-11-25,70043,70041,Blue,0,26020,26050,30
2022-09-17,70047,70045,Blue,0,25432,25534,102
2022-06-25,70042,70054,Blue,1,48714,49438,724
2022-10-29,70041,70039,Blue,0,55033,55064,31
2022-07-04,70042,70060,Blue,1,83261,84318,1057
2022-07-06,70050,70054,Blue,1,41814,42028,214
2022-01-17,70045,70043,Blue,0,56517,56625,108
2022-01-25,70038,70046,Blue,1,51780,52118,338
2022-09-29,70045,70041,Blue,0,50173,50352,179
2022-03-03,70040,70060,Blue,1,88396,89614,1218
2022-03-31,70039,70838,Blue,0,25691,25727,36
2022-06-02,70038,70048,Blue,1,20606,21083,477
2022-08-10,70047,70838,Blue,0,32002,32574,572
2022-12-31,70057,70051,Blue,0,57511,57760,249
2022-02-25,70044,70048,Blue,1,44403,44699,296
2022-07-05,70049,70043,Blue,0,80510,80862,352
2022-11-29,70040,70042,Blue,1,77392,77421,29
2022-12-27,70049,70041,Blue,0,30452,30898,446
2022-07-21,70040,70052,Blue,1,57195,57890,695
2022-02-07,70057,70043,Blue,0,34769,35616,847
2022-11-30,70053,70051,Blue,0,80261,80315,54
2022-06-21,70053,70049,Blue,0,27870,28096,226
2022-05-19,70044,70050,Blue,1,81844,82233,389
2022-10-14,70040,70056,Blue,1,30323,31139,816
2022-07-15,70059,70057,Blue,0,28875,28912,37
2022-01-23,70038,70054,Blue,1,30015,30797,782
2022-10-15,70048,70060,Blue,1,39349,39961,612
2022-08-05,70055,70045,Blue,0,49576,50102,526
2022-09-30,70059,70057,Blue,0,54621,54655,34
2022-01-04,70055,70051,Blue,0,52283,52456,173
2022-02-25,70055,70051,Blue,0,46833,46987,154
2022-07-18,70053,70047,Blue,0,33358,33723,365
2022-04-14,70053,70045,Blue,0,62585,63082,497
2022-04-19,70046,70054,Blue,1,62021,62434,413
2022-12-24,70059,70051,Blue,0,75793,76134,341
2022-01-11,70049,70045,Blue,0,66689,66875,186
2022-07-04,70059,70049,Blue,0,70872,71360,488
2022-04-06,70055,70045,Blue,0,37191,37762,571
2022-07-17,70047,70043,Blue,0,38808,39067,259
2022-06-13,70040,70044,Blue,1,31216,31339,123
2022-04-19,70058,70060,Blue,1,58868,58940,72
2022-09-13,70057,70041,Blue,0,58837,59680,843
2022-08-17,70048,70054,Blue,1,31276,31591,315
2022-11-27,70044,70046,Blue,1,49062,49170,108
2022-10-01,70055,70039,Blue,0,27280,28179,899
2022-03-14,70040,70044,Blue,1,44167,44277,110
2022-03-04,70052,70060,Blue,1,23075,23400,325
2022-01-28,70038,70052,Blue,1,61625,62327,702
2022-11-21,70055,70838,Blue,0,53258,54183,925
2022-02-26,70054,70056,Blue,1,49417,49463,46
2022-09-09,70050,70052,Blue,1,81364,81479,115
2022-02-22,70040,70056,Blue,1,62897,63774,877
2022-09-28,70048,70052,Blue,1,80159,80353,194
2022-03-06,70046,70056,Blue,1,74595,75116,521
2022-07-12,70048,70056,Blue,1,47719,48146,427
2022-01-15,70059,70039,Blue,0,33557,34588,1031
2022-08-29,70057,70838,Blue,0,55707,56811,1104
2022-07-28,70044,70046,Blue,1,28851,28953,102
2022-01-10,70051,70041,Blue,0,59042,59622,580
2022-07-05,70044,70056,Blue,1,74928,75589,661
2022-11-22,70048,70050,Blue,1,45572,45629,57
2022-08-01,70059,70045,Blue,0,82640,83297,657
2022-05-17,70050,70056,Blue,1,65615,65948,333
2022-12-11,70057,70053,Blue,0,40238,40395,157
2022-01-12,70057,70039,Blue,0,66548,67474,926
2022-06-11,70044,70060,Blue,1,83854,84870,1016
2022-03-15,70040,70060,Blue,1,69499,70569,1070
2022-09-27,70038,70042,Blue,1,23714,23826,112
2022-02-25,70055,70047,Blue,0,28675,29083,408
2022-05-21,70042,70052,Blue,1,44485,45092,607
2022-12-05,70040,70050,Blue,1,23219,23712,493
2022-01-20,70042,70060,Blue,1,52938,54085,1147
2022-08-02,70056,70060,Blue,1,35934,36178,244
2022-09-20,70053,70051,Blue,0,43967,44026,59
2022-11-08,70055,70049,Blue,0,64354,64686,332
2022-10-03,70038,70056,Blue,1,44821,45737,916
2022-10-11,70056,70060,Blue,1,24252,24448,196
2022-03-05,70053,70039,Blue,0,60850,61602,752
2022-05-31,70047,70045,Blue,0,45482,45580,98
2022-03-20,70049,70039,Blue,0,49857,50407,550
2022-03-01,70051,70041,Blue,0,35075,35716,641
2022-10-31,70059,70053,Blue,0,42196,42427,231
2022-04-21,70038,70044,Blue,1,58440,58656,216
2022-02-16,70041,70838,Blue,0,88398,88506,108
2022-07-17,70038,70054,Blue,1,78559,79364,805
2022-10-13,70049,70043,Blue,0,53564,53928,364
2022-01-05,70055,70039,Blue,0,59192,60057,865
2022-06-29,70047,70039,Blue,0,58493,58903,410
2022-03-26,70057,70053,Blue,0,43890,44044,154
2022-11-18,70057,70049,Blue,0,51345,51742,397
2022-07-02,70040,70042,Blue,1,67522,67555,33
2022-03-12,70045,70041,Blue,0,49417,49589,172
2022-03-09,70059,70039,Blue,0,59301,60302,1001
2022-11-30,70051,70045,Blue,0,31686,32045,359
2022-09-19,70043,70039,Blue,0,51552,51669,117
2022-08-04,70052,70060,Blue,1,23701,24066,365
2022-12-31,70053,70045,Blue,0,60897,61349,452
2022-01-19,70059,70838,Blue,0,53128,54321,1193
2022-07-07,70045,70039,Blue,0,77681,77932,251
2022-04-21,70048,70050,Blue,1,75744,75804,60
2022-11-13,70040,70058,Blue,1,58129,59142,1013
2022-06-19,70047,70043,Blue,0,88850,89112,262
2022-09-13,70046,70052,Blue,1,54108,54422,314
2022-06-03,70046,70052,Blue,1,71773,72218,445
2022-03-07,70052,70054,Blue,1,87822,87872,50
2022-07-08,70059,70057,Blue,0,46828,46863,35
2022-12-27,70055,70051,Blue,0,48923,49070,147
2022-01-12,70041,70838,Blue,0,45997,46110,113
2022-01-06,70057,70055,Blue,0,70100,70170,70
2022-01-14,70044,70046,Blue,1,50483,50605,122
2022-04-10,70057,70045,Blue,0,69033,69660,627
2022-09-29,70048,70052,Blue,1,83236,83454,218
2022-12-24,70053,70043,Blue,0,25997,26570,573
2022-08-22,70045,70043,Blue,0,58757,58852,95
2022-08-07,70042,70052,Blue,1,28601,29138,537
2022-04-27,70052,70058,Blue,1,51766,52002,236
2022-11-21,70038,70044,Blue,1,32356,32538,182
2022-01-02,70044,70054,Blue,1,32553,33158,605
2022-07-12,70045,70041,Blue,0,59188,59390,202
2022-04-11,70055,70051,Blue,0,23565,23711,146
2022-06-23,70048,70050,Blue,1,60057,60118,61
2022-11-18,70053,70041,Blue,0,29878,30546,668
2022-06-23,70053,70039,Blue,0,58250,59118,868
2022-12-31,70040,70052,Blue,1,75270,75946,676
2022-03-26,70040,70056,Blue,1,48616,49517,901
2022-08-23,70040,70052,Blue,1,59238,59944,706
2022-02-03,70040,70052,Blue,1,27968,28687,719
2022-11-16,70049,70039,Blue,0,63430,63948,518
2022-08-12,70057,70041,Blue,0,82614,83506,892
2022-11-28,70045,70838,Blue,0,23742,24120,378
2022-02-22,70059,70041,Blue,0,73264,74366,1102
2022-02-09,70052,70054,Blue,1,63684,63744,60
2022-08-17,70050,70058,Blue,1,67660,68067,407
2022-01-20,70059,70045,Blue,0,32354,33087,733
2022-09-19,70053,70043,Blue,0,43980,44587,607
2022-11-01,70055,70051,Blue,0,41815,41969,154
2022-07-09,70038,70042,Blue,1,37754,37862,108
2022-03-13,70055,70053,Blue,0,44949,44995,46
2022-01-05,70057,70047,Blue,0,78390,78946,556
2022-02-14,70044,70058,Blue,1,72172,73039,867
2022-09-11,70045,70043,Blue,0,38936,39024,88
2022-12-20,70038,70040,Blue,1,23764,23780,16
2022-01-22,70040,70050,Blue,1,81423,81914,491
2022-09-06,70040,70048,Blue,1,69928,70316,388
2022-09-23,70057,70049,Blue,0,53679,54067,388
2022-07-27,70051,70047,Blue,0,58590,58786,196
2022-01-01,70051,70838,Blue,0,45060,45794,734
2022-01-28,70055,70047,Blue,0,37726,38142,416
2022-10-18,70040,70056,Blue,1,68576,69395,819
2022-04-13,70051,70047,Blue,0,82729,83068,339
2022-11-29,70040,70042,Blue,1,87427,87457,30
2022-10-09,70040,70042,Blue,1,64158,64191,33
2022-07-29,70055,70039,Blue,0,85155,86037,882
2022-04-06,70055,70045,Blue,0,72797,73320,523
2022-09-13,70057,70041,Blue,0,85248,86060,812
2022-12-20,70038,70050,Blue,1,34338,34922,584
2022-11-09,70057,70049,Blue,0,57591,57993,402
2022-05-31,70047,70045,Blue,0,72285,72403,118
2022-03-11,70044,70058,Blue,1,56434,57171,737
2022-04-20,70038,70058,Blue,1,68982,70001,1019
2022-12-20,70048,70054,Blue,1,47440,47726,286
2022-04-20,70048,70052,Blue,1,82562,82767,205
2022-12-29,70044,70058,Blue,1,50334,51165,831
2022-06-14,70044,70056,Blue,1,51425,52132,707
2022-04-16,70055,70049,Blue,0,28883,29190,307
2022-08-04,70040,70052,Blue,1,36011,36759,748
2022-07-17,70044,70050,Blue,1,62571,62915,344
2022-09-17,70040,70042,Blue,1,84791,84822,31
2022-02-01,70040,70058,Blue,1,54081,55285,1204
2022-11-02,70044,70048,Blue,1,56239,56472,233
2022-03-05,70046,70054,Blue,1,84154,84569,415
2022-01-19,70047,70041,Blue,0,20296,20674,378
2022-07-02,70042,70058,Blue,1,56303,57268,965
2022-02-25,70046,70058,Blue,1,65603,66228,625
2022-08-07,70053,70047,Blue,0,77325,77632,307
2022-02-26,70057,70041,Blue,0,42255,43134,879
2022-07-28,70055,70045,Blue,0,86587,87192,605
2022-08-27,70044,70056,Blue,1,64427,65070,643
2022-02-12,70057,70047,Blue,0,20253,20707,454
2022-03-02,70046,70056,Blue,1,69850,70479,629
2022-10-22,70055,70039,Blue,0,86720,87591,871
2022-11-17,70038,70052,Blue,1,30324,31050,726
2022-03-31,70055,70039,Blue,0,40092,41135,1043
2022-02-24,70057,70043,Blue,0,26433,27282,849
2022-05-19,70038,70046,Blue,1,33252,33600,348
2022-08-29,70049,70041,Blue,0,44194,44621,427
2022-08-06,70049,70041,Blue,0,87864,88323,459
2022-02-22,70057,70043,Blue,0,42143,42910,767
2022-12-21,70042,70048,Blue,1,60000,60322,322
2022-07-28,70042,70052,Blue,1,61855,62453,598
2022-08-31,70053,70051,Blue,0,28627,28690,63
2022-07-06,70054,70056,Blue,1,76733,76780,47
2022-11-16,70040,70054,Blue,1,48298,49075,777
2022-08-27,70038,70042,Blue,1,52328,52442,114
2022-09-07,70042,70060,Blue,1,40828,42871,2043
2022-04-13,70048,70054,Blue,1,51298,51634,336
2022-01-07,70040,70042,Blue,1,35307,35360,53
2022-03-15,70049,70045,Blue,0,83428,83668,240
2022-07-08,70043,70039,Blue,0,52616,52727,111
2022-10-15,70044,70052,Blue,1,53146,53641,495
2022-02-23,70051,70049,Blue,0,87909,88013,104
2022-04-08,70038,70060,Blue,1,35692,37089,1397
2022-02-10,70040,70046,Blue,1,46010,46281,271
2022-06-20,70057,70053,Blue,0,29391,29550,159
2022-11-06,70048,70054,Blue,1,68796,69103,307
2022-02-19,70051,70045,Blue,0,57730,58069,339
2022-06-29,70046,70056,Blue,1,34842,35347,505
2022-11-22,70040,70054,Blue,1,80151,80922,771
2022-09-17,70055,70053,Blue,0,65097,65157,60
2022-01-06,70059,70838,Blue,0,25455,26616,1161
2022-09-22,70055,70039,Blue,0,82136,82943,807
2022-07-24,70040,70046,Blue,1,27055,27321,266
2022-11-13,70048,70052,Blue,1,36720,36914,194
2022-10-14,70049,70045,Blue,0,58711,58911,200
2022-08-22,70038,70040,Blue,1,26474,26494,20
2022-10-08,70042,70058,Blue,1,77463,78346,883
2022-12-17,70055,70047,Blue,0,54808,55202,394
2022-04-21,70050,70058,Blue,1,28454,28853,399
2022-11-11,70038,70058,Blue,1,70060,71145,1085
2022-04-18,70055,70041,Blue,0,22005,22899,894
2022-08-01,70046,70058,Blue,1,53252,53992,740
2022-11-01,70044,70054,Blue,1,37579,38167,588
2022-08-10,70042,70048,Blue,1,51460,51776,316
2022-09-16,70041,70039,Blue,0,53028,53059,31
2022-03-01,70050,70058,Blue,1,64232,64852,620
2022-09-20,70055,70049,Blue,0,36079,36396,317
2022-07-09,70046,70058,Blue,1,33282,33979,697
2022-11-13,70052,70056,Blue,1,30764,30912,148
2022-02-18,70038,70050,Blue,1,20401,20988,587
2022-09-18,70056,70058,Blue,1,81929,82002,73
2022-11-13,70042,70056,Blue,1,43120,43847,727
2022-09-20,70056,70060,Blue,1,54670,54848,178
2022-03-31,70041,70039,Blue,0,23001,23036,35
2022-12-15,70052,70058,Blue,1,55252,55518,266
2022-10-14,70040,70042,Blue,1,60205,60236,31
2022-10-15,70040,70048,Blue,1,86489,86891,402
2022-06-28,70046,70052,Blue,1,45941,46302,361
2022-12-07,70038,70042,Blue,1,83366,83476,110
2022-12-18,70057,70049,Blue,0,68506,68956,450
2022-04-16,70059,70043,Blue,0,38418,39441,1023
2022-12-07,70040,70058,Blue,1,25691,26609,918
2022-03-02,70047,70045,Blue,0,48804,48908,104
2022-07-24,70038,70050,Blue,1,70445,70974,529
2022-09-20,70055,70838,Blue,0,30776,31791,1015
2022-09-03,70046,70048,Blue,1,35487,35568,81
2022-11-30,70044,70058,Blue,1,46074,46825,751
2022-03-08,70059,70055,Blue,0,23991,24138,147
2022-03-28,70057,70045,Blue,0,71612,72235,623
2022-09-03,70040,70046,Blue,1,41096,41366,270
2022-04-13,70046,70056,Blue,1,38224,38919,695
